District,Constituency,Subcounty,Parish,Polling Station,Reg.Voters,ABED BWANIKA,BESIGYE KIZZA,OBOTE KALULU,SSEBAANA JOHN,YOWERI KAGUTA,Valid Votes,Invalid Votes,Total Votes,NON_REP,Modified Station ID
KALANGALA,BUJUMBA COUNTY,BUJUMBA,BUJUMBA,BUJUMBA,565,1,0,61,182,158,402,14,416,0,O-11-59-01-01-01
KALANGALA,BUJUMBA COUNTY,BUJUMBA,BUJUMBA,BUSWA,109,2,0,4,44,24,74,0,74,0,O-11-59-01-01-02
KALANGALA,BUJUMBA COUNTY,BUJUMBA,BUNYAMA,BUNYAMA,172,1,0,0,42,58,101,5,106,0,O-11-59-01-02-01
KALANGALA,BUJUMBA COUNTY,BUJUMBA,BUNYAMA,BUBEMBE,309,2,1,13,110,55,181,3,184,0,O-11-59-01-02-02
KALANGALA,BUJUMBA COUNTY,BUJUMBA,BUNYAMA,BUYIGI,144,1,0,0,35,22,58,2,60,0,O-11-59-01-02-03
KALANGALA,BUJUMBA COUNTY,BUJUMBA,BUNYAMA,KIVUNZA,333,1,0,1,79,96,177,2,179,0,O-11-59-01-02-04
KALANGALA,BUJUMBA COUNTY,BUJUMBA,BWENDERO,BWENDERO,511,0,0,6,102,101,209,6,215,0,O-11-59-01-03-01
KALANGALA,BUJUMBA COUNTY,BUJUMBA,BWENDERO,BWEZA,268,1,0,0,42,59,102,19,121,0,O-11-59-01-03-02
KALANGALA,BUJUMBA COUNTY,BUJUMBA,BWENDERO,KAAZI/MALANGA,417,3,0,5,90,92,190,36,226,0,O-11-59-01-03-03
KALANGALA,BUJUMBA COUNTY,BUJUMBA,MULABANA,KASAMBA,264,0,1,5,75,70,151,7,158,0,O-11-59-01-04-01
KALANGALA,BUJUMBA COUNTY,BUJUMBA,MULABANA,KYAGALANYI,544,5,0,2,114,187,308,6,314,0,O-11-59-01-04-02
KALANGALA,BUJUMBA COUNTY,BUJUMBA,MULABANA,MAKOKO,180,0,0,0,24,65,89,4,93,0,O-11-59-01-04-03
KALANGALA,BUJUMBA COUNTY,BUJUMBA,MULABANA,NAKATIBA,527,5,3,1,112,135,256,4,260,0,O-11-59-01-04-04
KALANGALA,BUJUMBA COUNTY,KALANGALA T/C,KALANGALA A,KIBANGA,547,5,2,16,97,227,347,9,356,0,O-11-59-02-01-01
KALANGALA,BUJUMBA COUNTY,KALANGALA T/C,KALANGALA B,KALANGALA HQTRS.,909,11,0,10,208,335,564,12,576,0,O-11-59-02-02-01
KALANGALA,BUJUMBA COUNTY,KALANGALA T/C,KALANGALA B,SSESE FARM SCHOOL,451,1,1,10,113,139,264,7,271,0,O-11-59-02-02-02
KALANGALA,BUJUMBA COUNTY,KALANGALA T/C,KALANGALA B,MWEENA,371,4,0,9,70,136,219,6,225,0,O-11-59-02-02-03
KALANGALA,BUJUMBA COUNTY,MUGOYE,BBETA,BBETA,536,0,0,16,99,239,354,6,360,0,O-11-59-03-01-01
KALANGALA,BUJUMBA COUNTY,MUGOYE,BBETA,KASEKULO,646,7,0,15,169,183,374,16,390,0,O-11-59-03-01-02
KALANGALA,BUJUMBA COUNTY,MUGOYE,BBETA,KIBAALE,253,4,0,11,66,74,155,34,189,0,O-11-59-03-01-03
KALANGALA,BUJUMBA COUNTY,MUGOYE,BBETA,KIKWAYU,139,0,0,13,33,67,113,4,117,0,O-11-59-03-01-04
KALANGALA,BUJUMBA COUNTY,MUGOYE,BBETA,SENERO,190,0,0,1,44,75,120,21,141,0,O-11-59-03-01-05
KALANGALA,BUJUMBA COUNTY,MUGOYE,KAGULUBE,BUGOMA,451,2,0,17,154,134,307,7,314,0,O-11-59-03-02-01
KALANGALA,BUJUMBA COUNTY,MUGOYE,KAGULUBE,KAGULUBE,406,3,1,17,97,136,254,13,267,0,O-11-59-03-02-02
KALANGALA,BUJUMBA COUNTY,MUGOYE,KAGULUBE,MAGOBA,362,2,0,5,89,117,213,53,266,0,O-11-59-03-02-03
KALANGALA,BUJUMBA COUNTY,MUGOYE,KAYUNGA,BUMANGI,772,6,0,52,160,269,487,54,541,0,O-11-59-03-03-01
KALANGALA,BUJUMBA COUNTY,MUGOYE,KAYUNGA,BUSANGA,433,1,0,5,99,160,265,21,286,0,O-11-59-03-03-02
KALANGALA,BUJUMBA COUNTY,MUGOYE,KAYUNGA,NJOGA,212,2,0,1,49,68,120,6,126,0,O-11-59-03-03-03
KALANGALA,KYAMUSWA,BUFUMIRA,BUFUMIRA,BUFUMIRA,445,2,1,11,110,131,255,22,277,0,O-11-60-01-01-01
KALANGALA,KYAMUSWA,BUFUMIRA,BUFUMIRA,BUGABA,265,1,1,3,68,88,161,1,162,0,O-11-60-01-01-02
KALANGALA,KYAMUSWA,BUFUMIRA,BUFUMIRA,MBUGWE,51,0,0,2,1,4,7,0,7,0,O-11-60-01-01-03
KALANGALA,KYAMUSWA,BUFUMIRA,BUFUMIRA,BUYOVU,390,2,0,10,81,90,183,1,184,0,O-11-60-01-01-04
KALANGALA,KYAMUSWA,BUFUMIRA,LULAMBA,MISONZI,980,2,3,10,200,289,504,8,512,0,O-11-60-01-02-01
KALANGALA,KYAMUSWA,BUFUMIRA,LULAMBA,SERINYA,320,0,0,4,81,111,196,3,199,0,O-11-60-01-02-02
KALANGALA,KYAMUSWA,BUFUMIRA,LULAMBA,BANDA/KITOBO,272,1,0,2,82,69,154,1,155,0,O-11-60-01-02-03
KALANGALA,KYAMUSWA,BUFUMIRA,LULAMBA,KAMESE,357,1,0,6,56,142,205,20,225,0,O-11-60-01-02-04
KALANGALA,KYAMUSWA,BUFUMIRA,LULAMBA,KACHANGA,980,6,1,9,191,256,463,19,482,0,O-11-60-01-02-05
KALANGALA,KYAMUSWA,BUFUMIRA,LULAMBA,KITOBO A,846,2,1,12,211,205,431,17,448,0,O-11-60-01-02-06
KALANGALA,KYAMUSWA,BUFUMIRA,LULAMBA,KAAYA,350,0,1,5,74,117,197,14,211,0,O-11-60-01-02-07
KALANGALA,KYAMUSWA,BUFUMIRA,LULAMBA,KITOBO B,407,1,1,5,86,56,149,19,168,0,O-11-60-01-02-08
KALANGALA,KYAMUSWA,JAANA BUBEKE-JAAWA,BUBEKE,KANDE,398,3,0,12,68,184,267,14,281,0,O-11-60-02-01-01
KALANGALA,KYAMUSWA,JAANA BUBEKE-JAAWA,BUBEKE,BUYANGE,461,3,0,10,86,130,229,7,236,0,O-11-60-02-01-02
KALANGALA,KYAMUSWA,JAANA BUBEKE-JAAWA,BUBEKE,NKESE,482,1,0,2,177,73,253,5,258,0,O-11-60-02-01-03
KALANGALA,KYAMUSWA,JAANA BUBEKE-JAAWA,BUBEKE,MISISI,465,0,1,16,84,177,278,5,283,0,O-11-60-02-01-04
KALANGALA,KYAMUSWA,JAANA BUBEKE-JAAWA,JAANA,KIIKU,306,6,0,5,49,127,187,8,195,0,O-11-60-02-02-01
KALANGALA,KYAMUSWA,JAANA BUBEKE-JAAWA,JAANA,LWAZI,338,0,0,4,69,109,182,10,192,0,O-11-60-02-02-02
KALANGALA,KYAMUSWA,KYAMUSWA,BUWANGA,BUWANGA,274,5,0,9,52,131,197,6,203,0,O-11-60-03-01-01
KALANGALA,KYAMUSWA,KYAMUSWA,BUWANGA,LWANABATYA,297,2,0,4,103,69,178,6,184,0,O-11-60-03-01-02
KALANGALA,KYAMUSWA,KYAMUSWA,BUWANGA,NTUWA,186,0,0,9,51,58,118,6,124,0,O-11-60-03-01-03
KALANGALA,KYAMUSWA,KYAMUSWA,BUZINGO,BUZINGO,212,0,0,5,45,85,135,3,138,0,O-11-60-03-02-01
KALANGALA,KYAMUSWA,KYAMUSWA,BUZINGO,BUWAZI,106,0,0,19,16,44,79,3,82,0,O-11-60-03-02-02
KALANGALA,KYAMUSWA,KYAMUSWA,BUZINGO,KISABA,675,1,1,12,156,134,304,4,308,0,O-11-60-03-02-03
KALANGALA,KYAMUSWA,KYAMUSWA,BUZINGO,NAKIBANGA,366,0,1,15,70,116,202,9,211,0,O-11-60-03-02-04
KALANGALA,KYAMUSWA,MAZINGA,BUGALA,BUGGALA,505,0,0,9,91,133,233,14,247,0,O-11-60-04-01-01
KALANGALA,KYAMUSWA,MAZINGA,BUGALA,KIRUGU,195,0,0,0,43,29,72,0,72,0,O-11-60-04-01-02
KALANGALA,KYAMUSWA,MAZINGA,BUGALA,NKOSE,595,3,2,8,176,103,292,3,295,0,O-11-60-04-01-03
KALANGALA,KYAMUSWA,MAZINGA,BUGALA,GUNGA,282,3,0,5,57,105,170,3,173,0,O-11-60-04-01-04
KALANGALA,KYAMUSWA,MAZINGA,BUTULUME,FUNVE,432,1,0,8,103,96,208,8,216,0,O-11-60-04-02-01
KALANGALA,KYAMUSWA,MAZINGA,BUTULUME,LUJAABWA,708,1,0,13,143,214,371,11,382,0,O-11-60-04-02-02
KALANGALA,KYAMUSWA,MAZINGA,BUTULUME,KYESERWA,233,0,0,4,77,90,171,3,174,0,O-11-60-04-02-03
KAMPALA,KAMPALA CENTRAL,KAMPALA CENTRAL,BUKESA,BAPTIST CHURCH,748,11,0,13,224,213,461,7,468,0,O-12-61-01-01-01
KAMPALA,KAMPALA CENTRAL,KAMPALA CENTRAL,BUKESA,HOIMA RD FLATS,513,4,0,10,174,104,292,0,292,0,O-12-61-01-01-02
KAMPALA,KAMPALA CENTRAL,KAMPALA CENTRAL,BUKESA,REV. CANON KIJJAMBU S HOME,1038,2,2,10,279,304,597,5,602,0,O-12-61-01-01-03
KAMPALA,KAMPALA CENTRAL,KAMPALA CENTRAL,BUKESA,GONZAGA S HOME,1107,5,4,9,277,361,656,14,670,0,O-12-61-01-01-04
KAMPALA,KAMPALA CENTRAL,KAMPALA CENTRAL,BUKESA,HAJJ KATENDES HOME [A - M],633,1,4,16,236,131,388,4,392,0,O-12-61-01-01-05
KAMPALA,KAMPALA CENTRAL,KAMPALA CENTRAL,BUKESA,KIYINDI MOSQUE,281,1,0,2,69,95,167,6,173,0,O-12-61-01-01-06
KAMPALA,KAMPALA CENTRAL,KAMPALA CENTRAL,BUKESA,BUKESA PARISH PR. SCH.,559,2,0,15,163,131,311,5,316,0,O-12-61-01-01-07
KAMPALA,KAMPALA CENTRAL,KAMPALA CENTRAL,BUKESA,KALANZI,519,3,1,3,159,143,309,4,313,0,O-12-61-01-01-08
KAMPALA,KAMPALA CENTRAL,KAMPALA CENTRAL,BUKESA,MUTI BAY CAR WASHING BAY,265,10,1,0,30,85,126,8,134,0,O-12-61-01-01-09
KAMPALA,KAMPALA CENTRAL,KAMPALA CENTRAL,BUKESA,HAJJ KATENDES HOME [N - Z],548,2,2,16,178,133,331,6,337,0,O-12-61-01-01-10
KAMPALA,KAMPALA CENTRAL,KAMPALA CENTRAL,CIVIC CENTRE,CITY HALL,1098,1,1,8,297,192,499,9,508,0,O-12-61-01-02-01
KAMPALA,KAMPALA CENTRAL,KAMPALA CENTRAL,INDUSTRIAL AREA,K.C.C YARD,587,2,4,8,188,130,332,8,340,0,O-12-61-01-03-01
KAMPALA,KAMPALA CENTRAL,KAMPALA CENTRAL,KAGUGUBE,MR. MUKIIBIS HOME [A - M],1139,0,1,5,246,257,509,80,589,0,O-12-61-01-04-01
KAMPALA,KAMPALA CENTRAL,KAMPALA CENTRAL,KAGUGUBE,KAGUGUBE,1305,5,0,12,367,326,710,9,719,0,O-12-61-01-04-02
KAMPALA,KAMPALA CENTRAL,KAMPALA CENTRAL,KAGUGUBE,KITAMANYANGAMBA,1421,2,1,9,287,342,641,6,647,0,O-12-61-01-04-03
KAMPALA,KAMPALA CENTRAL,KAMPALA CENTRAL,KAGUGUBE,KIVVULU I,1163,3,2,12,318,311,646,12,658,0,O-12-61-01-04-04
KAMPALA,KAMPALA CENTRAL,KAMPALA CENTRAL,KAGUGUBE,KIVVULU II,1132,1,0,5,218,283,507,7,514,0,O-12-61-01-04-05
KAMPALA,KAMPALA CENTRAL,KAMPALA CENTRAL,KAGUGUBE,NHCC FLATS,326,2,3,1,70,89,165,10,175,0,O-12-61-01-04-06
KAMPALA,KAMPALA CENTRAL,KAMPALA CENTRAL,KAGUGUBE,MR. MUKIIBIS HOME [N - Z],759,1,0,7,187,153,348,49,397,0,O-12-61-01-04-07
KAMPALA,KAMPALA CENTRAL,KAMPALA CENTRAL,KAMWOKYA I,ARYA PRIMARY SCHOOL,897,7,4,5,265,233,514,6,520,0,O-12-61-01-05-01
KAMPALA,KAMPALA CENTRAL,KAMPALA CENTRAL,KAMWOKYA I,KIIRA ROAD POLICE PLAYGROUN,824,6,4,4,222,208,444,27,471,0,O-12-61-01-05-02
KAMPALA,KAMPALA CENTRAL,KAMPALA CENTRAL,KAMWOKYA II,CENTRAL ZONE,654,0,1,2,136,234,373,4,377,0,O-12-61-01-06-01
KAMPALA,KAMPALA CENTRAL,KAMPALA CENTRAL,KAMWOKYA II,OLD CATHOLIC CHURCH [A- K],864,1,1,8,220,280,510,17,527,0,O-12-61-01-06-02
KAMPALA,KAMPALA CENTRAL,KAMPALA CENTRAL,KAMWOKYA II,KAVULE (A-M),757,3,1,6,234,158,402,13,415,0,O-12-61-01-06-03
KAMPALA,KAMPALA CENTRAL,KAMPALA CENTRAL,KAMWOKYA II,GREEN VALLEY PRI. SCH.[A-M],661,0,0,1,92,249,342,48,390,0,O-12-61-01-06-04
KAMPALA,KAMPALA CENTRAL,KAMPALA CENTRAL,KAMWOKYA II,NURSERY SCHOOL [A - K],781,0,2,1,166,282,451,0,451,0,O-12-61-01-06-05
KAMPALA,KAMPALA CENTRAL,KAMPALA CENTRAL,KAMWOKYA II,HOMSDALLEN PRIMARY SCH.[A-M],642,2,0,1,125,220,348,4,352,0,O-12-61-01-06-06
KAMPALA,KAMPALA CENTRAL,KAMPALA CENTRAL,KAMWOKYA II,JAMBULA [A-M],448,0,0,3,158,109,270,2,272,0,O-12-61-01-06-07
KAMPALA,KAMPALA CENTRAL,KAMPALA CENTRAL,KAMWOKYA II,COMMUNITY [A - K],738,0,1,4,224,186,415,1,416,0,O-12-61-01-06-08
KAMPALA,KAMPALA CENTRAL,KAMPALA CENTRAL,KAMWOKYA II,PARK YARD [A-Z],528,1,2,1,168,190,362,3,365,0,O-12-61-01-06-09
KAMPALA,KAMPALA CENTRAL,KAMPALA CENTRAL,KAMWOKYA II,MUYEMBE K.C.C OFFICE,607,3,0,7,191,177,378,2,380,0,O-12-61-01-06-10
KAMPALA,KAMPALA CENTRAL,KAMPALA CENTRAL,KAMWOKYA II,OLD CATHOLIC CHURCH [N- Z],1027,2,0,9,302,335,648,8,656,0,O-12-61-01-06-11
KAMPALA,KAMPALA CENTRAL,KAMPALA CENTRAL,KAMWOKYA II,NURSERY SCHOOL [O - Z],476,3,1,0,118,135,257,2,259,0,O-12-61-01-06-12
KAMPALA,KAMPALA CENTRAL,KAMPALA CENTRAL,KAMWOKYA II,COMMUNITY [L - NAZ],671,0,1,8,203,197,409,5,414,0,O-12-61-01-06-13
KAMPALA,KAMPALA CENTRAL,KAMPALA CENTRAL,KAMWOKYA II,OLD CATHOLIC CHURCH (L-M,344,1,1,5,108,107,222,3,225,0,O-12-61-01-06-14
KAMPALA,KAMPALA CENTRAL,KAMPALA CENTRAL,KAMWOKYA II,KAVULE (N-Z),577,2,0,13,182,112,309,26,335,0,O-12-61-01-06-15
KAMPALA,KAMPALA CENTRAL,KAMPALA CENTRAL,KAMWOKYA II,GREEN VALLEY PRI. SCH(N-Z),507,0,0,4,122,177,303,7,310,0,O-12-61-01-06-16
KAMPALA,KAMPALA CENTRAL,KAMPALA CENTRAL,KAMWOKYA II,NURSERY SCHOOL [L - N],881,0,1,1,123,298,423,1,424,0,O-12-61-01-06-17
KAMPALA,KAMPALA CENTRAL,KAMPALA CENTRAL,KAMWOKYA II,HOMSDALLEN PRIMARY SCH.[N-Z],472,0,3,1,79,152,235,1,236,0,O-12-61-01-06-18
KAMPALA,KAMPALA CENTRAL,KAMPALA CENTRAL,KAMWOKYA II,JAMBULA [N-Z],456,1,0,2,134,139,276,1,277,0,O-12-61-01-06-19
KAMPALA,KAMPALA CENTRAL,KAMPALA CENTRAL,KAMWOKYA II,COMMUNITY [NDA - Z],617,1,2,6,207,117,333,10,343,0,O-12-61-01-06-20
KAMPALA,KAMPALA CENTRAL,KAMPALA CENTRAL,KAMWOKYA II,PARK YARD[N-Z,406,3,0,4,133,123,263,5,268,0,O-12-61-01-06-21
KAMPALA,KAMPALA CENTRAL,KAMPALA CENTRAL,KISENYI I,CHAIRMAN S PLACE,339,1,0,3,97,84,185,6,191,0,O-12-61-01-07-01
KAMPALA,KAMPALA CENTRAL,KAMPALA CENTRAL,KISENYI I,NABAGEREKA PRIMARY SCH.,474,4,0,3,146,155,308,3,311,0,O-12-61-01-07-02
KAMPALA,KAMPALA CENTRAL,KAMPALA CENTRAL,KISENYI I,CHAIRMAN S PLACE,882,4,0,9,286,213,512,1,513,0,O-12-61-01-07-03
KAMPALA,KAMPALA CENTRAL,KAMPALA CENTRAL,KISENYI I,SPIDIQA [A - K],815,2,3,5,201,235,446,2,448,0,O-12-61-01-07-04
KAMPALA,KAMPALA CENTRAL,KAMPALA CENTRAL,KISENYI I,SPIDIQA [L - N],788,2,0,10,193,190,395,4,399,0,O-12-61-01-07-05
KAMPALA,KAMPALA CENTRAL,KAMPALA CENTRAL,KISENYI I,SPIDIQA [O - Z],447,3,0,6,138,91,238,6,244,0,O-12-61-01-07-06
KAMPALA,KAMPALA CENTRAL,KAMPALA CENTRAL,KISENYI II,CHURCH,1200,3,0,22,355,233,613,5,618,0,O-12-61-01-08-01
KAMPALA,KAMPALA CENTRAL,KAMPALA CENTRAL,KISENYI II,KAKAJJO LC,1348,6,5,16,248,305,580,23,603,0,O-12-61-01-08-02
KAMPALA,KAMPALA CENTRAL,KAMPALA CENTRAL,KISENYI II,KASAATO LC[A-M],1003,2,1,6,158,259,426,6,432,0,O-12-61-01-08-03
KAMPALA,KAMPALA CENTRAL,KAMPALA CENTRAL,KISENYI II,LUVUMA BAR,874,1,0,12,250,186,449,12,461,0,O-12-61-01-08-04
KAMPALA,KAMPALA CENTRAL,KAMPALA CENTRAL,KISENYI II,KALINA (A-M),795,1,0,13,192,229,435,7,442,0,O-12-61-01-08-05
KAMPALA,KAMPALA CENTRAL,KAMPALA CENTRAL,KISENYI II,BALIKUDDEMBE PRIMARY SCH.,683,1,0,8,188,179,376,2,378,0,O-12-61-01-08-06
KAMPALA,KAMPALA CENTRAL,KAMPALA CENTRAL,KISENYI II,NAKIVUBO SETTLEMENT,427,0,0,5,120,133,258,9,267,0,O-12-61-01-08-07
KAMPALA,KAMPALA CENTRAL,KAMPALA CENTRAL,KISENYI II,KALINA (N - Z),668,2,0,14,188,172,376,5,381,0,O-12-61-01-08-08
KAMPALA,KAMPALA CENTRAL,KAMPALA CENTRAL,KISENYI II,K.C.C. WATER TAP,826,1,1,5,212,233,452,13,465,0,O-12-61-01-08-09
KAMPALA,KAMPALA CENTRAL,KAMPALA CENTRAL,KISENYI II,NAKIVUBO BLUE [A-M],888,2,1,5,242,227,477,9,486,0,O-12-61-01-08-10
KAMPALA,KAMPALA CENTRAL,KAMPALA CENTRAL,KISENYI II,KASAATO LC[N-Z],613,2,1,5,110,117,235,0,235,0,O-12-61-01-08-11
KAMPALA,KAMPALA CENTRAL,KAMPALA CENTRAL,KISENYI II,DR LUMU PLACE,439,0,0,5,103,141,249,6,255,0,O-12-61-01-08-12
KAMPALA,KAMPALA CENTRAL,KAMPALA CENTRAL,KISENYI II,NAKIVUBO BLUE[N-Z],589,2,1,10,186,164,363,8,371,0,O-12-61-01-08-13
KAMPALA,KAMPALA CENTRAL,KAMPALA CENTRAL,KISENYI III,LC MEETING PLACE-KITAWULUZI,697,5,0,4,224,193,426,8,434,0,O-12-61-01-09-01
KAMPALA,KAMPALA CENTRAL,KAMPALA CENTRAL,KISENYI III,KIGULI MANGO TREE,789,1,2,8,217,244,472,9,481,0,O-12-61-01-09-02
KAMPALA,KAMPALA CENTRAL,KAMPALA CENTRAL,KISENYI III,PLAYGROUND NEAR THE WELL,890,0,1,9,311,203,524,12,536,0,O-12-61-01-09-03
KAMPALA,KAMPALA CENTRAL,KAMPALA CENTRAL,KISENYI III,LORRY PARK,1574,3,1,8,592,301,905,25,930,0,O-12-61-01-09-04
KAMPALA,KAMPALA CENTRAL,KAMPALA CENTRAL,KISENYI III,SAPOBA,167,0,0,3,79,52,134,4,138,0,O-12-61-01-09-05
KAMPALA,KAMPALA CENTRAL,KAMPALA CENTRAL,KOLOLO I,EAST KOLOLO PRIMARY SCH.,890,6,5,3,264,267,545,44,589,0,O-12-61-01-10-01
KAMPALA,KAMPALA CENTRAL,KAMPALA CENTRAL,KOLOLO II,KISEMENTI [A - M],525,3,2,3,144,163,315,1,316,0,O-12-61-01-11-01
KAMPALA,KAMPALA CENTRAL,KAMPALA CENTRAL,KOLOLO II,KISEMENTI [N - Z],379,2,0,2,113,104,221,0,221,0,O-12-61-01-11-02
KAMPALA,KAMPALA CENTRAL,KAMPALA CENTRAL,KOLOLO II,S.VIEW BARRACKS (A - H),425,1,0,0,7,358,366,3,369,0,O-12-61-01-11-03
KAMPALA,KAMPALA CENTRAL,KAMPALA CENTRAL,KOLOLO II,S.VIEW BARRACKS (I - M),517,0,0,0,16,436,452,18,470,0,O-12-61-01-11-04
KAMPALA,KAMPALA CENTRAL,KAMPALA CENTRAL,KOLOLO II,S.VIEW BARRACKS (N - Z),549,0,0,0,13,509,522,20,542,0,O-12-61-01-11-05
KAMPALA,KAMPALA CENTRAL,KAMPALA CENTRAL,KOLOLO III,KITANTEPRIMARY SCHOOL,416,2,0,1,99,125,227,1,228,0,O-12-61-01-12-01
KAMPALA,KAMPALA CENTRAL,KAMPALA CENTRAL,KOLOLO III,KITANTE HILL SCHOOL,429,7,1,3,115,123,249,1,250,0,O-12-61-01-12-02
KAMPALA,KAMPALA CENTRAL,KAMPALA CENTRAL,KOLOLO III,KITANTE COURTS (DMI)[A-L],476,0,0,1,39,347,387,19,406,0,O-12-61-01-12-03
KAMPALA,KAMPALA CENTRAL,KAMPALA CENTRAL,KOLOLO III,KITANTE COURTS (DMI)[M-Z],547,0,0,1,65,357,423,4,427,0,O-12-61-01-12-04
KAMPALA,KAMPALA CENTRAL,KAMPALA CENTRAL,KOLOLO IV,COMMUNITY FLATS,264,5,5,1,90,67,168,0,168,0,O-12-61-01-13-01
KAMPALA,KAMPALA CENTRAL,KAMPALA CENTRAL,KOLOLO IV,MANAGEMENT INSTITUTE,719,5,8,2,245,166,426,15,441,0,O-12-61-01-13-02
KAMPALA,KAMPALA CENTRAL,KAMPALA CENTRAL,KOLOLO IV,CORAL CRESCENT,322,2,3,3,74,93,175,0,175,0,O-12-61-01-13-03
KAMPALA,KAMPALA CENTRAL,KAMPALA CENTRAL,MENGO,BUDONIAN CLUB,426,1,0,13,129,97,240,9,249,0,O-12-61-01-14-01
KAMPALA,KAMPALA CENTRAL,KAMPALA CENTRAL,MENGO,RUBAGA PARISH COMPOUND,562,3,1,4,110,140,258,2,260,0,O-12-61-01-14-02
KAMPALA,KAMPALA CENTRAL,KAMPALA CENTRAL,MENGO,K.C.C. CLINIC,640,1,0,19,163,170,353,9,362,0,O-12-61-01-14-03
KAMPALA,KAMPALA CENTRAL,KAMPALA CENTRAL,MENGO,NANNOZI LC MEETING PLACE [A -,762,3,2,10,223,196,434,6,440,0,O-12-61-01-14-04
KAMPALA,KAMPALA CENTRAL,KAMPALA CENTRAL,MENGO,KITAWULUZI,1110,5,0,28,329,267,629,21,650,0,O-12-61-01-14-05
KAMPALA,KAMPALA CENTRAL,KAMPALA CENTRAL,MENGO,RUBAGA ROAD B LC MEETING PL,1388,4,0,47,398,352,801,7,808,0,O-12-61-01-14-06
KAMPALA,KAMPALA CENTRAL,KAMPALA CENTRAL,MENGO,MZEE SEMPEBWA S PLACE,678,4,2,4,170,140,320,50,370,0,O-12-61-01-14-07
KAMPALA,KAMPALA CENTRAL,KAMPALA CENTRAL,MENGO,MENGO SOCIAL CENTRE [A-M],655,2,2,11,162,218,395,3,398,0,O-12-61-01-14-08
KAMPALA,KAMPALA CENTRAL,KAMPALA CENTRAL,MENGO,SERWANGA [A - M],662,2,2,7,188,193,392,6,398,0,O-12-61-01-14-09
KAMPALA,KAMPALA CENTRAL,KAMPALA CENTRAL,MENGO,RUBAGA ROAD PRINTERY,934,2,2,21,221,240,486,8,494,0,O-12-61-01-14-10
KAMPALA,KAMPALA CENTRAL,KAMPALA CENTRAL,MENGO,NANNOZI LC MEETING PLACE [N -,686,1,1,9,213,184,408,9,417,0,O-12-61-01-14-11
KAMPALA,KAMPALA CENTRAL,KAMPALA CENTRAL,MENGO,SERWANGA [N - Z],536,2,2,12,174,138,328,5,333,0,O-12-61-01-14-12
KAMPALA,KAMPALA CENTRAL,KAMPALA CENTRAL,MENGO,MENGO SOCIAL CENTRE [N-Z],511,0,1,8,126,153,288,8,296,0,O-12-61-01-14-13
KAMPALA,KAMPALA CENTRAL,KAMPALA CENTRAL,NAKASERO I,CRESTED TOWERS,1047,3,4,3,283,316,609,1,610,0,O-12-61-01-15-01
KAMPALA,KAMPALA CENTRAL,KAMPALA CENTRAL,NAKASERO II,ALL SAINTS CHURCH [A-J],304,4,3,0,78,93,178,2,180,0,O-12-61-01-16-01
KAMPALA,KAMPALA CENTRAL,KAMPALA CENTRAL,NAKASERO II,MINISTRY OF INFORMATION,270,2,1,1,74,71,149,9,158,0,O-12-61-01-16-02
KAMPALA,KAMPALA CENTRAL,KAMPALA CENTRAL,NAKASERO II,ALL SAINTS CHURCH [N - Z],465,4,2,4,131,127,268,11,279,0,O-12-61-01-16-03
KAMPALA,KAMPALA CENTRAL,KAMPALA CENTRAL,NAKASERO II,ALL SAINTS CHURCH [K-M],457,4,1,8,111,165,289,4,293,0,O-12-61-01-16-04
KAMPALA,KAMPALA CENTRAL,KAMPALA CENTRAL,NAKASERO II,OUTSIDE Q. GUARD [A-L],520,1,0,0,17,494,512,4,516,0,O-12-61-01-16-05
KAMPALA,KAMPALA CENTRAL,KAMPALA CENTRAL,NAKASERO II,OUTSIDE Q. GUARD [M-Z],577,0,0,0,15,558,573,3,576,0,O-12-61-01-16-06
KAMPALA,KAMPALA CENTRAL,KAMPALA CENTRAL,NAKASERO III,PUBLIC LIBRARY,1136,7,2,14,368,218,609,12,621,0,O-12-61-01-17-01
KAMPALA,KAMPALA CENTRAL,KAMPALA CENTRAL,NAKASERO III,BAT VALLEY PRIMARY SCH.,1059,2,3,6,349,218,578,2,580,0,O-12-61-01-17-02
KAMPALA,KAMPALA CENTRAL,KAMPALA CENTRAL,NAKASERO IV,CITY HOUSE LC OFFICE,497,1,0,22,210,94,327,4,331,0,O-12-61-01-18-01
KAMPALA,KAMPALA CENTRAL,KAMPALA CENTRAL,NAKASERO IV,NAKASERO MARKET PARKING YA,1373,1,2,13,581,277,874,4,878,0,O-12-61-01-18-02
KAMPALA,KAMPALA CENTRAL,KAMPALA CENTRAL,NAKASERO IV,UTC YARD,691,0,0,7,286,117,410,2,412,0,O-12-61-01-18-03
KAMPALA,KAMPALA CENTRAL,KAMPALA CENTRAL,NAKIVUBO,MUNNO OFFICES,793,0,0,7,218,67,292,4,296,0,O-12-61-01-19-01
KAMPALA,KAMPALA CENTRAL,KAMPALA CENTRAL,NAKIVUBO,CHILDREN S LIBRARY (REMAND),514,0,3,3,127,79,212,2,214,0,O-12-61-01-19-02
KAMPALA,KAMPALA CENTRAL,KAMPALA CENTRAL,NAKIVUBO,CHILDRENS LIBRARY (SALONPAS),421,0,0,3,104,37,144,3,147,0,O-12-61-01-19-03
KAMPALA,KAMPALA CENTRAL,KAMPALA CENTRAL,NAKIVUBO,KATIMBA,891,0,1,4,213,115,333,0,333,0,O-12-61-01-19-04
KAMPALA,KAMPALA CENTRAL,KAMPALA CENTRAL,OLD KAMPALA,MARTIN ROAD. A,940,2,3,8,285,174,472,1,473,0,O-12-61-01-20-01
KAMPALA,KAMPALA CENTRAL,KAMPALA CENTRAL,OLD KAMPALA,MARTIN ROAD [A-M],630,4,0,12,192,180,388,2,390,0,O-12-61-01-20-02
KAMPALA,KAMPALA CENTRAL,KAMPALA CENTRAL,OLD KAMPALA,OLD KAMPALA S.S.S.,702,7,2,8,149,227,393,3,396,0,O-12-61-01-20-03
KAMPALA,KAMPALA CENTRAL,KAMPALA CENTRAL,OLD KAMPALA,MARTIN ROAD [N-Z],425,1,4,8,139,76,228,1,229,0,O-12-61-01-20-04
KAMPALA,KAWEMPE DIV. NORTH,KAWEMPE DIVISION,BWAYISE I,BISHOP MUKWAYA PR. SCH.[A-NA,590,2,1,12,219,113,347,7,354,0,O-12-62-01-01-01
KAMPALA,KAWEMPE DIV. NORTH,KAWEMPE DIVISION,BWAYISE I,BUBWAJWE C/U [A-NAB],448,0,0,6,168,88,262,3,265,0,O-12-62-01-01-02
KAMPALA,KAWEMPE DIV. NORTH,KAWEMPE DIVISION,BWAYISE I,AMUDAT PR. SCH.,1067,0,1,7,352,208,568,6,574,0,O-12-62-01-01-03
KAMPALA,KAWEMPE DIV. NORTH,KAWEMPE DIVISION,BWAYISE I,GLORY PR. SCH. (A - K),725,0,0,7,299,109,415,3,418,0,O-12-62-01-01-04
KAMPALA,KAWEMPE DIV. NORTH,KAWEMPE DIVISION,BWAYISE I,WEST MENGO GROUND,732,1,0,6,174,103,284,3,287,0,O-12-62-01-01-05
KAMPALA,KAWEMPE DIV. NORTH,KAWEMPE DIVISION,BWAYISE I,LC I OFFICE (A - M),780,2,0,6,295,147,450,3,453,0,O-12-62-01-01-06
KAMPALA,KAWEMPE DIV. NORTH,KAWEMPE DIVISION,BWAYISE I,SHEIKH KULUMBA' S RESIDENCE [,641,3,2,7,243,116,371,2,373,0,O-12-62-01-01-07
KAMPALA,KAWEMPE DIV. NORTH,KAWEMPE DIVISION,BWAYISE I,NEW BUBAJWE PR. SCH.,661,1,3,12,243,140,399,3,402,0,O-12-62-01-01-08
KAMPALA,KAWEMPE DIV. NORTH,KAWEMPE DIVISION,BWAYISE I,SEMPA SHOPING CENTRE,732,2,1,13,294,128,438,9,447,0,O-12-62-01-01-09
KAMPALA,KAWEMPE DIV. NORTH,KAWEMPE DIVISION,BWAYISE I,GLORY PR. SCH. (L - M),424,0,0,2,178,60,240,0,240,0,O-12-62-01-01-10
KAMPALA,KAWEMPE DIV. NORTH,KAWEMPE DIVISION,BWAYISE I,LC I OFFICE (N - Z),704,2,1,6,242,122,373,4,377,0,O-12-62-01-01-11
KAMPALA,KAWEMPE DIV. NORTH,KAWEMPE DIVISION,BWAYISE I,GLORY PR. SCH.(N-NAMA),466,0,0,6,122,80,208,37,245,0,O-12-62-01-01-12
KAMPALA,KAWEMPE DIV. NORTH,KAWEMPE DIVISION,BWAYISE I,GLORY PR. SCH. (O - Z),465,1,0,8,197,72,278,2,280,0,O-12-62-01-01-13
KAMPALA,KAWEMPE DIV. NORTH,KAWEMPE DIVISION,BWAYISE I,BISHOP MUKWAYA PR. SCH.[NAK-,596,2,1,12,219,113,347,7,354,0,O-12-62-01-01-14
KAMPALA,KAWEMPE DIV. NORTH,KAWEMPE DIVISION,BWAYISE I,BUBWAJWE C/U [NAC-Z],488,1,0,6,174,103,284,3,287,0,O-12-62-01-01-15
KAMPALA,KAWEMPE DIV. NORTH,KAWEMPE DIVISION,BWAYISE I,SHEIKH KULUMBA' S RESIDENCE [,492,1,1,4,174,86,266,8,274,0,O-12-62-01-01-16
KAMPALA,KAWEMPE DIV. NORTH,KAWEMPE DIVISION,BWAYISE I,GLORY PR. SCH.(NAMB-NZ),441,1,0,2,142,87,232,0,232,0,O-12-62-01-01-17
KAMPALA,KAWEMPE DIV. NORTH,KAWEMPE DIVISION,KANYANYA,LC I MEETING PLACE (A - KIM),762,2,0,17,292,137,448,5,453,0,O-12-62-01-02-01
KAMPALA,KAWEMPE DIV. NORTH,KAWEMPE DIVISION,KANYANYA,ST. JOHN PR. SCH.[A-NAK],634,1,0,9,168,125,303,3,306,0,O-12-62-01-02-02
KAMPALA,KAWEMPE DIV. NORTH,KAWEMPE DIVISION,KANYANYA,KANYANYA POLICE POST (A-K),921,3,0,12,337,179,531,5,536,0,O-12-62-01-02-03
KAMPALA,KAWEMPE DIV. NORTH,KAWEMPE DIVISION,KANYANYA,KANYANYA POLICE POST (N - NAL,576,0,1,0,166,122,289,0,289,0,O-12-62-01-02-04
KAMPALA,KAWEMPE DIV. NORTH,KAWEMPE DIVISION,KANYANYA,KANYANYA POLICE POST (O - Z),531,1,0,15,236,81,333,1,334,0,O-12-62-01-02-05
KAMPALA,KAWEMPE DIV. NORTH,KAWEMPE DIVISION,KANYANYA,ST. PETER'S PRIMARY SCHOOL (A,386,3,0,5,143,89,240,2,242,0,O-12-62-01-02-06
KAMPALA,KAWEMPE DIV. NORTH,KAWEMPE DIVISION,KANYANYA,ST. PETER'S PRIMARY SCHOOL (N,466,3,0,9,138,106,256,4,260,0,O-12-62-01-02-07
KAMPALA,KAWEMPE DIV. NORTH,KAWEMPE DIVISION,KANYANYA,LC I MEETING PLACE (N - NAL),660,0,0,4,194,167,365,2,367,0,O-12-62-01-02-08
KAMPALA,KAWEMPE DIV. NORTH,KAWEMPE DIVISION,KANYANYA,LC I MEETING PLACE (O - Z),467,2,0,9,195,89,295,1,296,0,O-12-62-01-02-09
KAMPALA,KAWEMPE DIV. NORTH,KAWEMPE DIVISION,KANYANYA,KAJABWANGU'S PLACE (A - M),616,2,1,13,247,144,407,2,409,0,O-12-62-01-02-10
KAMPALA,KAWEMPE DIV. NORTH,KAWEMPE DIVISION,KANYANYA,KANYANYA POLICE POST (L-M),634,1,2,11,241,127,382,8,390,0,O-12-62-01-02-11
KAMPALA,KAWEMPE DIV. NORTH,KAWEMPE DIVISION,KANYANYA,KAJABWANGU'S PLACE (N - Z),785,3,1,8,256,205,473,3,476,0,O-12-62-01-02-12
KAMPALA,KAWEMPE DIV. NORTH,KAWEMPE DIVISION,KANYANYA,LC I MEETING PLACE (KIN - M),374,1,3,11,169,54,238,2,240,0,O-12-62-01-02-13
KAMPALA,KAWEMPE DIV. NORTH,KAWEMPE DIVISION,KANYANYA,ST. JOHN PR. SCH. [NAK-Z],439,1,1,9,122,119,252,4,256,0,O-12-62-01-02-14
KAMPALA,KAWEMPE DIV. NORTH,KAWEMPE DIVISION,KANYANYA,KANYANYA POLICE POST (NAM -,437,0,0,2,134,79,215,5,220,0,O-12-62-01-02-15
KAMPALA,KAWEMPE DIV. NORTH,KAWEMPE DIVISION,KANYANYA,LC I MEETING PLACE (NAM - NZ),684,1,0,2,208,152,363,10,373,0,O-12-62-01-02-16
KAMPALA,KAWEMPE DIV. NORTH,KAWEMPE DIVISION,KAWEMPE I,UCTU GROUND (A - M),899,0,1,9,255,131,396,1,397,0,O-12-62-01-03-01
KAMPALA,KAWEMPE DIV. NORTH,KAWEMPE DIVISION,KAWEMPE I,MUGERWA'S HOME (A - KAJ),698,1,0,11,244,95,351,6,357,0,O-12-62-01-03-02
KAMPALA,KAWEMPE DIV. NORTH,KAWEMPE DIVISION,KAWEMPE I,KAWEMPE STANDARD SCH (A - K,689,3,1,15,243,129,391,5,396,0,O-12-62-01-03-03
KAMPALA,KAWEMPE DIV. NORTH,KAWEMPE DIVISION,KAWEMPE I,KAWEMPE C/U PRIM. SCHOOL (A -,974,2,2,10,325,167,506,6,512,0,O-12-62-01-03-04
KAMPALA,KAWEMPE DIV. NORTH,KAWEMPE DIVISION,KAWEMPE I,UCTU GROUND (N - Z),1004,5,2,18,266,150,441,21,462,0,O-12-62-01-03-05
KAMPALA,KAWEMPE DIV. NORTH,KAWEMPE DIVISION,KAWEMPE I,MBOGO PRIMARY SCHOOL (A - KA,829,4,1,8,281,126,420,8,428,0,O-12-62-01-03-06
KAMPALA,KAWEMPE DIV. NORTH,KAWEMPE DIVISION,KAWEMPE I,KIZZA'S HOME (A - M),1435,1,1,23,371,184,580,10,590,0,O-12-62-01-03-07
KAMPALA,KAWEMPE DIV. NORTH,KAWEMPE DIVISION,KAWEMPE I,HAJJ KIZITO'S PLACE (A - M),688,2,1,14,206,115,338,9,347,0,O-12-62-01-03-08
KAMPALA,KAWEMPE DIV. NORTH,KAWEMPE DIVISION,KAWEMPE I,HAJJ KIZITO'S PLACE (N - Z),930,1,2,13,231,245,492,9,501,0,O-12-62-01-03-09
KAMPALA,KAWEMPE DIV. NORTH,KAWEMPE DIVISION,KAWEMPE I,MUGERWA'S HOME (KAK - NAKA),898,2,0,14,269,159,444,5,449,0,O-12-62-01-03-10
KAMPALA,KAWEMPE DIV. NORTH,KAWEMPE DIVISION,KAWEMPE I,MUGERWA'S HOME (O - Z),421,2,2,5,194,60,263,1,264,0,O-12-62-01-03-11
KAMPALA,KAWEMPE DIV. NORTH,KAWEMPE DIVISION,KAWEMPE I,KAWEMPE STANDARD SCH (KE -,1120,4,0,25,444,210,683,3,686,0,O-12-62-01-03-12
KAMPALA,KAWEMPE DIV. NORTH,KAWEMPE DIVISION,KAWEMPE I,KAWEMPE STANDARD SCH (NAK -,243,0,0,0,59,57,116,0,116,0,O-12-62-01-03-13
KAMPALA,KAWEMPE DIV. NORTH,KAWEMPE DIVISION,KAWEMPE I,KAWEMPE STANDARD SCH (NAM -,637,1,0,12,190,130,333,8,341,0,O-12-62-01-03-14
KAMPALA,KAWEMPE DIV. NORTH,KAWEMPE DIVISION,KAWEMPE I,KAWEMPE C/U PRIM. SCHOOL (L -,503,2,1,6,185,95,289,7,296,0,O-12-62-01-03-15
KAMPALA,KAWEMPE DIV. NORTH,KAWEMPE DIVISION,KAWEMPE I,MBOGO PRIMARY SCHOOL (KAY -,724,3,1,13,290,103,410,8,418,0,O-12-62-01-03-16
KAMPALA,KAWEMPE DIV. NORTH,KAWEMPE DIVISION,KAWEMPE I,MBOGO PRIMARY SCHOOL (MUE -,655,1,0,8,245,125,379,2,381,0,O-12-62-01-03-17
KAMPALA,KAWEMPE DIV. NORTH,KAWEMPE DIVISION,KAWEMPE I,MBOGO PRIMARY SCHOOL (O - Z),645,1,0,7,275,98,381,6,387,0,O-12-62-01-03-18
KAMPALA,KAWEMPE DIV. NORTH,KAWEMPE DIVISION,KAWEMPE I,KIZZA'S HOME (N - NANS),401,1,0,5,104,93,203,1,204,0,O-12-62-01-03-19
KAMPALA,KAWEMPE DIV. NORTH,KAWEMPE DIVISION,KAWEMPE I,KAWEMPE C/U PRIM. SCHOOL (N-,463,5,0,3,125,100,233,7,240,0,O-12-62-01-03-20
KAMPALA,KAWEMPE DIV. NORTH,KAWEMPE DIVISION,KAWEMPE I,KAWEMPE C/U PRIM. SCHOOL (O -,520,2,0,5,204,56,267,1,268,0,O-12-62-01-03-21
KAMPALA,KAWEMPE DIV. NORTH,KAWEMPE DIVISION,KAWEMPE I,MUGERWA'S HOME (NAKE - NZ),829,0,1,8,222,157,388,6,394,0,O-12-62-01-03-22
KAMPALA,KAWEMPE DIV. NORTH,KAWEMPE DIVISION,KAWEMPE I,KAWEMPE STANDARD SCH (NAO -,789,3,0,18,279,137,437,8,445,0,O-12-62-01-03-23
KAMPALA,KAWEMPE DIV. NORTH,KAWEMPE DIVISION,KAWEMPE I,MBOGO PRIMARY SCHOOL (NAKK,813,2,0,11,243,159,415,3,418,0,O-12-62-01-03-24
KAMPALA,KAWEMPE DIV. NORTH,KAWEMPE DIVISION,KAWEMPE I,KIZZA'S HOME (NANT - Z),725,1,1,3,232,108,345,2,347,0,O-12-62-01-03-25
KAMPALA,KAWEMPE DIV. NORTH,KAWEMPE DIVISION,KAWEMPE I,KAWEMPE C/U PRIM. SCHOOL (NA,438,0,0,4,126,86,216,7,223,0,O-12-62-01-03-26
KAMPALA,KAWEMPE DIV. NORTH,KAWEMPE DIVISION,KAWEMPE II,KIWANUKA' S PLACE,1218,3,1,28,439,286,757,11,768,0,O-12-62-01-04-01
KAMPALA,KAWEMPE DIV. NORTH,KAWEMPE DIVISION,KAWEMPE II,MPERERWE PR. SCH.,1421,8,2,23,495,365,893,0,893,0,O-12-62-01-04-02
KAMPALA,KAWEMPE DIV. NORTH,KAWEMPE DIVISION,KAWEMPE II,MR. KIZZA'S PARKING YARD,891,1,2,23,318,217,561,0,561,0,O-12-62-01-04-03
KAMPALA,KAWEMPE DIV. NORTH,KAWEMPE DIVISION,KAWEMPE II,NAMWANDU NKOYOOYO'S HOME,1609,4,1,24,479,305,813,8,821,0,O-12-62-01-04-04
KAMPALA,KAWEMPE DIV. NORTH,KAWEMPE DIVISION,KAWEMPE II,MR. SEBAMBA'S COMPOUND (A -,823,1,0,16,359,152,528,15,543,0,O-12-62-01-04-05
KAMPALA,KAWEMPE DIV. NORTH,KAWEMPE DIVISION,KAWEMPE II,MR. SEBAMBA'S COMPOUND (N -,1137,7,2,20,344,281,654,0,654,0,O-12-62-01-04-06
KAMPALA,KAWEMPE DIV. NORTH,KAWEMPE DIVISION,KAZO-ANGOLA,HOLY FAMILY PRIMARY SCH. (A -,601,1,0,5,216,97,319,4,323,0,O-12-62-01-05-01
KAMPALA,KAWEMPE DIV. NORTH,KAWEMPE DIVISION,KAZO-ANGOLA,HOLY FAMILY PRIMARY SCH. (NAZ,1017,4,3,14,356,149,526,11,537,0,O-12-62-01-05-02
KAMPALA,KAWEMPE DIV. NORTH,KAWEMPE DIVISION,KAZO-ANGOLA,MATHEL NURSERY SCHOOL (A - K,548,4,1,10,191,95,301,2,303,0,O-12-62-01-05-03
KAMPALA,KAWEMPE DIV. NORTH,KAWEMPE DIVISION,KAZO-ANGOLA,KAZO-ANGOLA LC I OFFICE (A - K,652,1,1,11,214,119,346,3,349,0,O-12-62-01-05-04
KAMPALA,KAWEMPE DIV. NORTH,KAWEMPE DIVISION,KAZO-ANGOLA,MATHEL NURSERY SCHOOL (N - N,745,1,0,14,203,176,394,2,396,0,O-12-62-01-05-05
KAMPALA,KAWEMPE DIV. NORTH,KAWEMPE DIVISION,KAZO-ANGOLA,KAZO-ANGOLA LC I OFFICE (L - M,648,1,0,4,225,109,339,2,341,0,O-12-62-01-05-06
KAMPALA,KAWEMPE DIV. NORTH,KAWEMPE DIVISION,KAZO-ANGOLA,KAZO-ANGOLA LC I OFFICE (NAA -,603,2,1,7,154,147,311,5,316,0,O-12-62-01-05-07
KAMPALA,KAWEMPE DIV. NORTH,KAWEMPE DIVISION,KAZO-ANGOLA,KAZO-ANGOLA LC I OFFICE (NAO -,517,1,2,4,166,72,245,3,248,0,O-12-62-01-05-08
KAMPALA,KAWEMPE DIV. NORTH,KAWEMPE DIVISION,KAZO-ANGOLA,HOLY FAMILY PRIMARY SCH. (KIH,547,1,0,9,198,115,323,7,330,0,O-12-62-01-05-09
KAMPALA,KAWEMPE DIV. NORTH,KAWEMPE DIVISION,KAZO-ANGOLA,HOLY FAMILY PRIMARY SCH. (NA,673,2,0,11,164,173,350,7,357,0,O-12-62-01-05-10
KAMPALA,KAWEMPE DIV. NORTH,KAWEMPE DIVISION,KAZO-ANGOLA,MATHEL NURSERY SCHOOL (KIH -,499,3,0,13,203,88,307,2,309,0,O-12-62-01-05-11
KAMPALA,KAWEMPE DIV. NORTH,KAWEMPE DIVISION,KAZO-ANGOLA,KAZO-ANGOLA LC I OFFICE (KAM -,618,0,0,10,235,114,359,8,367,0,O-12-62-01-05-12
KAMPALA,KAWEMPE DIV. NORTH,KAWEMPE DIVISION,KAZO-ANGOLA,KAZO-ANGOLA LC I OFFICE (NALU,566,1,0,3,148,133,285,1,286,0,O-12-62-01-05-13
KAMPALA,KAWEMPE DIV. NORTH,KAWEMPE DIVISION,KAZO-ANGOLA,KAZO-ANGOLA LC I OFFICE (SSEK,523,0,2,6,195,75,278,5,283,0,O-12-62-01-05-14
KAMPALA,KAWEMPE DIV. NORTH,KAWEMPE DIVISION,KIKAYA,CHAIRMAN' S HOME,982,5,0,13,369,227,614,1,615,0,O-12-62-01-06-01
KAMPALA,KAWEMPE DIV. NORTH,KAWEMPE DIVISION,KIKAYA,KANISA [A-M],608,8,4,9,194,155,370,3,373,0,O-12-62-01-06-02
KAMPALA,KAWEMPE DIV. NORTH,KAWEMPE DIVISION,KIKAYA,KISAASI COLLEGE SCHOOL (A - M),927,5,4,6,334,200,549,6,555,0,O-12-62-01-06-03
KAMPALA,KAWEMPE DIV. NORTH,KAWEMPE DIVISION,KIKAYA,KISAASI COLLEGE SCHOOL (N - Z),967,9,1,8,0,201,219,13,232,0,O-12-62-01-06-04
KAMPALA,KAWEMPE DIV. NORTH,KAWEMPE DIVISION,KIKAYA,KISOTA [A - M],512,7,2,10,201,119,339,2,341,0,O-12-62-01-06-05
KAMPALA,KAWEMPE DIV. NORTH,KAWEMPE DIVISION,KIKAYA,SHEPERD NURSERY SCHOOL,1043,6,1,17,288,270,582,15,597,0,O-12-62-01-06-06
KAMPALA,KAWEMPE DIV. NORTH,KAWEMPE DIVISION,KIKAYA,BUYINZA BAR,1290,10,3,19,433,253,718,15,733,0,O-12-62-01-06-07
KAMPALA,KAWEMPE DIV. NORTH,KAWEMPE DIVISION,KIKAYA,KISOTA [N - Z],546,6,3,13,175,133,330,2,332,0,O-12-62-01-06-08
KAMPALA,KAWEMPE DIV. NORTH,KAWEMPE DIVISION,KIKAYA,KANISA [N-Z],603,5,0,11,201,151,368,8,376,0,O-12-62-01-06-09
KAMPALA,KAWEMPE DIV. NORTH,KAWEMPE DIVISION,KOMAMBOGA,SEBULU'S COMPOUND [A-M],500,10,0,10,159,116,295,2,297,0,O-12-62-01-07-01
KAMPALA,KAWEMPE DIV. NORTH,KAWEMPE DIVISION,KOMAMBOGA,KATALEMWA NURSERY SCH.,296,0,18,0,99,70,187,10,197,0,O-12-62-01-07-02
KAMPALA,KAWEMPE DIV. NORTH,KAWEMPE DIVISION,KOMAMBOGA,CENTRAL,400,3,0,11,132,85,231,3,234,0,O-12-62-01-07-03
KAMPALA,KAWEMPE DIV. NORTH,KAWEMPE DIVISION,KOMAMBOGA,COMMUNITY CENTRE,439,3,0,8,135,108,254,6,260,0,O-12-62-01-07-04
KAMPALA,KAWEMPE DIV. NORTH,KAWEMPE DIVISION,KOMAMBOGA,KWATA PLAY GROUND,764,7,0,22,234,232,495,13,508,0,O-12-62-01-07-05
KAMPALA,KAWEMPE DIV. NORTH,KAWEMPE DIVISION,KOMAMBOGA,SEBULU'S COMPOUND [N-Z],536,3,0,3,168,135,309,2,311,0,O-12-62-01-07-06
KAMPALA,KAWEMPE DIV. NORTH,KAWEMPE DIVISION,KYEBANDO,HORMISDALLEN (A - M),1382,5,2,18,538,208,771,6,777,0,O-12-62-01-08-01
KAMPALA,KAWEMPE DIV. NORTH,KAWEMPE DIVISION,KYEBANDO,SERINA PR. SCHOOL (A - M),669,3,0,11,253,148,415,9,424,0,O-12-62-01-08-02
KAMPALA,KAWEMPE DIV. NORTH,KAWEMPE DIVISION,KYEBANDO,KYEBANDO PR. SCHOOL (A - J),1580,4,1,5,393,295,698,25,723,0,O-12-62-01-08-03
KAMPALA,KAWEMPE DIV. NORTH,KAWEMPE DIVISION,KYEBANDO,LATE KANYIKE'S PLACE (A - K),1024,6,0,10,332,252,600,2,602,0,O-12-62-01-08-04
KAMPALA,KAWEMPE DIV. NORTH,KAWEMPE DIVISION,KYEBANDO,EDNA'S NURSERY SCHOOL (A - M),909,2,1,9,303,205,520,14,534,0,O-12-62-01-08-05
KAMPALA,KAWEMPE DIV. NORTH,KAWEMPE DIVISION,KYEBANDO,ANGELA MUSOKE'S PLACE (A - M),978,4,1,15,402,164,586,6,592,0,O-12-62-01-08-06
KAMPALA,KAWEMPE DIV. NORTH,KAWEMPE DIVISION,KYEBANDO,HORMISDALLEN (N - N),1123,3,0,9,315,241,568,1,569,0,O-12-62-01-08-07
KAMPALA,KAWEMPE DIV. NORTH,KAWEMPE DIVISION,KYEBANDO,HORMISDALLEN (O - Z),502,0,1,7,216,85,309,7,316,0,O-12-62-01-08-08
KAMPALA,KAWEMPE DIV. NORTH,KAWEMPE DIVISION,KYEBANDO,SERINA PR. SCHOOL (N - Z),804,3,1,5,259,193,461,8,469,0,O-12-62-01-08-09
KAMPALA,KAWEMPE DIV. NORTH,KAWEMPE DIVISION,KYEBANDO,KYEBANDO PR. SCHOOL (K - K),1230,5,1,11,301,354,672,2,674,0,O-12-62-01-08-10
KAMPALA,KAWEMPE DIV. NORTH,KAWEMPE DIVISION,KYEBANDO,KYEBANDO PR. SCHOOL (L - M),1095,1,0,8,298,281,588,15,603,0,O-12-62-01-08-11
KAMPALA,KAWEMPE DIV. NORTH,KAWEMPE DIVISION,KYEBANDO,KYEBANDO PR. SCHOOL (NAA - N,1419,7,2,11,277,427,724,23,747,0,O-12-62-01-08-12
KAMPALA,KAWEMPE DIV. NORTH,KAWEMPE DIVISION,KYEBANDO,KYEBANDO PR. SCHOOL (NB - R),1160,0,5,3,361,184,553,1,554,0,O-12-62-01-08-13
KAMPALA,KAWEMPE DIV. NORTH,KAWEMPE DIVISION,KYEBANDO,KYEBANDO PR. SCHOOL (S - Z),964,2,2,7,280,224,515,6,521,0,O-12-62-01-08-14
KAMPALA,KAWEMPE DIV. NORTH,KAWEMPE DIVISION,KYEBANDO,LATE KANYIKE'S PLACE ( N),980,3,0,11,228,303,545,1,546,0,O-12-62-01-08-15
KAMPALA,KAWEMPE DIV. NORTH,KAWEMPE DIVISION,KYEBANDO,LATE KANYIKE'S PLACE (O - Z),533,3,1,12,193,124,333,1,334,0,O-12-62-01-08-16
KAMPALA,KAWEMPE DIV. NORTH,KAWEMPE DIVISION,KYEBANDO,EDNA'S NURSERY SCHOOL (N - Z),931,3,1,16,271,193,484,12,496,0,O-12-62-01-08-17
KAMPALA,KAWEMPE DIV. NORTH,KAWEMPE DIVISION,KYEBANDO,ANGELA MUSOKE'S PLACE (N - Z),1128,4,0,5,360,241,610,8,618,0,O-12-62-01-08-18
KAMPALA,KAWEMPE DIV. NORTH,KAWEMPE DIVISION,KYEBANDO,LATE KANYIKE'S PLACE (L - M),486,3,2,10,179,120,314,1,315,0,O-12-62-01-08-19
KAMPALA,KAWEMPE DIV. NORTH,KAWEMPE DIVISION,MPERERWE,SEKATI NURSARY SCHOOL,636,6,0,13,227,147,393,0,393,0,O-12-62-01-09-01
KAMPALA,KAWEMPE DIV. NORTH,KAWEMPE DIVISION,MPERERWE,SEKANYONYI,1103,2,0,28,342,306,678,4,682,0,O-12-62-01-09-02
KAMPALA,KAWEMPE DIV. SOUTH,KAWEMPE DIV,BWAISE II,LC I OFFICE (A-M),589,1,1,2,219,113,336,0,336,0,O-12-63-01-01-01
KAMPALA,KAWEMPE DIV. SOUTH,KAWEMPE DIV,BWAISE II,NEAR DIV HQRS A-M,1010,3,0,8,408,181,600,14,614,0,O-12-63-01-01-02
KAMPALA,KAWEMPE DIV. SOUTH,KAWEMPE DIV,BWAISE II,BEHIND SHELL PETROL STATION-,130,0,0,1,50,35,86,0,86,0,O-12-63-01-01-03
KAMPALA,KAWEMPE DIV. SOUTH,KAWEMPE DIV,BWAISE II,SPIRE PR/SCHOOL [A-M],702,1,1,15,284,146,447,1,448,0,O-12-63-01-01-04
KAMPALA,KAWEMPE DIV. SOUTH,KAWEMPE DIV,BWAISE II,LC MEETING PLACE,1062,2,0,10,430,183,625,7,632,0,O-12-63-01-01-05
KAMPALA,KAWEMPE DIV. SOUTH,KAWEMPE DIV,BWAISE II,HOMELAND INTEGRATED SEC SC,721,1,0,21,260,136,418,8,426,0,O-12-63-01-01-06
KAMPALA,KAWEMPE DIV. SOUTH,KAWEMPE DIV,BWAISE II,ST. EMMANUEL COLLEGE [A-M],670,4,0,10,263,130,407,7,414,0,O-12-63-01-01-07
KAMPALA,KAWEMPE DIV. SOUTH,KAWEMPE DIV,BWAISE II,HOMELAND INTEGRATED SEC SC,807,1,0,15,245,164,425,4,429,0,O-12-63-01-01-08
KAMPALA,KAWEMPE DIV. SOUTH,KAWEMPE DIV,BWAISE II,NEAR DIV HQRS N-Z,1273,2,0,12,496,253,763,9,772,0,O-12-63-01-01-09
KAMPALA,KAWEMPE DIV. SOUTH,KAWEMPE DIV,BWAISE II,ST. EMMANUEL COLLEGE [N-N],656,1,0,13,145,155,314,43,357,0,O-12-63-01-01-10
KAMPALA,KAWEMPE DIV. SOUTH,KAWEMPE DIV,BWAISE II,SPIRE PR/SCHOOL [N-NAM],499,0,0,3,141,142,286,10,296,0,O-12-63-01-01-11
KAMPALA,KAWEMPE DIV. SOUTH,KAWEMPE DIV,BWAISE II,MUGOWA,1107,2,1,26,385,222,636,0,636,0,O-12-63-01-01-12
KAMPALA,KAWEMPE DIV. SOUTH,KAWEMPE DIV,BWAISE II,LC I OFFICE (N-Z),738,1,2,8,227,193,431,13,444,0,O-12-63-01-01-13
KAMPALA,KAWEMPE DIV. SOUTH,KAWEMPE DIV,BWAISE II,ST. EMMANUEL COLLEGE [O-Z],253,0,0,6,104,62,172,1,173,0,O-12-63-01-01-14
KAMPALA,KAWEMPE DIV. SOUTH,KAWEMPE DIV,BWAISE II,SPIRE PR/SCHOOL [NAN-Z],458,1,0,10,170,89,270,9,279,0,O-12-63-01-01-15
KAMPALA,KAWEMPE DIV. SOUTH,KAWEMPE DIV,BWAISE III,ST. JAMES CHURCH (A-M),575,1,2,12,248,95,358,10,368,0,O-12-63-01-02-01
KAMPALA,KAWEMPE DIV. SOUTH,KAWEMPE DIV,BWAISE III,DEMBE MARKET (A-M),425,1,2,5,156,90,254,7,261,0,O-12-63-01-02-02
KAMPALA,KAWEMPE DIV. SOUTH,KAWEMPE DIV,BWAISE III,ATOTI RESTAURANT AND BAR CO,497,0,1,14,170,134,319,5,324,0,O-12-63-01-02-03
KAMPALA,KAWEMPE DIV. SOUTH,KAWEMPE DIV,BWAISE III,LC MEETING PLACE (A-M),786,3,0,9,293,157,462,1,463,0,O-12-63-01-02-04
KAMPALA,KAWEMPE DIV. SOUTH,KAWEMPE DIV,BWAISE III,MENTALLY HANDCAPPED,742,1,1,17,278,159,456,9,465,0,O-12-63-01-02-05
KAMPALA,KAWEMPE DIV. SOUTH,KAWEMPE DIV,BWAISE III,LC MEETING PLACE (N-NAM),546,2,0,2,127,132,263,6,269,0,O-12-63-01-02-06
KAMPALA,KAWEMPE DIV. SOUTH,KAWEMPE DIV,BWAISE III,ST. FRANCIS NURSERY SCHOOL (,607,2,0,10,248,120,380,21,401,0,O-12-63-01-02-07
KAMPALA,KAWEMPE DIV. SOUTH,KAWEMPE DIV,BWAISE III,LC MEETING PLACE (NAN - Z),553,0,0,0,180,115,295,2,297,0,O-12-63-01-02-08
KAMPALA,KAWEMPE DIV. SOUTH,KAWEMPE DIV,BWAISE III,ST. FRANCIS NURSERY SCHOOL (,819,3,1,8,267,179,458,14,472,0,O-12-63-01-02-09
KAMPALA,KAWEMPE DIV. SOUTH,KAWEMPE DIV,BWAISE III,ST. JAMES CHURCH (N-Z),800,1,2,12,292,165,472,27,499,0,O-12-63-01-02-10
KAMPALA,KAWEMPE DIV. SOUTH,KAWEMPE DIV,BWAISE III,DEMBE MARKET (N-Z),665,2,0,8,187,137,334,56,390,0,O-12-63-01-02-11
KAMPALA,KAWEMPE DIV. SOUTH,KAWEMPE DIV,MAKERERE I,LC MEETING PLACE (A-M),581,2,1,17,186,153,359,6,365,0,O-12-63-01-03-01
KAMPALA,KAWEMPE DIV. SOUTH,KAWEMPE DIV,MAKERERE I,CITY KINDERGATEN,802,0,2,12,208,136,358,8,366,0,O-12-63-01-03-02
KAMPALA,KAWEMPE DIV. SOUTH,KAWEMPE DIV,MAKERERE I,NSANGI PR. SCH.,837,4,2,10,294,227,537,4,541,0,O-12-63-01-03-03
KAMPALA,KAWEMPE DIV. SOUTH,KAWEMPE DIV,MAKERERE I,CHESS CLUB [A-M],537,0,2,4,216,117,339,4,343,0,O-12-63-01-03-04
KAMPALA,KAWEMPE DIV. SOUTH,KAWEMPE DIV,MAKERERE I,MAKERERE JUNIOR SCHOOL,769,7,1,6,247,195,456,21,477,0,O-12-63-01-03-05
KAMPALA,KAWEMPE DIV. SOUTH,KAWEMPE DIV,MAKERERE I,CHESS CLUB [N-Z],668,3,0,8,231,172,414,4,418,0,O-12-63-01-03-06
KAMPALA,KAWEMPE DIV. SOUTH,KAWEMPE DIV,MAKERERE I,LC MEETING PLACE (N-Z),485,2,0,15,139,131,287,4,291,0,O-12-63-01-03-07
KAMPALA,KAWEMPE DIV. SOUTH,KAWEMPE DIV,MAKERERE II,SEVENTH DAY ADVENTIST CHUR,647,2,3,8,259,143,415,2,417,0,O-12-63-01-04-01
KAMPALA,KAWEMPE DIV. SOUTH,KAWEMPE DIV,MAKERERE II,MUTIGWEDEMBE A-L,425,3,0,7,117,118,245,6,251,0,O-12-63-01-04-02
KAMPALA,KAWEMPE DIV. SOUTH,KAWEMPE DIV,MAKERERE II,MR. MUKWAYAS PLACE[A-K],547,3,2,4,153,148,310,11,321,0,O-12-63-01-04-03
KAMPALA,KAWEMPE DIV. SOUTH,KAWEMPE DIV,MAKERERE II,TEAMWORK NURSERY SCHOOL [,1227,5,1,21,396,238,661,17,678,0,O-12-63-01-04-04
KAMPALA,KAWEMPE DIV. SOUTH,KAWEMPE DIV,MAKERERE II,MUTIGWEDEMBE M-Z,673,2,0,12,178,193,385,17,402,0,O-12-63-01-04-05
KAMPALA,KAWEMPE DIV. SOUTH,KAWEMPE DIV,MAKERERE II,MR MUKWAYA'S PLACE [M],383,4,1,4,107,96,212,3,215,0,O-12-63-01-04-06
KAMPALA,KAWEMPE DIV. SOUTH,KAWEMPE DIV,MAKERERE II,TEAMWORK NURSERY SCHOOL [,439,3,1,9,176,83,272,3,275,0,O-12-63-01-04-07
KAMPALA,KAWEMPE DIV. SOUTH,KAWEMPE DIV,MAKERERE II,TEAMWORK NURSERY SCHOOL [,608,3,1,15,233,90,342,3,345,0,O-12-63-01-04-08
KAMPALA,KAWEMPE DIV. SOUTH,KAWEMPE DIV,MAKERERE II,MR MUKWAYA'S PLACE [O-Z],497,3,1,7,157,93,261,4,265,0,O-12-63-01-04-09
KAMPALA,KAWEMPE DIV. SOUTH,KAWEMPE DIV,MAKERERE II,MR. MUKWAYAS PLACE [K-L],603,3,0,5,171,163,342,6,348,0,O-12-63-01-04-10
KAMPALA,KAWEMPE DIV. SOUTH,KAWEMPE DIV,MAKERERE II,MR MUKWAYA'S PLACE [N],764,2,0,9,182,214,407,6,413,0,O-12-63-01-04-11
KAMPALA,KAWEMPE DIV. SOUTH,KAWEMPE DIV,MAKERERE II,TEAMWORK NURSERY SCHOOL [,922,4,2,14,225,176,421,90,511,0,O-12-63-01-04-12
KAMPALA,KAWEMPE DIV. SOUTH,KAWEMPE DIV,MAKERERE III,HOPE AND CARE PR. SCH.,1139,3,0,21,367,278,669,4,673,0,O-12-63-01-05-01
KAMPALA,KAWEMPE DIV. SOUTH,KAWEMPE DIV,MAKERERE III,GOOD HOPE BAR,676,1,1,13,236,158,409,10,419,0,O-12-63-01-05-02
KAMPALA,KAWEMPE DIV. SOUTH,KAWEMPE DIV,MAKERERE III,SSINDE MAIZE MILL COMPOUND A,1083,5,2,14,441,178,640,16,656,0,O-12-63-01-05-03
KAMPALA,KAWEMPE DIV. SOUTH,KAWEMPE DIV,MAKERERE III,MAYINJA GROUND,1096,1,2,7,429,196,635,14,649,0,O-12-63-01-05-04
KAMPALA,KAWEMPE DIV. SOUTH,KAWEMPE DIV,MAKERERE III,ST NICHOLAS CHURCH GROUND,1039,7,2,14,366,220,609,4,613,0,O-12-63-01-05-05
KAMPALA,KAWEMPE DIV. SOUTH,KAWEMPE DIV,MAKERERE III,KIGGUNDU GROUND [A-M],574,2,1,17,208,153,381,4,385,0,O-12-63-01-05-06
KAMPALA,KAWEMPE DIV. SOUTH,KAWEMPE DIV,MAKERERE III,KIGGUNDU GROUND [N-Z],714,0,2,16,240,159,417,16,433,0,O-12-63-01-05-07
KAMPALA,KAWEMPE DIV. SOUTH,KAWEMPE DIV,MAKERERE III,CHILD CARE (N-NAL),443,3,2,2,109,86,202,5,207,0,O-12-63-01-05-08
KAMPALA,KAWEMPE DIV. SOUTH,KAWEMPE DIV,MAKERERE III,ST NICHOLAS CHURCH GROUND,1444,0,0,17,382,264,663,91,754,0,O-12-63-01-05-09
KAMPALA,KAWEMPE DIV. SOUTH,KAWEMPE DIV,MAKERERE III,CHILD CARE (O-Z),391,0,0,7,156,65,228,2,230,0,O-12-63-01-05-10
KAMPALA,KAWEMPE DIV. SOUTH,KAWEMPE DIV,MAKERERE III,CHILD CARE (NAM-NZ),413,2,1,5,129,73,210,6,216,0,O-12-63-01-05-11
KAMPALA,KAWEMPE DIV. SOUTH,KAWEMPE DIV,MULAGO I,BUTAKABUKIRWA PLAYGROUND [,347,1,0,0,42,169,212,3,215,0,O-12-63-01-06-01
KAMPALA,KAWEMPE DIV. SOUTH,KAWEMPE DIV,MULAGO I,LC MEETING PLACE-UPPER MAW,346,1,3,0,92,115,211,1,212,0,O-12-63-01-06-02
KAMPALA,KAWEMPE DIV. SOUTH,KAWEMPE DIV,MULAGO I,POLIO CLINIC,784,6,2,17,283,173,481,2,483,0,O-12-63-01-06-03
KAMPALA,KAWEMPE DIV. SOUTH,KAWEMPE DIV,MULAGO I,BUTAKABUKIRWA PLAYGROUND [,551,3,0,3,46,279,331,3,334,0,O-12-63-01-06-04
KAMPALA,KAWEMPE DIV. SOUTH,KAWEMPE DIV,MULAGO I,LC MEETING PLACE,723,3,2,3,196,270,474,1,475,0,O-12-63-01-06-05
KAMPALA,KAWEMPE DIV. SOUTH,KAWEMPE DIV,MULAGO I,GALLOWAY,486,5,0,9,173,85,272,8,280,0,O-12-63-01-06-06
KAMPALA,KAWEMPE DIV. SOUTH,KAWEMPE DIV,MULAGO I,ST FRANCIS PR. SCH.,397,4,1,3,109,124,241,4,245,0,O-12-63-01-06-07
KAMPALA,KAWEMPE DIV. SOUTH,KAWEMPE DIV,MULAGO I,STAFF HOSTEL- NURSES,1457,9,0,7,450,255,721,15,736,0,O-12-63-01-06-08
KAMPALA,KAWEMPE DIV. SOUTH,KAWEMPE DIV,MULAGO I,DOCTOR'S VILLAGE GATE,154,2,1,0,47,26,76,0,76,0,O-12-63-01-06-09
KAMPALA,KAWEMPE DIV. SOUTH,KAWEMPE DIV,MULAGO II,KAINAMULA' S PLACE,715,2,2,11,192,254,461,6,467,0,O-12-63-01-07-01
KAMPALA,KAWEMPE DIV. SOUTH,KAWEMPE DIV,MULAGO II,LATE SENDAGIRE' S HOME,1154,2,3,13,281,382,681,19,700,0,O-12-63-01-07-02
KAMPALA,KAWEMPE DIV. SOUTH,KAWEMPE DIV,MULAGO II,MARKET PLACE A-M,1032,4,1,2,177,306,490,23,513,0,O-12-63-01-07-03
KAMPALA,KAWEMPE DIV. SOUTH,KAWEMPE DIV,MULAGO II,LATE LUKANIKAS PLACE A-M,776,2,2,7,170,215,396,49,445,0,O-12-63-01-07-04
KAMPALA,KAWEMPE DIV. SOUTH,KAWEMPE DIV,MULAGO II,LC MEETING PLACE [A-M],838,4,3,14,304,212,537,6,543,0,O-12-63-01-07-05
KAMPALA,KAWEMPE DIV. SOUTH,KAWEMPE DIV,MULAGO II,ST. MARTIN PR. SCH.,656,4,1,9,210,210,434,0,434,0,O-12-63-01-07-06
KAMPALA,KAWEMPE DIV. SOUTH,KAWEMPE DIV,MULAGO II,ST MARTIN PR / SCHOOL A[A-M],654,3,1,9,199,195,407,12,419,0,O-12-63-01-07-07
KAMPALA,KAWEMPE DIV. SOUTH,KAWEMPE DIV,MULAGO II,MARKET PLACE N-Z,933,1,1,5,164,316,487,0,487,0,O-12-63-01-07-08
KAMPALA,KAWEMPE DIV. SOUTH,KAWEMPE DIV,MULAGO II,LATE LUKANIKAS PLACE N-Z,858,2,0,5,173,244,424,68,492,0,O-12-63-01-07-09
KAMPALA,KAWEMPE DIV. SOUTH,KAWEMPE DIV,MULAGO II,LC MEETING PLACE [N-Z],1065,7,2,23,340,249,621,9,630,0,O-12-63-01-07-10
KAMPALA,KAWEMPE DIV. SOUTH,KAWEMPE DIV,MULAGO II,ST MARTIN PR / SCHOOL A[N-Z],648,0,0,13,158,209,380,2,382,0,O-12-63-01-07-11
KAMPALA,KAWEMPE DIV. SOUTH,KAWEMPE DIV,MULAGO III,GOODWINS PR. SCH. (A-M),580,4,1,0,206,144,355,3,358,0,O-12-63-01-08-01
KAMPALA,KAWEMPE DIV. SOUTH,KAWEMPE DIV,MULAGO III,MAWANADA RD POLICE STATION,599,2,4,1,123,202,332,1,333,0,O-12-63-01-08-02
KAMPALA,KAWEMPE DIV. SOUTH,KAWEMPE DIV,MULAGO III,OLD MULAGO PRIMARY SCHOOL [,436,1,0,0,127,119,247,6,253,0,O-12-63-01-08-03
KAMPALA,KAWEMPE DIV. SOUTH,KAWEMPE DIV,MULAGO III,NEW MULAGO PR. SCH.[A-M],999,5,2,6,286,280,579,18,597,0,O-12-63-01-08-04
KAMPALA,KAWEMPE DIV. SOUTH,KAWEMPE DIV,MULAGO III,OLD MULAGO PRIMARY SCHOOL (,1171,5,0,8,278,369,660,17,677,0,O-12-63-01-08-05
KAMPALA,KAWEMPE DIV. SOUTH,KAWEMPE DIV,MULAGO III,MAWANADA RD POLICE STATION,382,0,0,0,90,127,217,0,217,0,O-12-63-01-08-06
KAMPALA,KAWEMPE DIV. SOUTH,KAWEMPE DIV,MULAGO III,OLD MULAGO PRIMARY SCHOOL [,462,0,2,5,156,108,271,3,274,0,O-12-63-01-08-07
KAMPALA,KAWEMPE DIV. SOUTH,KAWEMPE DIV,MULAGO III,MAWANADA RD POLICE STATION,531,1,3,2,148,158,312,1,313,0,O-12-63-01-08-08
KAMPALA,KAWEMPE DIV. SOUTH,KAWEMPE DIV,MULAGO III,NEW MULAGO PR. SCH.[N-Z],869,5,1,6,240,227,479,4,483,0,O-12-63-01-08-09
KAMPALA,KAWEMPE DIV. SOUTH,KAWEMPE DIV,MULAGO III,GOODWINS PR. SCH. (N-N),440,1,0,0,112,152,265,7,272,0,O-12-63-01-08-10
KAMPALA,KAWEMPE DIV. SOUTH,KAWEMPE DIV,MULAGO III,GOODWINS PR. SCH. (O-Z),200,1,1,6,60,47,115,2,117,0,O-12-63-01-08-11
KAMPALA,KAWEMPE DIV. SOUTH,KAWEMPE DIV,MULAGO III,MAWANADA RD POLICE STATION,476,1,0,5,84,191,281,7,288,0,O-12-63-01-08-12
KAMPALA,KAWEMPE DIV. SOUTH,KAWEMPE DIV,MULAGO III,MAWANADA RD POLICE STATION,570,0,0,2,79,231,312,2,314,0,O-12-63-01-08-13
KAMPALA,KAWEMPE DIV. SOUTH,KAWEMPE DIV,MULAGO III,OLD MULAGO PRIMARY SCHOOL [,553,2,0,5,183,170,360,4,364,0,O-12-63-01-08-14
KAMPALA,KAWEMPE DIV. SOUTH,KAWEMPE DIV,WANDEGEYA,LION' S CLUB,1110,1,1,9,368,223,602,16,618,0,O-12-63-01-09-01
KAMPALA,KAWEMPE DIV. SOUTH,KAWEMPE DIV,WANDEGEYA,WANDEGEYA MOSLEM P/S,677,1,2,6,235,162,406,5,411,0,O-12-63-01-09-02
KAMPALA,KAWEMPE DIV. SOUTH,KAWEMPE DIV,WANDEGEYA,PLAYGROUND [A-J],558,2,1,1,119,176,299,4,303,0,O-12-63-01-09-03
KAMPALA,KAWEMPE DIV. SOUTH,KAWEMPE DIV,WANDEGEYA,WANDEGEYA POST OFFICE,681,1,0,10,243,180,434,4,438,0,O-12-63-01-09-04
KAMPALA,KAWEMPE DIV. SOUTH,KAWEMPE DIV,WANDEGEYA,PLAYGROUND [M-M],434,0,0,6,115,136,257,2,259,0,O-12-63-01-09-05
KAMPALA,KAWEMPE DIV. SOUTH,KAWEMPE DIV,WANDEGEYA,PLAYGROUND [O-Z],555,1,1,1,176,148,327,1,328,0,O-12-63-01-09-06
KAMPALA,KAWEMPE DIV. SOUTH,KAWEMPE DIV,WANDEGEYA,PLAYGROUND [K-L],853,3,0,7,200,250,460,19,479,0,O-12-63-01-09-07
KAMPALA,KAWEMPE DIV. SOUTH,KAWEMPE DIV,WANDEGEYA,PLAYGROUND [N-N],817,4,2,3,194,265,468,8,476,0,O-12-63-01-09-08
KAMPALA,KAWEMPE DIV. SOUTH,MAKERERE UNIVERSITY,MULUKA I,C.C.E.,1051,14,0,7,228,153,402,10,412,0,O-12-63-02-01-01
KAMPALA,KAWEMPE DIV. SOUTH,MAKERERE UNIVERSITY,MULUKA I,ZONI 1,437,2,0,7,111,87,207,1,208,0,O-12-63-02-01-02
KAMPALA,KAWEMPE DIV. SOUTH,MAKERERE UNIVERSITY,MULUKA II,LUMUMBA (A-M),1237,9,1,10,406,119,545,6,551,0,O-12-63-02-02-01
KAMPALA,KAWEMPE DIV. SOUTH,MAKERERE UNIVERSITY,MULUKA II,MARYSTUART,1145,20,1,12,300,151,484,0,484,0,O-12-63-02-02-02
KAMPALA,KAWEMPE DIV. SOUTH,MAKERERE UNIVERSITY,MULUKA II,PROF THEREZA KAKOOZA' S,235,6,0,5,71,78,160,2,162,0,O-12-63-02-02-03
KAMPALA,KAWEMPE DIV. SOUTH,MAKERERE UNIVERSITY,MULUKA II,QUARRY FLATS,142,0,2,0,38,48,88,2,90,0,O-12-63-02-02-04
KAMPALA,KAWEMPE DIV. SOUTH,MAKERERE UNIVERSITY,MULUKA II,not specified),164,5,2,4,45,49,105,0,105,0,O-12-63-02-02-05
KAMPALA,KAWEMPE DIV. SOUTH,MAKERERE UNIVERSITY,MULUKA II,LIVINGSTONE,845,8,2,4,333,116,463,0,463,0,O-12-63-02-02-06
KAMPALA,KAWEMPE DIV. SOUTH,MAKERERE UNIVERSITY,MULUKA II,LUMUMBA (N-Z),800,10,2,8,291,64,375,2,377,0,O-12-63-02-02-07
KAMPALA,KAWEMPE DIV. SOUTH,MAKERERE UNIVERSITY,MULUKA III,AFRICA HALL,1096,17,1,4,254,129,405,2,407,0,O-12-63-02-03-01
KAMPALA,KAWEMPE DIV. SOUTH,MAKERERE UNIVERSITY,MULUKA III,MITCHELL HALL,992,15,1,7,393,127,543,0,543,0,O-12-63-02-03-02
KAMPALA,KAWEMPE DIV. SOUTH,MAKERERE UNIVERSITY,MULUKA III,BETWEEN NKURUMAH AND SWIM,1057,12,2,7,391,102,514,4,518,0,O-12-63-02-03-03
KAMPALA,KAWEMPE DIV. SOUTH,MAKERERE UNIVERSITY,MULUKA III,not specified),1118,13,8,5,432,113,571,3,574,0,O-12-63-02-03-04
KAMPALA,KAWEMPE DIV. SOUTH,MAKERERE UNIVERSITY,MULUKA IV,UNIVERSITY HALL PACKING YARD,1140,10,3,4,431,126,574,1,575,0,O-12-63-02-04-01
KAMPALA,KAWEMPE DIV. SOUTH,MAKERERE UNIVERSITY,MULUKA IV,MUGANZI FLATS,276,0,1,6,71,115,193,0,193,0,O-12-63-02-04-02
KAMPALA,KAWEMPE DIV. SOUTH,MAKERERE UNIVERSITY,MULUKA IV,FOOTBALL PITCH NEAR NSIBIRW,281,3,0,4,92,108,207,2,209,0,O-12-63-02-04-03
KAMPALA,KAWEMPE DIV. SOUTH,MAKERERE UNIVERSITY,MULUKA IV,not specified),216,2,2,0,43,54,101,4,105,0,O-12-63-02-04-04
KAMPALA,MAKINDYE DIV. EAST,MAKINDYE DIVISION,BUKASA,LC I MEETING PLACE KIYEMBE [A-,861,1,3,29,278,239,550,9,559,0,O-12-64-01-01-01
KAMPALA,MAKINDYE DIV. EAST,MAKINDYE DIVISION,BUKASA,BUKASA ROAD PROJECT [A - L],1039,5,4,3,293,162,467,14,481,0,O-12-64-01-01-02
KAMPALA,MAKINDYE DIV. EAST,MAKINDYE DIVISION,BUKASA,UDC COMPOUND,671,7,0,6,159,145,317,1,318,0,O-12-64-01-01-03
KAMPALA,MAKINDYE DIV. EAST,MAKINDYE DIVISION,BUKASA,ST. BANABAS S.S. SCHOOL,621,4,1,8,181,174,368,13,381,0,O-12-64-01-01-04
KAMPALA,MAKINDYE DIV. EAST,MAKINDYE DIVISION,BUKASA,BLOCK FACTORY,536,5,0,20,175,153,353,2,355,0,O-12-64-01-01-05
KAMPALA,MAKINDYE DIV. EAST,MAKINDYE DIVISION,BUKASA,ST. HENRY'S PRIMARY SCHOOL,605,2,3,6,178,173,362,5,367,0,O-12-64-01-01-06
KAMPALA,MAKINDYE DIV. EAST,MAKINDYE DIVISION,BUKASA,KATALE [A - J],838,1,2,0,221,133,357,13,370,0,O-12-64-01-01-07
KAMPALA,MAKINDYE DIV. EAST,MAKINDYE DIVISION,BUKASA,NAMUWONGO GRADERS,1232,3,2,7,334,213,559,14,573,0,O-12-64-01-01-08
KAMPALA,MAKINDYE DIV. EAST,MAKINDYE DIVISION,BUKASA,KINTU'S PLACE,593,2,3,15,174,157,351,1,352,0,O-12-64-01-01-09
KAMPALA,MAKINDYE DIV. EAST,MAKINDYE DIVISION,BUKASA,BUKASA ROAD PROJECT [M - N],672,0,0,0,128,201,329,19,348,0,O-12-64-01-01-10
KAMPALA,MAKINDYE DIV. EAST,MAKINDYE DIVISION,BUKASA,BUKASA ROAD PROJECT [O - Z],859,1,2,2,291,131,427,6,433,0,O-12-64-01-01-11
KAMPALA,MAKINDYE DIV. EAST,MAKINDYE DIVISION,BUKASA,KATALE [L - N],1014,1,0,1,176,290,468,8,476,0,O-12-64-01-01-12
KAMPALA,MAKINDYE DIV. EAST,MAKINDYE DIVISION,BUKASA,LC I MEETING PLACE KIYEMBE [N,823,3,2,16,236,201,458,0,458,0,O-12-64-01-01-13
KAMPALA,MAKINDYE DIV. EAST,MAKINDYE DIVISION,BUKASA,KATALE [O ],666,3,3,1,238,40,285,3,288,0,O-12-64-01-01-14
KAMPALA,MAKINDYE DIV. EAST,MAKINDYE DIVISION,BUKASA,KATALE [K] AND [P-Z),760,3,0,5,178,194,380,12,392,0,O-12-64-01-01-15
KAMPALA,MAKINDYE DIV. EAST,MAKINDYE DIVISION,GGABA,BUNGA HILL PRIMARY SCH. (A-MU,710,7,0,17,214,207,445,7,452,0,O-12-64-01-02-01
KAMPALA,MAKINDYE DIV. EAST,MAKINDYE DIVISION,GGABA,BUNGA TRADING CENTRE/NADULI,1338,9,0,45,473,252,779,9,788,0,O-12-64-01-02-02
KAMPALA,MAKINDYE DIV. EAST,MAKINDYE DIVISION,GGABA,NAMWANDU MUBIRU'S RESIDENC,914,4,4,40,260,246,554,2,556,0,O-12-64-01-02-03
KAMPALA,MAKINDYE DIV. EAST,MAKINDYE DIVISION,GGABA,KAWUKU FOOTBALL PITCH (A-NA,649,3,3,41,237,145,429,8,437,0,O-12-64-01-02-04
KAMPALA,MAKINDYE DIV. EAST,MAKINDYE DIVISION,GGABA,GGABA SECONDARY SCH. [A - KA,727,3,2,15,232,167,419,2,421,0,O-12-64-01-02-05
KAMPALA,MAKINDYE DIV. EAST,MAKINDYE DIVISION,GGABA,GGABA TRADING CENTRE/GABUD,788,5,3,16,266,196,486,2,488,0,O-12-64-01-02-06
KAMPALA,MAKINDYE DIV. EAST,MAKINDYE DIVISION,GGABA,BUNGA TRADING CENTRE/NADULI,1397,8,1,48,441,274,772,10,782,0,O-12-64-01-02-07
KAMPALA,MAKINDYE DIV. EAST,MAKINDYE DIVISION,GGABA,GGABA SEC SCHOOL[L-MUZ],617,6,1,22,234,123,386,1,387,0,O-12-64-01-02-08
KAMPALA,MAKINDYE DIV. EAST,MAKINDYE DIVISION,GGABA,GGABA SECONDARY SCH. [O - Z],813,3,4,19,313,131,470,7,477,0,O-12-64-01-02-09
KAMPALA,MAKINDYE DIV. EAST,MAKINDYE DIVISION,GGABA,GGABA TRADING CENTRE/GABUD,846,2,2,13,258,239,514,4,518,0,O-12-64-01-02-10
KAMPALA,MAKINDYE DIV. EAST,MAKINDYE DIVISION,GGABA,GGABA SEC SCHOOL[NAL-NZ],919,4,0,25,226,235,490,10,500,0,O-12-64-01-02-11
KAMPALA,MAKINDYE DIV. EAST,MAKINDYE DIVISION,GGABA,GGABA TRADING CENTRE/GABUD,501,0,0,7,190,102,299,13,312,0,O-12-64-01-02-12
KAMPALA,MAKINDYE DIV. EAST,MAKINDYE DIVISION,GGABA,BUNGA HILL PRIMARY SCHOOL (M,691,3,0,19,175,120,317,6,323,0,O-12-64-01-02-13
KAMPALA,MAKINDYE DIV. EAST,MAKINDYE DIVISION,GGABA,KAWUKU FOOTBALL PITCH (NABA,649,6,4,31,199,164,404,8,412,0,O-12-64-01-02-14
KAMPALA,MAKINDYE DIV. EAST,MAKINDYE DIVISION,GGABA,GGABA SECONDARY SCHOOL [KA,626,1,1,18,212,124,356,8,364,0,O-12-64-01-02-15
KAMPALA,MAKINDYE DIV. EAST,MAKINDYE DIVISION,GGABA,GGABA SEC SCHOOL [MW-N],577,0,0,10,138,175,323,9,332,0,O-12-64-01-02-16
KAMPALA,MAKINDYE DIV. EAST,MAKINDYE DIVISION,GGABA,GGABA TRADING CENTRE/GABUL,506,1,1,8,136,145,291,6,297,0,O-12-64-01-02-17
KAMPALA,MAKINDYE DIV. EAST,MAKINDYE DIVISION,KABALAGALA,JACK AND JILL PRIMARY SCHOOL,824,3,2,34,277,214,530,9,539,0,O-12-64-01-03-01
KAMPALA,MAKINDYE DIV. EAST,MAKINDYE DIVISION,KABALAGALA,KISAAWE PLAYGROUND (A-M),777,1,2,13,261,230,507,2,509,0,O-12-64-01-03-02
KAMPALA,MAKINDYE DIV. EAST,MAKINDYE DIVISION,KABALAGALA,ST. JOHN'S PLAY GROUND,977,3,0,28,314,218,563,19,582,0,O-12-64-01-03-03
KAMPALA,MAKINDYE DIV. EAST,MAKINDYE DIVISION,KABALAGALA,CHURCH OF UGANDA/PLAY GROU,1000,2,3,4,371,191,571,15,586,0,O-12-64-01-03-04
KAMPALA,MAKINDYE DIV. EAST,MAKINDYE DIVISION,KABALAGALA,LC I MEETING GROUND,908,3,3,27,303,269,605,8,613,0,O-12-64-01-03-05
KAMPALA,MAKINDYE DIV. EAST,MAKINDYE DIVISION,KABALAGALA,PLAYGROUND / OKIRIA'S RESIDE,805,3,5,8,250,129,395,2,397,0,O-12-64-01-03-06
KAMPALA,MAKINDYE DIV. EAST,MAKINDYE DIVISION,KABALAGALA,LC I MEETING GROUND [A - M],682,2,0,12,245,194,453,8,461,0,O-12-64-01-03-07
KAMPALA,MAKINDYE DIV. EAST,MAKINDYE DIVISION,KABALAGALA,SENKUSU' S PLACE,534,1,3,18,194,143,359,3,362,0,O-12-64-01-03-08
KAMPALA,MAKINDYE DIV. EAST,MAKINDYE DIVISION,KABALAGALA,CHURCH OF UGANDA/PLAYGROU,995,6,8,5,382,201,602,1,603,0,O-12-64-01-03-09
KAMPALA,MAKINDYE DIV. EAST,MAKINDYE DIVISION,KABALAGALA,PLAYGROUND / OKIRIA'S RESIDE,574,2,1,13,265,160,441,19,460,0,O-12-64-01-03-10
KAMPALA,MAKINDYE DIV. EAST,MAKINDYE DIVISION,KABALAGALA,LC I MEETING GROUND [N - Z],687,1,0,11,225,206,443,4,447,0,O-12-64-01-03-11
KAMPALA,MAKINDYE DIV. EAST,MAKINDYE DIVISION,KABALAGALA,KISAAWE PLAYGROUND (N-Z),666,2,1,19,221,165,408,2,410,0,O-12-64-01-03-12
KAMPALA,MAKINDYE DIV. EAST,MAKINDYE DIVISION,KANSANGA,CATHOLIC CHURCH,843,2,0,39,278,166,485,5,490,0,O-12-64-01-04-01
KAMPALA,MAKINDYE DIV. EAST,MAKINDYE DIVISION,KANSANGA,KABALAGALA POLICE POST [A-M],599,5,3,32,185,149,374,12,386,0,O-12-64-01-04-02
KAMPALA,MAKINDYE DIV. EAST,MAKINDYE DIVISION,KANSANGA,KATABI NURSERY SCHOOL,465,1,0,20,193,101,315,5,320,0,O-12-64-01-04-03
KAMPALA,MAKINDYE DIV. EAST,MAKINDYE DIVISION,KANSANGA,HAJAT 'S PLACE,259,4,0,13,65,67,149,8,157,0,O-12-64-01-04-04
KAMPALA,MAKINDYE DIV. EAST,MAKINDYE DIVISION,KANSANGA,PLAYGROUND,1180,3,4,42,344,280,673,15,688,0,O-12-64-01-04-05
KAMPALA,MAKINDYE DIV. EAST,MAKINDYE DIVISION,KANSANGA,K.C.C. PRIMARY SCHOOL [A - K],739,1,1,28,270,156,456,15,471,0,O-12-64-01-04-06
KAMPALA,MAKINDYE DIV. EAST,MAKINDYE DIVISION,KANSANGA,MUTESASILA PLAYGROUND,565,7,1,23,185,160,376,7,383,0,O-12-64-01-04-07
KAMPALA,MAKINDYE DIV. EAST,MAKINDYE DIVISION,KANSANGA,NABUTITI K.C.C PLAYGROUND [A -,721,2,2,25,190,217,436,4,440,0,O-12-64-01-04-08
KAMPALA,MAKINDYE DIV. EAST,MAKINDYE DIVISION,KANSANGA,K.C.C. PRIMARY SCHOOL [[A-M] [S,620,4,0,24,214,126,368,15,383,0,O-12-64-01-04-09
KAMPALA,MAKINDYE DIV. EAST,MAKINDYE DIVISION,KANSANGA,WHEELING PRIMARY,935,2,0,32,247,292,573,6,579,0,O-12-64-01-04-10
KAMPALA,MAKINDYE DIV. EAST,MAKINDYE DIVISION,KANSANGA,PEPSI-COLA,201,1,0,12,55,64,132,2,134,0,O-12-64-01-04-11
KAMPALA,MAKINDYE DIV. EAST,MAKINDYE DIVISION,KANSANGA,K.C.C. PRIMARY SCHOOL [ N ],907,0,1,29,273,248,551,11,562,0,O-12-64-01-04-12
KAMPALA,MAKINDYE DIV. EAST,MAKINDYE DIVISION,KANSANGA,K.C.C. PRIMARY SCHOOL [O - Z],474,3,1,20,188,98,310,5,315,0,O-12-64-01-04-13
KAMPALA,MAKINDYE DIV. EAST,MAKINDYE DIVISION,KANSANGA,NABUTITI K.C.C PLAYGROUND [[L-,382,1,1,8,116,101,227,1,228,0,O-12-64-01-04-14
KAMPALA,MAKINDYE DIV. EAST,MAKINDYE DIVISION,KANSANGA,KABALAGALA POLICE POST [N-Z],444,2,1,22,124,109,258,2,260,0,O-12-64-01-04-15
KAMPALA,MAKINDYE DIV. EAST,MAKINDYE DIVISION,KANSANGA,K.C.C PRIMARY SCHOOL [L-M],394,2,0,26,153,80,261,0,261,0,O-12-64-01-04-16
KAMPALA,MAKINDYE DIV. EAST,MAKINDYE DIVISION,KANSANGA,MUTESASIRA PLAYGROUND [N-Z],534,6,2,20,187,142,357,12,369,0,O-12-64-01-04-17
KAMPALA,MAKINDYE DIV. EAST,MAKINDYE DIVISION,KANSANGA,NABUTITI K.C.C PLAYGROUND [N-,1034,3,0,30,261,327,621,12,633,0,O-12-64-01-04-18
KAMPALA,MAKINDYE DIV. EAST,MAKINDYE DIVISION,KANSANGA,K.C.C PRIMARY SCHOOL [N-Z] [SS,647,2,3,26,200,158,389,4,393,0,O-12-64-01-04-19
KAMPALA,MAKINDYE DIV. EAST,MAKINDYE DIVISION,KIBULI,AGIP [A - M],1135,1,2,4,372,316,695,13,708,0,O-12-64-01-05-01
KAMPALA,MAKINDYE DIV. EAST,MAKINDYE DIVISION,KIBULI,AFRIGO HOUSE [A - M],521,0,0,5,187,125,317,6,323,0,O-12-64-01-05-02
KAMPALA,MAKINDYE DIV. EAST,MAKINDYE DIVISION,KIBULI,MUZAANA'S PLACE [A - M],743,5,0,9,262,155,431,8,439,0,O-12-64-01-05-03
KAMPALA,MAKINDYE DIV. EAST,MAKINDYE DIVISION,KIBULI,MULANGIRA' S PLACE,645,0,2,7,209,205,423,13,436,0,O-12-64-01-05-04
KAMPALA,MAKINDYE DIV. EAST,MAKINDYE DIVISION,KIBULI,LC I MEETING GROUND,523,0,1,9,180,103,293,13,306,0,O-12-64-01-05-05
KAMPALA,MAKINDYE DIV. EAST,MAKINDYE DIVISION,KIBULI,NURSERY SCHOOL,737,3,3,11,225,211,453,5,458,0,O-12-64-01-05-06
KAMPALA,MAKINDYE DIV. EAST,MAKINDYE DIVISION,KIBULI,MUZAANA'S PLACE [N - Z],608,1,3,4,227,104,339,6,345,0,O-12-64-01-05-07
KAMPALA,MAKINDYE DIV. EAST,MAKINDYE DIVISION,KIBULI,KATALE [A - M],1022,3,2,6,332,229,572,4,576,0,O-12-64-01-05-08
KAMPALA,MAKINDYE DIV. EAST,MAKINDYE DIVISION,KIBULI,LC I MEETING PLACE [A-M],577,2,1,2,202,152,359,0,359,0,O-12-64-01-05-09
KAMPALA,MAKINDYE DIV. EAST,MAKINDYE DIVISION,KIBULI,MARKET A [A-M],500,1,4,3,158,139,305,11,316,0,O-12-64-01-05-10
KAMPALA,MAKINDYE DIV. EAST,MAKINDYE DIVISION,KIBULI,MARKET B,601,2,1,8,216,137,364,34,398,0,O-12-64-01-05-11
KAMPALA,MAKINDYE DIV. EAST,MAKINDYE DIVISION,KIBULI,MOSQUE PLAYGROUND [A - M],816,2,1,8,288,159,458,10,468,0,O-12-64-01-05-12
KAMPALA,MAKINDYE DIV. EAST,MAKINDYE DIVISION,KIBULI,AGIP [N - Z],974,3,4,6,326,216,555,15,570,0,O-12-64-01-05-13
KAMPALA,MAKINDYE DIV. EAST,MAKINDYE DIVISION,KIBULI,AFRIGO HOUSE [N - Z],361,0,2,3,143,79,227,1,228,0,O-12-64-01-05-14
KAMPALA,MAKINDYE DIV. EAST,MAKINDYE DIVISION,KIBULI,KATALE [N - Z],909,0,6,7,319,161,493,11,504,0,O-12-64-01-05-15
KAMPALA,MAKINDYE DIV. EAST,MAKINDYE DIVISION,KIBULI,MOSQUE PLAYGROUND [O-Z],432,2,1,3,180,64,250,5,255,0,O-12-64-01-05-16
KAMPALA,MAKINDYE DIV. EAST,MAKINDYE DIVISION,KIBULI,KIBULI INSTITUTIONS,993,0,3,8,303,147,461,6,467,0,O-12-64-01-05-17
KAMPALA,MAKINDYE DIV. EAST,MAKINDYE DIVISION,KIBULI,LC 1 MEETING PLACE [N-Z],524,2,2,4,181,130,319,5,324,0,O-12-64-01-05-18
KAMPALA,MAKINDYE DIV. EAST,MAKINDYE DIVISION,KIBULI,MARKET ZONE A [N-Z],514,1,8,4,165,137,315,0,315,0,O-12-64-01-05-19
KAMPALA,MAKINDYE DIV. EAST,MAKINDYE DIVISION,KIBULI,MOSQUE PLAYGROUND [N],429,0,1,11,131,90,233,27,260,0,O-12-64-01-05-20
KAMPALA,MAKINDYE DIV. EAST,MAKINDYE DIVISION,KISUGU,MULUKA CHIEFS OFFICE [A - J],762,2,0,3,273,141,419,6,425,0,O-12-64-01-06-01
KAMPALA,MAKINDYE DIV. EAST,MAKINDYE DIVISION,KISUGU,KASANVU PLAYGROUND [A - M],735,1,1,9,185,220,416,4,420,0,O-12-64-01-06-02
KAMPALA,MAKINDYE DIV. EAST,MAKINDYE DIVISION,KISUGU,KIWULIRIZA PRIMARY SCHOOL [A,769,2,4,5,187,214,412,2,414,0,O-12-64-01-06-03
KAMPALA,MAKINDYE DIV. EAST,MAKINDYE DIVISION,KISUGU,PROJECT OFFICE,644,2,11,10,186,183,392,2,394,0,O-12-64-01-06-04
KAMPALA,MAKINDYE DIV. EAST,MAKINDYE DIVISION,KISUGU,KIWULILIZA PRIMARY SCHOOL,723,6,2,7,199,152,366,8,374,0,O-12-64-01-06-05
KAMPALA,MAKINDYE DIV. EAST,MAKINDYE DIVISION,KISUGU,KISUGU PRIMARY SCHOOL,1003,3,2,6,328,236,575,17,592,0,O-12-64-01-06-06
KAMPALA,MAKINDYE DIV. EAST,MAKINDYE DIVISION,KISUGU,ST. STEPHEN' S CHURCH 'A',646,4,4,3,209,145,365,1,366,0,O-12-64-01-06-07
KAMPALA,MAKINDYE DIV. EAST,MAKINDYE DIVISION,KISUGU,ST. STEPHEN' S CHURCH 'B',411,0,1,16,158,59,234,6,240,0,O-12-64-01-06-08
KAMPALA,MAKINDYE DIV. EAST,MAKINDYE DIVISION,KISUGU,MULUKA CHIEFS OFFICE [K-L],457,0,1,3,135,126,265,4,269,0,O-12-64-01-06-09
KAMPALA,MAKINDYE DIV. EAST,MAKINDYE DIVISION,KISUGU,MULUKA CHIEFS OFFICE [O - Z],785,0,5,3,290,140,438,6,444,0,O-12-64-01-06-10
KAMPALA,MAKINDYE DIV. EAST,MAKINDYE DIVISION,KISUGU,KIWULIRIZA PRIMARY SCHOOL [L,373,1,1,2,84,124,212,2,214,0,O-12-64-01-06-11
KAMPALA,MAKINDYE DIV. EAST,MAKINDYE DIVISION,KISUGU,KIWULIRIZA PRIMARY SCHOOL [O,591,3,1,7,190,112,313,1,314,0,O-12-64-01-06-12
KAMPALA,MAKINDYE DIV. EAST,MAKINDYE DIVISION,KISUGU,KASANVU PLAYGROUND [N - Z],718,1,1,3,162,233,400,3,403,0,O-12-64-01-06-13
KAMPALA,MAKINDYE DIV. EAST,MAKINDYE DIVISION,KISUGU,KIWULIRIZA PRIMARY SCHOOL [N],486,0,1,4,87,166,258,4,262,0,O-12-64-01-06-14
KAMPALA,MAKINDYE DIV. EAST,MAKINDYE DIVISION,KISUGU,MULUKA CHIEF'S PLACE [M-N],886,1,1,5,210,260,477,14,491,0,O-12-64-01-06-15
KAMPALA,MAKINDYE DIV. EAST,MAKINDYE DIVISION,NSAMBYA ESTATE,NSAMBYA ESTATE CANTEEN,573,2,0,12,187,157,358,0,358,0,O-12-64-01-07-01
KAMPALA,MAKINDYE DIV. EAST,MAKINDYE DIVISION,WABIGALO,CENTINARY P. S.,737,1,3,6,220,234,464,7,471,0,O-12-64-01-08-01
KAMPALA,MAKINDYE DIV. EAST,MAKINDYE DIVISION,WABIGALO,LC I MEETING PLACE [A - M],854,2,1,3,293,190,489,5,494,0,O-12-64-01-08-02
KAMPALA,MAKINDYE DIV. EAST,MAKINDYE DIVISION,WABIGALO,CHURCH [A - M],700,1,0,0,243,135,379,6,385,0,O-12-64-01-08-03
KAMPALA,MAKINDYE DIV. EAST,MAKINDYE DIVISION,WABIGALO,MARKET PLACE [A - M],671,1,2,3,218,163,387,6,393,0,O-12-64-01-08-04
KAMPALA,MAKINDYE DIV. EAST,MAKINDYE DIVISION,WABIGALO,CHURCH [N-Z],694,0,2,2,228,133,365,8,373,0,O-12-64-01-08-05
KAMPALA,MAKINDYE DIV. EAST,MAKINDYE DIVISION,WABIGALO,TRADING CENTRE,594,3,1,2,246,136,388,2,390,0,O-12-64-01-08-06
KAMPALA,MAKINDYE DIV. EAST,MAKINDYE DIVISION,WABIGALO,MUWAFU,820,2,4,5,286,178,475,6,481,0,O-12-64-01-08-07
KAMPALA,MAKINDYE DIV. EAST,MAKINDYE DIVISION,WABIGALO,CORONATION PRIMARY SCH. [A -,531,1,4,0,167,120,292,7,299,0,O-12-64-01-08-08
KAMPALA,MAKINDYE DIV. EAST,MAKINDYE DIVISION,WABIGALO,WABIGALO CHURCH OF UGANDA,868,3,4,3,267,242,519,0,519,0,O-12-64-01-08-09
KAMPALA,MAKINDYE DIV. EAST,MAKINDYE DIVISION,WABIGALO,KALINA [A - M],759,1,5,4,251,197,458,6,464,0,O-12-64-01-08-10
KAMPALA,MAKINDYE DIV. EAST,MAKINDYE DIVISION,WABIGALO,KELEZIA,757,0,1,7,203,222,433,17,450,0,O-12-64-01-08-11
KAMPALA,MAKINDYE DIV. EAST,MAKINDYE DIVISION,WABIGALO,LC I MEETING PLACE,398,0,0,0,99,115,214,2,216,0,O-12-64-01-08-12
KAMPALA,MAKINDYE DIV. EAST,MAKINDYE DIVISION,WABIGALO,MAIN ROAD,423,4,2,1,132,115,254,5,259,0,O-12-64-01-08-13
KAMPALA,MAKINDYE DIV. EAST,MAKINDYE DIVISION,WABIGALO,CORONATION PRIMARY SCH. [K-M,665,1,1,2,195,170,369,7,376,0,O-12-64-01-08-14
KAMPALA,MAKINDYE DIV. EAST,MAKINDYE DIVISION,WABIGALO,KALINA [N - Z],609,2,3,4,203,118,330,6,336,0,O-12-64-01-08-15
KAMPALA,MAKINDYE DIV. EAST,MAKINDYE DIVISION,WABIGALO,MARKET PLACE [N - Z],702,5,3,0,188,109,305,3,308,0,O-12-64-01-08-16
KAMPALA,MAKINDYE DIV. EAST,MAKINDYE DIVISION,WABIGALO,LC I MEETING PLACE [N - Z],940,6,8,3,268,193,478,11,489,0,O-12-64-01-08-17
KAMPALA,MAKINDYE DIV. EAST,MAKINDYE DIVISION,WABIGALO,CORONATION PRIMARY SCHOOL [,370,1,1,0,61,90,153,35,188,0,O-12-64-01-08-18
KAMPALA,MAKINDYE DIV. EAST,MAKINDYE DIVISION,WABIGALO,CORONATION PRIMARY SCOOL [O,693,3,12,1,225,127,368,6,374,0,O-12-64-01-08-19
KAMPALA,MAKINDYE DIVISION WEST,MAKINDYE DIVISION,BUZIGA,KATUUSO C.O.U. PRIMARY SCHO,866,5,3,27,263,172,470,9,479,0,O-12-65-01-09-01
KAMPALA,MAKINDYE DIVISION WEST,MAKINDYE DIVISION,BUZIGA,COMMUNITY CENTRE [A-KAZ],660,6,0,13,230,124,373,0,373,0,O-12-65-01-09-02
KAMPALA,MAKINDYE DIVISION WEST,MAKINDYE DIVISION,BUZIGA,MUWANGA MOSQUE (A-M),682,6,0,19,266,153,444,2,446,0,O-12-65-01-09-03
KAMPALA,MAKINDYE DIVISION WEST,MAKINDYE DIVISION,BUZIGA,KATUUSO C.O.U. PRIMARY SCHO,826,3,1,17,313,192,526,4,530,0,O-12-65-01-09-04
KAMPALA,MAKINDYE DIVISION WEST,MAKINDYE DIVISION,BUZIGA,COMMUNITY CENTRE [O-Z],406,1,1,9,143,66,220,0,220,0,O-12-65-01-09-05
KAMPALA,MAKINDYE DIVISION WEST,MAKINDYE DIVISION,BUZIGA,MUWANGA MOSQUE (N-Z),661,3,0,9,235,131,378,6,384,0,O-12-65-01-09-06
KAMPALA,MAKINDYE DIVISION WEST,MAKINDYE DIVISION,BUZIGA,COMMUNITY CENTRE (KE-M),447,2,0,17,173,65,257,6,263,0,O-12-65-01-09-07
KAMPALA,MAKINDYE DIVISION WEST,MAKINDYE DIVISION,BUZIGA,COMMNUITY CENTRE(N),824,3,0,24,206,172,405,0,405,0,O-12-65-01-09-08
KAMPALA,MAKINDYE DIVISION WEST,MAKINDYE DIVISION,KATWE I,LC I MEETING GROUND,460,0,0,29,193,83,305,5,310,0,O-12-65-01-10-01
KAMPALA,MAKINDYE DIVISION WEST,MAKINDYE DIVISION,KATWE I,KATWE KISAAWE,934,1,0,15,322,190,528,7,535,0,O-12-65-01-10-02
KAMPALA,MAKINDYE DIVISION WEST,MAKINDYE DIVISION,KATWE I,NOOR PRIMARY SCH.,799,1,1,6,357,137,502,16,518,0,O-12-65-01-10-03
KAMPALA,MAKINDYE DIVISION WEST,MAKINDYE DIVISION,KATWE I,BRIDGE NURSERY [A-M],943,1,0,20,339,184,544,7,551,0,O-12-65-01-10-04
KAMPALA,MAKINDYE DIVISION WEST,MAKINDYE DIVISION,KATWE I,MUWANGA S PLACE,714,2,3,17,282,131,435,11,446,0,O-12-65-01-10-05
KAMPALA,MAKINDYE DIVISION WEST,MAKINDYE DIVISION,KATWE I,HAJJI BATAS RESIDENCE,1154,5,0,36,422,250,713,13,726,0,O-12-65-01-10-06
KAMPALA,MAKINDYE DIVISION WEST,MAKINDYE DIVISION,KATWE I,KATWE C.O.U.,1003,4,3,52,424,135,618,4,622,0,O-12-65-01-10-07
KAMPALA,MAKINDYE DIVISION WEST,MAKINDYE DIVISION,KATWE I,BRIDGE NURSERY [O-Z],421,1,0,3,172,73,249,4,253,0,O-12-65-01-10-08
KAMPALA,MAKINDYE DIVISION WEST,MAKINDYE DIVISION,KATWE I,BRIDGE NURSERY [N]],781,2,0,8,247,179,436,11,447,0,O-12-65-01-10-09
KAMPALA,MAKINDYE DIVISION WEST,MAKINDYE DIVISION,KATWE II,CLOCK TOWER-KISAAWE [A-K],759,1,0,3,180,221,405,5,410,0,O-12-65-01-11-01
KAMPALA,MAKINDYE DIVISION WEST,MAKINDYE DIVISION,KATWE II,JAMBULA [A-M],466,4,2,0,144,126,276,14,290,0,O-12-65-01-11-02
KAMPALA,MAKINDYE DIVISION WEST,MAKINDYE DIVISION,KATWE II,KATWE PRIMARY SCH. [A-M],552,2,1,10,198,130,341,4,345,0,O-12-65-01-11-03
KAMPALA,MAKINDYE DIVISION WEST,MAKINDYE DIVISION,KATWE II,KATWE MIXED PRIMARY SCH [A-K],687,1,0,8,246,136,391,6,397,0,O-12-65-01-11-04
KAMPALA,MAKINDYE DIVISION WEST,MAKINDYE DIVISION,KATWE II,NURSERY SCHOOL [A-M],638,0,0,7,270,119,396,8,404,0,O-12-65-01-11-05
KAMPALA,MAKINDYE DIVISION WEST,MAKINDYE DIVISION,KATWE II,HAJI ISAAS PLACE [A-M],505,0,0,5,185,144,334,8,342,0,O-12-65-01-11-06
KAMPALA,MAKINDYE DIVISION WEST,MAKINDYE DIVISION,KATWE II,CLOCK TOWER-KISAAWE [N-Z],1019,1,1,16,268,282,568,14,582,0,O-12-65-01-11-07
KAMPALA,MAKINDYE DIVISION WEST,MAKINDYE DIVISION,KATWE II,KATWE MIXED PRIMARY SCH [N-Z],1118,2,1,11,388,203,605,12,617,0,O-12-65-01-11-08
KAMPALA,MAKINDYE DIVISION WEST,MAKINDYE DIVISION,KATWE II,NURSERY SCHOOL [N-Z],760,1,0,6,273,140,420,10,430,0,O-12-65-01-11-09
KAMPALA,MAKINDYE DIVISION WEST,MAKINDYE DIVISION,KATWE II,CLOCK TOWER - KISAWE [L-M],267,0,0,5,64,70,139,6,145,0,O-12-65-01-11-10
KAMPALA,MAKINDYE DIVISION WEST,MAKINDYE DIVISION,KATWE II,JAMBULA [N - Z],438,1,0,3,127,118,249,11,260,0,O-12-65-01-11-11
KAMPALA,MAKINDYE DIVISION WEST,MAKINDYE DIVISION,KATWE II,KATWE PRIMARY SCH. [N-Z],434,0,1,5,145,89,240,3,243,0,O-12-65-01-11-12
KAMPALA,MAKINDYE DIVISION WEST,MAKINDYE DIVISION,KATWE II,KATWE MIXED PRIMARY SCH [L-M,266,1,1,3,108,59,172,0,172,0,O-12-65-01-11-13
KAMPALA,MAKINDYE DIVISION WEST,MAKINDYE DIVISION,KATWE II,HAJI MUSA'S PLACE [N-Z],476,2,1,2,153,132,290,12,302,0,O-12-65-01-11-14
KAMPALA,MAKINDYE DIVISION WEST,MAKINDYE DIVISION,KIBUYE I,UNDER MANGO TREE (A-M),559,2,1,7,219,103,332,5,337,0,O-12-65-01-12-01
KAMPALA,MAKINDYE DIVISION WEST,MAKINDYE DIVISION,KIBUYE I,K.C.C OFFICE II SEKATAWA [A-K],974,2,1,25,333,156,517,3,520,0,O-12-65-01-12-02
KAMPALA,MAKINDYE DIVISION WEST,MAKINDYE DIVISION,KIBUYE I,NABISALU LC MEETING PLACE [A-,373,1,0,7,101,84,193,3,196,0,O-12-65-01-12-03
KAMPALA,MAKINDYE DIVISION WEST,MAKINDYE DIVISION,KIBUYE I,BALOKOLE PR SCH [A-J],395,0,0,6,108,70,184,2,186,0,O-12-65-01-12-04
KAMPALA,MAKINDYE DIVISION WEST,MAKINDYE DIVISION,KIBUYE I,IMEN PR SCH [A-M],946,4,0,23,372,178,577,16,593,0,O-12-65-01-12-05
KAMPALA,MAKINDYE DIVISION WEST,MAKINDYE DIVISION,KIBUYE I,KCC OFFICE II SEKATAWA [N],1269,5,0,19,418,204,646,12,658,0,O-12-65-01-12-06
KAMPALA,MAKINDYE DIVISION WEST,MAKINDYE DIVISION,KIBUYE I,K.C.C OFFICE II SEKATAWA [L-M],456,1,0,12,185,50,248,4,252,0,O-12-65-01-12-07
KAMPALA,MAKINDYE DIVISION WEST,MAKINDYE DIVISION,KIBUYE I,NABISALU LC MEETING PLACE [N,918,1,1,14,263,184,463,10,473,0,O-12-65-01-12-08
KAMPALA,MAKINDYE DIVISION WEST,MAKINDYE DIVISION,KIBUYE I,NABISALU LC MEETING PLACE [O-,664,0,1,12,262,114,389,5,394,0,O-12-65-01-12-09
KAMPALA,MAKINDYE DIVISION WEST,MAKINDYE DIVISION,KIBUYE I,NABISALU MEETING PLACE[G-K],890,0,0,18,340,150,508,4,512,0,O-12-65-01-12-10
KAMPALA,MAKINDYE DIVISION WEST,MAKINDYE DIVISION,KIBUYE I,NABISALU LC MEETING PLACE [N,576,0,2,3,161,110,276,0,276,0,O-12-65-01-12-11
KAMPALA,MAKINDYE DIVISION WEST,MAKINDYE DIVISION,KIBUYE I,BALOKOLE PR. SCH. (L-M),633,1,0,13,263,93,370,8,378,0,O-12-65-01-12-12
KAMPALA,MAKINDYE DIVISION WEST,MAKINDYE DIVISION,KIBUYE I,BALOKOLE PR SCH [NAM-NZ],902,1,0,9,250,164,424,8,432,0,O-12-65-01-12-13
KAMPALA,MAKINDYE DIVISION WEST,MAKINDYE DIVISION,KIBUYE I,BALOKOLE PR SCH [O-Z],618,1,3,9,250,89,352,1,353,0,O-12-65-01-12-14
KAMPALA,MAKINDYE DIVISION WEST,MAKINDYE DIVISION,KIBUYE I,BALOKOLE PR SCH [NAA-NAL],525,1,0,4,132,79,216,6,222,0,O-12-65-01-12-15
KAMPALA,MAKINDYE DIVISION WEST,MAKINDYE DIVISION,KIBUYE I,IMEN PR SCH [N-Z],1077,2,0,11,334,224,571,27,598,0,O-12-65-01-12-16
KAMPALA,MAKINDYE DIVISION WEST,MAKINDYE DIVISION,KIBUYE I,KCC OFFICE II SEKATAWA [O-Z],591,1,1,15,232,73,322,0,322,0,O-12-65-01-12-17
KAMPALA,MAKINDYE DIVISION WEST,MAKINDYE DIVISION,KIBUYE I,BALOKOLE (K),717,1,0,20,256,120,397,9,406,0,O-12-65-01-12-18
KAMPALA,MAKINDYE DIVISION WEST,MAKINDYE DIVISION,KIBUYE I,NABISALU MEETING PLACE[L-M],656,0,0,8,276,125,409,5,414,0,O-12-65-01-12-19
KAMPALA,MAKINDYE DIVISION WEST,MAKINDYE DIVISION,KIBUYE I,UNDER MANGO TREE (N-Z),668,1,0,11,245,125,382,0,382,0,O-12-65-01-12-20
KAMPALA,MAKINDYE DIVISION WEST,MAKINDYE DIVISION,KIBUYE II,KATENDES PLACE [A-M],646,3,1,21,226,94,345,4,349,0,O-12-65-01-13-01
KAMPALA,MAKINDYE DIVISION WEST,MAKINDYE DIVISION,KIBUYE II,MULUKA CHIEFS PLACE [A-M],841,4,0,18,315,163,500,2,502,0,O-12-65-01-13-02
KAMPALA,MAKINDYE DIVISION WEST,MAKINDYE DIVISION,KIBUYE II,MOLLYPAUL PR SCH [A-M],1035,1,1,20,366,195,583,10,593,0,O-12-65-01-13-03
KAMPALA,MAKINDYE DIVISION WEST,MAKINDYE DIVISION,KIBUYE II,C O U COMPOUND,1195,0,0,23,439,182,644,9,653,0,O-12-65-01-13-04
KAMPALA,MAKINDYE DIVISION WEST,MAKINDYE DIVISION,KIBUYE II,MULUKA CHIEFS PLACE [N-Z],908,0,0,13,299,183,495,2,497,0,O-12-65-01-13-05
KAMPALA,MAKINDYE DIVISION WEST,MAKINDYE DIVISION,KIBUYE II,MOLLYPAUL PR SCH [N-Z],1090,2,1,18,340,236,597,1,598,0,O-12-65-01-13-06
KAMPALA,MAKINDYE DIVISION WEST,MAKINDYE DIVISION,KIBUYE II,KATENDES PLACE [N-Z],777,2,0,17,253,116,388,7,395,0,O-12-65-01-13-07
KAMPALA,MAKINDYE DIVISION WEST,MAKINDYE DIVISION,LUKULI,COU LUKULI [A-M],985,2,0,35,339,203,579,4,583,0,O-12-65-01-14-01
KAMPALA,MAKINDYE DIVISION WEST,MAKINDYE DIVISION,LUKULI,LATE KYOYAGALAS PLACE,884,3,0,27,257,190,477,22,499,0,O-12-65-01-14-02
KAMPALA,MAKINDYE DIVISION WEST,MAKINDYE DIVISION,LUKULI,L C I MEETING GROUND,748,5,3,21,257,152,438,12,450,0,O-12-65-01-14-03
KAMPALA,MAKINDYE DIVISION WEST,MAKINDYE DIVISION,LUKULI,KATOS PLACE [LOWER KONGE][A-,688,3,3,7,243,88,344,69,413,0,O-12-65-01-14-04
KAMPALA,MAKINDYE DIVISION WEST,MAKINDYE DIVISION,LUKULI,TYABAS PLACE[A-M],804,2,4,30,299,171,506,4,510,0,O-12-65-01-14-05
KAMPALA,MAKINDYE DIVISION WEST,MAKINDYE DIVISION,LUKULI,KATOS PLACE [UPPER KONGE] [A-,517,1,3,14,224,112,354,1,355,0,O-12-65-01-14-06
KAMPALA,MAKINDYE DIVISION WEST,MAKINDYE DIVISION,LUKULI,NANGANDA PR SCH,986,3,0,26,307,179,515,79,594,0,O-12-65-01-14-07
KAMPALA,MAKINDYE DIVISION WEST,MAKINDYE DIVISION,LUKULI,COU LUKULI [N-Z],1061,4,2,38,324,239,607,4,611,0,O-12-65-01-14-08
KAMPALA,MAKINDYE DIVISION WEST,MAKINDYE DIVISION,LUKULI,TYABAS PLACE (N-Z),863,4,0,28,258,174,464,69,533,0,O-12-65-01-14-09
KAMPALA,MAKINDYE DIVISION WEST,MAKINDYE DIVISION,LUKULI,KATO'S PLACE[LOWER KONGE] [N,600,1,1,14,213,109,338,5,343,0,O-12-65-01-14-10
KAMPALA,MAKINDYE DIVISION WEST,MAKINDYE DIVISION,LUKULI,KATOS PLACE [UPPER KONGE] [N-,445,1,0,17,158,85,261,5,266,0,O-12-65-01-14-11
KAMPALA,MAKINDYE DIVISION WEST,MAKINDYE DIVISION,LUWAFU,KIKOMERA [A-M],1120,2,0,40,404,250,696,13,709,0,O-12-65-01-15-01
KAMPALA,MAKINDYE DIVISION WEST,MAKINDYE DIVISION,LUWAFU,GOMBOLOLA HQTRS [A-M],1040,5,0,32,399,181,617,16,633,0,O-12-65-01-15-02
KAMPALA,MAKINDYE DIVISION WEST,MAKINDYE DIVISION,LUWAFU,AMAZON PLAYGROUND [A-M],1129,3,0,46,408,177,634,19,653,0,O-12-65-01-15-03
KAMPALA,MAKINDYE DIVISION WEST,MAKINDYE DIVISION,LUWAFU,KIKOMERA [S-Z],581,1,0,17,227,110,355,0,355,0,O-12-65-01-15-04
KAMPALA,MAKINDYE DIVISION WEST,MAKINDYE DIVISION,LUWAFU,GOMBOLOLA HQTRS [NZ-Z],572,5,0,14,192,118,329,4,333,0,O-12-65-01-15-05
KAMPALA,MAKINDYE DIVISION WEST,MAKINDYE DIVISION,LUWAFU,AMAZON PLAYGROUND [N-Z],1217,3,3,38,411,220,675,6,681,0,O-12-65-01-15-06
KAMPALA,MAKINDYE DIVISION WEST,MAKINDYE DIVISION,LUWAFU,KIKOMERA [N-R],490,1,1,16,151,102,271,3,274,0,O-12-65-01-15-07
KAMPALA,MAKINDYE DIVISION WEST,MAKINDYE DIVISION,LUWAFU,GOMBOLOLA HQTRS [N-NY],508,0,1,18,126,65,210,5,215,0,O-12-65-01-15-08
KAMPALA,MAKINDYE DIVISION WEST,MAKINDYE DIVISION,MAKINDYE I,MIGADDES PLACE [A-M],767,2,1,21,298,130,452,42,494,0,O-12-65-01-16-01
KAMPALA,MAKINDYE DIVISION WEST,MAKINDYE DIVISION,MAKINDYE I,LC I MEETING PLACE,451,1,0,15,119,78,213,39,252,0,O-12-65-01-16-02
KAMPALA,MAKINDYE DIVISION WEST,MAKINDYE DIVISION,MAKINDYE I,NAMASOLE'S PLACE [A-M],1133,5,4,12,389,220,630,6,636,0,O-12-65-01-16-03
KAMPALA,MAKINDYE DIVISION WEST,MAKINDYE DIVISION,MAKINDYE I,LUVUMA KASAAWE,759,1,0,14,246,177,438,16,454,0,O-12-65-01-16-04
KAMPALA,MAKINDYE DIVISION WEST,MAKINDYE DIVISION,MAKINDYE I,TAWAFIQ PRIMARY SCHOOL [A-M],960,2,0,12,287,156,457,94,551,0,O-12-65-01-16-05
KAMPALA,MAKINDYE DIVISION WEST,MAKINDYE DIVISION,MAKINDYE I,KASENYAS PLACE,620,1,2,18,189,142,352,12,364,0,O-12-65-01-16-06
KAMPALA,MAKINDYE DIVISION WEST,MAKINDYE DIVISION,MAKINDYE I,MIGADDE'S PLACE (O-Z),452,1,2,8,202,65,278,0,278,0,O-12-65-01-16-07
KAMPALA,MAKINDYE DIVISION WEST,MAKINDYE DIVISION,MAKINDYE I,NAMASOLE'S PLACE (N-Z),289,2,1,6,114,41,164,1,165,0,O-12-65-01-16-08
KAMPALA,MAKINDYE DIVISION WEST,MAKINDYE DIVISION,MAKINDYE I,TAWAFIQ PRIMARY SCHOOL [N-Z],1004,1,0,22,328,199,550,7,557,0,O-12-65-01-16-09
KAMPALA,MAKINDYE DIVISION WEST,MAKINDYE DIVISION,MAKINDYE I,MIGADDE'S PLACE [N],657,1,1,14,192,103,311,60,371,0,O-12-65-01-16-10
KAMPALA,MAKINDYE DIVISION WEST,MAKINDYE DIVISION,MAKINDYE I,NAMASOLE'S PLACE [N],909,5,0,13,257,230,505,7,512,0,O-12-65-01-16-11
KAMPALA,MAKINDYE DIVISION WEST,MAKINDYE DIVISION,MAKINDYE I,MUBARAK ARMY [A-M],673,1,0,1,83,230,315,37,352,0,O-12-65-01-16-12
KAMPALA,MAKINDYE DIVISION WEST,MAKINDYE DIVISION,MAKINDYE I,MUBARAK ARMY [N-Z],395,1,3,0,62,191,257,0,257,0,O-12-65-01-16-13
KAMPALA,MAKINDYE DIVISION WEST,MAKINDYE DIVISION,MAKINDYE II,MAKINDYE MODEL NUR SCH [A-M],512,0,1,10,200,117,328,6,334,0,O-12-65-01-17-01
KAMPALA,MAKINDYE DIVISION WEST,MAKINDYE DIVISION,MAKINDYE II,KIBUYE PR SCH,539,1,0,25,152,138,316,2,318,0,O-12-65-01-17-02
KAMPALA,MAKINDYE DIVISION WEST,MAKINDYE DIVISION,MAKINDYE II,ROMAN CATHOLIC CHURCH [A-M],729,1,1,31,295,143,471,4,475,0,O-12-65-01-17-03
KAMPALA,MAKINDYE DIVISION WEST,MAKINDYE DIVISION,MAKINDYE II,NAMWANDU MUGULUMA [A-M],615,2,1,16,236,99,354,2,356,0,O-12-65-01-17-04
KAMPALA,MAKINDYE DIVISION WEST,MAKINDYE DIVISION,MAKINDYE II,KASAAWE [A-M],764,0,2,18,309,171,500,8,508,0,O-12-65-01-17-05
KAMPALA,MAKINDYE DIVISION WEST,MAKINDYE DIVISION,MAKINDYE II,KUBWAS PLACE [A-M],594,1,0,12,233,111,357,1,358,0,O-12-65-01-17-06
KAMPALA,MAKINDYE DIVISION WEST,MAKINDYE DIVISION,MAKINDYE II,ROMAN CATH CHURCH [O-Z],302,1,0,14,112,48,175,15,190,0,O-12-65-01-17-07
KAMPALA,MAKINDYE DIVISION WEST,MAKINDYE DIVISION,MAKINDYE II,NAMWANDU MUGULUMA [N-Z],436,2,0,12,171,81,266,3,269,0,O-12-65-01-17-08
KAMPALA,MAKINDYE DIVISION WEST,MAKINDYE DIVISION,MAKINDYE II,KASAAWE [N-Z],768,1,2,24,310,150,487,11,498,0,O-12-65-01-17-09
KAMPALA,MAKINDYE DIVISION WEST,MAKINDYE DIVISION,MAKINDYE II,MAKINDYE MODEL NUR SCH [N-Z],604,0,1,12,223,116,352,7,359,0,O-12-65-01-17-10
KAMPALA,MAKINDYE DIVISION WEST,MAKINDYE DIVISION,MAKINDYE II,NAMWANDU MUGULUMA [L-M],419,2,0,20,179,70,271,0,271,0,O-12-65-01-17-11
KAMPALA,MAKINDYE DIVISION WEST,MAKINDYE DIVISION,MAKINDYE II,KUBWA'S PLACE [N -Z],612,4,0,14,198,139,355,4,359,0,O-12-65-01-17-12
KAMPALA,MAKINDYE DIVISION WEST,MAKINDYE DIVISION,MAKINDYE II,ROMAN CATHOLIC CHURCH [N],535,0,0,24,158,138,320,8,328,0,O-12-65-01-17-13
KAMPALA,MAKINDYE DIVISION WEST,MAKINDYE DIVISION,MAKINDYE II,NAMWANDU MUGULUMA [N],848,3,0,22,244,179,448,9,457,0,O-12-65-01-17-14
KAMPALA,MAKINDYE DIVISION WEST,MAKINDYE DIVISION,NSAMBYA CENTRAL,ST PETERS SS SCHOOL [A-I],1037,3,1,10,306,250,570,10,580,0,O-12-65-01-18-01
KAMPALA,MAKINDYE DIVISION WEST,MAKINDYE DIVISION,NSAMBYA CENTRAL,KASAAWE (A-F),561,0,3,6,194,103,306,3,309,0,O-12-65-01-18-02
KAMPALA,MAKINDYE DIVISION WEST,MAKINDYE DIVISION,NSAMBYA CENTRAL,TANKHILL PRIMARY SCHOOL [A-M,422,0,1,2,106,118,227,4,231,0,O-12-65-01-18-03
KAMPALA,MAKINDYE DIVISION WEST,MAKINDYE DIVISION,NSAMBYA CENTRAL,HOSPITAL GROUNDS,629,1,0,11,156,74,242,7,249,0,O-12-65-01-18-04
KAMPALA,MAKINDYE DIVISION WEST,MAKINDYE DIVISION,NSAMBYA CENTRAL,ST PETERS PR SCH [A-J],844,0,6,1,291,105,403,8,411,0,O-12-65-01-18-05
KAMPALA,MAKINDYE DIVISION WEST,MAKINDYE DIVISION,NSAMBYA CENTRAL,ST PAUL PR SCHOOL [A-D],1017,2,1,7,234,284,528,7,535,0,O-12-65-01-18-06
KAMPALA,MAKINDYE DIVISION WEST,MAKINDYE DIVISION,NSAMBYA CENTRAL,ST PETERS SS SCH [N],897,1,1,13,230,269,514,11,525,0,O-12-65-01-18-07
KAMPALA,MAKINDYE DIVISION WEST,MAKINDYE DIVISION,NSAMBYA CENTRAL,ST PETERS SS SCH [O-Z],787,2,5,8,295,151,461,4,465,0,O-12-65-01-18-08
KAMPALA,MAKINDYE DIVISION WEST,MAKINDYE DIVISION,NSAMBYA CENTRAL,KASAAWE (O-Z),719,0,6,8,275,83,372,23,395,0,O-12-65-01-18-09
KAMPALA,MAKINDYE DIVISION WEST,MAKINDYE DIVISION,NSAMBYA CENTRAL,TANKHILL PR SCH [N],675,1,0,6,165,172,344,22,366,0,O-12-65-01-18-10
KAMPALA,MAKINDYE DIVISION WEST,MAKINDYE DIVISION,NSAMBYA CENTRAL,ST PETERS PR SCH [N-Z],1358,2,4,7,467,226,706,4,710,0,O-12-65-01-18-11
KAMPALA,MAKINDYE DIVISION WEST,MAKINDYE DIVISION,NSAMBYA CENTRAL,ST PETERS PR SCH [K-M],767,1,0,8,207,181,397,8,405,0,O-12-65-01-18-12
KAMPALA,MAKINDYE DIVISION WEST,MAKINDYE DIVISION,NSAMBYA CENTRAL,ST PAUL PR SCHOOL [E-J],336,1,0,2,72,70,145,2,147,0,O-12-65-01-18-13
KAMPALA,MAKINDYE DIVISION WEST,MAKINDYE DIVISION,NSAMBYA CENTRAL,ST PAUL PR SCH [KA],822,1,2,8,199,187,397,52,449,0,O-12-65-01-18-14
KAMPALA,MAKINDYE DIVISION WEST,MAKINDYE DIVISION,NSAMBYA CENTRAL,ST PAUL PR SCH [KE-KZ],727,1,0,8,169,180,358,19,377,0,O-12-65-01-18-15
KAMPALA,MAKINDYE DIVISION WEST,MAKINDYE DIVISION,NSAMBYA CENTRAL,ST PAUL PR SCH [M],1116,1,0,11,331,246,589,6,595,0,O-12-65-01-18-16
KAMPALA,MAKINDYE DIVISION WEST,MAKINDYE DIVISION,NSAMBYA CENTRAL,ST PAUL PR SCH [N-NAL],869,0,0,11,204,200,415,9,424,0,O-12-65-01-18-17
KAMPALA,MAKINDYE DIVISION WEST,MAKINDYE DIVISION,NSAMBYA CENTRAL,KISAAWE (N),719,2,0,20,203,165,390,7,397,0,O-12-65-01-18-18
KAMPALA,MAKINDYE DIVISION WEST,MAKINDYE DIVISION,NSAMBYA CENTRAL,KISAAWE (L-M),488,2,1,25,176,87,291,3,294,0,O-12-65-01-18-19
KAMPALA,MAKINDYE DIVISION WEST,MAKINDYE DIVISION,NSAMBYA CENTRAL,ST PAUL PR SCHOOL [L & O-R],527,0,0,7,139,120,266,3,269,0,O-12-65-01-18-20
KAMPALA,MAKINDYE DIVISION WEST,MAKINDYE DIVISION,NSAMBYA CENTRAL,ST PETERS SS SCH [M],487,1,1,7,169,137,315,7,322,0,O-12-65-01-18-21
KAMPALA,MAKINDYE DIVISION WEST,MAKINDYE DIVISION,NSAMBYA CENTRAL,TANKHILL PR SCH [O-Z],584,2,3,6,199,104,314,5,319,0,O-12-65-01-18-22
KAMPALA,MAKINDYE DIVISION WEST,MAKINDYE DIVISION,NSAMBYA CENTRAL,ST PAUL PR SCH [NAM-NZ],1140,2,0,12,282,265,561,15,576,0,O-12-65-01-18-23
KAMPALA,MAKINDYE DIVISION WEST,MAKINDYE DIVISION,NSAMBYA CENTRAL,ST PAUL PR SCH [S-Z],1097,1,2,15,317,222,557,37,594,0,O-12-65-01-18-24
KAMPALA,MAKINDYE DIVISION WEST,MAKINDYE DIVISION,NSAMBYA CENTRAL,POLICE NURSARY AND P/[A-F],1042,1,2,0,479,139,621,9,630,0,O-12-65-01-18-25
KAMPALA,MAKINDYE DIVISION WEST,MAKINDYE DIVISION,NSAMBYA CENTRAL,POLICE NURSARY AND P/S [G-M],824,3,0,1,254,199,457,34,491,0,O-12-65-01-18-26
KAMPALA,MAKINDYE DIVISION WEST,MAKINDYE DIVISION,NSAMBYA CENTRAL,POLICE NURSARY AND P/S [N-O],977,3,10,2,397,149,561,10,571,0,O-12-65-01-18-27
KAMPALA,MAKINDYE DIVISION WEST,MAKINDYE DIVISION,NSAMBYA CENTRAL,POLICE NURSARY AND P/S [P-Z],345,1,2,0,110,92,205,0,205,0,O-12-65-01-18-28
KAMPALA,MAKINDYE DIVISION WEST,MAKINDYE DIVISION,NSAMBYA CENTRAL,ST PETERS SS SCHOOL [J-L],388,0,0,6,122,97,225,23,248,0,O-12-65-01-18-29
KAMPALA,MAKINDYE DIVISION WEST,MAKINDYE DIVISION,NSAMBYA CENTRAL,KASAWE [G-K],476,0,0,18,143,91,252,2,254,0,O-12-65-01-18-30
KAMPALA,MAKINDYE DIVISION WEST,MAKINDYE DIVISION,NSAMBYA CENTRAL,TANKHILL PRIMARY SCHOOL [K-M,644,2,0,20,183,147,352,3,355,0,O-12-65-01-18-31
KAMPALA,MAKINDYE DIVISION WEST,MAKINDYE DIVISION,NSAMBYA RAILWAYS,KATALE,601,2,2,2,211,116,333,11,344,0,O-12-65-01-19-01
KAMPALA,MAKINDYE DIVISION WEST,MAKINDYE DIVISION,NSAMBYA RAILWAYS,NSAMBYA RAILWAYS PR SCH,802,3,1,1,344,155,504,8,512,0,O-12-65-01-19-02
KAMPALA,MAKINDYE DIVISION WEST,MAKINDYE DIVISION,NSAMBYA RAILWAYS,UNDER MANGO TREE,379,0,0,1,164,79,244,6,250,0,O-12-65-01-19-03
KAMPALA,MAKINDYE DIVISION WEST,MAKINDYE DIVISION,NSAMBYA RAILWAYS,KASAAWE,576,1,4,4,218,129,356,10,366,0,O-12-65-01-19-04
KAMPALA,MAKINDYE DIVISION WEST,MAKINDYE DIVISION,SALAMA,KITAWULUZI[A - M],597,6,1,34,239,95,375,5,380,0,O-12-65-01-20-01
KAMPALA,MAKINDYE DIVISION WEST,MAKINDYE DIVISION,SALAMA,KYAMULA COU [A-M],791,4,1,15,252,141,413,78,491,0,O-12-65-01-20-02
KAMPALA,MAKINDYE DIVISION WEST,MAKINDYE DIVISION,SALAMA,MUNYONYO PR SCH,1284,5,2,23,461,276,767,31,798,0,O-12-65-01-20-03
KAMPALA,MAKINDYE DIVISION WEST,MAKINDYE DIVISION,SALAMA,LUKYAMUZIS SHOP [A-M],931,2,2,41,385,166,596,4,600,0,O-12-65-01-20-04
KAMPALA,MAKINDYE DIVISION WEST,MAKINDYE DIVISION,SALAMA,KYAMULA COU [N-Z],953,7,0,32,282,212,533,16,549,0,O-12-65-01-20-05
KAMPALA,MAKINDYE DIVISION WEST,MAKINDYE DIVISION,SALAMA,LUKYAMUZIS SHOP [N-Z],1259,4,2,40,364,297,707,3,710,0,O-12-65-01-20-06
KAMPALA,MAKINDYE DIVISION WEST,MAKINDYE DIVISION,SALAMA,KITAWULUZI [N - Z],678,5,3,27,211,174,420,3,423,0,O-12-65-01-20-07
KAMPALA,NAKAWA DIVISION,NAKAWA,BANDA,MIN OF WORKS COMPOUND [A-K],920,4,0,3,321,141,469,8,477,0,O-12-68-01-01-01
KAMPALA,NAKAWA DIVISION,NAKAWA,BANDA,BANDA PR SCH,729,2,0,5,263,157,427,4,431,0,O-12-68-01-01-02
KAMPALA,NAKAWA DIVISION,NAKAWA,BANDA,BAGALAS PLACE,656,6,2,6,219,141,374,19,393,0,O-12-68-01-01-03
KAMPALA,NAKAWA DIVISION,NAKAWA,BANDA,KIMWANYI LC I GROUNDS,640,2,0,2,249,144,397,5,402,0,O-12-68-01-01-04
KAMPALA,NAKAWA DIVISION,NAKAWA,BANDA,MIN OF WORKS COMPOUND [L-N],420,0,0,1,135,82,218,9,227,0,O-12-68-01-01-05
KAMPALA,NAKAWA DIVISION,NAKAWA,BANDA,MUGERWAS PLACE,387,2,1,2,123,126,254,2,256,0,O-12-68-01-01-06
KAMPALA,NAKAWA DIVISION,NAKAWA,BANDA,LC II OFFICES,548,1,3,0,181,139,324,2,326,0,O-12-68-01-01-07
KAMPALA,NAKAWA DIVISION,NAKAWA,BANDA,NAMUWAWUS PLACE,542,4,0,6,193,142,345,2,347,0,O-12-68-01-01-08
KAMPALA,NAKAWA DIVISION,NAKAWA,BANDA,ABDALLAHS PLACE,745,1,4,8,217,202,432,10,442,0,O-12-68-01-01-09
KAMPALA,NAKAWA DIVISION,NAKAWA,BANDA,MOSQUE,559,0,0,9,186,155,350,2,352,0,O-12-68-01-01-10
KAMPALA,NAKAWA DIVISION,NAKAWA,BANDA,WAKALIMILAS PLACE (A-M),514,1,3,2,160,120,286,4,290,0,O-12-68-01-01-11
KAMPALA,NAKAWA DIVISION,NAKAWA,BANDA,KAWOYA CHANNEL (A-M),479,0,1,2,176,98,277,8,285,0,O-12-68-01-01-12
KAMPALA,NAKAWA DIVISION,NAKAWA,BANDA,MIN OF WORKS COMPOUND [O-Z],644,1,2,0,300,57,360,7,367,0,O-12-68-01-01-13
KAMPALA,NAKAWA DIVISION,NAKAWA,BANDA,WAKALIMILAS PLACE (N-Z),456,3,6,5,151,116,281,4,285,0,O-12-68-01-01-14
KAMPALA,NAKAWA DIVISION,NAKAWA,BANDA,KAWOYA CHANNEL (N-Z),467,1,0,2,121,143,267,2,269,0,O-12-68-01-01-15
KAMPALA,NAKAWA DIVISION,NAKAWA,BUGOLOBI,BLOCK 1 COMPOUND,909,9,9,3,263,262,546,3,549,0,O-12-68-01-02-01
KAMPALA,NAKAWA DIVISION,NAKAWA,BUGOLOBI,LC 2 OFFICES,598,3,5,2,130,218,358,5,363,0,O-12-68-01-02-02
KAMPALA,NAKAWA DIVISION,NAKAWA,BUGOLOBI,NEAR GABIRO,457,4,7,1,110,169,291,1,292,0,O-12-68-01-02-03
KAMPALA,NAKAWA DIVISION,NAKAWA,BUGOLOBI,LC 1 OFFICE (A),692,9,4,0,187,228,428,2,430,0,O-12-68-01-02-04
KAMPALA,NAKAWA DIVISION,NAKAWA,BUGOLOBI,BANGALOWS I,431,3,3,3,112,126,247,1,248,0,O-12-68-01-02-05
KAMPALA,NAKAWA DIVISION,NAKAWA,BUGOLOBI,LC 1 OFFICE (B),568,2,3,5,166,162,338,2,340,0,O-12-68-01-02-06
KAMPALA,NAKAWA DIVISION,NAKAWA,BUGOLOBI,INSIDE MARKET,403,1,0,3,120,130,254,3,257,0,O-12-68-01-02-07
KAMPALA,NAKAWA DIVISION,NAKAWA,BUGOLOBI,KCC OFFICES,750,3,3,4,214,220,444,9,453,0,O-12-68-01-02-08
KAMPALA,NAKAWA DIVISION,NAKAWA,BUGOLOBI,SILVER SPRINGS,300,1,1,3,94,62,161,2,163,0,O-12-68-01-02-09
KAMPALA,NAKAWA DIVISION,NAKAWA,BUGOLOBI,PLAN INTERNATIONAL,251,2,1,1,67,66,137,1,138,0,O-12-68-01-02-10
KAMPALA,NAKAWA DIVISION,NAKAWA,BUGOLOBI,AGOA FACTORY,960,0,0,0,183,206,389,31,420,0,O-12-68-01-02-11
KAMPALA,NAKAWA DIVISION,NAKAWA,BUKOTO I,PETER PIPER NUR SCH,536,7,0,5,139,164,315,2,317,0,O-12-68-01-03-01
KAMPALA,NAKAWA DIVISION,NAKAWA,BUKOTO I,LATE JUMAS PLACE,510,3,2,7,146,166,324,0,324,0,O-12-68-01-03-02
KAMPALA,NAKAWA DIVISION,NAKAWA,BUKOTO I,ALPHA,275,1,0,3,88,80,172,1,173,0,O-12-68-01-03-03
KAMPALA,NAKAWA DIVISION,NAKAWA,BUKOTO I,BEHIND NEW MARKET,358,2,0,4,103,113,222,0,222,0,O-12-68-01-03-04
KAMPALA,NAKAWA DIVISION,NAKAWA,BUKOTO I,MASALINI,592,6,1,4,173,199,383,3,386,0,O-12-68-01-03-05
KAMPALA,NAKAWA DIVISION,NAKAWA,BUKOTO I,KCC OFFICE,294,1,1,1,94,90,187,2,189,0,O-12-68-01-03-06
KAMPALA,NAKAWA DIVISION,NAKAWA,BUKOTO I,MUKALAZIS GATE,554,2,2,9,195,152,360,3,363,0,O-12-68-01-03-07
KAMPALA,NAKAWA DIVISION,NAKAWA,BUKOTO I,MULIMIRA [A-J],650,2,2,1,193,162,360,7,367,0,O-12-68-01-03-08
KAMPALA,NAKAWA DIVISION,NAKAWA,BUKOTO I,FROBEL PR SCH,700,4,8,8,239,200,459,1,460,0,O-12-68-01-03-09
KAMPALA,NAKAWA DIVISION,NAKAWA,BUKOTO I,NEXT TO CHURCH,634,5,1,9,193,173,381,15,396,0,O-12-68-01-03-10
KAMPALA,NAKAWA DIVISION,NAKAWA,BUKOTO I,AIDAHS PLACE,380,1,0,6,117,142,266,10,276,0,O-12-68-01-03-11
KAMPALA,NAKAWA DIVISION,NAKAWA,BUKOTO I,MAGULU MUTYABAS,466,5,1,11,130,135,282,3,285,0,O-12-68-01-03-12
KAMPALA,NAKAWA DIVISION,NAKAWA,BUKOTO I,LATE SSEMWOGERERE (A-M),567,4,1,3,176,164,348,12,360,0,O-12-68-01-03-13
KAMPALA,NAKAWA DIVISION,NAKAWA,BUKOTO I,MULIMIRA [K-M],962,7,2,3,274,281,567,7,574,0,O-12-68-01-03-14
KAMPALA,NAKAWA DIVISION,NAKAWA,BUKOTO I,MULIMIRA [N-N],703,4,1,7,139,255,406,0,406,0,O-12-68-01-03-15
KAMPALA,NAKAWA DIVISION,NAKAWA,BUKOTO I,MULIMIRA [O-Z],832,4,2,3,319,171,499,8,507,0,O-12-68-01-03-16
KAMPALA,NAKAWA DIVISION,NAKAWA,BUKOTO I,LATE SSEMWOGERERE (N-Z),472,1,1,3,151,123,279,3,282,0,O-12-68-01-03-17
KAMPALA,NAKAWA DIVISION,NAKAWA,BUKOTO II,BUKENYAS PLACE,1274,32,3,18,316,216,585,15,600,0,O-12-68-01-04-01
KAMPALA,NAKAWA DIVISION,NAKAWA,BUKOTO II,KIGOOWA PR SCH (A-M),457,11,0,14,161,109,295,2,297,0,O-12-68-01-04-02
KAMPALA,NAKAWA DIVISION,NAKAWA,BUKOTO II,KALINABIRI PR SCH A (A-M),643,7,1,7,211,117,343,13,356,0,O-12-68-01-04-03
KAMPALA,NAKAWA DIVISION,NAKAWA,BUKOTO II,KALINABIRI PR SCH B,989,22,3,12,342,180,559,15,574,0,O-12-68-01-04-04
KAMPALA,NAKAWA DIVISION,NAKAWA,BUKOTO II,LC 1 MEETING PLACE (A),848,17,4,13,266,190,490,4,494,0,O-12-68-01-04-05
KAMPALA,NAKAWA DIVISION,NAKAWA,BUKOTO II,KULAMBIRO TRADING CENTRE,626,9,2,8,188,151,358,9,367,0,O-12-68-01-04-06
KAMPALA,NAKAWA DIVISION,NAKAWA,BUKOTO II,KIGOOWA CHURCH A,516,10,1,8,147,114,280,2,282,0,O-12-68-01-04-07
KAMPALA,NAKAWA DIVISION,NAKAWA,BUKOTO II,KIGOOWA CHURCH B,969,11,1,14,306,210,542,6,548,0,O-12-68-01-04-08
KAMPALA,NAKAWA DIVISION,NAKAWA,BUKOTO II,BUKOTO MUSLIM PR / SCH [A-M],586,6,1,9,208,144,368,8,376,0,O-12-68-01-04-09
KAMPALA,NAKAWA DIVISION,NAKAWA,BUKOTO II,LC 1 MEETING PLACE (B),714,9,0,12,243,186,450,2,452,0,O-12-68-01-04-10
KAMPALA,NAKAWA DIVISION,NAKAWA,BUKOTO II,KALINABIRI PR SCH C,640,14,2,5,178,167,366,8,374,0,O-12-68-01-04-11
KAMPALA,NAKAWA DIVISION,NAKAWA,BUKOTO II,BUKOTO MUSLIM PR / SCH [N-Z],525,10,0,3,180,156,349,1,350,0,O-12-68-01-04-12
KAMPALA,NAKAWA DIVISION,NAKAWA,BUKOTO II,KIGOOWA PR SCH (N-Z),401,9,1,7,121,83,221,0,221,0,O-12-68-01-04-13
KAMPALA,NAKAWA DIVISION,NAKAWA,BUKOTO II,KALINABIRI PR SCH A (N-Z),617,6,1,4,168,118,297,51,348,0,O-12-68-01-04-14
KAMPALA,NAKAWA DIVISION,NAKAWA,BUTABIKA,BIINA CATHOLIC CHURCH A (A-M),697,3,3,13,273,185,477,13,490,0,O-12-68-01-05-01
KAMPALA,NAKAWA DIVISION,NAKAWA,BUTABIKA,BIINA CATHOLIC CHURCH B,469,2,0,10,205,96,313,6,319,0,O-12-68-01-05-02
KAMPALA,NAKAWA DIVISION,NAKAWA,BUTABIKA,BIINA CATHOLIC CHURCH C,802,0,2,9,297,195,503,15,518,0,O-12-68-01-05-03
KAMPALA,NAKAWA DIVISION,NAKAWA,BUTABIKA,BIINA CATHOLIC CHURCH D,731,7,0,5,292,138,442,3,445,0,O-12-68-01-05-04
KAMPALA,NAKAWA DIVISION,NAKAWA,BUTABIKA,BUTABIKA HOSPITAL GRNDS,533,4,1,1,147,119,272,1,273,0,O-12-68-01-05-05
KAMPALA,NAKAWA DIVISION,NAKAWA,BUTABIKA,TASINA HALL (A-M),833,2,3,7,332,154,498,15,513,0,O-12-68-01-05-06
KAMPALA,NAKAWA DIVISION,NAKAWA,BUTABIKA,BIINA CATHOLIC CHURCH E (A-M),733,5,2,6,301,163,477,5,482,0,O-12-68-01-05-07
KAMPALA,NAKAWA DIVISION,NAKAWA,BUTABIKA,BIINA CATHOLIC CHURCH A (N-Z),706,2,1,15,274,168,460,13,473,0,O-12-68-01-05-08
KAMPALA,NAKAWA DIVISION,NAKAWA,BUTABIKA,TASINA HALL (N-Z),856,4,4,6,332,195,541,9,550,0,O-12-68-01-05-09
KAMPALA,NAKAWA DIVISION,NAKAWA,BUTABIKA,BIINA CATHOLIC CHURCH E (N-Z),702,4,4,12,252,164,436,15,451,0,O-12-68-01-05-10
KAMPALA,NAKAWA DIVISION,NAKAWA,ITEK,ITEK DINING HALL [A-L],754,6,0,10,150,56,222,0,222,0,O-12-68-01-06-01
KAMPALA,NAKAWA DIVISION,NAKAWA,ITEK,ITEK DINING HALL [M-Z],648,1,1,4,123,63,192,0,192,0,O-12-68-01-06-02
KAMPALA,NAKAWA DIVISION,NAKAWA,KISWA,KISWA HEALTH CENTRE (A-M),723,4,4,1,268,180,457,6,463,0,O-12-68-01-07-01
KAMPALA,NAKAWA DIVISION,NAKAWA,KISWA,MARKET PLACE,883,4,7,5,240,215,471,5,476,0,O-12-68-01-07-02
KAMPALA,NAKAWA DIVISION,NAKAWA,KISWA,KISWA PR SCHOOL,521,6,1,4,155,154,320,4,324,0,O-12-68-01-07-03
KAMPALA,NAKAWA DIVISION,NAKAWA,KISWA,COMMUNITY CENTRE,469,3,1,4,126,122,256,6,262,0,O-12-68-01-07-04
KAMPALA,NAKAWA DIVISION,NAKAWA,KISWA,KISWA HEALTH CENTRE (N-Z),608,5,2,2,209,137,355,48,403,0,O-12-68-01-07-05
KAMPALA,NAKAWA DIVISION,NAKAWA,KIWATULE (KIWANDE,KIWATULE C O U (A-M),820,17,3,13,291,196,520,3,523,0,O-12-68-01-08-01
KAMPALA,NAKAWA DIVISION,NAKAWA,KIWATULE (KIWANDE,LC 1 MEETING PLACE (A),999,4,1,5,279,279,568,8,576,0,O-12-68-01-08-02
KAMPALA,NAKAWA DIVISION,NAKAWA,KIWATULE (KIWANDE,LC 1 MEETING PLACE (B),595,8,3,6,211,129,357,6,363,0,O-12-68-01-08-03
KAMPALA,NAKAWA DIVISION,NAKAWA,KIWATULE (KIWANDE,KELEZIA [A-K],780,13,0,9,251,201,474,8,482,0,O-12-68-01-08-04
KAMPALA,NAKAWA DIVISION,NAKAWA,KIWATULE (KIWANDE,KIWATULE C O U (N-Z),822,19,2,10,253,217,501,6,507,0,O-12-68-01-08-05
KAMPALA,NAKAWA DIVISION,NAKAWA,KIWATULE (KIWANDE,KELEZIA [L-M],381,3,1,6,155,73,238,6,244,0,O-12-68-01-08-06
KAMPALA,NAKAWA DIVISION,NAKAWA,KIWATULE (KIWANDE,KELEZIA [N-N],753,4,0,15,219,189,427,8,435,0,O-12-68-01-08-07
KAMPALA,NAKAWA DIVISION,NAKAWA,KIWATULE (KIWANDE,KELEZIA [O-Z],496,6,1,7,229,91,334,9,343,0,O-12-68-01-08-08
KAMPALA,NAKAWA DIVISION,NAKAWA,KYAMBOGO,WORKS TRAINING CENTRE,310,3,4,2,105,73,187,2,189,0,O-12-68-01-09-01
KAMPALA,NAKAWA DIVISION,NAKAWA,KYAMBOGO,WATERFORD NURSERY SCH,703,6,7,5,256,135,409,6,415,0,O-12-68-01-09-02
KAMPALA,NAKAWA DIVISION,NAKAWA,KYANJA,KULAMBIRO C O U (A),825,32,1,6,273,190,502,7,509,0,O-12-68-01-10-01
KAMPALA,NAKAWA DIVISION,NAKAWA,KYANJA,KYANJA MUSLIM PR SCH A,888,2,5,19,309,287,622,25,647,0,O-12-68-01-10-02
KAMPALA,NAKAWA DIVISION,NAKAWA,KYANJA,KISAASI QURAN PR SCH,2066,15,5,28,588,528,1164,24,1188,0,O-12-68-01-10-03
KAMPALA,NAKAWA DIVISION,NAKAWA,KYANJA,KULAMBIRO C O U (B),791,12,4,12,257,236,521,6,527,0,O-12-68-01-10-04
KAMPALA,NAKAWA DIVISION,NAKAWA,KYANJA,KYANJA MUSLIM PR SCH B,452,2,2,5,150,129,288,5,293,0,O-12-68-01-10-05
KAMPALA,NAKAWA DIVISION,NAKAWA,LUZIRA,AGATTIS PLACE,750,1,2,7,289,160,459,58,517,0,O-12-68-01-11-01
KAMPALA,NAKAWA DIVISION,NAKAWA,LUZIRA,LC I MEETING AREA,655,5,1,4,243,173,426,7,433,0,O-12-68-01-11-02
KAMPALA,NAKAWA DIVISION,NAKAWA,LUZIRA,KAMWANYI LC 1,294,0,0,2,109,65,176,1,177,0,O-12-68-01-11-03
KAMPALA,NAKAWA DIVISION,NAKAWA,LUZIRA,LAKEDRIVE POLICE DETACH,653,5,7,5,220,127,364,0,364,0,O-12-68-01-11-04
KAMPALA,NAKAWA DIVISION,NAKAWA,LUZIRA,KIYEMBE,431,0,2,7,178,132,319,1,320,0,O-12-68-01-11-05
KAMPALA,NAKAWA DIVISION,NAKAWA,LUZIRA,OLD KAYONZA DEPOT,599,3,0,12,193,195,403,1,404,0,O-12-68-01-11-06
KAMPALA,NAKAWA DIVISION,NAKAWA,LUZIRA,NEW KAYONZA DEPOT,497,1,0,2,166,130,299,2,301,0,O-12-68-01-11-07
KAMPALA,NAKAWA DIVISION,NAKAWA,LUZIRA,LAKESIDE LC 1 GROUNDS,643,6,2,17,244,161,430,1,431,0,O-12-68-01-11-08
KAMPALA,NAKAWA DIVISION,NAKAWA,LUZIRA,ST STEPHENS NURSERY,795,6,1,9,292,207,515,6,521,0,O-12-68-01-11-09
KAMPALA,NAKAWA DIVISION,NAKAWA,LUZIRA,WATER QUARTERS,328,2,1,3,138,60,204,3,207,0,O-12-68-01-11-10
KAMPALA,NAKAWA DIVISION,NAKAWA,LUZIRA,RAILWAY QUARTERS,522,0,0,0,126,86,212,36,248,0,O-12-68-01-11-11
KAMPALA,NAKAWA DIVISION,NAKAWA,LUZIRA,CAR WASHING BAY,542,1,2,9,160,138,310,5,315,0,O-12-68-01-11-12
KAMPALA,NAKAWA DIVISION,NAKAWA,LUZIRA,STAGE 5 POLLING STATION,755,3,1,20,258,184,466,4,470,0,O-12-68-01-11-13
KAMPALA,NAKAWA DIVISION,NAKAWA,LUZIRA,STAGE SIX,442,1,2,6,162,99,270,8,278,0,O-12-68-01-11-14
KAMPALA,NAKAWA DIVISION,NAKAWA,LUZIRA,UPPER BBIINA,535,2,5,18,193,109,327,8,335,0,O-12-68-01-11-15
KAMPALA,NAKAWA DIVISION,NAKAWA,LUZIRA,HAPPY HOURS NURSERY SCH.,294,1,1,5,100,62,169,6,175,0,O-12-68-01-11-16
KAMPALA,NAKAWA DIVISION,NAKAWA,LUZIRA PRISONS,MURCHISON BAY PR SCH,724,3,3,0,209,155,370,4,374,0,O-12-68-01-12-01
KAMPALA,NAKAWA DIVISION,NAKAWA,LUZIRA PRISONS,STAFF CANTEEN,703,3,9,1,202,147,362,4,366,0,O-12-68-01-12-02
KAMPALA,NAKAWA DIVISION,NAKAWA,LUZIRA PRISONS,INFRONT OF MURCH. BAY PRISO,486,0,2,0,112,65,179,34,213,0,O-12-68-01-12-03
KAMPALA,NAKAWA DIVISION,NAKAWA,LUZIRA PRISONS,FOOTBALL PLAYGROUND,558,3,5,0,117,60,185,3,188,0,O-12-68-01-12-04
KAMPALA,NAKAWA DIVISION,NAKAWA,LUZIRA PRISONS,REMAND PRISON,726,1,1,1,122,63,188,1,189,0,O-12-68-01-12-05
KAMPALA,NAKAWA DIVISION,NAKAWA,LUZIRA PRISONS,LUZIRA PRISONS OUTSIDE GUAR,233,0,0,0,27,44,71,3,74,0,O-12-68-01-12-06
KAMPALA,NAKAWA DIVISION,NAKAWA,MBUYA I,KULEMBERA MOSQUE,1016,1,1,5,283,278,568,8,576,0,O-12-68-01-13-01
KAMPALA,NAKAWA DIVISION,NAKAWA,MBUYA I,MBUYA TRADING CENTRE (A-M),768,0,1,5,206,227,439,1,440,0,O-12-68-01-13-02
KAMPALA,NAKAWA DIVISION,NAKAWA,MBUYA I,OKUVU A,427,0,2,1,144,42,189,2,191,0,O-12-68-01-13-03
KAMPALA,NAKAWA DIVISION,NAKAWA,MBUYA I,PARKING YARD (A-J),405,0,2,0,115,65,182,6,188,0,O-12-68-01-13-04
KAMPALA,NAKAWA DIVISION,NAKAWA,MBUYA I,MUJAMBULAS PLACE (A-B),1054,5,5,3,365,84,462,9,471,0,O-12-68-01-13-05
KAMPALA,NAKAWA DIVISION,NAKAWA,MBUYA I,MBUYA C O U,458,1,1,2,88,132,224,5,229,0,O-12-68-01-13-06
KAMPALA,NAKAWA DIVISION,NAKAWA,MBUYA I,ISAS PLACE,1081,1,8,1,331,175,516,9,525,0,O-12-68-01-13-07
KAMPALA,NAKAWA DIVISION,NAKAWA,MBUYA I,PARKING YARD (N-Z),784,3,3,1,256,176,439,6,445,0,O-12-68-01-13-08
KAMPALA,NAKAWA DIVISION,NAKAWA,MBUYA I,MUJAMBULAS PLACE (C-L),956,4,3,6,337,154,504,5,509,0,O-12-68-01-13-09
KAMPALA,NAKAWA DIVISION,NAKAWA,MBUYA I,MUJAMBULAS PLACE (M-N),1134,3,2,1,308,272,586,9,595,0,O-12-68-01-13-10
KAMPALA,NAKAWA DIVISION,NAKAWA,MBUYA I,OKUVU B,363,1,0,1,117,74,193,2,195,0,O-12-68-01-13-11
KAMPALA,NAKAWA DIVISION,NAKAWA,MBUYA I,PARKING YARD (K-M),506,0,2,4,161,126,293,5,298,0,O-12-68-01-13-12
KAMPALA,NAKAWA DIVISION,NAKAWA,MBUYA I,MBUYA TRADING CENTRE (N-Z),679,3,0,10,177,179,369,5,374,0,O-12-68-01-13-13
KAMPALA,NAKAWA DIVISION,NAKAWA,MBUYA I,MUJAMBULAS PLACE (O-O),1257,4,13,0,592,36,645,13,658,0,O-12-68-01-13-14
KAMPALA,NAKAWA DIVISION,NAKAWA,MBUYA I,MUJAMBULAS PLACE (P-Z),516,1,1,3,177,97,279,3,282,0,O-12-68-01-13-15
KAMPALA,NAKAWA DIVISION,NAKAWA,MBUYA I,UPPER MBUYA (A - A),693,1,7,0,89,112,209,2,211,0,O-12-68-01-13-16
KAMPALA,NAKAWA DIVISION,NAKAWA,MBUYA I,UPPER MBUYA (B - J),660,0,0,0,59,113,172,41,213,0,O-12-68-01-13-17
KAMPALA,NAKAWA DIVISION,NAKAWA,MBUYA I,UPPER MBUYA (K - K),609,0,0,1,50,164,215,3,218,0,O-12-68-01-13-18
KAMPALA,NAKAWA DIVISION,NAKAWA,MBUYA I,UPPER MBUYA (L - M),675,0,0,1,54,160,215,2,217,0,O-12-68-01-13-19
KAMPALA,NAKAWA DIVISION,NAKAWA,MBUYA I,UPPER MBUYA (N - O),1088,1,2,3,126,218,350,1,351,0,O-12-68-01-13-20
KAMPALA,NAKAWA DIVISION,NAKAWA,MBUYA I,UPPER MBUYA (P - Z),610,2,0,1,46,152,201,1,202,0,O-12-68-01-13-21
KAMPALA,NAKAWA DIVISION,NAKAWA,MBUYA II,STONE QUARRY,1047,8,9,8,346,230,601,20,621,0,O-12-68-01-14-01
KAMPALA,NAKAWA DIVISION,NAKAWA,MBUYA II,MUWALIMUS PLACE,946,4,1,4,356,216,581,9,590,0,O-12-68-01-14-02
KAMPALA,NAKAWA DIVISION,NAKAWA,MBUYA II,MASERUKAS PLACE,852,3,5,9,334,204,555,5,560,0,O-12-68-01-14-03
KAMPALA,NAKAWA DIVISION,NAKAWA,MBUYA II,MILO 4 TRADING CENTRE,1034,6,0,5,388,225,624,9,633,0,O-12-68-01-14-04
KAMPALA,NAKAWA DIVISION,NAKAWA,MBUYA II,KASIMASIMAS PLACE,393,1,0,5,161,83,250,3,253,0,O-12-68-01-14-05
KAMPALA,NAKAWA DIVISION,NAKAWA,MBUYA II,LC MEETING GROUND,604,2,0,2,182,168,354,12,366,0,O-12-68-01-14-06
KAMPALA,NAKAWA DIVISION,NAKAWA,MBUYA II,KITAWULUZI,1543,10,1,6,452,258,727,182,909,0,O-12-68-01-14-07
KAMPALA,NAKAWA DIVISION,NAKAWA,MBUYA II,NAKASERO SOAP WORKS,488,6,1,9,155,115,286,10,296,0,O-12-68-01-14-08
KAMPALA,NAKAWA DIVISION,NAKAWA,MUTUNGO,KATAKA GROUND (A-M),710,4,1,6,242,167,420,23,443,0,O-12-68-01-15-01
KAMPALA,NAKAWA DIVISION,NAKAWA,MUTUNGO,KIDUKA [A-A],689,1,1,0,214,107,323,42,365,0,O-12-68-01-15-02
KAMPALA,NAKAWA DIVISION,NAKAWA,MUTUNGO,KIDUKA (L-M),900,4,3,11,335,203,556,0,556,0,O-12-68-01-15-03
KAMPALA,NAKAWA DIVISION,NAKAWA,MUTUNGO,KIBIRA BAR (A-M),792,4,2,8,285,179,478,11,489,0,O-12-68-01-15-04
KAMPALA,NAKAWA DIVISION,NAKAWA,MUTUNGO,LC MEETING PLACE (A),530,1,2,6,153,94,256,5,261,0,O-12-68-01-15-05
KAMPALA,NAKAWA DIVISION,NAKAWA,MUTUNGO,KITINTALE POLICE POST (A-M),942,9,4,9,327,224,573,11,584,0,O-12-68-01-15-06
KAMPALA,NAKAWA DIVISION,NAKAWA,MUTUNGO,MARKET PLACE,1154,13,1,7,413,246,680,4,684,0,O-12-68-01-15-07
KAMPALA,NAKAWA DIVISION,NAKAWA,MUTUNGO,NURSERY SCHOOL,958,5,0,8,268,217,498,70,568,0,O-12-68-01-15-08
KAMPALA,NAKAWA DIVISION,NAKAWA,MUTUNGO,CAR WASHING BAY (A-L),651,4,0,5,267,125,401,0,401,0,O-12-68-01-15-09
KAMPALA,NAKAWA DIVISION,NAKAWA,MUTUNGO,CHAIRMAN GALABUZIS PLACE [A-,811,3,2,11,299,176,491,9,500,0,O-12-68-01-15-10
KAMPALA,NAKAWA DIVISION,NAKAWA,MUTUNGO,MARGARET GRANT SCHOOL (A-J),781,10,3,1,263,188,465,7,472,0,O-12-68-01-15-11
KAMPALA,NAKAWA DIVISION,NAKAWA,MUTUNGO,DDUNGU QUARTERS,760,6,3,6,300,166,481,8,489,0,O-12-68-01-15-12
KAMPALA,NAKAWA DIVISION,NAKAWA,MUTUNGO,KATAKA GROUND (N-Z),631,9,2,7,181,157,356,6,362,0,O-12-68-01-15-13
KAMPALA,NAKAWA DIVISION,NAKAWA,MUTUNGO,KIDUKA [NA-NAL],629,2,1,8,161,181,353,8,361,0,O-12-68-01-15-14
KAMPALA,NAKAWA DIVISION,NAKAWA,MUTUNGO,KIDUKA [O-R],811,2,5,0,373,46,426,16,442,0,O-12-68-01-15-15
KAMPALA,NAKAWA DIVISION,NAKAWA,MUTUNGO,KIBIRA BAR (N-Z),749,4,2,8,291,148,453,19,472,0,O-12-68-01-15-16
KAMPALA,NAKAWA DIVISION,NAKAWA,MUTUNGO,LC MEETING PLACE B[A-M],518,2,2,12,195,110,321,4,325,0,O-12-68-01-15-17
KAMPALA,NAKAWA DIVISION,NAKAWA,MUTUNGO,KITINTALE POLICE POST (N-Z),877,9,3,7,301,181,501,6,507,0,O-12-68-01-15-18
KAMPALA,NAKAWA DIVISION,NAKAWA,MUTUNGO,CAR WASHING BAY (M-Z),944,5,1,9,325,207,547,5,552,0,O-12-68-01-15-19
KAMPALA,NAKAWA DIVISION,NAKAWA,MUTUNGO,MARGARET GRANT SCHOOL (K-M),1278,11,0,20,470,368,869,2,871,0,O-12-68-01-15-20
KAMPALA,NAKAWA DIVISION,NAKAWA,MUTUNGO,MARGARET GRANT SCHOOL (N-N),1078,6,1,17,312,303,639,0,639,0,O-12-68-01-15-21
KAMPALA,NAKAWA DIVISION,NAKAWA,MUTUNGO,CHAIRMAN GALABUZIS PLACE [N-,750,2,1,12,279,161,455,4,459,0,O-12-68-01-15-22
KAMPALA,NAKAWA DIVISION,NAKAWA,MUTUNGO,LC MEETING PLACE B[N-Z],914,6,2,9,322,224,563,4,567,0,O-12-68-01-15-23
KAMPALA,NAKAWA DIVISION,NAKAWA,MUTUNGO,KIDUKA (K),973,6,1,15,309,238,569,9,578,0,O-12-68-01-15-24
KAMPALA,NAKAWA DIVISION,NAKAWA,MUTUNGO,MARGARET GRANT SCHOOL (O-Z),888,6,5,12,401,162,586,4,590,0,O-12-68-01-15-25
KAMPALA,NAKAWA DIVISION,NAKAWA,MUTUNGO,KIDUKA [B-J],759,4,3,4,260,156,427,8,435,0,O-12-68-01-15-26
KAMPALA,NAKAWA DIVISION,NAKAWA,MUTUNGO,KIDUKA [S-Z],816,7,0,8,294,171,480,11,491,0,O-12-68-01-15-27
KAMPALA,NAKAWA DIVISION,NAKAWA,MUTUNGO,KIDUKA [NAM-NZ],877,2,0,12,229,242,485,19,504,0,O-12-68-01-15-28
KAMPALA,NAKAWA DIVISION,NAKAWA,NABISUNSA,NATIONAL CURR. DEV. CENTRE,369,3,0,4,89,75,171,0,171,0,O-12-68-01-16-01
KAMPALA,NAKAWA DIVISION,NAKAWA,NAGURU I,BEHIND K.C.C OFFICES,376,1,6,1,110,110,228,2,230,0,O-12-68-01-17-01
KAMPALA,NAKAWA DIVISION,NAKAWA,NAGURU I,INFRONT OF KCC OFFICES,514,2,3,2,158,180,345,0,345,0,O-12-68-01-17-02
KAMPALA,NAKAWA DIVISION,NAKAWA,NAGURU I,KCC OFFICES [A-M],887,5,2,1,256,194,458,2,460,0,O-12-68-01-17-03
KAMPALA,NAKAWA DIVISION,NAKAWA,NAGURU I,NAGURU COMM CENTRE,1011,1,6,5,319,222,553,4,557,0,O-12-68-01-17-04
KAMPALA,NAKAWA DIVISION,NAKAWA,NAGURU I,NAGURU INFANT PR SCH,330,1,2,0,128,77,208,1,209,0,O-12-68-01-17-05
KAMPALA,NAKAWA DIVISION,NAKAWA,NAGURU I,KCC OFFICES [N-Z],664,4,1,5,182,137,329,0,329,0,O-12-68-01-17-06
KAMPALA,NAKAWA DIVISION,NAKAWA,NAGURU II,LC 1 MEETING PLACE,1152,3,10,5,403,171,592,20,612,0,O-12-68-01-18-01
KAMPALA,NAKAWA DIVISION,NAKAWA,NAGURU II,BROWN FLATS COMPOUND,323,5,4,4,99,80,192,2,194,0,O-12-68-01-18-02
KAMPALA,NAKAWA DIVISION,NAKAWA,NAGURU II,NAGURU KATALE PR SCH (A-M),633,4,2,4,174,130,314,0,314,0,O-12-68-01-18-03
KAMPALA,NAKAWA DIVISION,NAKAWA,NAGURU II,C O U GROUNDS,228,1,0,0,36,56,93,2,95,0,O-12-68-01-18-04
KAMPALA,NAKAWA DIVISION,NAKAWA,NAGURU II,EADB COMPOUND,361,0,3,2,91,79,175,1,176,0,O-12-68-01-18-05
KAMPALA,NAKAWA DIVISION,NAKAWA,NAGURU II,KIBOKOS PLACE A,861,0,3,0,321,108,432,7,439,0,O-12-68-01-18-06
KAMPALA,NAKAWA DIVISION,NAKAWA,NAGURU II,KIBOKOS PLACE B,895,3,4,3,279,106,395,9,404,0,O-12-68-01-18-07
KAMPALA,NAKAWA DIVISION,NAKAWA,NAGURU II,MARKET PLACE (A),530,2,3,3,170,100,278,3,281,0,O-12-68-01-18-08
KAMPALA,NAKAWA DIVISION,NAKAWA,NAGURU II,NAGURU KCC OFFICE,1352,3,2,8,421,250,684,8,692,0,O-12-68-01-18-09
KAMPALA,NAKAWA DIVISION,NAKAWA,NAGURU II,SHELL GROUNDS [A-A],684,2,4,0,295,54,355,4,359,0,O-12-68-01-18-10
KAMPALA,NAKAWA DIVISION,NAKAWA,NAGURU II,KCC OFFICE,992,2,4,3,285,151,445,4,449,0,O-12-68-01-18-11
KAMPALA,NAKAWA DIVISION,NAKAWA,NAGURU II,KIWALIMU MOSQUE,723,2,4,5,238,154,403,8,411,0,O-12-68-01-18-12
KAMPALA,NAKAWA DIVISION,NAKAWA,NAGURU II,SHELL GROUNDS [B-L],690,1,3,1,239,125,369,2,371,0,O-12-68-01-18-13
KAMPALA,NAKAWA DIVISION,NAKAWA,NAGURU II,BETTYS PLACE,900,1,1,1,367,168,538,28,566,0,O-12-68-01-18-14
KAMPALA,NAKAWA DIVISION,NAKAWA,NAGURU II,MARKET PLACE (B),582,1,2,0,191,96,290,2,292,0,O-12-68-01-18-15
KAMPALA,NAKAWA DIVISION,NAKAWA,NAGURU II,FULL GOSPEL CHURCH,574,0,2,1,196,104,303,10,313,0,O-12-68-01-18-16
KAMPALA,NAKAWA DIVISION,NAKAWA,NAGURU II,REGIONAL COOP FLATS CPD,623,3,16,6,187,154,366,5,371,0,O-12-68-01-18-17
KAMPALA,NAKAWA DIVISION,NAKAWA,NAGURU II,SHELL GROUNDS [M-N],576,3,2,3,158,142,308,2,310,0,O-12-68-01-18-18
KAMPALA,NAKAWA DIVISION,NAKAWA,NAGURU II,NAGURU KATALE PR SCH (N-Z),499,2,4,1,131,123,261,2,263,0,O-12-68-01-18-19
KAMPALA,NAKAWA DIVISION,NAKAWA,NAGURU II,SHELL GROUNDS [O-Z],777,1,8,1,325,85,420,8,428,0,O-12-68-01-18-20
KAMPALA,NAKAWA DIVISION,NAKAWA,NAKAWA,MIWANDAS PLACE,446,2,1,3,145,124,275,0,275,0,O-12-68-01-19-01
KAMPALA,NAKAWA DIVISION,NAKAWA,NAKAWA,KCC OFFICES,1306,7,11,2,516,225,761,8,769,0,O-12-68-01-19-02
KAMPALA,NAKAWA DIVISION,NAKAWA,NAKAWA,NAKAWA PS HOUSE/KIYEMBE Z/R,591,2,5,1,252,90,350,5,355,0,O-12-68-01-19-03
KAMPALA,NAKAWA DIVISION,NAKAWA,NAKAWA,PENTCOSTAL CHURCH,683,4,5,1,222,170,402,4,406,0,O-12-68-01-19-04
KAMPALA,NAKAWA DIVISION,NAKAWA,NAKAWA,NSIMBE KASI,585,1,0,6,236,114,357,22,379,0,O-12-68-01-19-05
KAMPALA,NAKAWA DIVISION,NAKAWA,NAKAWA,SENTAMUS PLACE,468,4,0,11,119,152,286,0,286,0,O-12-68-01-19-06
KAMPALA,NAKAWA DIVISION,NAKAWA,NAKAWA,NAKAWA PS HOUSE/KIYEMBE Z/R,699,1,5,2,300,136,444,3,447,0,O-12-68-01-19-07
KAMPALA,NAKAWA DIVISION,NAKAWA,NAKAWA INSTITUTIO,STAFF QUARTER,1098,11,3,5,363,192,574,4,578,0,O-12-68-01-20-01
KAMPALA,NAKAWA DIVISION,NAKAWA,NAKAWA INSTITUTIO,MUBS CAMPUS 602,2630,25,3,11,719,363,1121,2,1123,0,O-12-68-01-20-02
KAMPALA,NAKAWA DIVISION,NAKAWA,NTINDA,NTINDA POST OFFICE,637,25,3,14,189,130,361,11,372,0,O-12-68-01-21-01
KAMPALA,NAKAWA DIVISION,NAKAWA,NTINDA,INFORMATION FLATS (A-L),574,12,4,13,204,133,366,5,371,0,O-12-68-01-21-02
KAMPALA,NAKAWA DIVISION,NAKAWA,NTINDA,SCHOOL OF THE DEAF,1614,37,8,14,529,398,986,4,990,0,O-12-68-01-21-03
KAMPALA,NAKAWA DIVISION,NAKAWA,NTINDA,NTINDA NEW MARKET,776,17,7,7,230,157,418,49,467,0,O-12-68-01-21-04
KAMPALA,NAKAWA DIVISION,NAKAWA,NTINDA,TODLERS CENTRE,805,12,8,4,264,221,509,8,517,0,O-12-68-01-21-05
KAMPALA,NAKAWA DIVISION,NAKAWA,NTINDA,INFORMATION FLATS (M-Z),784,20,4,12,248,160,444,1,445,0,O-12-68-01-21-06
KAMPALA,NAKAWA DIVISION,NAKAWA,UPK,UPK - A MAIN HALL,432,5,2,3,118,79,207,2,209,0,O-12-68-01-22-01
KAMPALA,NAKAWA DIVISION,NAKAWA,UPK,UPK - CIVIL ENGINEERING (A-M),1048,9,2,10,226,96,343,0,343,0,O-12-68-01-22-02
KAMPALA,NAKAWA DIVISION,NAKAWA,UPK,UPK - CIVIL ENGINEERING (N-Z),800,3,4,7,178,84,276,0,276,0,O-12-68-01-22-03
KAMPALA,NAKAWA DIVISION,NAKAWA,UPPER ESTATE,ITEK MAINHALL,388,3,5,8,120,58,194,0,194,0,O-12-68-01-23-01
KAMPALA,NAKAWA DIVISION,NAKAWA,UPPER ESTATE,KYAMBOGO PR SCHOOL,569,7,0,7,163,180,357,4,361,0,O-12-68-01-23-02
KAMPALA,RUBAGA DIV. SOUTH,RUBAGA DIVISION,BUSEGA,KAJUBI MODERN PR. SCH. A.,631,1,0,7,246,131,385,5,390,0,O-12-67-01-01-01
KAMPALA,RUBAGA DIV. SOUTH,RUBAGA DIVISION,BUSEGA,KIRIBEDDA CATHOLIC CHURCH B,620,2,0,25,229,141,397,8,405,0,O-12-67-01-01-02
KAMPALA,RUBAGA DIV. SOUTH,RUBAGA DIVISION,BUSEGA,BUSEGA MODERN SCHOOL (A-M),995,1,1,21,389,153,565,75,640,0,O-12-67-01-01-03
KAMPALA,RUBAGA DIV. SOUTH,RUBAGA DIVISION,BUSEGA,NEW KABAALE PRIMARY SCH.,742,6,0,31,265,194,496,7,503,0,O-12-67-01-01-04
KAMPALA,RUBAGA DIV. SOUTH,RUBAGA DIVISION,BUSEGA,BUSEGA TRADING CENTRE [A-M],545,2,0,9,228,105,344,1,345,0,O-12-67-01-01-05
KAMPALA,RUBAGA DIV. SOUTH,RUBAGA DIVISION,BUSEGA,DDAMULIRA' S HOME,966,2,0,30,379,243,654,6,660,0,O-12-67-01-01-06
KAMPALA,RUBAGA DIV. SOUTH,RUBAGA DIVISION,BUSEGA,BUSEGA DEMO SCH (A -K),693,2,0,27,251,113,393,2,395,0,O-12-67-01-01-07
KAMPALA,RUBAGA DIV. SOUTH,RUBAGA DIVISION,BUSEGA,KITAKA ABC PR. SCH (A -K),929,2,1,22,331,158,514,7,521,0,O-12-67-01-01-08
KAMPALA,RUBAGA DIV. SOUTH,RUBAGA DIVISION,BUSEGA,K.C.C. COMMUNITY CENTRE,663,6,1,22,230,184,443,9,452,0,O-12-67-01-01-09
KAMPALA,RUBAGA DIV. SOUTH,RUBAGA DIVISION,BUSEGA,BUSEGA MODERN SCHOOL (N-NA,671,2,1,14,181,174,372,13,385,0,O-12-67-01-01-10
KAMPALA,RUBAGA DIV. SOUTH,RUBAGA DIVISION,BUSEGA,BUSEGA DEMO SCH (N -N),912,1,2,20,242,196,461,10,471,0,O-12-67-01-01-11
KAMPALA,RUBAGA DIV. SOUTH,RUBAGA DIVISION,BUSEGA,KITAKA ABC PR. SCH (L -M),577,2,0,22,205,90,319,2,321,0,O-12-67-01-01-12
KAMPALA,RUBAGA DIV. SOUTH,RUBAGA DIVISION,BUSEGA,KITAKA ABC PR. SCH (N -NAL),558,0,1,13,170,132,316,0,316,0,O-12-67-01-01-13
KAMPALA,RUBAGA DIV. SOUTH,RUBAGA DIVISION,BUSEGA,KITAKA ABC PR. SCH (O -Z),569,1,1,14,209,66,291,34,325,0,O-12-67-01-01-14
KAMPALA,RUBAGA DIV. SOUTH,RUBAGA DIVISION,BUSEGA,BUSEGA DEMO SCH (O -Z),423,1,0,11,186,83,281,2,283,0,O-12-67-01-01-15
KAMPALA,RUBAGA DIV. SOUTH,RUBAGA DIVISION,BUSEGA,BUSEGA TRADING CENTRE [N-Z],590,1,1,16,219,138,375,5,380,0,O-12-67-01-01-16
KAMPALA,RUBAGA DIV. SOUTH,RUBAGA DIVISION,BUSEGA,BUSEGA DEMO SCH (L -M),311,0,0,14,137,41,192,5,197,0,O-12-67-01-01-17
KAMPALA,RUBAGA DIV. SOUTH,RUBAGA DIVISION,BUSEGA,BUSEGA MODERN SCHOOL (NAN-,635,0,1,14,247,120,382,9,391,0,O-12-67-01-01-18
KAMPALA,RUBAGA DIV. SOUTH,RUBAGA DIVISION,BUSEGA,KITAKA ABC PR. SCH (NAM -NZ),653,1,0,15,164,134,314,4,318,0,O-12-67-01-01-19
KAMPALA,RUBAGA DIV. SOUTH,RUBAGA DIVISION,KABOWA,VICTORY PRIMARY SCH. (A - M),855,4,2,11,348,133,498,9,507,0,O-12-67-01-02-01
KAMPALA,RUBAGA DIV. SOUTH,RUBAGA DIVISION,KABOWA,TRINITY PRIMARY SCHOOL (A - KA,791,1,0,9,291,126,427,6,433,0,O-12-67-01-02-02
KAMPALA,RUBAGA DIV. SOUTH,RUBAGA DIVISION,KABOWA,KABOWA C/U PRIMARY SCH.II [A -,702,3,2,17,226,129,377,54,431,0,O-12-67-01-02-03
KAMPALA,RUBAGA DIV. SOUTH,RUBAGA DIVISION,KABOWA,KABOWA C. U. (A - M),653,2,0,17,276,116,411,8,419,0,O-12-67-01-02-04
KAMPALA,RUBAGA DIV. SOUTH,RUBAGA DIVISION,KABOWA,KISAAWE KIKADDE A (A - M),692,6,0,14,297,119,436,7,443,0,O-12-67-01-02-05
KAMPALA,RUBAGA DIV. SOUTH,RUBAGA DIVISION,KABOWA,KABOWA CATHOLIC CHURCH [A-,614,8,1,23,232,146,410,8,418,0,O-12-67-01-02-06
KAMPALA,RUBAGA DIV. SOUTH,RUBAGA DIVISION,KABOWA,KISAWE KIKADDE B (A - L),1084,5,0,18,419,170,612,99,711,0,O-12-67-01-02-07
KAMPALA,RUBAGA DIV. SOUTH,RUBAGA DIVISION,KABOWA,KABOWA C/U PRIMARY SCH.(A-M),704,4,0,16,228,152,400,4,404,0,O-12-67-01-02-08
KAMPALA,RUBAGA DIV. SOUTH,RUBAGA DIVISION,KABOWA,VICTORY PRIMARY SCH. (N - Z),1144,4,2,13,375,212,606,14,620,0,O-12-67-01-02-09
KAMPALA,RUBAGA DIV. SOUTH,RUBAGA DIVISION,KABOWA,KABOWA C. U. (N - Z),783,3,0,16,272,138,429,5,434,0,O-12-67-01-02-10
KAMPALA,RUBAGA DIV. SOUTH,RUBAGA DIVISION,KABOWA,TRINITY PRIMARY SCHOOL (M -NA,1338,3,0,19,337,240,599,104,703,0,O-12-67-01-02-11
KAMPALA,RUBAGA DIV. SOUTH,RUBAGA DIVISION,KABOWA,TRINITY PRIMARY SCHOOL (NAM -,225,1,0,0,69,20,90,18,108,0,O-12-67-01-02-12
KAMPALA,RUBAGA DIV. SOUTH,RUBAGA DIVISION,KABOWA,KISAAWE KIKADDE A (N - Z),871,4,1,10,319,161,495,3,498,0,O-12-67-01-02-13
KAMPALA,RUBAGA DIV. SOUTH,RUBAGA DIVISION,KABOWA,KISAWE KIKADDE B (M - NAJ),735,2,0,21,244,155,422,7,429,0,O-12-67-01-02-14
KAMPALA,RUBAGA DIV. SOUTH,RUBAGA DIVISION,KABOWA,KISAWE KIKADDE B (NAN - Z),956,2,0,12,407,148,569,6,575,0,O-12-67-01-02-15
KAMPALA,RUBAGA DIV. SOUTH,RUBAGA DIVISION,KABOWA,KABOWA C/U PRIMARY SCH.(N-N),467,3,1,6,129,99,238,26,264,0,O-12-67-01-02-16
KAMPALA,RUBAGA DIV. SOUTH,RUBAGA DIVISION,KABOWA,KABOWA C/U PRIMARY SCH.(O-Z),227,2,1,2,93,39,137,0,137,0,O-12-67-01-02-17
KAMPALA,RUBAGA DIV. SOUTH,RUBAGA DIVISION,KABOWA,TRINITY PRIMARY SCHOOL (KAT -,405,1,0,10,157,64,232,2,234,0,O-12-67-01-02-18
KAMPALA,RUBAGA DIV. SOUTH,RUBAGA DIVISION,KABOWA,KABOWA C/U PRIMARY SCH.II [NA,443,2,1,14,147,86,250,6,256,0,O-12-67-01-02-19
KAMPALA,RUBAGA DIV. SOUTH,RUBAGA DIVISION,KABOWA,KABOWA CATHOLIC CHURCH [N-Z,645,8,0,20,215,140,383,9,392,0,O-12-67-01-02-20
KAMPALA,RUBAGA DIV. SOUTH,RUBAGA DIVISION,KABOWA,TRINITY PRIMARY SCHOOL (NAC -,381,0,0,5,89,79,173,3,176,0,O-12-67-01-02-21
KAMPALA,RUBAGA DIV. SOUTH,RUBAGA DIVISION,KABOWA,TRINITY PRIMARY SCHOOL (NT -Z,450,0,0,13,117,60,190,23,213,0,O-12-67-01-02-22
KAMPALA,RUBAGA DIV. SOUTH,RUBAGA DIVISION,KABOWA,KISAWE KIKADDE B (NAK - NAM),464,1,0,4,137,92,234,24,258,0,O-12-67-01-02-23
KAMPALA,RUBAGA DIV. SOUTH,RUBAGA DIVISION,MUTUNDWE,MUTEESA II PRIMARY SCH. ( A -K),1247,3,1,29,398,193,624,18,642,0,O-12-67-01-03-01
KAMPALA,RUBAGA DIV. SOUTH,RUBAGA DIVISION,MUTUNDWE,KIGAGGA TRADING CENTRE,664,3,0,29,218,152,402,16,418,0,O-12-67-01-03-02
KAMPALA,RUBAGA DIV. SOUTH,RUBAGA DIVISION,MUTUNDWE,KITEBI PRIMARY SCHOOL ( A- L ),950,3,2,31,333,168,537,7,544,0,O-12-67-01-03-03
KAMPALA,RUBAGA DIV. SOUTH,RUBAGA DIVISION,MUTUNDWE,MBAAWO TRADING CENTRE,778,0,0,18,299,140,457,13,470,0,O-12-67-01-03-04
KAMPALA,RUBAGA DIV. SOUTH,RUBAGA DIVISION,MUTUNDWE,MUTUNDWE POLICE POST,576,3,1,25,186,118,333,0,333,0,O-12-67-01-03-05
KAMPALA,RUBAGA DIV. SOUTH,RUBAGA DIVISION,MUTUNDWE,MUTUNDWE C/U,855,4,1,43,281,152,481,0,481,0,O-12-67-01-03-06
KAMPALA,RUBAGA DIV. SOUTH,RUBAGA DIVISION,MUTUNDWE,HAJJ BUKENYA MEMORIAL SCH. (,838,2,0,25,338,148,513,13,526,0,O-12-67-01-03-07
KAMPALA,RUBAGA DIV. SOUTH,RUBAGA DIVISION,MUTUNDWE,MUTUNDWE PRIMARY SCH.,879,1,1,26,276,157,461,2,463,0,O-12-67-01-03-08
KAMPALA,RUBAGA DIV. SOUTH,RUBAGA DIVISION,MUTUNDWE,KITAWULUZI CATHOLIC CHURCH,1212,5,1,40,393,236,675,7,682,0,O-12-67-01-03-09
KAMPALA,RUBAGA DIV. SOUTH,RUBAGA DIVISION,MUTUNDWE,MUTEESA II PRIMARY SCH. ( L -NA,994,1,1,19,292,153,466,4,470,0,O-12-67-01-03-10
KAMPALA,RUBAGA DIV. SOUTH,RUBAGA DIVISION,MUTUNDWE,MUTEESA II PRIMARY SCH. ( NAM,844,2,0,13,208,155,378,20,398,0,O-12-67-01-03-11
KAMPALA,RUBAGA DIV. SOUTH,RUBAGA DIVISION,MUTUNDWE,MUTEESA II PRIMARY SCH. ( O - Z),988,2,0,17,280,103,402,9,411,0,O-12-67-01-03-12
KAMPALA,RUBAGA DIV. SOUTH,RUBAGA DIVISION,MUTUNDWE,KITEBI PRIMARY SCHOOL ( M- N),1702,7,1,28,518,310,864,14,878,0,O-12-67-01-03-13
KAMPALA,RUBAGA DIV. SOUTH,RUBAGA DIVISION,MUTUNDWE,KITEBI PRIMARY SCHOOL ( O- Z),592,2,1,16,216,92,327,28,355,0,O-12-67-01-03-14
KAMPALA,RUBAGA DIV. SOUTH,RUBAGA DIVISION,MUTUNDWE,HAJJ BUKENYA MEMORIAL SCH. (,1005,4,0,20,309,174,507,10,517,0,O-12-67-01-03-15
KAMPALA,RUBAGA DIV. SOUTH,RUBAGA DIVISION,NAJJANANKUMBI I,LATE MPAGI'S HOME ( A - M),1117,7,0,27,429,185,648,14,662,0,O-12-67-01-04-01
KAMPALA,RUBAGA DIV. SOUTH,RUBAGA DIVISION,NAJJANANKUMBI I,ST.ANDREW'S CHURCH (A - M),802,0,1,19,317,153,490,6,496,0,O-12-67-01-04-02
KAMPALA,RUBAGA DIV. SOUTH,RUBAGA DIVISION,NAJJANANKUMBI I,PLAY GROUND (A - M),1237,4,0,22,426,256,708,19,727,0,O-12-67-01-04-03
KAMPALA,RUBAGA DIV. SOUTH,RUBAGA DIVISION,NAJJANANKUMBI I,ST.JUDE PRIMARY SCHOOL (A - M,988,4,1,24,371,209,609,5,614,0,O-12-67-01-04-04
KAMPALA,RUBAGA DIV. SOUTH,RUBAGA DIVISION,NAJJANANKUMBI I,LATE MPAGI'S HOME (N - NANS),649,2,0,12,221,119,354,3,357,0,O-12-67-01-04-05
KAMPALA,RUBAGA DIV. SOUTH,RUBAGA DIVISION,NAJJANANKUMBI I,ST.ANDREW'S CHURCH (N - Z),771,1,0,16,281,147,445,2,447,0,O-12-67-01-04-06
KAMPALA,RUBAGA DIV. SOUTH,RUBAGA DIVISION,NAJJANANKUMBI I,PLAY GROUND (N - Z),1271,6,0,25,362,232,625,0,625,0,O-12-67-01-04-07
KAMPALA,RUBAGA DIV. SOUTH,RUBAGA DIVISION,NAJJANANKUMBI I,ST.JUDE PRIMARY SCHOOL (N - Z),1042,6,0,22,361,200,589,4,593,0,O-12-67-01-04-08
KAMPALA,RUBAGA DIV. SOUTH,RUBAGA DIVISION,NAJJANANKUMBI I,LATE MPAGI'S HOME (NANT - Z),711,0,0,11,297,130,438,0,438,0,O-12-67-01-04-09
KAMPALA,RUBAGA DIV. SOUTH,RUBAGA DIVISION,NAJJANANKUMBI II,LUWAAWO PRIMARY SCH. ( A - M),733,6,0,30,290,129,455,7,462,0,O-12-67-01-05-01
KAMPALA,RUBAGA DIV. SOUTH,RUBAGA DIVISION,NAJJANANKUMBI II,KIVIRI'S HOME ( A - M),942,7,1,25,304,179,516,69,585,0,O-12-67-01-05-02
KAMPALA,RUBAGA DIV. SOUTH,RUBAGA DIVISION,NAJJANANKUMBI II,GWAFU ( A - KIJ),590,1,0,16,220,135,372,3,375,0,O-12-67-01-05-03
KAMPALA,RUBAGA DIV. SOUTH,RUBAGA DIVISION,NAJJANANKUMBI II,NABIRYE HOUSE [A-M],715,1,0,15,271,111,398,35,433,0,O-12-67-01-05-04
KAMPALA,RUBAGA DIV. SOUTH,RUBAGA DIVISION,NAJJANANKUMBI II,LUWAAWO PRIMARY SCH. ( N - Z),750,0,0,27,291,133,451,5,456,0,O-12-67-01-05-05
KAMPALA,RUBAGA DIV. SOUTH,RUBAGA DIVISION,NAJJANANKUMBI II,KIVIRI'S HOME ( N - Z),857,4,0,35,324,154,517,5,522,0,O-12-67-01-05-06
KAMPALA,RUBAGA DIV. SOUTH,RUBAGA DIVISION,NAJJANANKUMBI II,GWAFU ( N - NAM),530,0,0,9,172,112,293,2,295,0,O-12-67-01-05-07
KAMPALA,RUBAGA DIV. SOUTH,RUBAGA DIVISION,NAJJANANKUMBI II,NABIRYE HOUSE [N-Z],719,4,0,17,292,109,422,14,436,0,O-12-67-01-05-08
KAMPALA,RUBAGA DIV. SOUTH,RUBAGA DIVISION,NAJJANANKUMBI II,GWAFU ( KIK - M),578,2,1,20,252,119,394,4,398,0,O-12-67-01-05-09
KAMPALA,RUBAGA DIV. SOUTH,RUBAGA DIVISION,NAJJANANKUMBI II,GWAFU ( NAN - Z),645,4,0,15,264,113,396,11,407,0,O-12-67-01-05-10
KAMPALA,RUBAGA DIV. SOUTH,RUBAGA DIVISION,NATEETE,BEHIND AGIP PETROL STATION-N,684,1,0,20,322,97,440,4,444,0,O-12-67-01-06-01
KAMPALA,RUBAGA DIV. SOUTH,RUBAGA DIVISION,NATEETE,POLICE PLAY GROUND A (A - M),858,2,0,21,329,137,489,14,503,0,O-12-67-01-06-02
KAMPALA,RUBAGA DIV. SOUTH,RUBAGA DIVISION,NATEETE,POLICE PLAY GROUND B [A - NAJ],792,0,3,19,320,134,476,2,478,0,O-12-67-01-06-03
KAMPALA,RUBAGA DIV. SOUTH,RUBAGA DIVISION,NATEETE,UGASTA [A -NAJ],648,1,0,27,257,125,410,3,413,0,O-12-67-01-06-04
KAMPALA,RUBAGA DIV. SOUTH,RUBAGA DIVISION,NATEETE,NATEETE MOSLEM PRIMARY SCH.,807,3,0,36,290,167,496,10,506,0,O-12-67-01-06-05
KAMPALA,RUBAGA DIV. SOUTH,RUBAGA DIVISION,NATEETE,2000 PRIMARY SCHOOL [A- NAJ],717,0,0,20,301,140,461,40,501,0,O-12-67-01-06-06
KAMPALA,RUBAGA DIV. SOUTH,RUBAGA DIVISION,NATEETE,NEW BAR,714,0,0,26,291,121,438,1,439,0,O-12-67-01-06-07
KAMPALA,RUBAGA DIV. SOUTH,RUBAGA DIVISION,NATEETE,NATEETE MOSLEM S.S.S [A-NAJ],726,5,0,21,271,126,423,2,425,0,O-12-67-01-06-08
KAMPALA,RUBAGA DIV. SOUTH,RUBAGA DIVISION,NATEETE,CITY PRIMARY SCHOOL,704,2,0,16,273,121,412,12,424,0,O-12-67-01-06-09
KAMPALA,RUBAGA DIV. SOUTH,RUBAGA DIVISION,NATEETE,PREPARATORY SCHOOL [A - NAF],654,1,0,14,247,135,397,8,405,0,O-12-67-01-06-10
KAMPALA,RUBAGA DIV. SOUTH,RUBAGA DIVISION,NATEETE,MACKAY PRIMARY SCH. (A - KIJ),568,1,0,17,193,145,356,3,359,0,O-12-67-01-06-11
KAMPALA,RUBAGA DIV. SOUTH,RUBAGA DIVISION,NATEETE,PLAY GROUND (A - M),653,2,0,13,273,122,410,33,443,0,O-12-67-01-06-12
KAMPALA,RUBAGA DIV. SOUTH,RUBAGA DIVISION,NATEETE,BEHIND AGIP PETROL STATION-N,878,0,0,15,302,203,520,17,537,0,O-12-67-01-06-13
KAMPALA,RUBAGA DIV. SOUTH,RUBAGA DIVISION,NATEETE,POLICE PLAY GROUND A (N - NAM,487,0,0,7,136,106,249,6,255,0,O-12-67-01-06-14
KAMPALA,RUBAGA DIV. SOUTH,RUBAGA DIVISION,NATEETE,MACKAY PRIMARY SCH. (N - Z),1073,2,1,33,333,247,616,5,621,0,O-12-67-01-06-15
KAMPALA,RUBAGA DIV. SOUTH,RUBAGA DIVISION,NATEETE,PLAY GROUND (N - Z),890,0,1,18,334,116,469,2,471,0,O-12-67-01-06-16
KAMPALA,RUBAGA DIV. SOUTH,RUBAGA DIVISION,NATEETE,POLICE PLAY GROUND B [NAK - Z],785,1,1,17,289,159,467,8,475,0,O-12-67-01-06-17
KAMPALA,RUBAGA DIV. SOUTH,RUBAGA DIVISION,NATEETE,UGASTA [NAK -Z],723,1,0,24,256,135,416,12,428,0,O-12-67-01-06-18
KAMPALA,RUBAGA DIV. SOUTH,RUBAGA DIVISION,NATEETE,2000 PRIMARY SCHOOL [NAK - Z],772,0,1,16,254,159,430,73,503,0,O-12-67-01-06-19
KAMPALA,RUBAGA DIV. SOUTH,RUBAGA DIVISION,NATEETE,POLICE PLAY GROUND A (NAN - Z,519,0,1,9,230,91,331,1,332,0,O-12-67-01-06-20
KAMPALA,RUBAGA DIV. SOUTH,RUBAGA DIVISION,NATEETE,NATEETE MOSLEM S.S.S [NAK - Z],800,3,1,10,252,141,407,20,427,0,O-12-67-01-06-21
KAMPALA,RUBAGA DIV. SOUTH,RUBAGA DIVISION,NATEETE,PREPARATORY SCHOOL [NAG-Z],718,2,1,15,264,157,439,5,444,0,O-12-67-01-06-22
KAMPALA,RUBAGA DIV. SOUTH,RUBAGA DIVISION,NATEETE,MACKAY PRIMARY SCH. (KIK - M),390,1,0,13,130,70,214,0,214,0,O-12-67-01-06-23
KAMPALA,RUBAGA DIV. SOUTH,RUBAGA DIVISION,NDEEBA,STANDARD S.S.S [A-MUT],470,0,0,10,132,127,269,3,272,0,O-12-67-01-07-01
KAMPALA,RUBAGA DIV. SOUTH,RUBAGA DIVISION,NDEEBA,MR. J.B. KASAJJA' S PLACE,757,2,0,24,257,163,446,2,448,0,O-12-67-01-07-02
KAMPALA,RUBAGA DIV. SOUTH,RUBAGA DIVISION,NDEEBA,CALTEX SPACE,578,1,0,17,242,99,359,6,365,0,O-12-67-01-07-03
KAMPALA,RUBAGA DIV. SOUTH,RUBAGA DIVISION,NDEEBA,OLD POLICE POST(A - M),683,1,1,19,287,99,407,40,447,0,O-12-67-01-07-04
KAMPALA,RUBAGA DIV. SOUTH,RUBAGA DIVISION,NDEEBA,KIBUYE MARKET,301,0,0,13,112,70,195,5,200,0,O-12-67-01-07-05
KAMPALA,RUBAGA DIV. SOUTH,RUBAGA DIVISION,NDEEBA,MR. KADDU' S HOME [A-NAB],766,2,0,19,333,98,452,59,511,0,O-12-67-01-07-06
KAMPALA,RUBAGA DIV. SOUTH,RUBAGA DIVISION,NDEEBA,LORRY PARKING YARD [A-NAJ],591,2,0,20,298,88,408,4,412,0,O-12-67-01-07-07
KAMPALA,RUBAGA DIV. SOUTH,RUBAGA DIVISION,NDEEBA,MPOMBA' S PLACE,792,1,1,19,355,150,526,5,531,0,O-12-67-01-07-08
KAMPALA,RUBAGA DIV. SOUTH,RUBAGA DIVISION,NDEEBA,BIG WAYS,764,3,0,22,318,163,506,4,510,0,O-12-67-01-07-09
KAMPALA,RUBAGA DIV. SOUTH,RUBAGA DIVISION,NDEEBA,PROF SENYONJO' S PLACE,435,1,0,17,164,98,280,6,286,0,O-12-67-01-07-10
KAMPALA,RUBAGA DIV. SOUTH,RUBAGA DIVISION,NDEEBA,OLD POLICE POST(N - Z),840,4,1,22,291,142,460,0,460,0,O-12-67-01-07-11
KAMPALA,RUBAGA DIV. SOUTH,RUBAGA DIVISION,NDEEBA,BUKADDE MAGEZI FLATS(A - M),834,1,0,25,363,129,518,5,523,0,O-12-67-01-07-12
KAMPALA,RUBAGA DIV. SOUTH,RUBAGA DIVISION,NDEEBA,B.M.K.,950,1,1,17,327,168,514,52,566,0,O-12-67-01-07-13
KAMPALA,RUBAGA DIV. SOUTH,RUBAGA DIVISION,NDEEBA,HIS GRACE PHOTO STUDIO,891,6,0,20,356,131,513,9,522,0,O-12-67-01-07-14
KAMPALA,RUBAGA DIV. SOUTH,RUBAGA DIVISION,NDEEBA,BUKADDE MAGEZI FLATS(N - NAM,493,0,0,10,167,91,268,3,271,0,O-12-67-01-07-15
KAMPALA,RUBAGA DIV. SOUTH,RUBAGA DIVISION,NDEEBA,STANDARD S.S.S [MUS-Z],468,2,1,15,127,112,257,12,269,0,O-12-67-01-07-16
KAMPALA,RUBAGA DIV. SOUTH,RUBAGA DIVISION,NDEEBA,MR. KADDU' S HOME [NAC-Z],659,0,1,26,259,126,412,7,419,0,O-12-67-01-07-17
KAMPALA,RUBAGA DIV. SOUTH,RUBAGA DIVISION,NDEEBA,LORRY PARKING YARD [NAK-Z],618,1,0,20,243,114,378,7,385,0,O-12-67-01-07-18
KAMPALA,RUBAGA DIV. SOUTH,RUBAGA DIVISION,NDEEBA,BUKADDE MAGEZI FLATS(NAN - Z),503,1,0,6,223,65,295,2,297,0,O-12-67-01-07-19
KAMPALA,RUBAGA DIV. SOUTH,RUBAGA DIVISION,RUBAGA,LATE KAMYA' S HOME[A-M],471,3,0,22,172,113,310,3,313,0,O-12-67-01-08-01
KAMPALA,RUBAGA DIV. SOUTH,RUBAGA DIVISION,RUBAGA,BULWA TRADING CENTRE,693,2,2,35,234,157,430,6,436,0,O-12-67-01-08-02
KAMPALA,RUBAGA DIV. SOUTH,RUBAGA DIVISION,RUBAGA,LUBAGA S.S.S. PLAY GROUND,513,0,0,26,163,136,325,10,335,0,O-12-67-01-08-03
KAMPALA,RUBAGA DIV. SOUTH,RUBAGA DIVISION,RUBAGA,LUBAGA HOSPITAL,330,1,1,21,99,98,220,0,220,0,O-12-67-01-08-04
KAMPALA,RUBAGA DIV. SOUTH,RUBAGA DIVISION,RUBAGA,ST. ANDREWS CHURCH,732,2,0,32,245,162,441,8,449,0,O-12-67-01-08-05
KAMPALA,RUBAGA DIV. SOUTH,RUBAGA DIVISION,RUBAGA,OLD GOMBOLOLA HQRS,682,2,0,21,190,183,396,10,406,0,O-12-67-01-08-06
KAMPALA,RUBAGA DIV. SOUTH,RUBAGA DIVISION,RUBAGA,NALUKOLONGO PLAY GROUND (A,658,0,0,19,261,103,383,6,389,0,O-12-67-01-08-07
KAMPALA,RUBAGA DIV. SOUTH,RUBAGA DIVISION,RUBAGA,NALUKOLONGO PLAY GROUND (M,723,0,0,9,246,160,415,9,424,0,O-12-67-01-08-08
KAMPALA,RUBAGA DIV. SOUTH,RUBAGA DIVISION,RUBAGA,LUBAGA NURSERY SCHOOL [A -M],434,2,2,28,180,79,291,0,291,0,O-12-67-01-08-09
KAMPALA,RUBAGA DIV. SOUTH,RUBAGA DIVISION,RUBAGA,KIDDUKA,747,1,0,72,266,145,484,3,487,0,O-12-67-01-08-10
KAMPALA,RUBAGA DIV. SOUTH,RUBAGA DIVISION,RUBAGA,LATE LULE' S HOME,772,3,0,36,259,155,453,2,455,0,O-12-67-01-08-11
KAMPALA,RUBAGA DIV. SOUTH,RUBAGA DIVISION,RUBAGA,POPE PAUL MEMORIAL,776,3,0,42,255,175,475,5,480,0,O-12-67-01-08-12
KAMPALA,RUBAGA DIV. SOUTH,RUBAGA DIVISION,RUBAGA,WAGABA' S HOME,514,1,0,17,157,142,317,17,334,0,O-12-67-01-08-13
KAMPALA,RUBAGA DIV. SOUTH,RUBAGA DIVISION,RUBAGA,NABUUMA' S HOME,696,0,1,22,239,174,436,8,444,0,O-12-67-01-08-14
KAMPALA,RUBAGA DIV. SOUTH,RUBAGA DIVISION,RUBAGA,ST.BENEDICT PRIMARY SCH. (A -,773,3,1,31,345,107,487,1,488,0,O-12-67-01-08-15
KAMPALA,RUBAGA DIV. SOUTH,RUBAGA DIVISION,RUBAGA,ST.BENEDICT PRIMARY SCH. (N -,954,2,1,29,340,186,558,10,568,0,O-12-67-01-08-16
KAMPALA,RUBAGA DIV. SOUTH,RUBAGA DIVISION,RUBAGA,LATE KAMYA' S HOME [N-Z],533,1,1,29,196,121,348,1,349,0,O-12-67-01-08-17
KAMPALA,RUBAGA DIV. SOUTH,RUBAGA DIVISION,RUBAGA,NALUKOLONGO PLAY GROUND (N,766,0,0,8,272,102,382,0,382,0,O-12-67-01-08-18
KAMPALA,RUBAGA DIV. SOUTH,RUBAGA DIVISION,RUBAGA,LUBAGA NURSERY SCHOOL [N-Z],515,0,1,31,157,107,296,7,303,0,O-12-67-01-08-19
KAMPALA,RUBAGA DIVISION NORTH,RUBAGA DIVISION,KASUBI,ZALWANGO NURSERY SCH [A-J],463,1,1,2,144,127,275,5,280,0,O-12-66-01-09-01
KAMPALA,RUBAGA DIVISION NORTH,RUBAGA DIVISION,KASUBI,KISEKKA FOUNDATION [A-L],945,3,0,24,320,187,534,7,541,0,O-12-66-01-09-02
KAMPALA,RUBAGA DIVISION NORTH,RUBAGA DIVISION,KASUBI,FAMILY PRIMARY SCHOOL [A-KAS],592,0,1,6,197,143,347,0,347,0,O-12-66-01-09-03
KAMPALA,RUBAGA DIVISION NORTH,RUBAGA DIVISION,KASUBI,MASIRO-KASUBI [A-K],971,4,1,17,338,239,599,3,602,0,O-12-66-01-09-04
KAMPALA,RUBAGA DIVISION NORTH,RUBAGA DIVISION,KASUBI,KAWAALA C/U [A-L],991,5,0,24,318,209,556,9,565,0,O-12-66-01-09-05
KAMPALA,RUBAGA DIVISION NORTH,RUBAGA DIVISION,KASUBI,BRAIN TRUST PR SCH [A-KAJ],541,2,1,3,177,130,313,0,313,0,O-12-66-01-09-06
KAMPALA,RUBAGA DIVISION NORTH,RUBAGA DIVISION,KASUBI,ST. DANIEL KAGGWA P/S [A-KIM],603,2,1,10,219,138,370,1,371,0,O-12-66-01-09-07
KAMPALA,RUBAGA DIVISION NORTH,RUBAGA DIVISION,KASUBI,MUGEMA NURSERY SCHOOL [A-M,896,1,1,13,335,200,550,4,554,0,O-12-66-01-09-08
KAMPALA,RUBAGA DIVISION NORTH,RUBAGA DIVISION,KASUBI,NAMUNGOONA PLAYGROUND [A-J,369,2,1,2,113,86,204,1,205,0,O-12-66-01-09-09
KAMPALA,RUBAGA DIVISION NORTH,RUBAGA DIVISION,KASUBI,ZALWANGO NURSERY SCH [K-KIF],516,1,2,4,167,123,297,3,300,0,O-12-66-01-09-10
KAMPALA,RUBAGA DIVISION NORTH,RUBAGA DIVISION,KASUBI,ZALWANGO NURSERY SCH [M-NA,622,1,0,9,235,150,395,4,399,0,O-12-66-01-09-11
KAMPALA,RUBAGA DIVISION NORTH,RUBAGA DIVISION,KASUBI,ZALWANGO NURSERY SCH [NAC-,596,0,0,10,172,142,324,4,328,0,O-12-66-01-09-12
KAMPALA,RUBAGA DIVISION NORTH,RUBAGA DIVISION,KASUBI,ZALWANGO NURSERY SCH [O-Z],651,1,1,9,268,123,402,3,405,0,O-12-66-01-09-13
KAMPALA,RUBAGA DIVISION NORTH,RUBAGA DIVISION,KASUBI,KISEKKA FOUNDATION [M-M],351,0,0,7,133,71,211,2,213,0,O-12-66-01-09-14
KAMPALA,RUBAGA DIVISION NORTH,RUBAGA DIVISION,KASUBI,KISEKKA FOUNDATION [O-Z],504,2,0,10,192,92,296,4,300,0,O-12-66-01-09-15
KAMPALA,RUBAGA DIVISION NORTH,RUBAGA DIVISION,KASUBI,FAMILY PRIMARY SCHOOL [M-NAB,539,2,0,8,180,118,308,5,313,0,O-12-66-01-09-16
KAMPALA,RUBAGA DIVISION NORTH,RUBAGA DIVISION,KASUBI,FAMILY PRIMARY SCHOOL [NAM-N,224,0,0,5,79,49,133,1,134,0,O-12-66-01-09-17
KAMPALA,RUBAGA DIVISION NORTH,RUBAGA DIVISION,KASUBI,MASIRO-KASUBI [L-M],520,5,1,10,204,108,328,3,331,0,O-12-66-01-09-18
KAMPALA,RUBAGA DIVISION NORTH,RUBAGA DIVISION,KASUBI,MASIRO-KASUBI [N-NAL],549,2,0,4,159,133,298,8,306,0,O-12-66-01-09-19
KAMPALA,RUBAGA DIVISION NORTH,RUBAGA DIVISION,KASUBI,KAWAALA C/U [M-NAL],934,3,1,12,251,218,485,2,487,0,O-12-66-01-09-20
KAMPALA,RUBAGA DIVISION NORTH,RUBAGA DIVISION,KASUBI,KAWAALA C/U [NAM-Z],1017,5,1,22,302,213,543,7,550,0,O-12-66-01-09-21
KAMPALA,RUBAGA DIVISION NORTH,RUBAGA DIVISION,KASUBI,BRAIN TRUST PR SCH [L-M],690,2,2,16,267,143,430,6,436,0,O-12-66-01-09-22
KAMPALA,RUBAGA DIVISION NORTH,RUBAGA DIVISION,KASUBI,BRAIN TRUST PR. SCH. (N-NAL),683,3,2,5,209,164,383,3,386,0,O-12-66-01-09-23
KAMPALA,RUBAGA DIVISION NORTH,RUBAGA DIVISION,KASUBI,BRAIN TRUST PR SCH [O-Z],715,2,0,13,320,127,462,8,470,0,O-12-66-01-09-24
KAMPALA,RUBAGA DIVISION NORTH,RUBAGA DIVISION,KASUBI,ST. DANIEL KAGGWA P/S (O-Z),456,1,1,12,191,86,291,1,292,0,O-12-66-01-09-25
KAMPALA,RUBAGA DIVISION NORTH,RUBAGA DIVISION,KASUBI,MUGEMA NURSERY SCHOOL [N-A,535,0,0,8,151,127,286,4,290,0,O-12-66-01-09-26
KAMPALA,RUBAGA DIVISION NORTH,RUBAGA DIVISION,KASUBI,NAMUNGOONA PLAYGROUND [K-,820,1,1,25,294,150,471,4,475,0,O-12-66-01-09-27
KAMPALA,RUBAGA DIVISION NORTH,RUBAGA DIVISION,KASUBI,NAMUNGOONA PLAYGROUND [M-,1073,1,2,18,319,181,521,5,526,0,O-12-66-01-09-28
KAMPALA,RUBAGA DIVISION NORTH,RUBAGA DIVISION,KASUBI,NAMUNGOONA PLAYGROUND [NA,714,1,1,5,218,142,367,12,379,0,O-12-66-01-09-29
KAMPALA,RUBAGA DIVISION NORTH,RUBAGA DIVISION,KASUBI,NAMUNGOONA PLAYGROUND [P -,532,2,0,10,240,70,322,5,327,0,O-12-66-01-09-30
KAMPALA,RUBAGA DIVISION NORTH,RUBAGA DIVISION,KASUBI,BRAIN TRUST PR. SCH.(NAM-NAM),773,4,0,7,218,182,411,2,413,0,O-12-66-01-09-31
KAMPALA,RUBAGA DIVISION NORTH,RUBAGA DIVISION,KASUBI,ST. DANIEL KAGGWA P/S (N-NAL),460,1,0,3,125,106,235,2,237,0,O-12-66-01-09-32
KAMPALA,RUBAGA DIVISION NORTH,RUBAGA DIVISION,KASUBI,KISEKKA FOUNDATION [N-N],1048,2,0,8,304,251,565,7,572,0,O-12-66-01-09-33
KAMPALA,RUBAGA DIVISION NORTH,RUBAGA DIVISION,KASUBI,MASIRO-KASUBI [O-Z],482,0,0,15,196,99,310,3,313,0,O-12-66-01-09-34
KAMPALA,RUBAGA DIVISION NORTH,RUBAGA DIVISION,KASUBI,FAMILY PRIMARY SCHOOL [KAT-L],513,1,0,10,217,85,313,8,321,0,O-12-66-01-09-35
KAMPALA,RUBAGA DIVISION NORTH,RUBAGA DIVISION,KASUBI,BRAIN TRUST PR SCH [KAK-KZ],738,2,0,19,285,168,474,3,477,0,O-12-66-01-09-36
KAMPALA,RUBAGA DIVISION NORTH,RUBAGA DIVISION,KASUBI,ST. DANIEL KAGGWA P/S [KIN-M],613,7,0,10,220,139,376,4,380,0,O-12-66-01-09-37
KAMPALA,RUBAGA DIVISION NORTH,RUBAGA DIVISION,KASUBI,ZALWANGO NURSERY SCH [KIG-L,470,1,0,12,181,94,288,3,291,0,O-12-66-01-09-38
KAMPALA,RUBAGA DIVISION NORTH,RUBAGA DIVISION,KASUBI,ZALWANGO NURSERY SCH [NAMP,616,3,0,7,142,114,266,53,319,0,O-12-66-01-09-39
KAMPALA,RUBAGA DIVISION NORTH,RUBAGA DIVISION,KASUBI,FAMILY PRIMARY SCHOOL [O-Z],573,0,1,15,241,101,358,1,359,0,O-12-66-01-09-40
KAMPALA,RUBAGA DIVISION NORTH,RUBAGA DIVISION,KASUBI,MASIRO-KASUBI [NAM-NZ],563,0,0,4,168,148,320,4,324,0,O-12-66-01-09-41
KAMPALA,RUBAGA DIVISION NORTH,RUBAGA DIVISION,KASUBI,MUGEMA NURSERY SCHOOL [NA,551,0,0,11,192,142,345,4,349,0,O-12-66-01-09-42
KAMPALA,RUBAGA DIVISION NORTH,RUBAGA DIVISION,KASUBI,FAMILY PRIMARY SCHOOL [NAN-N,377,0,2,3,107,95,207,2,209,0,O-12-66-01-09-43
KAMPALA,RUBAGA DIVISION NORTH,RUBAGA DIVISION,KASUBI,ST. DANIEL KAGGWA P/S (NAM-NZ,538,3,0,4,154,140,301,2,303,0,O-12-66-01-09-44
KAMPALA,RUBAGA DIVISION NORTH,RUBAGA DIVISION,KASUBI,FAMILY PRIMARY SCHOOL [NAC-N,450,0,0,2,139,116,257,3,260,0,O-12-66-01-09-45
KAMPALA,RUBAGA DIVISION NORTH,RUBAGA DIVISION,LUBYA,MASANAFU ROMAN CATHOLIC CH,967,2,4,35,333,248,622,2,624,0,O-12-66-01-10-01
KAMPALA,RUBAGA DIVISION NORTH,RUBAGA DIVISION,LUBYA,MASANAFU C/U {A - NAG},732,3,0,15,272,175,465,11,476,0,O-12-66-01-10-02
KAMPALA,RUBAGA DIVISION NORTH,RUBAGA DIVISION,LUBYA,NJOVU HOUSE [A-J],318,0,0,6,101,79,186,4,190,0,O-12-66-01-10-03
KAMPALA,RUBAGA DIVISION NORTH,RUBAGA DIVISION,LUBYA,LUGALA TRADING CENTRE {A - NA,641,0,0,13,211,155,379,71,450,0,O-12-66-01-10-04
KAMPALA,RUBAGA DIVISION NORTH,RUBAGA DIVISION,LUBYA,RISE AND SHINE (A-KA),518,2,0,10,177,118,307,14,321,0,O-12-66-01-10-05
KAMPALA,RUBAGA DIVISION NORTH,RUBAGA DIVISION,LUBYA,MAPEERA PRIMARY SCH. {A - NAC,603,2,1,17,186,166,372,3,375,0,O-12-66-01-10-06
KAMPALA,RUBAGA DIVISION NORTH,RUBAGA DIVISION,LUBYA,KABAZZI-MITI HOUSE [A-M],871,2,2,19,300,211,534,5,539,0,O-12-66-01-10-07
KAMPALA,RUBAGA DIVISION NORTH,RUBAGA DIVISION,LUBYA,ST. JOHN BAPTIST C/U [A-J],580,1,1,8,177,154,341,7,348,0,O-12-66-01-10-08
KAMPALA,RUBAGA DIVISION NORTH,RUBAGA DIVISION,LUBYA,ROMAN CATHOLIC CHURCH [A-M],846,5,1,21,344,181,552,13,565,0,O-12-66-01-10-09
KAMPALA,RUBAGA DIVISION NORTH,RUBAGA DIVISION,LUBYA,NJOVU HOUSE [K-M],1000,3,1,25,364,213,606,12,618,0,O-12-66-01-10-10
KAMPALA,RUBAGA DIVISION NORTH,RUBAGA DIVISION,LUBYA,NJOVU HOUSE [N],916,3,1,14,279,261,558,8,566,0,O-12-66-01-10-11
KAMPALA,RUBAGA DIVISION NORTH,RUBAGA DIVISION,LUBYA,NJOVU HOUSE [O-Z],449,0,0,7,181,97,285,2,287,0,O-12-66-01-10-12
KAMPALA,RUBAGA DIVISION NORTH,RUBAGA DIVISION,LUBYA,RISE AND SHINE (N-NAP),586,1,0,8,142,194,345,8,353,0,O-12-66-01-10-13
KAMPALA,RUBAGA DIVISION NORTH,RUBAGA DIVISION,LUBYA,KABAZZI-MITI HOUSE [N-Z],937,8,0,13,293,245,559,5,564,0,O-12-66-01-10-14
KAMPALA,RUBAGA DIVISION NORTH,RUBAGA DIVISION,LUBYA,ST. JOHN BAPTIST C/U [K-KAX],501,4,0,8,193,121,326,3,329,0,O-12-66-01-10-15
KAMPALA,RUBAGA DIVISION NORTH,RUBAGA DIVISION,LUBYA,ST. JOHN BAPTIST C/U [L-M],781,2,0,12,289,146,449,51,500,0,O-12-66-01-10-16
KAMPALA,RUBAGA DIVISION NORTH,RUBAGA DIVISION,LUBYA,ST. JOHN BAPTIST C/U [NAA-NAL],829,4,1,10,248,184,447,0,447,0,O-12-66-01-10-17
KAMPALA,RUBAGA DIVISION NORTH,RUBAGA DIVISION,LUBYA,ST. JOHN BAPTIST C/U [NAM-NAM],415,2,0,9,111,92,214,3,217,0,O-12-66-01-10-18
KAMPALA,RUBAGA DIVISION NORTH,RUBAGA DIVISION,LUBYA,ST. JOHN BAPTIST C/U [O-Z],842,2,1,15,327,165,510,7,517,0,O-12-66-01-10-19
KAMPALA,RUBAGA DIVISION NORTH,RUBAGA DIVISION,LUBYA,ROMAN CATHOLIC CHURCH [N-NA,463,3,0,9,133,124,269,3,272,0,O-12-66-01-10-20
KAMPALA,RUBAGA DIVISION NORTH,RUBAGA DIVISION,LUBYA,MASANAFU C/U {NAH-Z},718,1,1,13,231,196,442,63,505,0,O-12-66-01-10-21
KAMPALA,RUBAGA DIVISION NORTH,RUBAGA DIVISION,LUBYA,LUGALA TRADING CENTRE {NAH -,637,1,0,10,226,171,408,24,432,0,O-12-66-01-10-22
KAMPALA,RUBAGA DIVISION NORTH,RUBAGA DIVISION,LUBYA,RISE AND SHINE (KB-M),521,3,0,21,174,130,328,12,340,0,O-12-66-01-10-23
KAMPALA,RUBAGA DIVISION NORTH,RUBAGA DIVISION,LUBYA,MAPEERA PRIMARY SCH. {NAD - Z,581,1,0,11,172,148,332,0,332,0,O-12-66-01-10-24
KAMPALA,RUBAGA DIVISION NORTH,RUBAGA DIVISION,LUBYA,RISE AND SHINE (NAR-Z),468,1,0,3,170,109,283,9,292,0,O-12-66-01-10-25
KAMPALA,RUBAGA DIVISION NORTH,RUBAGA DIVISION,LUBYA,ST. JOHN BAPTIST C/U [KAY-KZ],513,2,0,13,202,109,326,2,328,0,O-12-66-01-10-26
KAMPALA,RUBAGA DIVISION NORTH,RUBAGA DIVISION,LUBYA,ST. JOHN BAPTIST C/U [NAN-NZ],525,1,0,3,165,95,264,4,268,0,O-12-66-01-10-27
KAMPALA,RUBAGA DIVISION NORTH,RUBAGA DIVISION,LUBYA,ROMAN CATHOLIC CHURCH [NAN-,499,2,0,10,188,106,306,13,319,0,O-12-66-01-10-28
KAMPALA,RUBAGA DIVISION NORTH,RUBAGA DIVISION,LUNGUJJA,BULANGE CHURCH OF UGANDA,697,2,0,18,180,258,458,7,465,0,O-12-66-01-11-01
KAMPALA,RUBAGA DIVISION NORTH,RUBAGA DIVISION,LUNGUJJA,MR. KAMYA' S HOME,640,9,5,14,197,194,419,1,420,0,O-12-66-01-11-02
KAMPALA,RUBAGA DIVISION NORTH,RUBAGA DIVISION,LUNGUJJA,MR. SENYONDO' COMPOUND,751,4,1,42,292,141,480,6,486,0,O-12-66-01-11-03
KAMPALA,RUBAGA DIVISION NORTH,RUBAGA DIVISION,LUNGUJJA,GWAFU I,723,5,1,40,249,156,451,10,461,0,O-12-66-01-11-04
KAMPALA,RUBAGA DIVISION NORTH,RUBAGA DIVISION,LUNGUJJA,HOPE MUKASA' S PLAYGROUND,672,1,1,34,248,155,439,10,449,0,O-12-66-01-11-05
KAMPALA,RUBAGA DIVISION NORTH,RUBAGA DIVISION,LUNGUJJA,GWAFU II [A - NAJ],566,3,0,11,168,99,281,11,292,0,O-12-66-01-11-06
KAMPALA,RUBAGA DIVISION NORTH,RUBAGA DIVISION,LUNGUJJA,WAKALIGA PR. SCH [A-M],711,1,0,35,284,133,453,16,469,0,O-12-66-01-11-07
KAMPALA,RUBAGA DIVISION NORTH,RUBAGA DIVISION,LUNGUJJA,LUNGUJJA NURSERY SCH [A-M],820,4,1,24,277,210,516,2,518,0,O-12-66-01-11-08
KAMPALA,RUBAGA DIVISION NORTH,RUBAGA DIVISION,LUNGUJJA,NEAR KCC OFFICE LUNGUJJA [A-,1057,1,2,29,400,217,649,16,665,0,O-12-66-01-11-09
KAMPALA,RUBAGA DIVISION NORTH,RUBAGA DIVISION,LUNGUJJA,WAKALIGA PR. SCH [N-Z],831,3,0,27,273,187,490,14,504,0,O-12-66-01-11-10
KAMPALA,RUBAGA DIVISION NORTH,RUBAGA DIVISION,LUNGUJJA,LUNGUJJA NURSERY SCH [N-Z],813,4,2,26,244,211,487,8,495,0,O-12-66-01-11-11
KAMPALA,RUBAGA DIVISION NORTH,RUBAGA DIVISION,LUNGUJJA,NEAR KCC OFFICE LUNGUJJA [N-,468,1,2,4,129,127,263,1,264,0,O-12-66-01-11-12
KAMPALA,RUBAGA DIVISION NORTH,RUBAGA DIVISION,LUNGUJJA,GWAFU II [NAK - Z],477,1,0,7,128,133,269,2,271,0,O-12-66-01-11-13
KAMPALA,RUBAGA DIVISION NORTH,RUBAGA DIVISION,LUNGUJJA,NEAR KCC OFFICE LUNGUJJA [NA,668,0,0,12,247,158,417,9,426,0,O-12-66-01-11-14
KAMPALA,RUBAGA DIVISION NORTH,RUBAGA DIVISION,NAKULABYE,MEMBER'S HOUSE [A-M],533,0,1,11,175,156,343,5,348,0,O-12-66-01-12-01
KAMPALA,RUBAGA DIVISION NORTH,RUBAGA DIVISION,NAKULABYE,NAKULABYE CHURCH OF UGAND,567,1,0,6,177,151,335,8,343,0,O-12-66-01-12-02
KAMPALA,RUBAGA DIVISION NORTH,RUBAGA DIVISION,NAKULABYE,CHURCH OF GOD [A - NAL],811,0,0,18,260,215,493,2,495,0,O-12-66-01-12-03
KAMPALA,RUBAGA DIVISION NORTH,RUBAGA DIVISION,NAKULABYE,MR LUBEGA'S MANGO TREE [A-M],1036,4,1,13,350,263,631,9,640,0,O-12-66-01-12-04
KAMPALA,RUBAGA DIVISION NORTH,RUBAGA DIVISION,NAKULABYE,WEST CHURCH [A-KIS],740,2,0,15,205,238,460,5,465,0,O-12-66-01-12-05
KAMPALA,RUBAGA DIVISION NORTH,RUBAGA DIVISION,NAKULABYE,JAMES LULE'S COMPOUND,641,1,2,8,183,178,372,19,391,0,O-12-66-01-12-06
KAMPALA,RUBAGA DIVISION NORTH,RUBAGA DIVISION,NAKULABYE,FORMER U.C.B.,979,10,0,25,290,263,588,10,598,0,O-12-66-01-12-07
KAMPALA,RUBAGA DIVISION NORTH,RUBAGA DIVISION,NAKULABYE,KABASEKE'S MANGO TREE [A-KH],433,2,0,10,154,104,270,10,280,0,O-12-66-01-12-08
KAMPALA,RUBAGA DIVISION NORTH,RUBAGA DIVISION,NAKULABYE,OUR LADY OF FATIMA [A-M],886,2,0,8,194,292,496,5,501,0,O-12-66-01-12-09
KAMPALA,RUBAGA DIVISION NORTH,RUBAGA DIVISION,NAKULABYE,MR LUBEGA'S MANGO TREE [N-NA,498,2,0,7,156,135,300,0,300,0,O-12-66-01-12-10
KAMPALA,RUBAGA DIVISION NORTH,RUBAGA DIVISION,NAKULABYE,WEST CHURCH [N-NAM],681,0,0,11,193,206,410,3,413,0,O-12-66-01-12-11
KAMPALA,RUBAGA DIVISION NORTH,RUBAGA DIVISION,NAKULABYE,KABASEKE'S MANGO TREE [N-Z],475,2,0,13,178,105,298,7,305,0,O-12-66-01-12-12
KAMPALA,RUBAGA DIVISION NORTH,RUBAGA DIVISION,NAKULABYE,OUR LADY OF FATIMA [N-Z],640,1,0,8,150,207,366,11,377,0,O-12-66-01-12-13
KAMPALA,RUBAGA DIVISION NORTH,RUBAGA DIVISION,NAKULABYE,MEMBER'S HOUSE [N-NAM],538,0,0,11,144,168,323,7,330,0,O-12-66-01-12-14
KAMPALA,RUBAGA DIVISION NORTH,RUBAGA DIVISION,NAKULABYE,MEMBER'S HOUSE [KI-M],595,1,1,15,188,160,365,2,367,0,O-12-66-01-12-15
KAMPALA,RUBAGA DIVISION NORTH,RUBAGA DIVISION,NAKULABYE,NAKULABYE CHURCH OF UGAND,513,2,1,9,166,141,319,4,323,0,O-12-66-01-12-16
KAMPALA,RUBAGA DIVISION NORTH,RUBAGA DIVISION,NAKULABYE,CHURCH OF GOD [NAM - Z],482,2,1,16,165,135,319,2,321,0,O-12-66-01-12-17
KAMPALA,RUBAGA DIVISION NORTH,RUBAGA DIVISION,NAKULABYE,WEST CHURCH [KIT-M],561,1,0,12,190,138,341,3,344,0,O-12-66-01-12-18
KAMPALA,RUBAGA DIVISION NORTH,RUBAGA DIVISION,NAKULABYE,MR LUBEGA'S MANGO TREE [NAN-,560,3,4,8,211,126,352,0,352,0,O-12-66-01-12-19
KAMPALA,RUBAGA DIVISION NORTH,RUBAGA DIVISION,NAKULABYE,WEST CHURCH [NAN-Z],768,1,0,16,234,165,416,9,425,0,O-12-66-01-12-20
KAMPALA,RUBAGA DIVISION NORTH,RUBAGA DIVISION,NAKULABYE,MEMBER'S HOUSE [NAN-Z],585,3,0,13,209,154,379,4,383,0,O-12-66-01-12-21
KAMPALA,RUBAGA DIVISION NORTH,RUBAGA DIVISION,NAMIREMBE,SEMAKULA' S HOME [A-M],587,2,0,6,139,169,316,27,343,0,O-12-66-01-13-01
KAMPALA,RUBAGA DIVISION NORTH,RUBAGA DIVISION,NAMIREMBE,BAKULI MARKET,877,4,3,13,253,226,499,11,510,0,O-12-66-01-13-02
KAMPALA,RUBAGA DIVISION NORTH,RUBAGA DIVISION,NAMIREMBE,BUTIKIRO ROAD,695,0,3,12,172,201,388,9,397,0,O-12-66-01-13-03
KAMPALA,RUBAGA DIVISION NORTH,RUBAGA DIVISION,NAMIREMBE,MENGO PRIMARY SCHOOL,388,7,0,3,121,106,237,1,238,0,O-12-66-01-13-04
KAMPALA,RUBAGA DIVISION NORTH,RUBAGA DIVISION,NAMIREMBE,MENGO POST OFFICE,642,4,0,14,218,161,397,10,407,0,O-12-66-01-13-05
KAMPALA,RUBAGA DIVISION NORTH,RUBAGA DIVISION,NAMIREMBE,SCHOOL FOR DISABLED,1049,4,1,31,308,318,662,47,709,0,O-12-66-01-13-06
KAMPALA,RUBAGA DIVISION NORTH,RUBAGA DIVISION,NAMIREMBE,CARDINAL' S WORKSHOP [A -M],418,1,0,11,127,114,253,3,256,0,O-12-66-01-13-07
KAMPALA,RUBAGA DIVISION NORTH,RUBAGA DIVISION,NAMIREMBE,MACKAY PLAYGROUND [A-M],507,5,1,16,161,145,328,4,332,0,O-12-66-01-13-08
KAMPALA,RUBAGA DIVISION NORTH,RUBAGA DIVISION,NAMIREMBE,NURSES HOSTEL,685,7,0,11,155,106,279,7,286,0,O-12-66-01-13-09
KAMPALA,RUBAGA DIVISION NORTH,RUBAGA DIVISION,NAMIREMBE,ARMY SHOP,821,3,0,15,268,183,469,7,476,0,O-12-66-01-13-10
KAMPALA,RUBAGA DIVISION NORTH,RUBAGA DIVISION,NAMIREMBE,SAIDINA HOSPITAL [A-M],796,2,2,6,237,242,489,14,503,0,O-12-66-01-13-11
KAMPALA,RUBAGA DIVISION NORTH,RUBAGA DIVISION,NAMIREMBE,NSUBUGA' S HOME,1015,3,1,19,300,247,570,8,578,0,O-12-66-01-13-12
KAMPALA,RUBAGA DIVISION NORTH,RUBAGA DIVISION,NAMIREMBE,CANON HOUSE-KANANI HOUSE,300,4,2,10,101,84,201,0,201,0,O-12-66-01-13-13
KAMPALA,RUBAGA DIVISION NORTH,RUBAGA DIVISION,NAMIREMBE,SAIDINA HOSPITAL [N-Z],598,2,1,6,145,168,322,14,336,0,O-12-66-01-13-14
KAMPALA,RUBAGA DIVISION NORTH,RUBAGA DIVISION,NAMIREMBE,SEMAKULA' S HOME [N-Z],469,1,2,5,117,138,263,3,266,0,O-12-66-01-13-15
KAMPALA,RUBAGA DIVISION NORTH,RUBAGA DIVISION,NAMIREMBE,CARDINAL' S WORKSHOP [N-Z],424,3,1,11,103,104,222,6,228,0,O-12-66-01-13-16
KAMPALA,RUBAGA DIVISION NORTH,RUBAGA DIVISION,NAMIREMBE,MACKAY PLAYGROUND [N-Z],513,1,0,12,126,150,289,8,297,0,O-12-66-01-13-17
KIBOGA,KIBOGA COUNTY EAST,BUKOMERO,KAGOGO,LUSAANA,606,5,1,6,86,302,400,12,412,0,O-17-84-01-01-01
KIBOGA,KIBOGA COUNTY EAST,BUKOMERO,KAGOGO,KYANAMUYONJO,460,0,1,2,46,249,298,18,316,0,O-17-84-01-01-02
KIBOGA,KIBOGA COUNTY EAST,BUKOMERO,KAGOGO,KANZIIRA,315,3,0,11,52,142,208,13,221,0,O-17-84-01-01-03
KIBOGA,KIBOGA COUNTY EAST,BUKOMERO,KATEERA,KATEERA I,706,4,0,12,140,273,429,5,434,0,O-17-84-01-02-01
KIBOGA,KIBOGA COUNTY EAST,BUKOMERO,KATEERA,KATEERA II,622,1,0,12,102,311,426,19,445,0,O-17-84-01-02-02
KIBOGA,KIBOGA COUNTY EAST,BUKOMERO,KATEERA,KAKUNYU C.O.U,654,4,1,9,153,253,420,21,441,0,O-17-84-01-02-03
KIBOGA,KIBOGA COUNTY EAST,BUKOMERO,KATEERA,KIJOOJOLO,211,0,1,2,27,117,147,8,155,0,O-17-84-01-02-04
KIBOGA,KIBOGA COUNTY EAST,BUKOMERO,KATEERA,NABINENE P/S,542,7,0,7,93,216,323,17,340,0,O-17-84-01-02-05
KIBOGA,KIBOGA COUNTY EAST,BUKOMERO,KATEERA,BUKOMERO,713,5,0,11,147,250,413,12,425,0,O-17-84-01-02-06
KIBOGA,KIBOGA COUNTY EAST,BUKOMERO,KIKOOBA,KIKOOBA,412,4,2,1,69,183,259,9,268,0,O-17-84-01-03-01
KIBOGA,KIBOGA COUNTY EAST,BUKOMERO,KIKOOBA,MASIRIBA,405,3,0,12,82,176,273,6,279,0,O-17-84-01-03-02
KIBOGA,KIBOGA COUNTY EAST,BUKOMERO,KIKOOBA,NAKATOOKE,572,2,1,2,46,295,346,10,356,0,O-17-84-01-03-03
KIBOGA,KIBOGA COUNTY EAST,BUKOMERO,KYOOMYA,KAYUNGA,437,2,0,3,96,206,307,17,324,0,O-17-84-01-04-01
KIBOGA,KIBOGA COUNTY EAST,BUKOMERO,KYOOMYA,KABBO,395,0,0,5,68,219,292,12,304,0,O-17-84-01-04-02
KIBOGA,KIBOGA COUNTY EAST,BUKOMERO,MATAGI,MATAAGI I,421,1,1,3,92,190,287,10,297,0,O-17-84-01-05-01
KIBOGA,KIBOGA COUNTY EAST,BUKOMERO,MATAGI,LUTTI,584,4,3,3,155,165,330,20,350,0,O-17-84-01-05-02
KIBOGA,KIBOGA COUNTY EAST,BUKOMERO,MWEZI,MWEZI PRIMARY SCHOOL,448,0,0,5,77,218,300,17,317,0,O-17-84-01-06-01
KIBOGA,KIBOGA COUNTY EAST,BUKOMERO,MWEZI,KYEYITABYA PRIMARY SCHOOL,371,0,0,1,7,252,260,29,289,0,O-17-84-01-06-02
KIBOGA,KIBOGA COUNTY EAST,BUKOMERO,MWEZI,SOGOLERO PRIMARY SCHOOL,467,2,0,14,69,235,320,25,345,0,O-17-84-01-06-03
KIBOGA,KIBOGA COUNTY EAST,DDWANIRO,KAKINZI,KAKINZI,329,2,1,6,57,178,244,16,260,0,O-17-84-02-01-01
KIBOGA,KIBOGA COUNTY EAST,DDWANIRO,KAKINZI,KIGWANYA,420,3,1,3,81,186,274,9,283,0,O-17-84-02-01-02
KIBOGA,KIBOGA COUNTY EAST,DDWANIRO,KAKINZI,KANDEGEYA,242,1,0,3,2,193,199,8,207,0,O-17-84-02-01-03
KIBOGA,KIBOGA COUNTY EAST,DDWANIRO,KALOKOLA,MUTOOMA,724,1,0,9,68,316,394,5,399,0,O-17-84-02-02-01
KIBOGA,KIBOGA COUNTY EAST,DDWANIRO,KALOKOLA,BUGABO I,221,0,0,2,34,105,141,6,147,0,O-17-84-02-02-02
KIBOGA,KIBOGA COUNTY EAST,DDWANIRO,KALOKOLA,BUGABO II,523,2,0,7,92,237,338,7,345,0,O-17-84-02-02-03
KIBOGA,KIBOGA COUNTY EAST,DDWANIRO,KALOKOLA,KIBISI P/S,178,2,0,2,29,85,118,2,120,0,O-17-84-02-02-04
KIBOGA,KIBOGA COUNTY EAST,DDWANIRO,KALOKOLA,KISANDA P/S,224,0,0,2,42,98,142,5,147,0,O-17-84-02-02-05
KIBOGA,KIBOGA COUNTY EAST,DDWANIRO,KATARAMA,KALUNGU,375,1,0,4,10,274,289,3,292,0,O-17-84-02-03-01
KIBOGA,KIBOGA COUNTY EAST,DDWANIRO,KATARAMA,KAMUGABO,561,3,2,2,39,335,381,12,393,0,O-17-84-02-03-02
KIBOGA,KIBOGA COUNTY EAST,DDWANIRO,LWAKONGE,MUYENJE,284,2,2,1,23,176,204,3,207,0,O-17-84-02-04-01
KIBOGA,KIBOGA COUNTY EAST,DDWANIRO,LWAKONGE,DWANIRO,626,3,1,3,39,314,360,13,373,0,O-17-84-02-04-02
KIBOGA,KIBOGA COUNTY EAST,DDWANIRO,LWAKONGE,LWANKONGE,162,1,0,0,8,99,108,1,109,0,O-17-84-02-04-03
KIBOGA,KIBOGA COUNTY EAST,DDWANIRO,LWAKONGE,LWANTENGA CHURCH,254,0,0,5,0,231,236,6,242,0,O-17-84-02-04-04
KIBOGA,KIBOGA COUNTY EAST,KAPEKE,KAGOBE,KAGOBE PRIMARY SCHOOL,326,1,2,1,49,134,187,7,194,0,O-17-84-03-01-01
KIBOGA,KIBOGA COUNTY EAST,KAPEKE,KAGOBE,KYETUME ISLAMIC P/S,491,1,0,5,91,165,262,9,271,0,O-17-84-03-01-02
KIBOGA,KIBOGA COUNTY EAST,KAPEKE,KASEGA,KIRINDA PRIMARY SCHOOL,825,2,1,14,180,339,536,13,549,0,O-17-84-03-02-01
KIBOGA,KIBOGA COUNTY EAST,KAPEKE,KASEGA,KASININA P/SCHOOL,416,2,0,1,50,191,244,3,247,0,O-17-84-03-02-02
KIBOGA,KIBOGA COUNTY EAST,KAPEKE,KASEGA,BUDIIBO P/SCHOOL,648,2,0,5,40,299,346,31,377,0,O-17-84-03-02-03
KIBOGA,KIBOGA COUNTY EAST,KAPEKE,KAYEERA,KABUYE,411,0,1,0,8,395,404,2,406,0,O-17-84-03-03-01
KIBOGA,KIBOGA COUNTY EAST,KAPEKE,KAYEERA,KYAMUKWEYA,310,0,0,0,9,294,303,7,310,0,O-17-84-03-03-02
KIBOGA,KIBOGA COUNTY EAST,KAPEKE,KYAYIMBA,KAYIMBA,488,2,1,1,74,268,346,15,361,0,O-17-84-03-04-01
KIBOGA,KIBOGA COUNTY EAST,KAPEKE,KYAYIMBA,KAPEKE,439,0,0,0,7,369,376,8,384,0,O-17-84-03-04-02
KIBOGA,KIBOGA COUNTY EAST,KAPEKE,KYAYIMBA,KACHWANGOZI H/C,294,0,0,2,40,118,160,8,168,0,O-17-84-03-04-03
KIBOGA,KIBOGA COUNTY EAST,KIBIGA,DEGEYA,DDEGEYA,529,2,2,11,35,263,313,78,391,0,O-17-84-04-01-01
KIBOGA,KIBOGA COUNTY EAST,KIBIGA,DEGEYA,KIMIRAMPANGO,424,3,0,5,4,290,302,30,332,0,O-17-84-04-01-02
KIBOGA,KIBOGA COUNTY EAST,KIBIGA,KAJJERE,KATOMA A,632,2,0,3,96,295,396,16,412,0,O-17-84-04-02-01
KIBOGA,KIBOGA COUNTY EAST,KIBIGA,KAJJERE,KAJERE C/U,906,1,1,5,52,479,538,16,554,0,O-17-84-04-02-02
KIBOGA,KIBOGA COUNTY EAST,KIBIGA,KAJJERE,KASUBI A,573,3,1,4,14,351,373,27,400,0,O-17-84-04-02-03
KIBOGA,KIBOGA COUNTY EAST,KIBIGA,KAJJERE,KASUBI B,360,1,0,2,20,211,234,24,258,0,O-17-84-04-02-04
KIBOGA,KIBOGA COUNTY EAST,KIBIGA,KIBAALE,KABADA/KIKWATAMBOGA,620,2,2,9,68,251,332,17,349,0,O-17-84-04-03-01
KIBOGA,KIBOGA COUNTY EAST,KIBIGA,KIBAALE,NAMUNYUKA,945,4,2,4,50,506,566,40,606,0,O-17-84-04-03-02
KIBOGA,KIBOGA COUNTY EAST,KIBIGA,KIBAALE,SEETA P/S,1138,1,0,8,9,355,373,46,419,0,O-17-84-04-03-03
KIBOGA,KIBOGA COUNTY EAST,KIBIGA,KIBAALE,KALUSUNGWA,355,1,0,2,7,140,150,12,162,0,O-17-84-04-03-04
KIBOGA,KIBOGA COUNTY EAST,KIBIGA,KIBAALE,NYANJATEGERA (NA-NS),463,0,2,2,4,136,144,21,165,0,O-17-84-04-03-05
KIBOGA,KIBOGA COUNTY EAST,KIBIGA,KIBAALE,KABUKOKWA,427,0,0,0,4,93,97,5,102,0,O-17-84-04-03-06
KIBOGA,KIBOGA COUNTY EAST,KIBIGA,KIBAALE,KIBUYE P/S,584,1,3,3,24,366,397,6,403,0,O-17-84-04-03-07
KIBOGA,KIBOGA COUNTY EAST,KIBIGA,KIBAALE,NAKAYAGA T.C,325,1,1,1,3,189,195,26,221,0,O-17-84-04-03-08
KIBOGA,KIBOGA COUNTY EAST,KIBIGA,KIBAALE,NYANJATEGERA (NTA-O),346,4,2,3,3,111,123,5,128,0,O-17-84-04-03-09
KIBOGA,KIBOGA COUNTY EAST,KIBIGA,KIBIGA,KIBIGA,652,2,0,8,95,356,461,10,471,0,O-17-84-04-04-01
KIBOGA,KIBOGA COUNTY EAST,KIBIGA,KIBIGA,GOGONYA,549,3,1,1,41,302,348,25,373,0,O-17-84-04-04-02
KIBOGA,KIBOGA COUNTY EAST,KIBIGA,KIZINGA,KYEKUMBYA PRIMARY SCHOOL,619,0,1,10,62,251,324,33,357,0,O-17-84-04-05-01
KIBOGA,KIBOGA COUNTY EAST,KIBIGA,KIZINGA,KIZINGA F/GROUND,593,1,0,13,84,280,378,12,390,0,O-17-84-04-05-02
KIBOGA,KIBOGA COUNTY EAST,KIBIGA,NKANDWA,KIJWIGA CATHOLIC CHURCH,663,4,0,10,67,224,305,3,308,0,O-17-84-04-06-01
KIBOGA,KIBOGA COUNTY EAST,KIBIGA,NKANDWA,KISEEZA (A-M),552,0,0,4,10,76,90,4,94,0,O-17-84-04-06-02
KIBOGA,KIBOGA COUNTY EAST,KIBIGA,NKANDWA,KAMBUGU,427,2,1,5,40,166,214,14,228,0,O-17-84-04-06-03
KIBOGA,KIBOGA COUNTY EAST,KIBIGA,NKANDWA,KISEEZA (N-Z),708,2,1,5,57,246,311,9,320,0,O-17-84-04-06-04
KIBOGA,KIBOGA COUNTY EAST,KIBIGA,NKANDWA,ZANYIRO T.C,534,0,0,1,3,70,74,7,81,0,O-17-84-04-06-05
KIBOGA,KIBOGA COUNTY EAST,KIBOGA TOWN COUNCIL,BAMUSUUTA,KABAKANJAGALA I/LUFULA,870,5,0,4,205,272,486,12,498,0,O-17-84-05-01-01
KIBOGA,KIBOGA COUNTY EAST,KIBOGA TOWN COUNCIL,BAMUSUUTA,KABAKANJAGALA II/ST. ANDREWS,1010,2,1,7,240,354,604,33,637,0,O-17-84-05-01-02
KIBOGA,KIBOGA COUNTY EAST,KIBOGA TOWN COUNCIL,BAMUSUUTA,BAMUSUUTA P/SCHOOL,543,1,2,7,139,190,339,15,354,0,O-17-84-05-01-03
KIBOGA,KIBOGA COUNTY EAST,KIBOGA TOWN COUNCIL,BUZIBWEERA,KIYEMBE MOSQUE,930,3,0,2,225,321,551,23,574,0,O-17-84-05-02-01
KIBOGA,KIBOGA COUNTY EAST,KIBOGA TOWN COUNCIL,BUZIBWEERA,KIBOGA GINNERY,796,2,4,6,187,283,482,13,495,0,O-17-84-05-02-02
KIBOGA,KIBOGA COUNTY EAST,KIBOGA TOWN COUNCIL,KIBOGA TOWN,SAZA GROUND,813,0,1,8,175,323,507,6,513,0,O-17-84-05-03-01
KIBOGA,KIBOGA COUNTY EAST,KIBOGA TOWN COUNCIL,KIRULUMBA,D.A.S PRIMARY SCHOOL A,603,3,3,1,113,257,377,3,380,0,O-17-84-05-04-01
KIBOGA,KIBOGA COUNTY EAST,KIBOGA TOWN COUNCIL,KIRULUMBA,D.A.S PRIMARY SCHOOL B,855,2,1,6,171,338,518,6,524,0,O-17-84-05-04-02
KIBOGA,KIBOGA COUNTY EAST,LWAMATA,BUNINGA,NAKAKABALA,466,0,0,3,17,278,298,10,308,0,O-17-84-06-01-01
KIBOGA,KIBOGA COUNTY EAST,LWAMATA,BUNINGA,NSANJE,633,2,0,1,52,318,373,10,383,0,O-17-84-06-01-02
KIBOGA,KIBOGA COUNTY EAST,LWAMATA,BUNINGA,KIGATTANSI,422,1,0,0,21,259,281,10,291,0,O-17-84-06-01-03
KIBOGA,KIBOGA COUNTY EAST,LWAMATA,KASEJJERE,KIJUMAGWA TRADING CENTRE,949,2,2,12,56,525,597,22,619,0,O-17-84-06-02-01
KIBOGA,KIBOGA COUNTY EAST,LWAMATA,KASEJJERE,SSINZIBWA,318,1,0,4,11,217,233,10,243,0,O-17-84-06-02-02
KIBOGA,KIBOGA COUNTY EAST,LWAMATA,KISAGAZI,LUKULI,585,1,2,2,21,393,419,10,429,0,O-17-84-06-03-01
KIBOGA,KIBOGA COUNTY EAST,LWAMATA,KISAGAZI,KALWAYO,558,2,0,2,18,239,261,2,263,0,O-17-84-06-03-02
KIBOGA,KIBOGA COUNTY EAST,LWAMATA,KISAGAZI,KYAKASOZI SDA CHURCH,664,0,0,5,21,349,375,4,379,0,O-17-84-06-03-03
KIBOGA,KIBOGA COUNTY EAST,LWAMATA,KISWEKA,KISWEKA C/O UGANDA,789,2,0,10,88,465,565,17,582,0,O-17-84-06-04-01
KIBOGA,KIBOGA COUNTY EAST,LWAMATA,KYEKUMBYA,KYEKUMBYA,623,5,1,5,72,341,424,6,430,0,O-17-84-06-05-01
KIBOGA,KIBOGA COUNTY EAST,LWAMATA,KYEKUMBYA,BUSWABULONGO,375,0,0,4,34,216,254,2,256,0,O-17-84-06-05-02
KIBOGA,KIBOGA COUNTY EAST,LWAMATA,LWAMATA,LWAMATA TRADING CENTRE,813,4,0,13,148,311,476,16,492,0,O-17-84-06-06-01
KIBOGA,KIBOGA COUNTY EAST,LWAMATA,LWAMATA,LUUNYA,386,2,0,2,79,176,259,7,266,0,O-17-84-06-06-02
KIBOGA,KIBOGA COUNTY EAST,LWAMATA,LWAMATA,LWAMATA B HEALTH CENTRE II,569,2,1,6,43,284,336,13,349,0,O-17-84-06-06-03
KIBOGA,KIBOGA COUNTY EAST,LWAMATA,LWAMATA,LWAMATA B HEALTH CENTRE III,243,0,0,5,54,91,150,5,155,0,O-17-84-06-06-04
KIBOGA,KIBOGA COUNTY EAST,LWAMATA,NSALA,NSALA,588,1,3,8,36,351,399,15,414,0,O-17-84-06-07-01
KIBOGA,KIBOGA COUNTY EAST,LWAMATA,NSALA,KIRIBEDDA P/SCHOOL,548,1,0,5,23,339,368,14,382,0,O-17-84-06-07-02
KIBOGA,KIBOGA COUNTY EAST,LWAMATA,SSINDE,SSINDE PRIMARY SCHOOL,563,0,1,22,80,298,401,28,429,0,O-17-84-06-08-01
KIBOGA,KIBOGA COUNTY EAST,MUWANGA,BIKKO,BIKKO,684,3,0,6,32,384,425,11,436,0,O-17-84-07-01-01
KIBOGA,KIBOGA COUNTY EAST,MUWANGA,MUWANGA,MUWANGA,770,2,1,4,50,443,500,15,515,0,O-17-84-07-02-01
KIBOGA,KIBOGA COUNTY EAST,MUWANGA,MUWANGA,KIGOMA P/S,343,0,0,2,16,204,222,22,244,0,O-17-84-07-02-02
KIBOGA,KIBOGA COUNTY EAST,MUWANGA,NABWENDO,NABWENDO C.O.U P/S,741,3,1,5,70,449,528,8,536,0,O-17-84-07-03-01
KIBOGA,KIBOGA COUNTY EAST,MUWANGA,NABWENDO,NABWENDO R/C P.S II,403,1,0,6,22,248,277,2,279,0,O-17-84-07-03-02
KIBOGA,KIBOGA COUNTY EAST,MUWANGA,NABWENDO,NDIRAWERA P/S,317,3,0,1,31,218,253,2,255,0,O-17-84-07-03-03
KIBOGA,KIBOGA COUNTY EAST,MUWANGA,NABWENDO,BULAMAZZI P/S,245,0,1,0,9,157,167,4,171,0,O-17-84-07-03-04
KIBOGA,KIBOGA COUNTY EAST,MUWANGA,NAKASENGERE,NAKASENGERE I,875,6,0,17,74,436,533,34,567,0,O-17-84-07-04-01
KIBOGA,KIBOGA COUNTY EAST,MUWANGA,NAKASENGERE,NAKASENGERE II,299,0,0,3,9,191,203,7,210,0,O-17-84-07-04-02
KIBOGA,KIBOGA COUNTY EAST,MUWANGA,NAKASENGERE,NAKASENGERE III,476,1,1,0,20,268,290,12,302,0,O-17-84-07-04-03
KIBOGA,KIBOGA COUNTY EAST,MUWANGA,NAKASOZI,NAKASOZI A,391,2,1,4,54,206,267,12,279,0,O-17-84-07-05-01
KIBOGA,KIBOGA COUNTY EAST,MUWANGA,NAKASOZI,NAKASOZI B,300,1,0,1,13,199,214,17,231,0,O-17-84-07-05-02
KIBOGA,KIBOGA COUNTY EAST,MUWANGA,NAKASOZI,KYERIMA T.C,374,1,0,1,36,207,245,7,252,0,O-17-84-07-05-03
LUWEERO,BAMUNANIKA COUNTY,BAMUNANIKA,KIBANYI,KIBANYI TRADING CENTRE,660,4,0,8,71,398,481,13,494,0,O-23-110-01-01-01
LUWEERO,BAMUNANIKA COUNTY,BAMUNANIKA,KIBANYI,KALWE TRADING CENTRE,674,2,3,2,146,348,501,18,519,0,O-23-110-01-01-02
LUWEERO,BAMUNANIKA COUNTY,BAMUNANIKA,KIBIRIZI,NKOKONJERU PRIMARY SCHOOL,570,0,0,10,110,277,397,16,413,0,O-23-110-01-02-01
LUWEERO,BAMUNANIKA COUNTY,BAMUNANIKA,KIBIRIZI,KISAMBU'S RESIDENCE,420,1,0,7,69,213,290,18,308,0,O-23-110-01-02-02
LUWEERO,BAMUNANIKA COUNTY,BAMUNANIKA,KIBIRIZI,NKULUZE CATHOLIC CHURCH,237,0,0,6,33,141,180,1,181,0,O-23-110-01-02-03
LUWEERO,BAMUNANIKA COUNTY,BAMUNANIKA,KITEME,KITEME TRADING CENTRE,832,2,3,14,172,395,586,12,598,0,O-23-110-01-03-01
LUWEERO,BAMUNANIKA COUNTY,BAMUNANIKA,KITEME,MALUNGU Pr. SCHOOL,520,1,0,29,124,212,366,4,370,0,O-23-110-01-03-02
LUWEERO,BAMUNANIKA COUNTY,BAMUNANIKA,KITEME,KAJJULE PRIMARY SCHOOL,723,5,3,21,108,372,509,11,520,0,O-23-110-01-03-03
LUWEERO,BAMUNANIKA COUNTY,BAMUNANIKA,KYAMPISI (BAMUNANI),BAMUNANIKA COUNTY HQTRS A (,568,4,2,6,145,207,364,18,382,0,O-23-110-01-04-01
LUWEERO,BAMUNANIKA COUNTY,BAMUNANIKA,KYAMPISI (BAMUNANI),LUTEETE COMMUNITY CENTRE.,424,0,1,14,69,189,273,6,279,0,O-23-110-01-04-02
LUWEERO,BAMUNANIKA COUNTY,BAMUNANIKA,KYAMPISI (BAMUNANI),KIKAABYA TRADING CENTRE,627,4,0,17,121,306,448,11,459,0,O-23-110-01-04-03
LUWEERO,BAMUNANIKA COUNTY,BAMUNANIKA,KYAMPISI (BAMUNANI),BBUTO STORE,322,2,0,4,57,176,239,5,244,0,O-23-110-01-04-04
LUWEERO,BAMUNANIKA COUNTY,BAMUNANIKA,KYAMPISI (BAMUNANI),BAMUNANIKA COUNTY HQTRS B (,581,1,0,7,96,287,391,9,400,0,O-23-110-01-04-05
LUWEERO,BAMUNANIKA COUNTY,BAMUNANIKA,MPOLOGOMA,KANGULUMIRA TRADING CENTRE,415,1,1,7,84,220,313,7,320,0,O-23-110-01-05-01
LUWEERO,BAMUNANIKA COUNTY,BAMUNANIKA,MPOLOGOMA,MITYEBIRI SDA P/SCH.,328,1,1,3,50,192,247,2,249,0,O-23-110-01-05-02
LUWEERO,BAMUNANIKA COUNTY,BAMUNANIKA,SEKAMULI,SEKAMULI COOPERATIVE STORE,537,1,1,10,121,244,377,4,381,0,O-23-110-01-06-01
LUWEERO,BAMUNANIKA COUNTY,BAMUNANIKA,SEKAMULI,NDABIRAKODALA,549,5,1,8,74,319,407,0,407,0,O-23-110-01-06-02
LUWEERO,BAMUNANIKA COUNTY,BAMUNANIKA,SEKAMULI,KAKOOLA,215,1,0,23,35,95,154,4,158,0,O-23-110-01-06-03
LUWEERO,BAMUNANIKA COUNTY,BAMUNANIKA,SEKAMULI,NAKULABYE BOREHOLE,460,1,1,3,48,287,340,5,345,0,O-23-110-01-06-04
LUWEERO,BAMUNANIKA COUNTY,KALAGALA,BUSIIKA,BUSIIKA TRADING CENTRE,845,4,0,14,224,279,521,12,533,0,O-23-110-02-01-01
LUWEERO,BAMUNANIKA COUNTY,KALAGALA,BUSIIKA,NAMUMIRA PRIMARY SCHOOL,480,4,0,13,127,207,351,12,363,0,O-23-110-02-01-02
LUWEERO,BAMUNANIKA COUNTY,KALAGALA,BUSIIKA,SENERO S.D.A PRI. SCH,327,5,0,4,105,103,217,13,230,0,O-23-110-02-01-03
LUWEERO,BAMUNANIKA COUNTY,KALAGALA,BUSOKE,MPIGI PRIMARY SCHOOL,687,5,2,15,108,327,457,3,460,0,O-23-110-02-02-01
LUWEERO,BAMUNANIKA COUNTY,KALAGALA,BUSOKE,VUMBA PRIMARY SCHOOL,639,4,1,16,117,294,432,9,441,0,O-23-110-02-02-02
LUWEERO,BAMUNANIKA COUNTY,KALAGALA,DDEGEYA,BAKIJULURA CHURCH OF UGAND,476,2,1,9,153,143,308,7,315,0,O-23-110-02-03-01
LUWEERO,BAMUNANIKA COUNTY,KALAGALA,DDEGEYA,NAMWATULIRA HEALTH UNIT,416,6,0,3,95,144,248,6,254,0,O-23-110-02-03-02
LUWEERO,BAMUNANIKA COUNTY,KALAGALA,DDEGEYA,BUGABO CHURCH OF UGANDA,338,3,0,3,76,141,223,3,226,0,O-23-110-02-03-03
LUWEERO,BAMUNANIKA COUNTY,KALAGALA,DDEGEYA,KIREKA,295,0,0,6,44,180,230,8,238,0,O-23-110-02-03-04
LUWEERO,BAMUNANIKA COUNTY,KALAGALA,KALANAMU,KALAGALA S/C HQTRS.,626,2,0,14,167,223,406,6,412,0,O-23-110-02-04-01
LUWEERO,BAMUNANIKA COUNTY,KALAGALA,KALANAMU,KALANAMU TRADING CENTRE,413,2,1,14,91,164,272,7,279,0,O-23-110-02-04-02
LUWEERO,BAMUNANIKA COUNTY,KALAGALA,KALANAMU,KALUNGU PLAYGROUND,451,1,1,5,96,178,281,8,289,0,O-23-110-02-04-03
LUWEERO,BAMUNANIKA COUNTY,KALAGALA,KAMIRA,BUGEMA COLLEGE DISPENSARY,897,5,2,11,186,319,523,9,532,0,O-23-110-02-05-01
LUWEERO,BAMUNANIKA COUNTY,KALAGALA,KAMIRA,KAMIRA PARISH HQTRS,469,2,0,7,102,200,311,20,331,0,O-23-110-02-05-02
LUWEERO,BAMUNANIKA COUNTY,KALAGALA,KAYINDU,LUTEETE UMEA PRIMARY SCHOO,458,6,0,4,144,152,306,8,314,0,O-23-110-02-06-01
LUWEERO,BAMUNANIKA COUNTY,KALAGALA,KAYINDU,KAYINDU C.O.U. PRIMARY SCHOO,490,1,0,7,95,156,259,11,270,0,O-23-110-02-06-02
LUWEERO,BAMUNANIKA COUNTY,KALAGALA,KAYINDU,KALAGALA PRIMARY SCHOOL,410,0,1,14,99,149,263,6,269,0,O-23-110-02-06-03
LUWEERO,BAMUNANIKA COUNTY,KALAGALA,KAYINDU,KYOGO C.O.U.,282,2,1,4,83,103,193,0,193,0,O-23-110-02-06-04
LUWEERO,BAMUNANIKA COUNTY,KALAGALA,LUNYOLYA,LUNYOLYA COOP. STORE,251,1,0,5,26,110,142,5,147,0,O-23-110-02-07-01
LUWEERO,BAMUNANIKA COUNTY,KALAGALA,LUNYOLYA,KKOKO C.O.U. PRIMARY SCHOOL,340,0,0,13,120,105,238,10,248,0,O-23-110-02-07-02
LUWEERO,BAMUNANIKA COUNTY,KALAGALA,LUNYOLYA,DAAZA,226,1,0,4,50,102,157,12,169,0,O-23-110-02-07-03
LUWEERO,BAMUNANIKA COUNTY,KALAGALA,LUNYOLYA,LUNYOLYA L.C A (A-M),368,2,0,11,98,97,208,3,211,0,O-23-110-02-07-04
LUWEERO,BAMUNANIKA COUNTY,KALAGALA,LUNYOLYA,LUNYOLYA L.C B (N-Z),600,4,0,14,107,224,349,7,356,0,O-23-110-02-07-05
LUWEERO,BAMUNANIKA COUNTY,KALAGALA,VVUMBA,NDEEBA COOP. STORE,716,9,0,14,218,307,548,12,560,0,O-23-110-02-08-01
LUWEERO,BAMUNANIKA COUNTY,KALAGALA,VVUMBA,KYETUME P/SCHOOL,241,0,1,5,61,101,168,4,172,0,O-23-110-02-08-02
LUWEERO,BAMUNANIKA COUNTY,KALAGALA,VVUMBA,KIBANGA P/SCHOOL,600,5,0,17,176,237,435,23,458,0,O-23-110-02-08-03
LUWEERO,BAMUNANIKA COUNTY,KALAGALA,VVUMBA,VVUMBA T.C,565,5,1,15,117,253,391,4,395,0,O-23-110-02-08-04
LUWEERO,BAMUNANIKA COUNTY,KALAGALA,VVUMBA,NDEEBA T.C,180,2,0,2,26,108,138,3,141,0,O-23-110-02-08-05
LUWEERO,BAMUNANIKA COUNTY,KAMIRA,KABUNYATA,MATEMBE P/SCHOOL,533,1,0,6,63,281,351,1,352,0,O-23-110-03-01-01
LUWEERO,BAMUNANIKA COUNTY,KAMIRA,KABUNYATA,KABUNYATA TOWN,498,1,2,3,43,272,321,4,325,0,O-23-110-03-01-02
LUWEERO,BAMUNANIKA COUNTY,KAMIRA,KASWA,KAMIRA S/C HQTRS.,707,0,2,6,85,343,436,10,446,0,O-23-110-03-02-01
LUWEERO,BAMUNANIKA COUNTY,KAMIRA,KASWA,NAKASEJJERE STORES,638,2,2,9,88,279,380,5,385,0,O-23-110-03-02-02
LUWEERO,BAMUNANIKA COUNTY,KAMIRA,KASWA,KIKANDWA T/C,285,1,0,1,31,140,173,11,184,0,O-23-110-03-02-03
LUWEERO,BAMUNANIKA COUNTY,KAMIRA,KATAGGWE,MAKONKONYIGO P/SCH,449,1,1,7,37,234,280,14,294,0,O-23-110-03-03-01
LUWEERO,BAMUNANIKA COUNTY,KAMIRA,KATAGGWE,BUKIIBI P/SCH,687,2,2,7,60,337,408,14,422,0,O-23-110-03-03-02
LUWEERO,BAMUNANIKA COUNTY,KAMIRA,KATAGGWE,KEERA PRI. SCH,339,3,0,1,43,181,228,0,228,0,O-23-110-03-03-03
LUWEERO,BAMUNANIKA COUNTY,KAMIRA,KITENDERI,NKUNGEERE,318,1,2,4,30,199,236,5,241,0,O-23-110-03-04-01
LUWEERO,BAMUNANIKA COUNTY,KAMIRA,KITENDERI,KIGUMBYA T.C,263,1,0,0,25,110,136,5,141,0,O-23-110-03-04-02
LUWEERO,BAMUNANIKA COUNTY,KAMIRA,MABUYE,MABUYE Pr. SCHOOL A,619,2,1,8,61,294,366,16,382,0,O-23-110-03-05-01
LUWEERO,BAMUNANIKA COUNTY,KAMIRA,MABUYE,KIKONDERE T/C,246,3,0,7,36,112,158,3,161,0,O-23-110-03-05-02
LUWEERO,BAMUNANIKA COUNTY,KAMIRA,MABUYE,KIZITO T/C,393,5,0,2,50,204,261,10,271,0,O-23-110-03-05-03
LUWEERO,BAMUNANIKA COUNTY,KAMIRA,MAZZI,MAZZI PRIMARY SCHOOL,488,6,2,4,56,217,285,0,285,0,O-23-110-03-06-01
LUWEERO,BAMUNANIKA COUNTY,KAMIRA,MAZZI,MAZZI PARISH HQRS,469,1,1,10,30,174,216,23,239,0,O-23-110-03-06-02
LUWEERO,BAMUNANIKA COUNTY,KAMIRA,MAZZI,KABUKUNGA T/C,295,0,1,4,43,150,198,5,203,0,O-23-110-03-06-03
LUWEERO,BAMUNANIKA COUNTY,KAMIRA,NAMBEERE,GALIKWOLEKA PARENTS SCHOO,709,2,1,5,58,365,431,3,434,0,O-23-110-03-07-01
LUWEERO,BAMUNANIKA COUNTY,KAMIRA,NAMBEERE,NAMBERE PARENTS SCHOOL,720,2,0,7,70,320,399,7,406,0,O-23-110-03-07-02
LUWEERO,BAMUNANIKA COUNTY,KIKYUSA,KIBENGO,KAYONZA TOWN,717,3,3,3,84,361,454,21,475,0,O-23-110-04-01-01
LUWEERO,BAMUNANIKA COUNTY,KIKYUSA,KIBENGO,KIBENGO PRIMARY SCHOOL,297,2,0,1,28,195,226,10,236,0,O-23-110-04-01-02
LUWEERO,BAMUNANIKA COUNTY,KIKYUSA,KIBENGO,KATABONA,176,2,0,0,30,81,113,5,118,0,O-23-110-04-01-03
LUWEERO,BAMUNANIKA COUNTY,KIKYUSA,KIBENGO,MANYWA,355,0,0,3,59,197,259,12,271,0,O-23-110-04-01-04
LUWEERO,BAMUNANIKA COUNTY,KIKYUSA,KIREKU,DAMASCUS Pr. SCHOOL,542,3,1,4,69,259,336,0,336,0,O-23-110-04-02-01
LUWEERO,BAMUNANIKA COUNTY,KIKYUSA,KIREKU,KIWANGUZI PRIMARY SCHOOL,651,0,2,10,51,342,405,26,431,0,O-23-110-04-02-02
LUWEERO,BAMUNANIKA COUNTY,KIKYUSA,KIREKU,MULUNGIOMU CHURCH OF UGAN,259,2,0,2,50,112,166,4,170,0,O-23-110-04-02-03
LUWEERO,BAMUNANIKA COUNTY,KIKYUSA,KIZIBA,KIKYUSA KELEZIA (A - M),694,3,3,12,186,227,431,18,449,0,O-23-110-04-03-01
LUWEERO,BAMUNANIKA COUNTY,KIKYUSA,KIZIBA,BUMBU P/SCH.,405,1,2,10,41,191,245,6,251,0,O-23-110-04-03-02
LUWEERO,BAMUNANIKA COUNTY,KIKYUSA,KIZIBA,WAKIVULE RC I HQRS.,317,4,1,15,70,131,221,6,227,0,O-23-110-04-03-03
LUWEERO,BAMUNANIKA COUNTY,KIKYUSA,KIZIBA,KIKYUSA KELEZIA (O- Z),276,2,1,4,78,87,172,2,174,0,O-23-110-04-03-04
LUWEERO,BAMUNANIKA COUNTY,KIKYUSA,KIZIBA,ST.CATHERINE P/S,239,1,1,15,38,109,164,6,170,0,O-23-110-04-03-05
LUWEERO,BAMUNANIKA COUNTY,KIKYUSA,KIZIBA,KIKYUSA KELEZIA (N),784,0,1,7,93,344,445,16,461,0,O-23-110-04-03-06
LUWEERO,BAMUNANIKA COUNTY,KIKYUSA,KIZIBA,KIZIBA C.O.U P/S,402,2,0,3,51,186,242,5,247,0,O-23-110-04-03-07
LUWEERO,BAMUNANIKA COUNTY,KIKYUSA,KYAMPOGOLA,KAWE C.O.U PRIMARY SCHOOL,318,0,2,7,40,158,207,9,216,0,O-23-110-04-04-01
LUWEERO,BAMUNANIKA COUNTY,KIKYUSA,KYAMPOGOLA,KYAMPOGOLA TRADING CENTRE,514,2,4,4,55,270,335,11,346,0,O-23-110-04-04-02
LUWEERO,BAMUNANIKA COUNTY,KIKYUSA,KYAMPOGOLA,MASINGA C.O.U,226,0,0,1,26,135,162,5,167,0,O-23-110-04-04-03
LUWEERO,BAMUNANIKA COUNTY,KIKYUSA,WABUSANA,WABUSAANA,547,3,1,1,69,263,337,12,349,0,O-23-110-04-05-01
LUWEERO,BAMUNANIKA COUNTY,KIKYUSA,WABUSANA,NAZARETH S.D.A P/S,462,1,0,4,60,197,262,4,266,0,O-23-110-04-05-02
LUWEERO,BAMUNANIKA COUNTY,KIKYUSA,WABUSANA,KANKOOLE,393,3,2,8,73,174,260,5,265,0,O-23-110-04-05-03
LUWEERO,BAMUNANIKA COUNTY,KIKYUSA,WABUSANA,GAMBIRANA T/C,252,2,0,4,19,121,146,13,159,0,O-23-110-04-05-04
LUWEERO,BAMUNANIKA COUNTY,KIKYUSA,WABUSANA,TEMA T/C,201,0,0,4,32,114,150,3,153,0,O-23-110-04-05-05
LUWEERO,BAMUNANIKA COUNTY,KIKYUSA,WANKANYA,KIMAZI Pr. SCHOOL,407,4,0,3,79,221,307,6,313,0,O-23-110-04-06-01
LUWEERO,BAMUNANIKA COUNTY,KIKYUSA,WANKANYA,KIRUMANDAGI AID POST,408,2,0,6,55,238,301,8,309,0,O-23-110-04-06-02
LUWEERO,BAMUNANIKA COUNTY,KIKYUSA,WANKANYA,MUSANJE,211,0,1,0,39,99,139,5,144,0,O-23-110-04-06-03
LUWEERO,BAMUNANIKA COUNTY,ZIROBWE,BUBUUBI,BUBUUBI COOP. STORE,493,2,1,7,109,204,323,10,333,0,O-23-110-05-01-01
LUWEERO,BAMUNANIKA COUNTY,ZIROBWE,BUBUUBI,MASUNGWE PRIMARY SCHOOL,305,2,0,3,27,166,198,14,212,0,O-23-110-05-01-02
LUWEERO,BAMUNANIKA COUNTY,ZIROBWE,BUBUUBI,NAKABULULU T/C,254,3,0,4,21,121,149,0,149,0,O-23-110-05-01-03
LUWEERO,BAMUNANIKA COUNTY,ZIROBWE,BUBUUBI,KABUWOMERO,178,0,1,0,17,100,118,4,122,0,O-23-110-05-01-04
LUWEERO,BAMUNANIKA COUNTY,ZIROBWE,BUKIMU,ZIROBWE S\C HQTRS,907,7,3,7,236,305,558,20,578,0,O-23-110-05-02-01
LUWEERO,BAMUNANIKA COUNTY,ZIROBWE,BUKIMU,BUKIMU MOSLEM P.S.,852,6,3,10,197,299,515,33,548,0,O-23-110-05-02-02
LUWEERO,BAMUNANIKA COUNTY,ZIROBWE,BUKIMU,BUKASA PRIMARY SCHOOL,411,1,1,13,88,156,259,6,265,0,O-23-110-05-02-03
LUWEERO,BAMUNANIKA COUNTY,ZIROBWE,BUKIMU,KIJJUDE,317,0,1,3,35,182,221,15,236,0,O-23-110-05-02-04
LUWEERO,BAMUNANIKA COUNTY,ZIROBWE,BUKIMU,KISULA PLAYGROUND,330,2,0,1,87,146,236,10,246,0,O-23-110-05-02-05
LUWEERO,BAMUNANIKA COUNTY,ZIROBWE,KABULANAKA,KABULANAKA STORE,628,10,1,11,124,318,464,12,476,0,O-23-110-05-03-01
LUWEERO,BAMUNANIKA COUNTY,ZIROBWE,KABULANAKA,JANDA SAKA'S HOME,582,2,1,5,159,240,407,20,427,0,O-23-110-05-03-02
LUWEERO,BAMUNANIKA COUNTY,ZIROBWE,KABULANAKA,MANYAMA CHURCH,232,2,0,7,54,90,153,5,158,0,O-23-110-05-03-03
LUWEERO,BAMUNANIKA COUNTY,ZIROBWE,KAKAKALA,WAKATAYI PR. SCHOOL,633,5,3,2,159,217,386,0,386,0,O-23-110-05-04-01
LUWEERO,BAMUNANIKA COUNTY,ZIROBWE,KAKAKALA,KAKAKALA PARISH HQTRS,398,3,0,8,102,123,236,12,248,0,O-23-110-05-04-02
LUWEERO,BAMUNANIKA COUNTY,ZIROBWE,KAKAKALA,KIJUGUMBYA PRIMARY SCHOOL,339,1,1,7,57,164,230,3,233,0,O-23-110-05-04-03
LUWEERO,BAMUNANIKA COUNTY,ZIROBWE,KAKAKALA,KIREEBA T/C,246,4,1,2,83,72,162,14,176,0,O-23-110-05-04-04
LUWEERO,BAMUNANIKA COUNTY,ZIROBWE,KAKAKALA,BUBENGWA STORE,514,3,1,8,98,235,345,8,353,0,O-23-110-05-04-05
LUWEERO,BAMUNANIKA COUNTY,ZIROBWE,KYETUME,KYETUME PARISH HQTRS.,608,5,0,5,89,334,433,10,443,0,O-23-110-05-05-01
LUWEERO,BAMUNANIKA COUNTY,ZIROBWE,KYETUME,WABITUNGULU,725,5,0,3,122,357,487,28,515,0,O-23-110-05-05-02
LUWEERO,BAMUNANIKA COUNTY,ZIROBWE,KYETUME,BUYONDO T/C,312,1,0,0,67,151,219,16,235,0,O-23-110-05-05-03
LUWEERO,BAMUNANIKA COUNTY,ZIROBWE,NAKIGOZA,NAKIGOZA PARISH HQTRS.,652,0,0,5,50,392,447,15,462,0,O-23-110-05-06-01
LUWEERO,BAMUNANIKA COUNTY,ZIROBWE,NAKIGOZA,KIYIYA PRIMARY SCHOOL,546,0,2,7,49,327,385,13,398,0,O-23-110-05-06-02
LUWEERO,BAMUNANIKA COUNTY,ZIROBWE,NAKIGOZA,NAWABBONGO,192,0,1,1,18,128,148,3,151,0,O-23-110-05-06-03
LUWEERO,BAMUNANIKA COUNTY,ZIROBWE,NAKIGOZA,TONGO P/S,470,4,2,4,55,254,319,12,331,0,O-23-110-05-06-04
LUWEERO,BAMUNANIKA COUNTY,ZIROBWE,NAMBI,NAMBI PARISH HQTRS.,368,0,0,17,107,120,244,0,244,0,O-23-110-05-07-01
LUWEERO,BAMUNANIKA COUNTY,ZIROBWE,NAMBI,NAMBI PRIMARY SCHOOL,509,4,1,8,118,201,332,8,340,0,O-23-110-05-07-02
LUWEERO,BAMUNANIKA COUNTY,ZIROBWE,NAMBI,NAMAKOFU P/S,369,3,0,15,68,152,238,1,239,0,O-23-110-05-07-03
LUWEERO,BAMUNANIKA COUNTY,ZIROBWE,NGALONKALU,KAJANO TRADING CENTRE,715,9,0,9,106,393,517,20,537,0,O-23-110-05-08-01
LUWEERO,BAMUNANIKA COUNTY,ZIROBWE,NGALONKALU,NAMATOGOYA PRIMARY SCHOOL,868,2,1,13,103,508,627,25,652,0,O-23-110-05-08-02
LUWEERO,BAMUNANIKA COUNTY,ZIROBWE,NGALONKALU,TIMBA TRADING CENTRE,563,2,0,4,52,367,425,14,439,0,O-23-110-05-08-03
LUWEERO,KATIKAMU COUNTY NORTH,BUTUNTUMULA,BAMUGOLODDE,ASIISO TRADING CENTRE,560,2,3,9,89,207,310,0,310,0,O-23-107-01-01-01
LUWEERO,KATIKAMU COUNTY NORTH,BUTUNTUMULA,BAMUGOLODDE,UMONDE,598,2,1,6,59,326,394,13,407,0,O-23-107-01-01-02
LUWEERO,KATIKAMU COUNTY NORTH,BUTUNTUMULA,BAMUGOLODDE,AMUGOLODDE P/SCHOOL,661,1,0,35,83,310,429,13,442,0,O-23-107-01-01-03
LUWEERO,KATIKAMU COUNTY NORTH,BUTUNTUMULA,BAMUGOLODDE,IBIKE T/C,201,2,2,2,47,75,128,13,141,0,O-23-107-01-01-04
LUWEERO,KATIKAMU COUNTY NORTH,BUTUNTUMULA,BAMUGOLODDE,ATI VOCATIONAL SCH.,242,0,0,1,51,116,168,5,173,0,O-23-107-01-01-05
LUWEERO,KATIKAMU COUNTY NORTH,BUTUNTUMULA,BUKAMBAGGA,USENKE TRADING CENTRE,496,5,0,5,44,263,317,11,328,0,O-23-107-01-02-01
LUWEERO,KATIKAMU COUNTY NORTH,BUTUNTUMULA,BUKAMBAGGA,IREEBEREEBE PLAY GROUND,618,5,4,6,127,279,421,0,421,0,O-23-107-01-02-02
LUWEERO,KATIKAMU COUNTY NORTH,BUTUNTUMULA,KAKABALA,AKABALA P. SCHOOL,695,2,1,6,84,380,473,2,475,0,O-23-107-01-03-01
LUWEERO,KATIKAMU COUNTY NORTH,BUTUNTUMULA,KAKABALA,ALONGO P/SCHOOL,478,2,0,6,56,236,300,13,313,0,O-23-107-01-03-02
LUWEERO,KATIKAMU COUNTY NORTH,BUTUNTUMULA,KAKABALA,AKINZI PRIMARY SCHOOL,786,4,2,8,95,425,534,9,543,0,O-23-107-01-03-03
LUWEERO,KATIKAMU COUNTY NORTH,BUTUNTUMULA,KAKABALA,DIBULUNGI P/SCHOOL,548,0,2,2,67,233,304,8,312,0,O-23-107-01-03-04
LUWEERO,KATIKAMU COUNTY NORTH,BUTUNTUMULA,KAKINZI,YAMBOGO PR. SCHOOL,632,3,1,20,81,322,427,10,437,0,O-23-107-01-04-01
LUWEERO,KATIKAMU COUNTY NORTH,BUTUNTUMULA,KAKINZI,AKAKONO MOSQUE,639,1,0,13,118,324,456,5,461,0,O-23-107-01-04-02
LUWEERO,KATIKAMU COUNTY NORTH,BUTUNTUMULA,KAKINZI,ABANYI P.S,191,3,0,1,15,105,124,4,128,0,O-23-107-01-04-03
LUWEERO,KATIKAMU COUNTY NORTH,BUTUNTUMULA,KALWANGA,ALWANGA,375,1,0,1,28,189,219,5,224,0,O-23-107-01-05-01
LUWEERO,KATIKAMU COUNTY NORTH,BUTUNTUMULA,KALWANGA,AAYA FARM,270,0,0,0,15,144,159,5,164,0,O-23-107-01-05-02
LUWEERO,KATIKAMU COUNTY NORTH,BUTUNTUMULA,KYAWANGABI,YAWANGABI,816,2,2,8,85,433,530,11,541,0,O-23-107-01-06-01
LUWEERO,KATIKAMU COUNTY NORTH,BUTUNTUMULA,KYAWANGABI,UTUURA TRADING CENTRE,724,4,3,2,69,326,404,57,461,0,O-23-107-01-06-02
LUWEERO,KATIKAMU COUNTY NORTH,BUTUNTUMULA,KYAWANGABI,ANSAKA P/SCH.,349,1,1,3,23,193,221,2,223,0,O-23-107-01-06-03
LUWEERO,KATIKAMU COUNTY NORTH,BUTUNTUMULA,NGOGOLO,ASAALA BOYS P/SCHOOL,692,1,0,11,91,346,449,10,459,0,O-23-107-01-07-01
LUWEERO,KATIKAMU COUNTY NORTH,BUTUNTUMULA,NGOGOLO,ASAALA GIRLS P/SCHOOL,461,2,0,4,50,214,270,10,280,0,O-23-107-01-07-02
LUWEERO,KATIKAMU COUNTY NORTH,BUTUNTUMULA,NGOGOLO,GOGOLO SDA P/SCH,483,2,0,14,100,187,303,8,311,0,O-23-107-01-07-03
LUWEERO,KATIKAMU COUNTY NORTH,BUTUNTUMULA,NGOGOLO,SENGE P/SCH,363,0,0,2,34,205,241,0,241,0,O-23-107-01-07-04
LUWEERO,KATIKAMU COUNTY NORTH,KATIKAMU - NORTH,BUYUKI,IRYAMURONDO TR. CENTRE,443,0,2,6,133,175,316,8,324,0,O-23-107-02-01-01
LUWEERO,KATIKAMU COUNTY NORTH,KATIKAMU - NORTH,BUYUKI,UYUKI C.O.U. P/SCHOOL,665,4,0,21,193,206,424,18,442,0,O-23-107-02-01-02
LUWEERO,KATIKAMU COUNTY NORTH,KATIKAMU - NORTH,BUYUKI,UBAMITWE,204,1,0,7,41,111,160,5,165,0,O-23-107-02-01-03
LUWEERO,KATIKAMU COUNTY NORTH,KATIKAMU - NORTH,BUYUKI,ULAMA P/SCHOOL,230,3,0,16,67,91,177,2,179,0,O-23-107-02-01-04
LUWEERO,KATIKAMU COUNTY NORTH,KATIKAMU - NORTH,BUYUKI,ACHAMPA CHURCH,266,2,0,5,54,121,182,18,200,0,O-23-107-02-01-05
LUWEERO,KATIKAMU COUNTY NORTH,KATIKAMU - NORTH,BUYUKI,ONDE BUYUKI,195,0,0,4,45,90,139,4,143,0,O-23-107-02-01-06
LUWEERO,KATIKAMU COUNTY NORTH,KATIKAMU - NORTH,KYALUGONDO,IKOZA T.C,285,3,0,4,36,163,206,3,209,0,O-23-107-02-02-01
LUWEERO,KATIKAMU COUNTY NORTH,KATIKAMU - NORTH,KYALUGONDO,YALUGONDO IN LUTEMBE,463,2,1,10,64,221,298,16,314,0,O-23-107-02-02-02
LUWEERO,KATIKAMU COUNTY NORTH,KATIKAMU - NORTH,KYALUGONDO,ILLENIUM COLLEGE BUTANZA,462,2,0,11,69,239,321,11,332,0,O-23-107-02-02-03
LUWEERO,KATIKAMU COUNTY NORTH,KATIKAMU - NORTH,KYALUGONDO,YALUGONDO P.S,257,2,0,6,66,101,175,4,179,0,O-23-107-02-02-04
LUWEERO,KATIKAMU COUNTY NORTH,KATIKAMU - NORTH,MIGADDE,UKOMERA TRADING CENTRE,513,3,1,11,128,214,357,7,364,0,O-23-107-02-03-01
LUWEERO,KATIKAMU COUNTY NORTH,KATIKAMU - NORTH,MIGADDE,MAUS CENTRE,422,2,1,5,88,203,299,18,317,0,O-23-107-02-03-02
LUWEERO,KATIKAMU COUNTY NORTH,KATIKAMU - NORTH,MIGADDE,UKUSU,556,3,0,19,93,264,379,64,443,0,O-23-107-02-03-03
LUWEERO,KATIKAMU COUNTY NORTH,KATIKAMU - NORTH,MIGADDE,ALUVULE P/SCH,272,0,0,4,62,134,200,9,209,0,O-23-107-02-03-04
LUWEERO,KATIKAMU COUNTY NORTH,KATIKAMU - NORTH,MIGADDE,OOJO MOSQUE CENTRE,336,1,0,8,63,173,245,5,250,0,O-23-107-02-03-05
LUWEERO,KATIKAMU COUNTY NORTH,LUWEERO TOWN COUNCIL,KASANA P.W.D.,EARS CENTRE,461,1,0,11,108,182,302,6,308,0,O-23-107-03-01-01
LUWEERO,KATIKAMU COUNTY NORTH,LUWEERO TOWN COUNCIL,KASANA P.W.D.,PIIDA HIGH SCH.,565,3,0,17,142,228,390,8,398,0,O-23-107-03-01-02
LUWEERO,KATIKAMU COUNTY NORTH,LUWEERO TOWN COUNCIL,KAVULE,LUWEERO S.S.S A,591,1,0,6,108,158,273,16,289,0,O-23-107-03-02-01
LUWEERO,KATIKAMU COUNTY NORTH,LUWEERO TOWN COUNCIL,KAVULE,KASANA KAKOKOLO,932,0,0,13,192,319,524,5,529,0,O-23-107-03-02-02
LUWEERO,KATIKAMU COUNTY NORTH,LUWEERO TOWN COUNCIL,KAVULE,LITTLE ANGLES P.SCH,688,7,2,3,117,186,315,23,338,0,O-23-107-03-02-03
LUWEERO,KATIKAMU COUNTY NORTH,LUWEERO TOWN COUNCIL,KAVULE,LUWEERO S.S.S B,560,4,0,3,83,182,272,18,290,0,O-23-107-03-02-04
LUWEERO,KATIKAMU COUNTY NORTH,LUWEERO TOWN COUNCIL,KIWOGOZI,KASANA ST JUDE P/SCH A(A-M),364,4,0,6,89,131,230,6,236,0,O-23-107-03-03-01
LUWEERO,KATIKAMU COUNTY NORTH,LUWEERO TOWN COUNCIL,KIWOGOZI,KASANA HEALTH CENTRE A (A-M),544,2,0,4,152,171,329,5,334,0,O-23-107-03-03-02
LUWEERO,KATIKAMU COUNTY NORTH,LUWEERO TOWN COUNCIL,KIWOGOZI,KASANA HEALTH CENTRE B (N-Z),831,2,2,11,161,313,489,9,498,0,O-23-107-03-03-03
LUWEERO,KATIKAMU COUNTY NORTH,LUWEERO TOWN COUNCIL,KIWOGOZI,SHAMAH HIGH SCH,755,3,0,4,150,264,421,59,480,0,O-23-107-03-03-04
LUWEERO,KATIKAMU COUNTY NORTH,LUWEERO TOWN COUNCIL,KIWOGOZI,KASANA ST JUDE P/SCH B(N-Z),503,1,0,7,72,220,300,9,309,0,O-23-107-03-03-05
LUWEERO,KATIKAMU COUNTY NORTH,LUWEERO TOWN COUNCIL,LUWERO CENTRAL,LUWEERO TAXI PARK A(A-M),491,1,0,8,111,117,237,32,269,0,O-23-107-03-04-01
LUWEERO,KATIKAMU COUNTY NORTH,LUWEERO TOWN COUNCIL,LUWERO CENTRAL,LUWEERO SDA P/S A(A-M),427,1,0,3,110,101,215,0,215,0,O-23-107-03-04-02
LUWEERO,KATIKAMU COUNTY NORTH,LUWEERO TOWN COUNCIL,LUWERO CENTRAL,LUWEERO TAXI PARK B(N-Z),414,3,0,6,83,107,199,32,231,0,O-23-107-03-04-03
LUWEERO,KATIKAMU COUNTY NORTH,LUWEERO TOWN COUNCIL,LUWERO CENTRAL,LUWEERO SDA P/S B(N-Z),384,0,1,5,81,125,212,0,212,0,O-23-107-03-04-04
LUWEERO,KATIKAMU COUNTY NORTH,LUWEERO TOWN COUNCIL,LUWERO SOUTH EAS,LUWERO ISLAMIC P.SCH A(A-M),558,3,1,6,173,126,309,39,348,0,O-23-107-03-05-01
LUWEERO,KATIKAMU COUNTY NORTH,LUWEERO TOWN COUNCIL,LUWERO SOUTH EAS,LUBEGA MEMORIAL P/SCH,551,2,1,9,135,228,375,1,376,0,O-23-107-03-05-02
LUWEERO,KATIKAMU COUNTY NORTH,LUWEERO TOWN COUNCIL,LUWERO SOUTH EAS,LUWERO ISLAMIC P.SCH B(N-Z),853,4,0,5,186,266,461,43,504,0,O-23-107-03-05-03
LUWEERO,KATIKAMU COUNTY NORTH,LUWEERO TOWN COUNCIL,LUWERO WEST,COFFEE FACTORY (A-M),664,3,0,10,164,158,335,6,341,0,O-23-107-03-06-01
LUWEERO,KATIKAMU COUNTY NORTH,LUWEERO TOWN COUNCIL,LUWERO WEST,LIGHT OF LIFE S.S.S,441,6,2,13,138,134,293,0,293,0,O-23-107-03-06-02
LUWEERO,KATIKAMU COUNTY NORTH,LUWEERO TOWN COUNCIL,LUWERO WEST,LUWERO HIGH SCHOOL (A-M),994,3,2,8,233,204,450,83,533,0,O-23-107-03-06-03
LUWEERO,KATIKAMU COUNTY NORTH,LUWEERO TOWN COUNCIL,LUWERO WEST,COFFEE FACTORY (N-Z),415,4,0,5,93,139,241,2,243,0,O-23-107-03-06-04
LUWEERO,KATIKAMU COUNTY NORTH,LUWEERO TOWN COUNCIL,LUWERO WEST,LUWERO HIGH SCHOOL (N-Z),834,5,0,11,195,295,506,0,506,0,O-23-107-03-06-05
LUWEERO,KATIKAMU COUNTY NORTH,LUWERO,BWAZIBA,WAZIBA PARISH HQTRS,459,1,0,8,67,278,354,6,360,0,O-23-107-04-01-01
LUWEERO,KATIKAMU COUNTY NORTH,LUWERO,BWAZIBA,IBERRENGE PUBLIC SCHOOL,362,0,1,2,95,163,261,10,271,0,O-23-107-04-01-02
LUWEERO,KATIKAMU COUNTY NORTH,LUWERO,BWAZIBA,AKAKALA TRADING CENTRE,307,2,0,2,63,130,197,12,209,0,O-23-107-04-01-03
LUWEERO,KATIKAMU COUNTY NORTH,LUWERO,BWAZIBA,AKIJJU C.O.U,249,0,0,6,23,144,173,13,186,0,O-23-107-04-01-04
LUWEERO,KATIKAMU COUNTY NORTH,LUWERO,BWEYEYO,AMA PRIMARY SCHOOL,648,2,0,6,107,343,458,12,470,0,O-23-107-04-02-01
LUWEERO,KATIKAMU COUNTY NORTH,LUWERO,BWEYEYO,EETA TRADING CENTRE,580,0,1,8,65,351,425,14,439,0,O-23-107-04-02-02
LUWEERO,KATIKAMU COUNTY NORTH,LUWERO,KABAKEDDI,IBULA PRIMARY SCH,481,1,1,4,79,251,336,15,351,0,O-23-107-04-03-01
LUWEERO,KATIKAMU COUNTY NORTH,LUWERO,KABAKEDDI,ABUYE UMEA P/SCH,421,4,2,11,107,154,278,17,295,0,O-23-107-04-03-02
LUWEERO,KATIKAMU COUNTY NORTH,LUWERO,KABAKEDDI,ABAKEDI PARISH HQT,734,4,1,9,116,374,504,23,527,0,O-23-107-04-03-03
LUWEERO,KATIKAMU COUNTY NORTH,LUWERO,KAGUGGO,UNYAKA,358,7,0,9,47,205,268,8,276,0,O-23-107-04-04-01
LUWEERO,KATIKAMU COUNTY NORTH,LUWERO,KAGUGGO,AKABUSOLO,691,4,1,4,62,404,475,23,498,0,O-23-107-04-04-02
LUWEERO,KATIKAMU COUNTY NORTH,LUWERO,KAGUGGO,UKUMA,181,1,0,0,24,101,126,4,130,0,O-23-107-04-04-03
LUWEERO,KATIKAMU COUNTY NORTH,LUWERO,KASAALA,YEGOMBWA P/SCH.,498,11,1,27,75,242,356,14,370,0,O-23-107-04-05-01
LUWEERO,KATIKAMU COUNTY NORTH,LUWERO,KASAALA,YEVUNZE P/SCH.,581,3,0,8,114,290,415,6,421,0,O-23-107-04-05-02
LUWEERO,KATIKAMU COUNTY NORTH,LUWERO,KATUUGO,KATUUGO T. CENTRE,405,0,1,1,27,244,273,9,282,0,O-23-107-04-06-01
LUWEERO,KATIKAMU COUNTY NORTH,LUWERO,KATUUGO,KIWALE,549,1,1,6,35,311,354,20,374,0,O-23-107-04-06-02
LUWEERO,KATIKAMU COUNTY NORTH,LUWERO,KATUUGO,BULANZI STORE,263,1,0,1,27,167,196,9,205,0,O-23-107-04-06-03
LUWEERO,KATIKAMU COUNTY NORTH,LUWERO,KIGOMBE,MAMULI P/SCHOOL,618,7,1,5,99,292,404,24,428,0,O-23-107-04-07-01
LUWEERO,KATIKAMU COUNTY NORTH,LUWERO,KIGOMBE,KIWUMPA PRIMARY SCHOOL,324,3,0,3,44,144,194,22,216,0,O-23-107-04-07-02
LUWEERO,KATIKAMU COUNTY NORTH,LUWERO,KIGOMBE,NSOZIBIRYE T/C,333,2,1,3,37,174,217,14,231,0,O-23-107-04-07-03
LUWEERO,KATIKAMU COUNTY NORTH,LUWERO,KIKUBE,KIKUBE R.C P/SCHOOL,583,1,0,3,68,303,375,20,395,0,O-23-107-04-08-01
LUWEERO,KATIKAMU COUNTY NORTH,LUWERO,KIKUBE,KYAMPISI P/SCH,496,2,1,6,43,294,346,19,365,0,O-23-107-04-08-02
LUWEERO,KATIKAMU COUNTY NORTH,LUWERO,NAKIKOOTA,NAKIKOOTA,484,2,0,4,58,265,329,26,355,0,O-23-107-04-09-01
LUWEERO,KATIKAMU COUNTY NORTH,LUWERO,NAKIKOOTA,BUKASA PRIMARY SCHOOL,507,1,1,17,69,260,348,16,364,0,O-23-107-04-09-02
LUWEERO,KATIKAMU COUNTY NORTH,LUWERO,NAKIKOOTA,LUWEERO COMMUNITY P/S,247,0,0,3,35,126,164,15,179,0,O-23-107-04-09-03
LUWEERO,KATIKAMU COUNTY SOUTH,BOMBO TOWNSHIP,BOMBO CENTRAL,BOMBO C.O.U.,508,1,0,5,135,157,298,5,303,0,O-23-108-01-01-01
LUWEERO,KATIKAMU COUNTY SOUTH,BOMBO TOWNSHIP,BOMBO CENTRAL,BOMBO CHURCH PLAYGROUND,513,3,0,0,141,157,301,1,302,0,O-23-108-01-01-02
LUWEERO,KATIKAMU COUNTY SOUTH,BOMBO TOWNSHIP,LOMULE,BOMBO UMEA PRIMARY SCHOOL,750,3,0,1,205,100,309,6,315,0,O-23-108-01-02-01
LUWEERO,KATIKAMU COUNTY SOUTH,BOMBO TOWNSHIP,LOMULE,WABIKOMA,355,0,0,0,134,71,205,0,205,0,O-23-108-01-02-02
LUWEERO,KATIKAMU COUNTY SOUTH,BOMBO TOWNSHIP,LOMULE,GANGAMA,441,0,0,0,107,74,181,0,181,0,O-23-108-01-02-03
LUWEERO,KATIKAMU COUNTY SOUTH,BOMBO TOWNSHIP,LOMULE,BOMBO UMEA PRIMARY SCHOOL,1049,1,3,1,208,170,383,15,398,0,O-23-108-01-02-04
LUWEERO,KATIKAMU COUNTY SOUTH,BOMBO TOWNSHIP,LOMULE,BOMBO S.S.S,663,2,2,1,163,108,276,6,282,0,O-23-108-01-02-05
LUWEERO,KATIKAMU COUNTY SOUTH,BOMBO TOWNSHIP,LOMULE,BOMBO HIGH SCH.,498,3,2,3,179,92,279,0,279,0,O-23-108-01-02-06
LUWEERO,KATIKAMU COUNTY SOUTH,BOMBO TOWNSHIP,MPAKAWERO,LATE MARJAN'S HOME,432,0,0,3,124,127,254,8,262,0,O-23-108-01-03-01
LUWEERO,KATIKAMU COUNTY SOUTH,BOMBO TOWNSHIP,MPAKAWERO,BOMBO DISPENSARY GROUND A (,929,1,1,1,155,264,422,5,427,0,O-23-108-01-03-02
LUWEERO,KATIKAMU COUNTY SOUTH,BOMBO TOWNSHIP,MPAKAWERO,BOMBO DISPENSARY GROUND B (,793,0,1,5,88,299,393,7,400,0,O-23-108-01-03-03
LUWEERO,KATIKAMU COUNTY SOUTH,BOMBO TOWNSHIP,MPAKAWERO,BOMBO DISPENSARY GROUND C (,678,0,0,2,70,262,334,2,336,0,O-23-108-01-03-04
LUWEERO,KATIKAMU COUNTY SOUTH,BOMBO TOWNSHIP,MPAKAWERO,BOMBO DISPENSARY GROUND D (,726,1,0,0,106,206,313,2,315,0,O-23-108-01-03-05
LUWEERO,KATIKAMU COUNTY SOUTH,BOMBO TOWNSHIP,MPAKAWERO,BOMBO DISPENSARY GROUND E (,810,1,2,1,100,272,376,1,377,0,O-23-108-01-03-06
LUWEERO,KATIKAMU COUNTY SOUTH,BOMBO TOWNSHIP,MPAKAWERO,BOMBO DISPENSARY GROUND F (,753,1,2,0,174,166,343,2,345,0,O-23-108-01-03-07
LUWEERO,KATIKAMU COUNTY SOUTH,BOMBO TOWNSHIP,MPAKAWERO,BOMBO DISPENSARY GROUND G(,699,1,0,1,84,243,329,3,332,0,O-23-108-01-03-08
LUWEERO,KATIKAMU COUNTY SOUTH,BOMBO TOWNSHIP,NAMALIGA,BOMBO MIXED SCHOOL A,465,2,0,3,104,168,277,5,282,0,O-23-108-01-04-01
LUWEERO,KATIKAMU COUNTY SOUTH,BOMBO TOWNSHIP,NAMALIGA,BOMBO MIXED SCHOOL B,555,2,1,8,121,195,327,8,335,0,O-23-108-01-04-02
LUWEERO,KATIKAMU COUNTY SOUTH,BOMBO TOWNSHIP,NAMALIGA,BOMBO ORATORY SCH.,363,0,0,4,78,134,216,2,218,0,O-23-108-01-04-03
LUWEERO,KATIKAMU COUNTY SOUTH,BOMBO TOWNSHIP,NKOKONJERU,NKOKONJERU MUSLIM PRI. SCHO,398,0,0,1,119,148,268,2,270,0,O-23-108-01-05-01
LUWEERO,KATIKAMU COUNTY SOUTH,BOMBO TOWNSHIP,NKOKONJERU,KABULANAKA,407,4,1,4,138,118,265,7,272,0,O-23-108-01-05-02
LUWEERO,KATIKAMU COUNTY SOUTH,KATIKAMU,BUKEEKA,BUKEEKA LATE KALULE SPEAKER,665,6,0,15,148,265,434,13,447,0,O-23-108-02-01-01
LUWEERO,KATIKAMU COUNTY SOUTH,KATIKAMU,BUKEEKA,NKONGE TRADING CENTRE,526,6,0,11,150,200,367,13,380,0,O-23-108-02-01-02
LUWEERO,KATIKAMU COUNTY SOUTH,KATIKAMU,KIKOMA,GOMBE,420,0,2,7,121,171,301,14,315,0,O-23-108-02-02-01
LUWEERO,KATIKAMU COUNTY SOUTH,KATIKAMU,KIKOMA,BUKALASA KATWE,474,0,1,17,83,252,353,12,365,0,O-23-108-02-02-02
LUWEERO,KATIKAMU COUNTY SOUTH,KATIKAMU,KIKOMA,KIYAMBIDDE PRI. SCHOOL,418,3,0,10,90,190,293,6,299,0,O-23-108-02-02-03
LUWEERO,KATIKAMU COUNTY SOUTH,KATIKAMU,MUSAALE(BUSULA),SEMPA PR. SCHOOL,490,1,1,5,89,248,344,9,353,0,O-23-108-02-03-01
LUWEERO,KATIKAMU COUNTY SOUTH,KATIKAMU,MUSAALE(BUSULA),NSAWO PRI. SCHOOL,419,4,0,8,119,144,275,11,286,0,O-23-108-02-03-02
LUWEERO,KATIKAMU COUNTY SOUTH,KATIKAMU,MUSAALE(BUSULA),BUSULA HEALTH CENTRE,639,2,1,7,136,196,342,22,364,0,O-23-108-02-03-03
LUWEERO,KATIKAMU COUNTY SOUTH,KATIKAMU,MUSAALE(BUSULA),KASWA PARISH HEADQUARTERS,629,5,0,9,159,233,406,7,413,0,O-23-108-02-03-04
LUWEERO,KATIKAMU COUNTY SOUTH,KATIKAMU,MUSAALE(BUSULA),BUSULA PENTECOSTAL CHURCH,146,1,0,7,52,84,144,0,144,0,O-23-108-02-03-05
LUWEERO,KATIKAMU COUNTY SOUTH,KATIKAMU,TWEYANZE,TWEYANZE PRI. SCHOOL,567,3,1,13,133,249,399,5,404,0,O-23-108-02-04-01
LUWEERO,KATIKAMU COUNTY SOUTH,KATIKAMU,TWEYANZE,LUKYAMU,627,2,2,32,146,268,450,13,463,0,O-23-108-02-04-02
LUWEERO,KATIKAMU COUNTY SOUTH,KATIKAMU,TWEYANZE,MONDE R.C. SCHOOL,130,1,3,10,38,53,105,3,108,0,O-23-108-02-04-03
LUWEERO,KATIKAMU COUNTY SOUTH,MAKULUBITA,KAGOGO,KAGOGO PRI. SCHOOL,622,1,0,9,131,214,355,24,379,0,O-23-108-03-01-01
LUWEERO,KATIKAMU COUNTY SOUTH,MAKULUBITA,KAGOGO,BOWA TECHNICAL SCHOOL,356,2,0,10,45,103,160,6,166,0,O-23-108-03-01-02
LUWEERO,KATIKAMU COUNTY SOUTH,MAKULUBITA,KALASA,KALASA COMMUNITY CENTRE,585,2,1,18,73,230,324,4,328,0,O-23-108-03-02-01
LUWEERO,KATIKAMU COUNTY SOUTH,MAKULUBITA,KALASA,KALASA S.S.S.,441,3,0,16,54,206,279,8,287,0,O-23-108-03-02-02
LUWEERO,KATIKAMU COUNTY SOUTH,MAKULUBITA,KANGAYE,KIWANGULA CO-OPERATIVE STO,380,4,2,16,62,174,258,0,258,0,O-23-108-03-03-01
LUWEERO,KATIKAMU COUNTY SOUTH,MAKULUBITA,KANGAYE,KIKUNYA TRADING CENTRE,387,1,0,6,55,208,270,5,275,0,O-23-108-03-03-02
LUWEERO,KATIKAMU COUNTY SOUTH,MAKULUBITA,KANYANDA,KANYANDA PR. SCHOOL,490,0,1,12,106,197,316,5,321,0,O-23-108-03-04-01
LUWEERO,KATIKAMU COUNTY SOUTH,MAKULUBITA,KANYANDA,BULAMBA P/SCH.,574,2,0,8,86,205,301,52,353,0,O-23-108-03-04-02
LUWEERO,KATIKAMU COUNTY SOUTH,MAKULUBITA,KASOZI,KISAZI PRI. SCHOOL,320,0,0,10,38,125,173,37,210,0,O-23-108-03-05-01
LUWEERO,KATIKAMU COUNTY SOUTH,MAKULUBITA,KASOZI,KASOZI PARISH HQTRS,502,1,2,5,60,226,294,32,326,0,O-23-108-03-05-02
LUWEERO,KATIKAMU COUNTY SOUTH,MAKULUBITA,MAKULUBITA,NAKIGONGE PRI. SCHOOL,758,2,0,22,73,354,451,75,526,0,O-23-108-03-06-01
LUWEERO,KATIKAMU COUNTY SOUTH,MAKULUBITA,MAKULUBITA,MAKULUBITA PLAYGROUND,450,2,0,8,58,198,266,45,311,0,O-23-108-03-06-02
LUWEERO,KATIKAMU COUNTY SOUTH,MAKULUBITA,MAWALE,KAGEMBE PR. SCHOOL A,484,1,1,7,80,317,406,20,426,0,O-23-108-03-07-01
LUWEERO,KATIKAMU COUNTY SOUTH,MAKULUBITA,MAWALE,KAGEMBE PRI. SCHOOL B,653,0,0,11,53,198,262,57,319,0,O-23-108-03-07-02
LUWEERO,KATIKAMU COUNTY SOUTH,MAKULUBITA,NSANVU,NAMAYAMBA Pr. SCHOOL,417,0,0,8,83,188,279,6,285,0,O-23-108-03-08-01
LUWEERO,KATIKAMU COUNTY SOUTH,MAKULUBITA,NSANVU,KASIZI PR. SCHOOL,436,2,0,23,75,224,324,7,331,0,O-23-108-03-08-02
LUWEERO,KATIKAMU COUNTY SOUTH,MAKULUBITA,WALULEETA,WALULEETA HEALTH CENTRE,550,6,1,22,122,219,370,3,373,0,O-23-108-03-09-01
LUWEERO,KATIKAMU COUNTY SOUTH,MAKULUBITA,WALULEETA,BOWA PRI. SCHOOL,348,0,1,11,54,139,205,9,214,0,O-23-108-03-09-02
LUWEERO,KATIKAMU COUNTY SOUTH,MAKULUBITA,WALULEETA,KAWAGALO,262,1,0,30,36,100,167,4,171,0,O-23-108-03-09-03
LUWEERO,KATIKAMU COUNTY SOUTH,NYIMBWA,BAJJO,BAJJO KISINGIRI A,306,3,0,9,92,94,198,7,205,0,O-23-108-04-01-01
LUWEERO,KATIKAMU COUNTY SOUTH,NYIMBWA,BAJJO,BAJJO KISINGIRI B,409,6,0,8,139,122,275,2,277,0,O-23-108-04-01-02
LUWEERO,KATIKAMU COUNTY SOUTH,NYIMBWA,BAJJO,BAJJO KISINGIRI C,619,1,1,3,178,217,400,9,409,0,O-23-108-04-01-03
LUWEERO,KATIKAMU COUNTY SOUTH,NYIMBWA,BAJJO,BAJJO KISINGIRI D,459,2,1,3,188,103,297,11,308,0,O-23-108-04-01-04
LUWEERO,KATIKAMU COUNTY SOUTH,NYIMBWA,BUVUMA,KIBAMBURA,395,1,1,7,122,121,252,13,265,0,O-23-108-04-02-01
LUWEERO,KATIKAMU COUNTY SOUTH,NYIMBWA,BUVUMA,BUFUMBANSWA,444,4,0,10,61,203,278,14,292,0,O-23-108-04-02-02
LUWEERO,KATIKAMU COUNTY SOUTH,NYIMBWA,BUVUMA,NKONDO P/S,288,4,1,6,42,124,177,10,187,0,O-23-108-04-02-03
LUWEERO,KATIKAMU COUNTY SOUTH,NYIMBWA,KALULE,KALULE UMEA PRI. SCHOOL,724,7,4,44,176,236,467,16,483,0,O-23-108-04-03-01
LUWEERO,KATIKAMU COUNTY SOUTH,NYIMBWA,KALULE,KWESE,409,5,1,15,96,164,281,4,285,0,O-23-108-04-03-02
LUWEERO,KATIKAMU COUNTY SOUTH,NYIMBWA,KALULE,SINALYA,248,0,0,38,47,83,168,4,172,0,O-23-108-04-03-03
LUWEERO,KATIKAMU COUNTY SOUTH,NYIMBWA,KIYANDA,BBALE PRI. SCHOOL,618,0,0,16,106,201,323,63,386,0,O-23-108-04-04-01
LUWEERO,KATIKAMU COUNTY SOUTH,NYIMBWA,KIYANDA,NANDERE GIRLS PR. SCHOOL,625,1,1,6,84,286,378,16,394,0,O-23-108-04-04-02
LUWEERO,KATIKAMU COUNTY SOUTH,NYIMBWA,KIYANDA,NANDERE BOYS,588,1,1,13,86,238,339,18,357,0,O-23-108-04-04-03
LUWEERO,KATIKAMU COUNTY SOUTH,NYIMBWA,NAKATONYA,NYIMBWA SUB-COUNTY HQTRS,670,5,2,2,208,175,392,12,404,0,O-23-108-04-05-01
LUWEERO,KATIKAMU COUNTY SOUTH,NYIMBWA,NAKATONYA,BEMBE HILL PRI. SCHOOL,522,2,2,3,174,179,360,4,364,0,O-23-108-04-05-02
LUWEERO,KATIKAMU COUNTY SOUTH,NYIMBWA,NAKATONYA,NYIMBWA PRI. SCHOOL,275,0,1,7,29,142,179,5,184,0,O-23-108-04-05-03
LUWEERO,KATIKAMU COUNTY SOUTH,NYIMBWA,NAKATONYA,NAKATONYA MOSQUE,530,4,0,0,198,97,299,65,364,0,O-23-108-04-05-04
LUWEERO,KATIKAMU COUNTY SOUTH,NYIMBWA,SSAMBWE,SAMBWE PLAYGROUND,508,2,0,16,107,219,344,18,362,0,O-23-108-04-06-01
LUWEERO,KATIKAMU COUNTY SOUTH,NYIMBWA,SSAMBWE,KAKUTE PLAYGROUND,625,4,0,12,104,281,401,13,414,0,O-23-108-04-06-02
LUWEERO,KATIKAMU COUNTY SOUTH,NYIMBWA,SSAMBWE,NDEJJE JUNIOR SCHOOL,870,19,3,28,192,309,551,0,551,0,O-23-108-04-06-03
LUWEERO,KATIKAMU COUNTY SOUTH,NYIMBWA,SSAMBWE,BUYEGO NURSERY SCHOOL,520,5,1,3,132,218,359,5,364,0,O-23-108-04-06-04
LUWEERO,KATIKAMU COUNTY SOUTH,NYIMBWA,SSAMBWE,NSANGI PRIMARY SCHOOL,368,2,1,11,73,162,249,8,257,0,O-23-108-04-06-05
LUWEERO,KATIKAMU COUNTY SOUTH,WOBULENZI T.C.,BUKALASA,BUKALASA COLLEGE,273,1,2,4,57,144,208,4,212,0,O-23-108-05-01-01
LUWEERO,KATIKAMU COUNTY SOUTH,WOBULENZI T.C.,KATIKAMU,KATIKAMU NURSERY SCHOOL,482,0,0,12,123,173,308,3,311,0,O-23-108-05-02-01
LUWEERO,KATIKAMU COUNTY SOUTH,WOBULENZI T.C.,KATIKAMU,LUTAMU TRADING CENTRE,456,2,0,4,113,146,265,6,271,0,O-23-108-05-02-02
LUWEERO,KATIKAMU COUNTY SOUTH,WOBULENZI T.C.,KATIKAMU,LUYIMA TRADING CENTRE,490,1,1,13,99,95,209,2,211,0,O-23-108-05-02-03
LUWEERO,KATIKAMU COUNTY SOUTH,WOBULENZI T.C.,KATIKAMU,BUKOLWA C.O.U. P/SCHOOL,466,0,0,16,96,229,341,12,353,0,O-23-108-05-02-04
LUWEERO,KATIKAMU COUNTY SOUTH,WOBULENZI T.C.,WOBULENZI CENTRA,LUZZI A,627,3,0,8,184,140,335,51,386,0,O-23-108-05-03-01
LUWEERO,KATIKAMU COUNTY SOUTH,WOBULENZI T.C.,WOBULENZI CENTRA,LUZZI B,452,0,0,8,161,99,268,8,276,0,O-23-108-05-03-02
LUWEERO,KATIKAMU COUNTY SOUTH,WOBULENZI T.C.,WOBULENZI CENTRA,LUZZI C,421,2,0,7,136,105,250,8,258,0,O-23-108-05-03-03
LUWEERO,KATIKAMU COUNTY SOUTH,WOBULENZI T.C.,WOBULENZI CENTRA,KIKOMA,581,5,0,13,155,211,384,7,391,0,O-23-108-05-03-04
LUWEERO,KATIKAMU COUNTY SOUTH,WOBULENZI T.C.,WOBULENZI CENTRA,KIKASA,265,1,0,10,62,107,180,1,181,0,O-23-108-05-03-05
LUWEERO,KATIKAMU COUNTY SOUTH,WOBULENZI T.C.,WOBULENZI EAST,WOBULENZI PLAY GROUND A(A-M,699,4,0,12,216,183,415,8,423,0,O-23-108-05-04-01
LUWEERO,KATIKAMU COUNTY SOUTH,WOBULENZI T.C.,WOBULENZI EAST,WOBULENZI PLAY GROUND B(N-Z,706,0,3,12,184,217,416,7,423,0,O-23-108-05-04-02
LUWEERO,KATIKAMU COUNTY SOUTH,WOBULENZI T.C.,WOBULENZI EAST,KIGULU,380,6,3,6,75,102,192,24,216,0,O-23-108-05-04-03
LUWEERO,KATIKAMU COUNTY SOUTH,WOBULENZI T.C.,WOBULENZI EAST,EBENEZER CHURCH,243,0,0,7,66,73,146,3,149,0,O-23-108-05-04-04
LUWEERO,KATIKAMU COUNTY SOUTH,WOBULENZI T.C.,WOBULENZI EAST,NAKASERO A(A-M),514,0,1,6,178,99,284,22,306,0,O-23-108-05-04-05
LUWEERO,KATIKAMU COUNTY SOUTH,WOBULENZI T.C.,WOBULENZI EAST,NAKASERO B(N),523,1,0,4,98,174,277,12,289,0,O-23-108-05-04-06
LUWEERO,KATIKAMU COUNTY SOUTH,WOBULENZI T.C.,WOBULENZI EAST,NAKASERO B(O-Z),211,1,0,1,84,36,122,9,131,0,O-23-108-05-04-07
LUWEERO,KATIKAMU COUNTY SOUTH,WOBULENZI T.C.,WOBULENZI WEST,SIKANUSU,583,2,17,3,169,88,279,34,313,0,O-23-108-05-05-01
LUWEERO,KATIKAMU COUNTY SOUTH,WOBULENZI T.C.,WOBULENZI WEST,WOBULENZI TAXI PARK,244,0,0,10,64,75,149,1,150,0,O-23-108-05-05-02
LUWEERO,KATIKAMU COUNTY SOUTH,WOBULENZI T.C.,WOBULENZI WEST,NAKADINGIDI WATER KIOSK A(A-,447,1,0,10,158,112,281,0,281,0,O-23-108-05-05-03
LUWEERO,KATIKAMU COUNTY SOUTH,WOBULENZI T.C.,WOBULENZI WEST,FAITH XTIAN CENTRE A( ),241,2,0,2,84,54,142,0,142,0,O-23-108-05-05-04
LUWEERO,KATIKAMU COUNTY SOUTH,WOBULENZI T.C.,WOBULENZI WEST,FAITH XTIAN CENTRE B( ),448,1,0,6,92,129,228,5,233,0,O-23-108-05-05-05
LUWEERO,KATIKAMU COUNTY SOUTH,WOBULENZI T.C.,WOBULENZI WEST,NAKADINGIDI WATER KIOSK B(N-Z,721,3,0,8,164,227,402,13,415,0,O-23-108-05-05-06
MASAKA,BUKOTO CENTRAL,KABONERA,BISANJE,KASAALI,448,0,0,28,164,134,326,0,326,0,O-24-116-01-01-01
MASAKA,BUKOTO CENTRAL,KABONERA,BISANJE,BUTAAYA,618,2,0,18,192,165,377,101,478,0,O-24-116-01-01-02
MASAKA,BUKOTO CENTRAL,KABONERA,BISANJE,BISANJE WEST,732,5,1,45,279,188,518,21,539,0,O-24-116-01-01-03
MASAKA,BUKOTO CENTRAL,KABONERA,BISANJE,BISANJE EAST,483,2,0,32,203,48,285,22,307,0,O-24-116-01-01-04
MASAKA,BUKOTO CENTRAL,KABONERA,BUTALE,BUTALE,515,6,0,4,155,156,321,83,404,0,O-24-116-01-02-01
MASAKA,BUKOTO CENTRAL,KABONERA,BUTALE,KIKUNGWE,789,3,0,8,227,263,501,89,590,0,O-24-116-01-02-02
MASAKA,BUKOTO CENTRAL,KABONERA,BUTALE,TAKAJJUNGE,299,2,0,2,114,97,215,21,236,0,O-24-116-01-02-03
MASAKA,BUKOTO CENTRAL,KABONERA,KAKUNYU,KAKUNYU,628,2,0,4,132,258,396,107,503,0,O-24-116-01-03-01
MASAKA,BUKOTO CENTRAL,KABONERA,KAKUNYU,BUKOTO,749,2,0,10,186,254,452,95,547,0,O-24-116-01-03-02
MASAKA,BUKOTO CENTRAL,KABONERA,KAKUNYU,KYANKASE,273,1,0,0,98,141,240,1,241,0,O-24-116-01-03-03
MASAKA,BUKOTO CENTRAL,KABONERA,KIRIMYA,KIRIMYA A,738,0,0,10,300,157,467,22,489,0,O-24-116-01-04-01
MASAKA,BUKOTO CENTRAL,KABONERA,KIRIMYA,KIRIMYA VILLAGE,702,0,0,13,215,112,340,73,413,0,O-24-116-01-04-02
MASAKA,BUKOTO CENTRAL,KABONERA,KIRIMYA,GAYAZA,630,0,1,26,206,137,370,102,472,0,O-24-116-01-04-03
MASAKA,BUKOTO CENTRAL,KABONERA,KITANGA,KASAMBYA,440,0,0,18,131,99,248,90,338,0,O-24-116-01-05-01
MASAKA,BUKOTO CENTRAL,KABONERA,KITANGA,KASEETA,253,1,0,10,78,68,157,34,191,0,O-24-116-01-05-02
MASAKA,BUKOTO CENTRAL,KABONERA,KITANGA,KITANGA,579,1,0,19,160,204,384,70,454,0,O-24-116-01-05-03
MASAKA,BUKOTO CENTRAL,KABONERA,KIZIBA,KABONERA TRADING CENTRE,838,3,1,20,257,226,507,126,633,0,O-24-116-01-06-01
MASAKA,BUKOTO CENTRAL,KABONERA,KIZIBA,KASANJE,506,1,0,20,105,211,337,59,396,0,O-24-116-01-06-02
MASAKA,BUKOTO CENTRAL,KABONERA,KYAMUYIMBWA,KYANJALE,678,2,0,11,277,150,440,90,530,0,O-24-116-01-07-01
MASAKA,BUKOTO CENTRAL,KABONERA,KYAMUYIMBWA,KAGEZI,678,2,1,27,227,165,422,99,521,0,O-24-116-01-07-02
MASAKA,BUKOTO CENTRAL,KABONERA,KYAMUYIMBWA,BUSENSE,293,2,0,1,75,94,172,27,199,0,O-24-116-01-07-03
MASAKA,BUKOTO CENTRAL,KYANAMUKAKA,BBULIRO,GAYAZA,309,1,1,4,86,161,253,11,264,0,O-24-116-02-01-01
MASAKA,BUKOTO CENTRAL,KYANAMUKAKA,BBULIRO,KATIKAMU,358,0,3,4,65,194,266,15,281,0,O-24-116-02-01-02
MASAKA,BUKOTO CENTRAL,KYANAMUKAKA,BBULIRO,BBULIRO P/S,426,1,2,2,104,161,270,73,343,0,O-24-116-02-01-03
MASAKA,BUKOTO CENTRAL,KYANAMUKAKA,BBULIRO,DDIMO A,401,1,0,9,80,136,226,0,226,0,O-24-116-02-01-04
MASAKA,BUKOTO CENTRAL,KYANAMUKAKA,BBULIRO,DDIMO B,412,1,0,3,59,141,204,6,210,0,O-24-116-02-01-05
MASAKA,BUKOTO CENTRAL,KYANAMUKAKA,BUGERE,MWERUKA,421,3,0,12,100,223,338,10,348,0,O-24-116-02-02-01
MASAKA,BUKOTO CENTRAL,KYANAMUKAKA,BUGERE,NDEEBA TRADING CENTRE,470,1,1,9,175,155,341,8,349,0,O-24-116-02-02-02
MASAKA,BUKOTO CENTRAL,KYANAMUKAKA,BUGERE,BUGERE P.S,368,2,1,18,109,155,285,10,295,0,O-24-116-02-02-03
MASAKA,BUKOTO CENTRAL,KYANAMUKAKA,BUGERE,KAMULEGU P/S,541,4,0,20,203,212,439,14,453,0,O-24-116-02-02-04
MASAKA,BUKOTO CENTRAL,KYANAMUKAKA,BUYAGA,KIWUMPA,656,0,1,13,154,352,520,10,530,0,O-24-116-02-03-01
MASAKA,BUKOTO CENTRAL,KYANAMUKAKA,BUYAGA,MIREMBE,491,1,0,11,97,229,338,26,364,0,O-24-116-02-03-02
MASAKA,BUKOTO CENTRAL,KYANAMUKAKA,BUYAGA,NKUUNA,258,3,0,8,50,147,208,6,214,0,O-24-116-02-03-03
MASAKA,BUKOTO CENTRAL,KYANAMUKAKA,BUYAGA,LUWEREKERA,374,0,0,18,82,198,298,17,315,0,O-24-116-02-03-04
MASAKA,BUKOTO CENTRAL,KYANAMUKAKA,BUYINJA,SEMUTO,383,2,0,7,113,183,305,17,322,0,O-24-116-02-04-01
MASAKA,BUKOTO CENTRAL,KYANAMUKAKA,BUYINJA,MIKOMAGO,653,1,0,15,165,308,489,64,553,0,O-24-116-02-04-02
MASAKA,BUKOTO CENTRAL,KYANAMUKAKA,BUYINJA,BUYINJA,485,0,0,14,132,237,383,11,394,0,O-24-116-02-04-03
MASAKA,BUKOTO CENTRAL,KYANAMUKAKA,KAMUZINDA,KAMUZINDA,709,2,1,38,126,364,531,33,564,0,O-24-116-02-05-01
MASAKA,BUKOTO CENTRAL,KYANAMUKAKA,KAMUZINDA,KANONI,467,3,0,29,141,194,367,7,374,0,O-24-116-02-05-02
MASAKA,BUKOTO CENTRAL,KYANAMUKAKA,KAMUZINDA,KIKUUMA/BUKUNDA,849,2,0,36,359,239,636,23,659,0,O-24-116-02-05-03
MASAKA,BUKOTO CENTRAL,KYANAMUKAKA,KITUNGA,KITUNGA P/S,744,5,1,6,103,406,521,23,544,0,O-24-116-02-06-01
MASAKA,BUKOTO CENTRAL,KYANAMUKAKA,KITUNGA,KYAMUZIMBA PLAY GROUND,558,3,3,4,88,279,377,15,392,0,O-24-116-02-06-02
MASAKA,BUKOTO CENTRAL,KYANAMUKAKA,KYANTALE,KYANTALE,516,1,0,37,154,227,419,6,425,0,O-24-116-02-07-01
MASAKA,BUKOTO CENTRAL,KYANAMUKAKA,KYANTALE,BUWUNDE,427,0,0,14,60,256,330,4,334,0,O-24-116-02-07-02
MASAKA,BUKOTO CENTRAL,KYANAMUKAKA,KYANTALE,KKINDU,496,1,1,21,80,280,383,4,387,0,O-24-116-02-07-03
MASAKA,BUKOTO CENTRAL,KYANAMUKAKA,KYANTALE,KYANAMUKAAKA,565,1,0,12,112,291,416,12,428,0,O-24-116-02-07-04
MASAKA,BUKOTO CENTRAL,KYANAMUKAKA,KYANTALE,KYAMBAZZI,451,2,0,6,96,274,378,8,386,0,O-24-116-02-07-05
MASAKA,BUKOTO CENTRAL,KYANAMUKAKA,KYESIIGA,KYESIIGA/NATEETE,258,3,1,4,155,29,192,4,196,0,O-24-116-02-08-01
MASAKA,BUKOTO CENTRAL,KYANAMUKAKA,KYESIIGA,KABANDA,594,3,1,4,155,292,455,4,459,0,O-24-116-02-08-02
MASAKA,BUKOTO CENTRAL,KYANAMUKAKA,KYESIIGA,MAGIRI,395,0,0,8,123,206,337,3,340,0,O-24-116-02-08-03
MASAKA,BUKOTO CENTRAL,KYANAMUKAKA,KYESIIGA,KATWE,360,0,1,14,101,165,281,15,296,0,O-24-116-02-08-04
MASAKA,BUKOTO CENTRAL,KYANAMUKAKA,KYESIIGA,LWEMODDE,383,3,0,1,51,204,259,43,302,0,O-24-116-02-08-05
MASAKA,BUKOTO CENTRAL,KYANAMUKAKA,ZZIMWE,MINYINYA,527,0,0,8,152,291,451,11,462,0,O-24-116-02-09-01
MASAKA,BUKOTO CENTRAL,KYANAMUKAKA,ZZIMWE,LUKINDU,595,2,2,6,146,303,459,5,464,0,O-24-116-02-09-02
MASAKA,BUKOTO CENTRAL,KYANAMUKAKA,ZZIMWE,KATINYONDO,600,0,1,7,118,320,446,13,459,0,O-24-116-02-09-03
MASAKA,BUKOTO EAST,BUKAKATA,BUKIBONGA,LAMBU (A - M),730,2,1,6,208,193,410,10,420,0,O-24-114-01-01-01
MASAKA,BUKOTO EAST,BUKAKATA,BUKIBONGA,BUKAKATA,385,2,0,14,91,186,293,8,301,0,O-24-114-01-01-02
MASAKA,BUKOTO EAST,BUKAKATA,BUKIBONGA,SUNLIGHT PRIMARY SCHOOL,300,4,1,5,51,139,200,9,209,0,O-24-114-01-01-03
MASAKA,BUKOTO EAST,BUKAKATA,BUKIBONGA,KAZIRU PRIMARY SCHOOL,521,3,0,13,93,192,301,9,310,0,O-24-114-01-01-04
MASAKA,BUKOTO EAST,BUKAKATA,BUKIBONGA,KABASESE,591,2,0,7,110,190,309,0,309,0,O-24-114-01-01-05
MASAKA,BUKOTO EAST,BUKAKATA,BUKIBONGA,LAMBU (N - Z),830,1,0,4,183,266,454,12,466,0,O-24-114-01-01-06
MASAKA,BUKOTO EAST,BUKAKATA,MAKONZI,BWAMI,266,0,0,4,31,121,156,7,163,0,O-24-114-01-02-01
MASAKA,BUKOTO EAST,BUKAKATA,MAKONZI,KISUKU,622,5,1,9,117,168,300,11,311,0,O-24-114-01-02-02
MASAKA,BUKOTO EAST,BUKAKATA,MAKONZI,NSAMBYA OLD P.SCHOOL,198,1,0,3,43,62,109,1,110,0,O-24-114-01-02-03
MASAKA,BUKOTO EAST,BUKAKATA,SSUNGA,KASANJE,521,1,0,2,109,261,373,11,384,0,O-24-114-01-03-01
MASAKA,BUKOTO EAST,BUKAKATA,SSUNGA,KISAAKA,429,5,0,14,104,174,297,14,311,0,O-24-114-01-03-02
MASAKA,BUKOTO EAST,BUKAKATA,SSUNGA,BUKAAYI,352,5,0,7,65,182,259,17,276,0,O-24-114-01-03-03
MASAKA,BUKOTO EAST,BUKAKATA,SSUNGA,KIGO,273,2,1,5,42,148,198,4,202,0,O-24-114-01-03-04
MASAKA,BUKOTO EAST,BUWUNGA,BULANDO,KAYIJJA,644,1,0,27,179,296,503,5,508,0,O-24-114-02-01-01
MASAKA,BUKOTO EAST,BUWUNGA,BULANDO,BULANDO,348,2,0,19,121,129,271,14,285,0,O-24-114-02-01-02
MASAKA,BUKOTO EAST,BUWUNGA,BULANDO,SSERINYA P.SCHOOL,290,1,0,12,64,158,235,3,238,0,O-24-114-02-01-03
MASAKA,BUKOTO EAST,BUWUNGA,BUWUNGA,BUWUNGA,469,3,1,7,175,182,368,6,374,0,O-24-114-02-02-01
MASAKA,BUKOTO EAST,BUWUNGA,BUWUNGA,KITWE,514,4,1,11,208,173,397,9,406,0,O-24-114-02-02-02
MASAKA,BUKOTO EAST,BUWUNGA,BUWUNGA,KYASUNSU DOGERO,312,2,0,5,79,131,217,4,221,0,O-24-114-02-02-03
MASAKA,BUKOTO EAST,BUWUNGA,GGULUMA,BUKINDA,246,0,1,4,81,105,191,4,195,0,O-24-114-02-03-01
MASAKA,BUKOTO EAST,BUWUNGA,GGULUMA,KIGANGAZZI,512,0,0,9,161,157,327,80,407,0,O-24-114-02-03-02
MASAKA,BUKOTO EAST,BUWUNGA,GGULUMA,NAKASOJJO,234,0,0,2,66,145,213,2,215,0,O-24-114-02-03-03
MASAKA,BUKOTO EAST,BUWUNGA,GGULUMA,JANGANO,201,2,0,8,66,90,166,5,171,0,O-24-114-02-03-04
MASAKA,BUKOTO EAST,BUWUNGA,KAMWOZI,KYANJOVU,523,2,0,11,138,167,318,97,415,0,O-24-114-02-04-01
MASAKA,BUKOTO EAST,BUWUNGA,KAMWOZI,KYEERA,431,0,0,24,169,131,324,19,343,0,O-24-114-02-04-02
MASAKA,BUKOTO EAST,BUWUNGA,KAMWOZI,KALUGONDO,308,0,0,6,100,106,212,10,222,0,O-24-114-02-04-03
MASAKA,BUKOTO EAST,BUWUNGA,KAMWOZI,KAMWOZI,302,2,2,3,69,81,157,61,218,0,O-24-114-02-04-04
MASAKA,BUKOTO EAST,BUWUNGA,KAMWOZI,KIJONJO,282,1,0,12,75,125,213,12,225,0,O-24-114-02-04-05
MASAKA,BUKOTO EAST,BUWUNGA,KAMWOZI,BUTEBERE,178,0,0,13,49,49,111,27,138,0,O-24-114-02-04-06
MASAKA,BUKOTO EAST,BUWUNGA,KANYWA,KANYWA,572,0,3,11,183,258,455,4,459,0,O-24-114-02-05-01
MASAKA,BUKOTO EAST,BUWUNGA,KANYWA,NAKIYAGA,484,0,1,23,214,139,377,8,385,0,O-24-114-02-05-02
MASAKA,BUKOTO EAST,BUWUNGA,KANYWA,KITOMA,351,0,0,9,89,71,169,96,265,0,O-24-114-02-05-03
MASAKA,BUKOTO EAST,BUWUNGA,KANYWA,NKUKE,493,2,0,8,106,316,432,6,438,0,O-24-114-02-05-04
MASAKA,BUKOTO EAST,BUWUNGA,KANYWA,TEKERA,436,0,0,21,102,140,263,92,355,0,O-24-114-02-05-05
MASAKA,BUKOTO EAST,BUWUNGA,KASAKA,KASAKA,470,1,0,50,88,211,350,22,372,0,O-24-114-02-06-01
MASAKA,BUKOTO EAST,BUWUNGA,KASAKA,BIRONGO-NYONDO,308,0,0,4,41,180,225,9,234,0,O-24-114-02-06-02
MASAKA,BUKOTO EAST,BUWUNGA,KASAKA,KAJUNA-BULENGO,603,2,0,5,191,265,463,9,472,0,O-24-114-02-06-03
MASAKA,BUKOTO EAST,BUWUNGA,KASAKA,KALODDO,188,1,0,7,49,77,134,13,147,0,O-24-114-02-06-04
MASAKA,BUKOTO EAST,BUWUNGA,KITENGESA,KIDDA,363,0,0,6,136,94,236,33,269,0,O-24-114-02-07-01
MASAKA,BUKOTO EAST,BUWUNGA,KITENGESA,KITENGEESA,654,3,0,17,211,138,369,107,476,0,O-24-114-02-07-02
MASAKA,BUKOTO EAST,BUWUNGA,KITENGESA,KITEZA/MIKONI RC I,294,0,0,19,88,109,216,15,231,0,O-24-114-02-07-03
MASAKA,BUKOTO EAST,BUWUNGA,KITENGESA,KYASSUMA/LWANYI,386,2,1,16,139,122,280,6,286,0,O-24-114-02-07-04
MASAKA,BUKOTO EAST,BUWUNGA,KITENGESA,MIZINGA,541,1,0,34,203,127,365,20,385,0,O-24-114-02-07-05
MASAKA,BUKOTO EAST,BUWUNGA,MAZINGA,BUTENZI,452,1,0,16,188,154,359,7,366,0,O-24-114-02-08-01
MASAKA,BUKOTO EAST,BUWUNGA,MAZINGA,MISANSALA,507,2,1,6,176,171,356,15,371,0,O-24-114-02-08-02
MASAKA,BUKOTO EAST,BUWUNGA,MAZINGA,MAZINGA,303,2,0,11,106,128,247,4,251,0,O-24-114-02-08-03
MASAKA,BUKOTO EAST,BUWUNGA,MAZINGA,BUTALE,447,2,2,12,72,219,307,11,318,0,O-24-114-02-08-04
MASAKA,BUKOTO EAST,MUKUNGWE,BUGABIRA,NDEGEYA A,397,0,0,16,118,141,275,13,288,0,O-24-114-03-01-01
MASAKA,BUKOTO EAST,MUKUNGWE,BUGABIRA,LWABUSIISI,441,1,0,18,130,192,341,6,347,0,O-24-114-03-01-02
MASAKA,BUKOTO EAST,MUKUNGWE,BUGABIRA,KYALUGO,441,0,0,24,126,176,326,21,347,0,O-24-114-03-01-03
MASAKA,BUKOTO EAST,MUKUNGWE,BUGABIRA,NDEGEYA B,240,1,0,13,62,102,178,6,184,0,O-24-114-03-01-04
MASAKA,BUKOTO EAST,MUKUNGWE,BULAYI,LUGUUDO,620,2,0,20,204,268,494,10,504,0,O-24-114-03-02-01
MASAKA,BUKOTO EAST,MUKUNGWE,BULAYI,MUTEMULA-KIYUMBA RC CHURCH,569,1,0,17,198,193,409,18,427,0,O-24-114-03-02-02
MASAKA,BUKOTO EAST,MUKUNGWE,BULAYI,KIKULULA(KIWAALA TC),326,0,0,12,52,192,256,9,265,0,O-24-114-03-02-03
MASAKA,BUKOTO EAST,MUKUNGWE,KALAGALA,KAYUNGA S.S.S,277,0,0,29,117,72,218,4,222,0,O-24-114-03-03-01
MASAKA,BUKOTO EAST,MUKUNGWE,KALAGALA,KITENGA,514,0,0,58,215,99,372,13,385,0,O-24-114-03-03-02
MASAKA,BUKOTO EAST,MUKUNGWE,KALAGALA,KASANA TRADING CENTRE,750,3,0,80,279,153,515,11,526,0,O-24-114-03-03-03
MASAKA,BUKOTO EAST,MUKUNGWE,KALAGALA,KASANA KIYEMBE,533,3,1,30,194,132,360,15,375,0,O-24-114-03-03-04
MASAKA,BUKOTO EAST,MUKUNGWE,KALAGALA,KALAGALA,498,1,0,44,118,137,300,64,364,0,O-24-114-03-03-05
MASAKA,BUKOTO EAST,MUKUNGWE,KATWADDE,LUVULE,352,1,0,23,92,130,246,10,256,0,O-24-114-03-04-01
MASAKA,BUKOTO EAST,MUKUNGWE,KATWADDE,KATWADDE,592,4,2,19,150,254,429,13,442,0,O-24-114-03-04-02
MASAKA,BUKOTO EAST,MUKUNGWE,KATWADDE,MUGIRA'S FARM,527,1,1,33,80,170,285,90,375,0,O-24-114-03-04-03
MASAKA,BUKOTO EAST,MUKUNGWE,KATWADDE,KASAALA,504,1,1,48,128,203,381,20,401,0,O-24-114-03-04-04
MASAKA,BUKOTO EAST,MUKUNGWE,MATANGA,BUTALE,622,0,1,14,162,263,440,11,451,0,O-24-114-03-05-01
MASAKA,BUKOTO EAST,MUKUNGWE,MATANGA,KINYERERE P/S,561,4,0,15,128,249,396,14,410,0,O-24-114-03-05-02
MASAKA,BUKOTO EAST,MUKUNGWE,MATANGA,MATANGA/BUTENDE,489,2,1,38,161,150,352,7,359,0,O-24-114-03-05-03
MASAKA,BUKOTO EAST,MUKUNGWE,MATANGA,MATANGA RC I,561,0,0,21,198,185,404,9,413,0,O-24-114-03-05-04
MASAKA,BUKOTO EAST,MUKUNGWE,SAMALIA,KAKO P7 SCH,747,5,1,48,175,295,524,14,538,0,O-24-114-03-06-01
MASAKA,BUKOTO EAST,MUKUNGWE,SAMALIA,MPUGWE P 7 SCHOOL (A - M),633,2,0,18,226,167,413,20,433,0,O-24-114-03-06-02
MASAKA,BUKOTO EAST,MUKUNGWE,SAMALIA,KYALUSOWE P.7 SCHOOL,523,5,1,42,134,243,425,6,431,0,O-24-114-03-06-03
MASAKA,BUKOTO EAST,MUKUNGWE,SAMALIA,MUKUNGWE SUB COUNTY,471,3,0,27,94,202,326,4,330,0,O-24-114-03-06-04
MASAKA,BUKOTO EAST,MUKUNGWE,SAMALIA,MPUGWE P.7 SCHOOL (N - Z),1016,4,0,22,284,351,661,13,674,0,O-24-114-03-06-05
MASAKA,BUKOTO SOUTH,KINGO,KASANA,NZIZI,612,1,0,36,113,208,358,0,358,0,O-24-115-01-01-01
MASAKA,BUKOTO SOUTH,KINGO,KASANA,KASAANA A,482,2,0,3,72,198,275,95,370,0,O-24-115-01-01-02
MASAKA,BUKOTO SOUTH,KINGO,KASANA,BIGANDO PRIMARY SCHOOL,653,3,0,16,185,257,461,7,468,0,O-24-115-01-01-03
MASAKA,BUKOTO SOUTH,KINGO,KASANA,KASAANA B,435,1,0,11,142,109,263,36,299,0,O-24-115-01-01-04
MASAKA,BUKOTO SOUTH,KINGO,KIGANDA,KYOKO PRIMARY SCHOOL,535,1,0,10,205,191,407,12,419,0,O-24-115-01-02-01
MASAKA,BUKOTO SOUTH,KINGO,KIGANDA,KAGGANDA T.C,664,2,0,15,255,142,414,0,414,0,O-24-115-01-02-02
MASAKA,BUKOTO SOUTH,KINGO,KIGANDA,NKALWE T.C,467,2,0,10,174,100,286,64,350,0,O-24-115-01-02-03
MASAKA,BUKOTO SOUTH,KINGO,KIGANDA,KABULASSOKE PR SCHOOL,620,3,1,26,199,206,435,66,501,0,O-24-115-01-02-04
MASAKA,BUKOTO SOUTH,KINGO,KIGANDA,KABWAMI,429,1,0,7,78,201,287,53,340,0,O-24-115-01-02-05
MASAKA,BUKOTO SOUTH,KINGO,KISANSALA,KISANSALA,616,3,2,15,192,149,361,107,468,0,O-24-115-01-03-01
MASAKA,BUKOTO SOUTH,KINGO,KISANSALA,KABWAMI,458,3,1,5,99,175,283,84,367,0,O-24-115-01-03-02
MASAKA,BUKOTO SOUTH,KINGO,KISANSALA,NGONDATI,720,7,1,6,236,319,569,13,582,0,O-24-115-01-03-03
MASAKA,BUKOTO SOUTH,KINGO,KITEREDDE,KIMWANYI P.7 SCHOOL,654,9,0,45,181,235,470,10,480,0,O-24-115-01-04-01
MASAKA,BUKOTO SOUTH,KINGO,KITEREDDE,KISAAKA PLAY GROUND,667,2,0,18,242,213,475,11,486,0,O-24-115-01-04-02
MASAKA,BUKOTO SOUTH,KINGO,KITEREDDE,KYALUWUBU PLAYGROUND,823,3,0,44,260,280,587,33,620,0,O-24-115-01-04-03
MASAKA,BUKOTO SOUTH,KINGO,KITEREDDE,MWALO PLAY GROUND -KAWUMO,262,4,0,12,80,82,178,37,215,0,O-24-115-01-04-04
MASAKA,BUKOTO SOUTH,KINGO,KITEREDDE,KISOSSO,476,2,1,16,186,133,338,3,341,0,O-24-115-01-04-05
MASAKA,BUKOTO SOUTH,KINGO,NKONI,KYANGOMA,385,2,0,13,141,105,261,7,268,0,O-24-115-01-05-01
MASAKA,BUKOTO SOUTH,KINGO,NKONI,NKONI,667,4,1,48,207,187,447,2,449,0,O-24-115-01-05-02
MASAKA,BUKOTO SOUTH,KINGO,NKONI,KAKUNYU,689,0,1,17,133,264,415,101,516,0,O-24-115-01-05-03
MASAKA,BUKOTO SOUTH,KINGO,NKONI,KYABBOGO(MARKET PLACE),432,1,0,20,158,141,320,13,333,0,O-24-115-01-05-04
MASAKA,BUKOTO SOUTH,KINGO,SSENYA,SSENYA,604,0,0,27,145,211,383,80,463,0,O-24-115-01-06-01
MASAKA,BUKOTO SOUTH,KINGO,SSENYA,SSETTAALA,285,0,0,20,82,118,220,3,223,0,O-24-115-01-06-02
MASAKA,BUKOTO SOUTH,KINGO,SSENYA,KASWA,544,7,4,14,201,153,379,15,394,0,O-24-115-01-06-03
MASAKA,BUKOTO SOUTH,KINGO,SSENYA,KITAMBUZA,605,6,0,7,222,210,445,13,458,0,O-24-115-01-06-04
MASAKA,BUKOTO SOUTH,KISEKKA,BUSUBI,SSEKE,738,4,0,9,213,253,479,15,494,0,O-24-115-02-01-01
MASAKA,BUKOTO SOUTH,KISEKKA,BUSUBI,BUSUBI,567,1,0,23,147,189,360,44,404,0,O-24-115-02-01-02
MASAKA,BUKOTO SOUTH,KISEKKA,BUSUBI,KYETUME,473,1,0,13,87,242,343,25,368,0,O-24-115-02-01-03
MASAKA,BUKOTO SOUTH,KISEKKA,BUSUBI,KYASSONKO,542,1,0,25,97,255,378,54,432,0,O-24-115-02-01-04
MASAKA,BUKOTO SOUTH,KISEKKA,KANKAMBA,BUKUMBULA,467,0,0,6,75,212,293,79,372,0,O-24-115-02-02-01
MASAKA,BUKOTO SOUTH,KISEKKA,KANKAMBA,KYEMBAZZI (A - M),338,1,1,9,84,142,237,12,249,0,O-24-115-02-02-02
MASAKA,BUKOTO SOUTH,KISEKKA,KANKAMBA,BULEMERE (A - M),287,3,0,7,111,98,219,11,230,0,O-24-115-02-02-03
MASAKA,BUKOTO SOUTH,KISEKKA,KANKAMBA,KYEMBAZZI (N - Z),527,3,0,15,94,257,369,32,401,0,O-24-115-02-02-04
MASAKA,BUKOTO SOUTH,KISEKKA,KANKAMBA,BULEMERE (N - Z),554,2,2,10,169,208,391,16,407,0,O-24-115-02-02-05
MASAKA,BUKOTO SOUTH,KISEKKA,KIKENENE,KASERERE,402,2,0,6,130,165,303,42,345,0,O-24-115-02-03-01
MASAKA,BUKOTO SOUTH,KISEKKA,KIKENENE,KALEGERO,712,0,1,19,191,269,480,83,563,0,O-24-115-02-03-02
MASAKA,BUKOTO SOUTH,KISEKKA,KIKENENE,TTABA,644,0,1,10,179,284,474,56,530,0,O-24-115-02-03-03
MASAKA,BUKOTO SOUTH,KISEKKA,KIKENENE,LWAGGULWE,302,2,0,5,56,181,244,21,265,0,O-24-115-02-03-04
MASAKA,BUKOTO SOUTH,KISEKKA,KINONI TRADING CE,WASWA STAGE (A - M),740,3,0,8,242,147,400,44,444,0,O-24-115-02-04-01
MASAKA,BUKOTO SOUTH,KISEKKA,KINONI TRADING CE,BUGAGGA (A - M),422,3,0,8,170,90,271,1,272,0,O-24-115-02-04-02
MASAKA,BUKOTO SOUTH,KISEKKA,KINONI TRADING CE,WASWA STAGE (N - Z),1265,2,0,12,313,331,658,58,716,0,O-24-115-02-04-03
MASAKA,BUKOTO SOUTH,KISEKKA,KINONI TRADING CE,BUGAGGA (N - Z),667,1,1,4,161,196,363,52,415,0,O-24-115-02-04-04
MASAKA,BUKOTO SOUTH,KISEKKA,KIWANGALA,KIWANGALA (A - M),395,2,0,8,178,114,302,8,310,0,O-24-115-02-05-01
MASAKA,BUKOTO SOUTH,KISEKKA,KIWANGALA,KATOOKE,482,1,0,7,157,176,341,49,390,0,O-24-115-02-05-02
MASAKA,BUKOTO SOUTH,KISEKKA,KIWANGALA,KYANUKUZI,517,2,1,8,123,242,376,40,416,0,O-24-115-02-05-03
MASAKA,BUKOTO SOUTH,KISEKKA,KIWANGALA,KANKU,539,2,0,14,106,229,351,78,429,0,O-24-115-02-05-04
MASAKA,BUKOTO SOUTH,KISEKKA,KIWANGALA,MIGONGO,345,3,0,2,50,202,257,24,281,0,O-24-115-02-05-05
MASAKA,BUKOTO SOUTH,KISEKKA,KIWANGALA,KIWANGALA (N - Z),704,6,0,6,162,263,437,94,531,0,O-24-115-02-05-06
MASAKA,BUKOTO SOUTH,KISEKKA,NAKALEMBE,KYANGWE,301,1,0,11,72,128,212,0,212,0,O-24-115-02-06-01
MASAKA,BUKOTO SOUTH,KISEKKA,NAKALEMBE,KIBAALE,323,2,0,18,65,156,241,0,241,0,O-24-115-02-06-02
MASAKA,BUKOTO SOUTH,KISEKKA,NAKALEMBE,KASAMBYA,314,1,0,6,87,92,186,11,197,0,O-24-115-02-06-03
MASAKA,BUKOTO SOUTH,KISEKKA,NAKALEMBE,BUZIRANDULU,647,5,0,23,156,263,447,9,456,0,O-24-115-02-06-04
MASAKA,BUKOTO SOUTH,KISEKKA,NAKALEMBE,KABOYO ZONE,244,1,0,7,69,71,148,10,158,0,O-24-115-02-06-05
MASAKA,BUKOTO SOUTH,KISEKKA,NAKALEMBE,LUBOWA/SULA,428,5,0,9,83,183,280,44,324,0,O-24-115-02-06-06
MASAKA,BUKOTO SOUTH,KISEKKA,NAKATETE,KYAMAGANDA,369,0,0,9,78,152,239,22,261,0,O-24-115-02-07-01
MASAKA,BUKOTO SOUTH,KISEKKA,NAKATETE,DDEGEYA (A - M),358,2,1,3,126,80,212,35,247,0,O-24-115-02-07-02
MASAKA,BUKOTO SOUTH,KISEKKA,NAKATETE,DONGWA,438,4,0,11,101,168,284,68,352,0,O-24-115-02-07-03
MASAKA,BUKOTO SOUTH,KISEKKA,NAKATETE,KYAKANYOMOZI,336,2,0,19,47,127,195,57,252,0,O-24-115-02-07-04
MASAKA,BUKOTO SOUTH,KISEKKA,NAKATETE,DDEGEYA (N - Z),609,3,0,7,199,210,419,17,436,0,O-24-115-02-07-05
MASAKA,BUKOTO SOUTH,KISEKKA,NGEREKO,NAKATETE P. SCHOOL,507,2,0,7,91,326,426,14,440,0,O-24-115-02-08-01
MASAKA,BUKOTO SOUTH,KISEKKA,NGEREKO,BUYOGA,269,2,0,4,69,119,194,28,222,0,O-24-115-02-08-02
MASAKA,BUKOTO SOUTH,KISEKKA,NGEREKO,NGEREKO (A - NAB),556,5,0,24,175,241,445,0,445,0,O-24-115-02-08-03
MASAKA,BUKOTO SOUTH,KISEKKA,NGEREKO,NGEREKO (NAC - Z),746,9,1,27,161,376,574,13,587,0,O-24-115-02-08-04
MASAKA,MASAKA MUNICIPALITY,KATWE/BUTEGO,BUTEGO,SAZA (A - M),444,4,0,22,154,93,273,6,279,0,O-24-121-01-01-01
MASAKA,MASAKA MUNICIPALITY,KATWE/BUTEGO,BUTEGO,KIRUMBA A,479,5,0,24,136,137,302,8,310,0,O-24-121-01-01-02
MASAKA,MASAKA MUNICIPALITY,KATWE/BUTEGO,BUTEGO,KIRUMBA B,477,6,0,18,203,97,324,10,334,0,O-24-121-01-01-03
MASAKA,MASAKA MUNICIPALITY,KATWE/BUTEGO,BUTEGO,KAMUGOMBWA,559,1,0,24,131,137,293,53,346,0,O-24-121-01-01-04
MASAKA,MASAKA MUNICIPALITY,KATWE/BUTEGO,BUTEGO,KIYIMBWE,705,3,0,46,186,231,466,7,473,0,O-24-121-01-01-05
MASAKA,MASAKA MUNICIPALITY,KATWE/BUTEGO,BUTEGO,BUTEGO,339,2,0,15,71,129,217,39,256,0,O-24-121-01-01-06
MASAKA,MASAKA MUNICIPALITY,KATWE/BUTEGO,BUTEGO,SAZA (N - Z),702,3,0,17,185,190,395,6,401,0,O-24-121-01-01-07
MASAKA,MASAKA MUNICIPALITY,KATWE/BUTEGO,KATWE,KIRUMBA-KATWE A,581,2,0,25,206,133,366,6,372,0,O-24-121-01-02-01
MASAKA,MASAKA MUNICIPALITY,KATWE/BUTEGO,KATWE,KIRUMBA-KATWE B,457,4,0,13,157,90,264,45,309,0,O-24-121-01-02-02
MASAKA,MASAKA MUNICIPALITY,KATWE/BUTEGO,KATWE,GARDENS CELL,748,1,0,22,202,179,404,1,405,0,O-24-121-01-02-03
MASAKA,MASAKA MUNICIPALITY,KATWE/BUTEGO,KATWE,CINEMA CELL,905,3,1,20,436,127,587,0,587,0,O-24-121-01-02-04
MASAKA,MASAKA MUNICIPALITY,KATWE/BUTEGO,KATWE,FOLKLAND CELL A,580,5,0,17,246,92,360,2,362,0,O-24-121-01-02-05
MASAKA,MASAKA MUNICIPALITY,KATWE/BUTEGO,KATWE,FOLKLAND CELL B,461,3,1,11,176,77,268,5,273,0,O-24-121-01-02-06
MASAKA,MASAKA MUNICIPALITY,KATWE/BUTEGO,KATWE,MARKET CELL B,563,1,0,13,221,111,346,3,349,0,O-24-121-01-02-07
MASAKA,MASAKA MUNICIPALITY,KATWE/BUTEGO,KATWE,BATA CELL A,753,0,1,22,263,128,414,2,416,0,O-24-121-01-02-08
MASAKA,MASAKA MUNICIPALITY,KATWE/BUTEGO,KATWE,BATA CELL B,561,3,0,12,245,113,373,5,378,0,O-24-121-01-02-09
MASAKA,MASAKA MUNICIPALITY,KATWE/BUTEGO,KATWE,TOWN YARD CELL (A- M),489,1,1,10,162,104,278,0,278,0,O-24-121-01-02-10
MASAKA,MASAKA MUNICIPALITY,KATWE/BUTEGO,KATWE,BWALA,361,1,0,4,90,123,218,32,250,0,O-24-121-01-02-11
MASAKA,MASAKA MUNICIPALITY,KATWE/BUTEGO,KATWE,KISUUNA (A - M),326,0,0,4,150,63,217,27,244,0,O-24-121-01-02-12
MASAKA,MASAKA MUNICIPALITY,KATWE/BUTEGO,KATWE,KANONI-KITABAAZI,470,2,1,13,133,165,314,9,323,0,O-24-121-01-02-13
MASAKA,MASAKA MUNICIPALITY,KATWE/BUTEGO,KATWE,TOWN YARD CELL (N - Z),575,4,0,11,162,122,299,5,304,0,O-24-121-01-02-14
MASAKA,MASAKA MUNICIPALITY,KATWE/BUTEGO,KATWE,KISUUNA (N - Z),433,0,0,7,175,113,295,8,303,0,O-24-121-01-02-15
MASAKA,MASAKA MUNICIPALITY,KIMAANYA/KYABAKUZA,KIMAANYA,KISIJJAGIRWA VILLAGE,889,5,1,13,259,282,560,12,572,0,O-24-121-02-01-01
MASAKA,MASAKA MUNICIPALITY,KIMAANYA/KYABAKUZA,KIMAANYA,KIMAANYA B1,579,2,0,14,204,136,356,9,365,0,O-24-121-02-01-02
MASAKA,MASAKA MUNICIPALITY,KIMAANYA/KYABAKUZA,KIMAANYA,KIMANYA B2,820,0,0,20,279,193,492,11,503,0,O-24-121-02-01-03
MASAKA,MASAKA MUNICIPALITY,KIMAANYA/KYABAKUZA,KIMAANYA,KIMANYA A (A - M),539,2,2,18,165,100,287,54,341,0,O-24-121-02-01-04
MASAKA,MASAKA MUNICIPALITY,KIMAANYA/KYABAKUZA,KIMAANYA,KAZUNGU,582,7,1,15,137,163,323,0,323,0,O-24-121-02-01-05
MASAKA,MASAKA MUNICIPALITY,KIMAANYA/KYABAKUZA,KIMAANYA,MASAKA S.S.S,784,2,0,26,191,128,347,19,366,0,O-24-121-02-01-06
MASAKA,MASAKA MUNICIPALITY,KIMAANYA/KYABAKUZA,KIMAANYA,KIJJABWEMI A,855,4,0,28,256,260,548,15,563,0,O-24-121-02-01-07
MASAKA,MASAKA MUNICIPALITY,KIMAANYA/KYABAKUZA,KIMAANYA,KIJJABWEMI B,742,4,0,20,228,231,483,14,497,0,O-24-121-02-01-08
MASAKA,MASAKA MUNICIPALITY,KIMAANYA/KYABAKUZA,KIMAANYA,KIMANYA A (N - Z),819,5,0,28,226,216,475,15,490,0,O-24-121-02-01-09
MASAKA,MASAKA MUNICIPALITY,KIMAANYA/KYABAKUZA,KIMAANYA,KASIJJAGIRWA OUTSIDE GUARD (,943,1,0,0,71,265,337,5,342,0,O-24-121-02-01-10
MASAKA,MASAKA MUNICIPALITY,KIMAANYA/KYABAKUZA,KIMAANYA,KASIJJAGIRWA OUTSIDE GUARD (,615,0,1,1,42,167,211,2,213,0,O-24-121-02-01-11
MASAKA,MASAKA MUNICIPALITY,KIMAANYA/KYABAKUZA,KYABAKUZA,KYABAKUZA TC A,542,3,0,21,221,113,358,1,359,0,O-24-121-02-02-01
MASAKA,MASAKA MUNICIPALITY,KIMAANYA/KYABAKUZA,KYABAKUZA,KYABAKUZA T.C B,636,6,0,17,270,132,425,3,428,0,O-24-121-02-02-02
MASAKA,MASAKA MUNICIPALITY,KIMAANYA/KYABAKUZA,KYABAKUZA,KYABAKUZA A,593,1,0,57,195,137,390,13,403,0,O-24-121-02-02-03
MASAKA,MASAKA MUNICIPALITY,KIMAANYA/KYABAKUZA,KYABAKUZA,KYABAKUZA B,374,1,0,18,139,100,258,0,258,0,O-24-121-02-02-04
MASAKA,MASAKA MUNICIPALITY,KIMAANYA/KYABAKUZA,KYABAKUZA,MWALO,80,0,0,12,29,18,59,5,64,0,O-24-121-02-02-05
MASAKA,MASAKA MUNICIPALITY,KIMAANYA/KYABAKUZA,KYABAKUZA,GAYAZA,475,1,0,11,152,120,284,49,333,0,O-24-121-02-02-06
MASAKA,MASAKA MUNICIPALITY,NYENDO/SENYANGE,NYENDO,BINYONYI A,820,2,0,19,316,163,500,7,507,0,O-24-121-03-01-01
MASAKA,MASAKA MUNICIPALITY,NYENDO/SENYANGE,NYENDO,BINYONYI B I,566,0,0,15,249,115,379,3,382,0,O-24-121-03-01-02
MASAKA,MASAKA MUNICIPALITY,NYENDO/SENYANGE,NYENDO,BINYONYI B II,557,2,0,10,195,111,318,5,323,0,O-24-121-03-01-03
MASAKA,MASAKA MUNICIPALITY,NYENDO/SENYANGE,NYENDO,KASANA (A - M),474,2,1,20,188,79,290,6,296,0,O-24-121-03-01-04
MASAKA,MASAKA MUNICIPALITY,NYENDO/SENYANGE,NYENDO,KAYIRIKITI (A - M),553,3,1,16,230,133,383,4,387,0,O-24-121-03-01-05
MASAKA,MASAKA MUNICIPALITY,NYENDO/SENYANGE,NYENDO,KITAKA A,611,2,1,8,218,116,345,45,390,0,O-24-121-03-01-06
MASAKA,MASAKA MUNICIPALITY,NYENDO/SENYANGE,NYENDO,KITAKA B,840,3,0,9,260,154,426,73,499,0,O-24-121-03-01-07
MASAKA,MASAKA MUNICIPALITY,NYENDO/SENYANGE,NYENDO,KITOVU NNUME (A - M),512,1,0,19,237,79,336,10,346,0,O-24-121-03-01-08
MASAKA,MASAKA MUNICIPALITY,NYENDO/SENYANGE,NYENDO,KITOVU ROAD (A - M),426,1,0,23,202,64,290,14,304,0,O-24-121-03-01-09
MASAKA,MASAKA MUNICIPALITY,NYENDO/SENYANGE,NYENDO,MARKET TRIANGLE,757,1,0,25,278,149,453,21,474,0,O-24-121-03-01-10
MASAKA,MASAKA MUNICIPALITY,NYENDO/SENYANGE,NYENDO,MUKUDDE (A - M),680,3,1,17,227,112,360,3,363,0,O-24-121-03-01-11
MASAKA,MASAKA MUNICIPALITY,NYENDO/SENYANGE,NYENDO,NAKAIBA,648,4,1,19,348,82,454,7,461,0,O-24-121-03-01-12
MASAKA,MASAKA MUNICIPALITY,NYENDO/SENYANGE,NYENDO,NSEREKO ZONE,551,1,0,21,243,116,381,5,386,0,O-24-121-03-01-13
MASAKA,MASAKA MUNICIPALITY,NYENDO/SENYANGE,NYENDO,BLOCK A,845,1,1,31,401,151,585,3,588,0,O-24-121-03-01-14
MASAKA,MASAKA MUNICIPALITY,NYENDO/SENYANGE,NYENDO,MUKUDDE (N - P),772,0,0,15,222,148,385,7,392,0,O-24-121-03-01-15
MASAKA,MASAKA MUNICIPALITY,NYENDO/SENYANGE,NYENDO,BLOCK A (N - Z),469,0,0,16,193,78,287,6,293,0,O-24-121-03-01-16
MASAKA,MASAKA MUNICIPALITY,NYENDO/SENYANGE,NYENDO,MUKUDDE (Q - Z),277,1,0,15,102,35,153,3,156,0,O-24-121-03-01-17
MASAKA,MASAKA MUNICIPALITY,NYENDO/SENYANGE,NYENDO,KITOVU NNUME (N - Z),769,2,2,23,304,170,501,4,505,0,O-24-121-03-01-18
MASAKA,MASAKA MUNICIPALITY,NYENDO/SENYANGE,NYENDO,KITOVU ROAD (N - Z),585,4,0,31,181,101,317,56,373,0,O-24-121-03-01-19
MASAKA,MASAKA MUNICIPALITY,NYENDO/SENYANGE,NYENDO,KASANA (N - Z),796,2,0,20,293,169,484,11,495,0,O-24-121-03-01-20
MASAKA,MASAKA MUNICIPALITY,NYENDO/SENYANGE,NYENDO,KAYIRIKITI (N - Z),777,5,0,15,264,138,422,48,470,0,O-24-121-03-01-21
MASAKA,MASAKA MUNICIPALITY,NYENDO/SENYANGE,SENYANGE,BUCHULO,297,1,0,5,65,117,188,6,194,0,O-24-121-03-02-01
MASAKA,MASAKA MUNICIPALITY,NYENDO/SENYANGE,SENYANGE,SENYANGE A1,516,2,1,52,173,150,378,16,394,0,O-24-121-03-02-02
MASAKA,MASAKA MUNICIPALITY,NYENDO/SENYANGE,SENYANGE,SENYANGE A2,503,1,0,36,169,156,362,0,362,0,O-24-121-03-02-03
MASAKA,MASAKA MUNICIPALITY,NYENDO/SENYANGE,SENYANGE,SENYANGE B,472,1,2,6,95,235,339,20,359,0,O-24-121-03-02-04
MASAKA,MASAKA MUNICIPALITY,NYENDO/SENYANGE,SENYANGE,ST. HENRY'S COLLEGE,376,1,0,32,128,56,217,1,218,0,O-24-121-03-02-05
MASAKA,MASAKA MUNICIPALITY,NYENDO/SENYANGE,SENYANGE,KITOVU HOSPITAL,186,0,0,10,64,49,123,1,124,0,O-24-121-03-02-06
MPIGI,MAWOKOTA COUNTY NORTH,JJEZA,BULEREJJE,JJEZA A,826,4,0,13,146,264,427,87,514,0,O-30-162-01-01-01
MPIGI,MAWOKOTA COUNTY NORTH,JJEZA,BULEREJJE,JJEZA B,498,1,1,2,59,232,295,56,351,0,O-30-162-01-01-02
MPIGI,MAWOKOTA COUNTY NORTH,JJEZA,LUGYO,KISAMMULA,780,6,2,20,281,226,535,7,542,0,O-30-162-01-02-01
MPIGI,MAWOKOTA COUNTY NORTH,JJEZA,LUGYO,BUJUUKO P/S,612,2,1,39,178,220,440,7,447,0,O-30-162-01-02-02
MPIGI,MAWOKOTA COUNTY NORTH,JJEZA,LUGYO,LUGYO,566,1,1,18,107,188,315,50,365,0,O-30-162-01-02-03
MPIGI,MAWOKOTA COUNTY NORTH,JJEZA,LUGYO,MALUBE-NALUBUGO,416,1,0,17,86,109,213,89,302,0,O-30-162-01-02-04
MPIGI,MAWOKOTA COUNTY NORTH,JJEZA,MAGALA,MAWUGULU P/S,519,1,0,16,61,286,364,15,379,0,O-30-162-01-03-01
MPIGI,MAWOKOTA COUNTY NORTH,JJEZA,MALIMA,GAVU A,526,2,1,12,123,192,330,10,340,0,O-30-162-01-04-01
MPIGI,MAWOKOTA COUNTY NORTH,JJEZA,MALIMA,NKAMBO P/S,534,3,1,20,165,158,347,13,360,0,O-30-162-01-04-02
MPIGI,MAWOKOTA COUNTY NORTH,JJEZA,MALIMA,NSWANJERE,281,1,0,28,45,117,191,7,198,0,O-30-162-01-04-03
MPIGI,MAWOKOTA COUNTY NORTH,JJEZA,MBAZZI,KATUULO P/S,649,0,1,21,134,169,325,19,344,0,O-30-162-01-05-01
MPIGI,MAWOKOTA COUNTY NORTH,JJEZA,MBAZZI,KISOZI,418,0,0,8,140,147,295,4,299,0,O-30-162-01-05-02
MPIGI,MAWOKOTA COUNTY NORTH,JJEZA,TIRIBOGO,BULAMU,338,5,1,6,75,132,219,11,230,0,O-30-162-01-06-01
MPIGI,MAWOKOTA COUNTY NORTH,JJEZA,TIRIBOGO,MUDUUMA,547,1,0,23,131,212,367,8,375,0,O-30-162-01-06-02
MPIGI,MAWOKOTA COUNTY NORTH,JJEZA,TIRIBOGO,TIRIBOGO,290,1,0,14,82,127,224,3,227,0,O-30-162-01-06-03
MPIGI,MAWOKOTA COUNTY NORTH,JJEZA,TIRIBOGO,BULAMU P/S,472,2,1,8,75,218,304,10,314,0,O-30-162-01-06-04
MPIGI,MAWOKOTA COUNTY NORTH,KAMENGO,BUTOOLO,BUTOOLO,768,1,0,56,163,327,547,23,570,0,O-30-162-02-01-01
MPIGI,MAWOKOTA COUNTY NORTH,KAMENGO,BUTOOLO,KAMUSOGONYA,207,0,0,5,26,114,145,8,153,0,O-30-162-02-01-02
MPIGI,MAWOKOTA COUNTY NORTH,KAMENGO,KAMENGO,KAMMENGO,743,0,2,54,180,240,476,11,487,0,O-30-162-02-02-01
MPIGI,MAWOKOTA COUNTY NORTH,KAMENGO,KAMENGO,BWAMULAMIRA,556,1,1,45,106,228,381,13,394,0,O-30-162-02-02-02
MPIGI,MAWOKOTA COUNTY NORTH,KAMENGO,KAMENGO,KISWA,499,0,1,31,75,245,352,13,365,0,O-30-162-02-02-03
MPIGI,MAWOKOTA COUNTY NORTH,KAMENGO,KANYIKE,KANYIKE,450,3,1,40,66,201,311,11,322,0,O-30-162-02-03-01
MPIGI,MAWOKOTA COUNTY NORTH,KAMENGO,KANYIKE,KATABA,597,1,1,18,80,274,374,16,390,0,O-30-162-02-03-02
MPIGI,MAWOKOTA COUNTY NORTH,KAMENGO,KANYIKE,BUTENGA,435,1,3,41,89,173,307,8,315,0,O-30-162-02-03-03
MPIGI,MAWOKOTA COUNTY NORTH,KAMENGO,KYANJA,BUBUULE,703,0,4,33,96,345,478,34,512,0,O-30-162-02-04-01
MPIGI,MAWOKOTA COUNTY NORTH,KAMENGO,KYANJA,KWAABA,503,2,1,13,72,285,373,16,389,0,O-30-162-02-04-02
MPIGI,MAWOKOTA COUNTY NORTH,KAMENGO,KYANJA,BUKOOZA,495,2,5,13,55,317,392,19,411,0,O-30-162-02-04-03
MPIGI,MAWOKOTA COUNTY NORTH,KAMENGO,LUWALA,BUSERO,513,0,0,37,73,263,373,16,389,0,O-30-162-02-05-01
MPIGI,MAWOKOTA COUNTY NORTH,KAMENGO,LUWALA,MASAKA,507,4,1,16,56,275,352,1,353,0,O-30-162-02-05-02
MPIGI,MAWOKOTA COUNTY NORTH,KAMENGO,LWAGGWA/KIBAANG,KIBANGA,493,1,0,40,97,176,314,15,329,0,O-30-162-02-06-01
MPIGI,MAWOKOTA COUNTY NORTH,KAMENGO,LWAGGWA/KIBAANG,LUGADDA,243,0,1,10,49,128,188,6,194,0,O-30-162-02-06-02
MPIGI,MAWOKOTA COUNTY NORTH,KAMENGO,MUSA,SERINNYABBI,488,2,1,25,78,241,347,11,358,0,O-30-162-02-07-01
MPIGI,MAWOKOTA COUNTY NORTH,KAMENGO,MUSA,BUKABI,494,5,0,13,64,260,342,16,358,0,O-30-162-02-07-02
MPIGI,MAWOKOTA COUNTY NORTH,KAMENGO,MUSA,MASAAZI,397,1,0,14,43,251,309,10,319,0,O-30-162-02-07-03
MPIGI,MAWOKOTA COUNTY NORTH,KAMENGO,MUSA,MUSA,314,0,1,7,33,183,224,7,231,0,O-30-162-02-07-04
MPIGI,MAWOKOTA COUNTY NORTH,KAMENGO,MUSA,BUYIGA A ISLAND,291,3,0,3,22,128,156,0,156,0,O-30-162-02-07-05
MPIGI,MAWOKOTA COUNTY NORTH,KAMENGO,MUYIRA,KAMPIRINGISA,647,5,3,31,71,377,487,14,501,0,O-30-162-02-08-01
MPIGI,MAWOKOTA COUNTY NORTH,KAMENGO,MUYIRA,MAGEJJO,341,3,0,12,86,117,218,13,231,0,O-30-162-02-08-02
MPIGI,MAWOKOTA COUNTY NORTH,KIRINGENTE,KAVULE,KAVULE,611,2,0,41,163,217,423,17,440,0,O-30-162-03-01-01
MPIGI,MAWOKOTA COUNTY NORTH,KIRINGENTE,KAVULE,NAKIBISO,326,4,0,5,61,173,243,17,260,0,O-30-162-03-01-02
MPIGI,MAWOKOTA COUNTY NORTH,KIRINGENTE,KAVULE,KATENDE,748,2,0,43,228,201,474,15,489,0,O-30-162-03-01-03
MPIGI,MAWOKOTA COUNTY NORTH,KIRINGENTE,KIKONDO,KIKONDO,280,1,0,19,48,110,178,4,182,0,O-30-162-03-02-01
MPIGI,MAWOKOTA COUNTY NORTH,KIRINGENTE,KIKONDO,NSUJJUWE,581,1,0,22,204,151,378,10,388,0,O-30-162-03-02-02
MPIGI,MAWOKOTA COUNTY NORTH,KIRINGENTE,KIKONDO,NAKIREBE (A-M),516,2,0,14,141,167,324,13,337,0,O-30-162-03-02-03
MPIGI,MAWOKOTA COUNTY NORTH,KIRINGENTE,KIKONDO,NAKIREBE (N-Z),777,4,1,6,169,277,457,10,467,0,O-30-162-03-02-04
MPIGI,MAWOKOTA COUNTY NORTH,KIRINGENTE,KIRINGENTE(LUVUMB,LUVUMBULA,473,3,0,28,118,195,344,5,349,0,O-30-162-03-03-01
MPIGI,MAWOKOTA COUNTY NORTH,KIRINGENTE,KIRINGENTE(LUVUMB,NNAMA,237,0,1,15,62,96,174,3,177,0,O-30-162-03-03-02
MPIGI,MAWOKOTA COUNTY NORTH,KIRINGENTE,KOLOLO,KOLOLO,586,2,4,8,113,233,360,28,388,0,O-30-162-03-04-01
MPIGI,MAWOKOTA COUNTY NORTH,KIRINGENTE,SEKIWUNGA,SEKIWUNGA,954,4,0,11,174,334,523,25,548,0,O-30-162-03-05-01
MPIGI,MAWOKOTA COUNTY NORTH,KIRINGENTE,SEKIWUNGA,MABUYE,176,0,0,7,37,79,123,0,123,0,O-30-162-03-05-02
MPIGI,MAWOKOTA COUNTY NORTH,KIRINGENTE,SEKIWUNGA,KAGGABA,267,2,0,5,47,121,175,8,183,0,O-30-162-03-05-03
MPIGI,MAWOKOTA COUNTY NORTH,MPIGI TOWN COUNCIL,BUMOOZI,BOZA,589,3,1,30,146,213,393,5,398,0,O-30-162-04-01-01
MPIGI,MAWOKOTA COUNTY NORTH,MPIGI TOWN COUNCIL,BUMOOZI,BUMOOZI,264,2,1,11,76,98,188,5,193,0,O-30-162-04-01-02
MPIGI,MAWOKOTA COUNTY NORTH,MPIGI TOWN COUNCIL,BUMOOZI,KONGE,660,2,0,68,141,210,421,9,430,0,O-30-162-04-01-03
MPIGI,MAWOKOTA COUNTY NORTH,MPIGI TOWN COUNCIL,KAFUMU,BULIRO,509,0,4,48,142,173,367,9,376,0,O-30-162-04-02-01
MPIGI,MAWOKOTA COUNTY NORTH,MPIGI TOWN COUNCIL,KAFUMU,KITAWANUULWA,352,0,0,23,48,174,245,18,263,0,O-30-162-04-02-02
MPIGI,MAWOKOTA COUNTY NORTH,MPIGI TOWN COUNCIL,KAKOOLA,BUNAMWERI,615,1,2,31,130,284,448,9,457,0,O-30-162-04-03-01
MPIGI,MAWOKOTA COUNTY NORTH,MPIGI TOWN COUNCIL,KAKOOLA,KITAVUJJA,163,1,1,19,22,77,120,2,122,0,O-30-162-04-03-02
MPIGI,MAWOKOTA COUNTY NORTH,MPIGI TOWN COUNCIL,KONKOMA,NDUGU,381,1,1,29,74,187,292,2,294,0,O-30-162-04-04-01
MPIGI,MAWOKOTA COUNTY NORTH,MPIGI TOWN COUNCIL,KONKOMA,JJANYA,309,1,1,26,56,129,213,12,225,0,O-30-162-04-04-02
MPIGI,MAWOKOTA COUNTY NORTH,MPIGI TOWN COUNCIL,KONKOMA,NSEKE,726,0,1,22,121,423,567,15,582,0,O-30-162-04-04-03
MPIGI,MAWOKOTA COUNTY NORTH,MPIGI TOWN COUNCIL,KONKOMA,MPAMBIRE T.C,712,6,2,22,160,310,500,18,518,0,O-30-162-04-04-04
MPIGI,MAWOKOTA COUNTY NORTH,MPIGI TOWN COUNCIL,KYALI,KYALI,585,1,0,15,89,273,378,34,412,0,O-30-162-04-05-01
MPIGI,MAWOKOTA COUNTY NORTH,MPIGI TOWN COUNCIL,KYALI,KASAAMU,675,3,0,19,110,331,463,35,498,0,O-30-162-04-05-02
MPIGI,MAWOKOTA COUNTY NORTH,MPIGI TOWN COUNCIL,LWANGA,LWANGA,597,1,0,23,86,313,423,17,440,0,O-30-162-04-06-01
MPIGI,MAWOKOTA COUNTY NORTH,MPIGI TOWN COUNCIL,LWANGA,ZIWUNGWE,372,1,2,7,83,150,243,5,248,0,O-30-162-04-06-02
MPIGI,MAWOKOTA COUNTY NORTH,MPIGI TOWN COUNCIL,MAZIBA,LUNGALA,719,2,0,41,120,363,526,13,539,0,O-30-162-04-07-01
MPIGI,MAWOKOTA COUNTY NORTH,MPIGI TOWN COUNCIL,MAZIBA,NAMULAMUZI,494,1,2,25,121,219,368,24,392,0,O-30-162-04-07-02
MPIGI,MAWOKOTA COUNTY NORTH,MPIGI TOWN COUNCIL,MAZIBA,SENENE,309,3,2,9,45,155,214,7,221,0,O-30-162-04-07-03
MPIGI,MAWOKOTA COUNTY NORTH,MPIGI TOWN COUNCIL,MAZIBA,MAKUKU,331,4,0,22,63,139,228,9,237,0,O-30-162-04-07-04
MPIGI,MAWOKOTA COUNTY NORTH,MPIGI TOWN COUNCIL,WARD A,PARK VILLAGE,540,1,2,9,144,127,283,6,289,0,O-30-162-04-08-01
MPIGI,MAWOKOTA COUNTY NORTH,MPIGI TOWN COUNCIL,WARD A,CHURCH CENTRE (A-M),669,1,1,33,242,154,431,4,435,0,O-30-162-04-08-02
MPIGI,MAWOKOTA COUNTY NORTH,MPIGI TOWN COUNCIL,WARD A,MPAMI,246,1,0,13,71,62,147,3,150,0,O-30-162-04-08-03
MPIGI,MAWOKOTA COUNTY NORTH,MPIGI TOWN COUNCIL,WARD A,CHURCH CENTRE (N-Z),933,5,3,33,231,268,540,10,550,0,O-30-162-04-08-04
MPIGI,MAWOKOTA COUNTY NORTH,MPIGI TOWN COUNCIL,WARD B,SABWE,608,7,1,20,160,188,376,10,386,0,O-30-162-04-09-01
MPIGI,MAWOKOTA COUNTY NORTH,MPIGI TOWN COUNCIL,WARD B,NALAKULYA P/S,637,5,0,25,176,210,416,7,423,0,O-30-162-04-09-02
MPIGI,MAWOKOTA COUNTY NORTH,MPIGI TOWN COUNCIL,WARD B,WAGUMBULIZI P/S,372,2,0,30,119,86,237,13,250,0,O-30-162-04-09-03
MPIGI,MAWOKOTA COUNTY NORTH,MPIGI TOWN COUNCIL,WARD C,WMBALE,673,3,2,18,146,289,458,17,475,0,O-30-162-04-10-01
MPIGI,MAWOKOTA COUNTY NORTH,MPIGI TOWN COUNCIL,WARD D,MAYEMBE UPPER,531,8,0,23,103,163,297,5,302,0,O-30-162-04-11-01
MPIGI,MAWOKOTA COUNTY NORTH,MPIGI TOWN COUNCIL,WARD D,MAYEMBE LOWER,264,2,0,14,84,65,165,5,170,0,O-30-162-04-11-02
MPIGI,MAWOKOTA COUNTY NORTH,MUDUMA,BULEREJJE,BULEREJJE,483,2,1,9,113,193,318,15,333,0,O-30-162-05-01-01
MPIGI,MAWOKOTA COUNTY NORTH,MUDUMA,BULEREJJE,KIBUMBIRO P/S,285,0,0,2,39,148,189,4,193,0,O-30-162-05-01-02
MPIGI,MAWOKOTA COUNTY SOUTH,BUWAMA,BONGOLE,BONGOLE,404,0,0,47,81,168,296,3,299,0,O-30-163-01-01-01
MPIGI,MAWOKOTA COUNTY SOUTH,BUWAMA,BONGOLE,NTC NKOZI,305,3,1,17,60,40,121,0,121,0,O-30-163-01-01-02
MPIGI,MAWOKOTA COUNTY SOUTH,BUWAMA,BONGOLE,MAGGYA,561,2,1,26,86,294,409,30,439,0,O-30-163-01-01-03
MPIGI,MAWOKOTA COUNTY SOUTH,BUWAMA,BONGOLE,NYONDO,311,6,0,16,50,162,234,12,246,0,O-30-163-01-01-04
MPIGI,MAWOKOTA COUNTY SOUTH,BUWAMA,BONGOLE,TEREZA P/S,282,1,0,11,78,99,189,4,193,0,O-30-163-01-01-05
MPIGI,MAWOKOTA COUNTY SOUTH,BUWAMA,BUNJAKO,BUZAAMI,776,2,7,15,128,373,525,7,532,0,O-30-163-01-02-01
MPIGI,MAWOKOTA COUNTY SOUTH,BUWAMA,BUNJAKO,MUNYONYO,743,4,0,10,76,414,504,23,527,0,O-30-163-01-02-02
MPIGI,MAWOKOTA COUNTY SOUTH,BUWAMA,BUNJAKO,SENNYONDO,990,5,3,21,122,337,488,0,488,0,O-30-163-01-02-03
MPIGI,MAWOKOTA COUNTY SOUTH,BUWAMA,BUYIJJA,NSANGWA,390,0,0,24,33,249,306,10,316,0,O-30-163-01-03-01
MPIGI,MAWOKOTA COUNTY SOUTH,BUWAMA,BUYIJJA,BUYIJJA,514,0,3,8,63,322,396,12,408,0,O-30-163-01-03-02
MPIGI,MAWOKOTA COUNTY SOUTH,BUWAMA,BUYIJJA,KALONGERO,452,2,0,56,63,231,352,7,359,0,O-30-163-01-03-03
MPIGI,MAWOKOTA COUNTY SOUTH,BUWAMA,JALAMBA,LUBANGA,595,2,1,18,82,352,455,11,466,0,O-30-163-01-04-01
MPIGI,MAWOKOTA COUNTY SOUTH,BUWAMA,JALAMBA,JJALAMBA,526,6,2,32,146,185,371,9,380,0,O-30-163-01-04-02
MPIGI,MAWOKOTA COUNTY SOUTH,BUWAMA,JALAMBA,ST. MUGAGA,323,1,0,24,73,149,247,6,253,0,O-30-163-01-04-03
MPIGI,MAWOKOTA COUNTY SOUTH,BUWAMA,LUBUGUMU,LUBUGUMU,396,2,0,24,74,206,306,6,312,0,O-30-163-01-05-01
MPIGI,MAWOKOTA COUNTY SOUTH,BUWAMA,LUBUGUMU,LUSANSA,479,2,0,34,82,231,349,12,361,0,O-30-163-01-05-02
MPIGI,MAWOKOTA COUNTY SOUTH,BUWAMA,MBIZINYA,BUYAAYA,599,2,0,28,175,243,448,7,455,0,O-30-163-01-06-01
MPIGI,MAWOKOTA COUNTY SOUTH,BUWAMA,MBIZINYA,BUWAMA A,566,3,0,17,136,146,302,3,305,0,O-30-163-01-06-02
MPIGI,MAWOKOTA COUNTY SOUTH,BUWAMA,MBIZINYA,TRACTOR WORKSHOP,663,5,1,26,162,210,404,2,406,0,O-30-163-01-06-03
MPIGI,MAWOKOTA COUNTY SOUTH,BUWAMA,MBIZINYA,MUSLIM P/S (A-M),320,1,0,16,104,95,216,3,219,0,O-30-163-01-06-04
MPIGI,MAWOKOTA COUNTY SOUTH,BUWAMA,MBIZINYA,BUWAMA B,592,5,1,32,144,184,366,16,382,0,O-30-163-01-06-05
MPIGI,MAWOKOTA COUNTY SOUTH,BUWAMA,MBIZINYA,MUSLIM P/S (N-Z),522,0,0,18,105,192,315,5,320,0,O-30-163-01-06-06
MPIGI,MAWOKOTA COUNTY SOUTH,BUWAMA,MUSALE (BULUNDA),KATEBO,516,0,1,14,91,224,330,10,340,0,O-30-163-01-07-01
MPIGI,MAWOKOTA COUNTY SOUTH,BUWAMA,MUSALE (BULUNDA),BULUNDA R.C P/S,358,0,0,10,57,179,246,2,248,0,O-30-163-01-07-02
MPIGI,MAWOKOTA COUNTY SOUTH,BUWAMA,NABITETE (BUWERE),BUWERE P/S,497,2,0,22,84,274,382,12,394,0,O-30-163-01-08-01
MPIGI,MAWOKOTA COUNTY SOUTH,BUWAMA,NABITETE (BUWERE),NABITEETE PARISH HQTRS,598,1,0,61,104,260,426,14,440,0,O-30-163-01-08-02
MPIGI,MAWOKOTA COUNTY SOUTH,BUWAMA,NABITETE (BUWERE),NABITEETE PLAYGROUND,315,0,0,11,28,176,215,20,235,0,O-30-163-01-08-03
MPIGI,MAWOKOTA COUNTY SOUTH,BUWAMA,SABAGABO(KAWUMB,KAWUMBA,425,0,0,36,65,186,287,7,294,0,O-30-163-01-09-01
MPIGI,MAWOKOTA COUNTY SOUTH,BUWAMA,SABAGABO(KAWUMB,SEMUKOMBE,467,4,2,29,106,215,356,10,366,0,O-30-163-01-09-02
MPIGI,MAWOKOTA COUNTY SOUTH,BUWAMA,SANGO,BUYIWE P/S,1205,4,1,51,219,532,807,24,831,0,O-30-163-01-10-01
MPIGI,MAWOKOTA COUNTY SOUTH,BUWAMA,SANGO,SANGO P/S,354,0,0,33,82,103,218,14,232,0,O-30-163-01-10-02
MPIGI,MAWOKOTA COUNTY SOUTH,GOLO,BUSESE,BUKALUNGA,881,1,0,26,263,305,595,4,599,0,O-30-163-02-01-01
MPIGI,MAWOKOTA COUNTY SOUTH,GOLO,BUSESE,BUGONJA,895,3,0,22,182,371,578,9,587,0,O-30-163-02-01-02
MPIGI,MAWOKOTA COUNTY SOUTH,GOLO,KAYABWE,KAYABWE 1,756,5,1,20,262,209,497,18,515,0,O-30-163-02-02-01
MPIGI,MAWOKOTA COUNTY SOUTH,GOLO,KAYABWE,KALAGALA,419,1,0,18,51,105,175,6,181,0,O-30-163-02-02-02
MPIGI,MAWOKOTA COUNTY SOUTH,GOLO,KAYABWE,JANDIRA,152,0,0,5,28,83,116,4,120,0,O-30-163-02-02-03
MPIGI,MAWOKOTA COUNTY SOUTH,GOLO,KAYABWE,KAYABWE T.C,775,3,1,15,181,252,452,7,459,0,O-30-163-02-02-04
MPIGI,MAWOKOTA COUNTY SOUTH,GOLO,KAYABWE,KASUUBO,130,0,0,2,20,54,76,2,78,0,O-30-163-02-02-05
MPIGI,MAWOKOTA COUNTY SOUTH,GOLO,MUGGE,NABYEWANGA,750,1,2,14,112,267,396,0,396,0,O-30-163-02-03-01
MPIGI,MAWOKOTA COUNTY SOUTH,GOLO,MUGGE,GWANIKA,693,4,2,13,106,329,454,39,493,0,O-30-163-02-03-02
MPIGI,MAWOKOTA COUNTY SOUTH,GOLO,MUGGE,NTINZI,391,0,0,12,56,192,260,21,281,0,O-30-163-02-03-03
MPIGI,MAWOKOTA COUNTY SOUTH,GOLO,NABUSANKE,NABUSANKE,792,3,2,33,185,305,528,5,533,0,O-30-163-02-04-01
MPIGI,MAWOKOTA COUNTY SOUTH,GOLO,NABUSANKE,WASSOZI,261,0,0,21,61,110,192,4,196,0,O-30-163-02-04-02
MPIGI,MAWOKOTA COUNTY SOUTH,GOLO,NABUSANKE,NABUSANKE T.C,368,0,2,20,70,195,287,5,292,0,O-30-163-02-04-03
MPIGI,MAWOKOTA COUNTY SOUTH,KITUNTU,KAGENDA (BUKASA),KASAMBYA,623,3,1,0,109,328,441,39,480,0,O-30-163-03-01-01
MPIGI,MAWOKOTA COUNTY SOUTH,KITUNTU,KAGENDA (BUKASA),NJERU,730,3,1,21,74,373,472,27,499,0,O-30-163-03-01-02
MPIGI,MAWOKOTA COUNTY SOUTH,KITUNTU,KAGENDA (BUKASA),BUKASA,754,4,3,18,146,357,528,22,550,0,O-30-163-03-01-03
MPIGI,MAWOKOTA COUNTY SOUTH,KITUNTU,KANAKUKKA (BUKEM,BUKEMBA,572,1,0,27,120,262,410,21,431,0,O-30-163-03-02-01
MPIGI,MAWOKOTA COUNTY SOUTH,KITUNTU,KANAKUKKA (BUKEM,KINAKUKKA,333,1,0,24,73,133,231,9,240,0,O-30-163-03-02-02
MPIGI,MAWOKOTA COUNTY SOUTH,KITUNTU,KANTIINI,KYEWANISE,602,5,1,24,62,375,467,0,467,0,O-30-163-03-03-01
MPIGI,MAWOKOTA COUNTY SOUTH,KITUNTU,KANTIINI,KAYUNGA,528,4,1,28,129,205,367,16,383,0,O-30-163-03-03-02
MPIGI,MAWOKOTA COUNTY SOUTH,KITUNTU,KITUNTU(KASOZI),KASOZI,743,3,3,40,172,279,497,21,518,0,O-30-163-03-04-01
MPIGI,MAWOKOTA COUNTY SOUTH,KITUNTU,KITUNTU(KASOZI),KUTUNTU,426,0,0,6,88,211,305,5,310,0,O-30-163-03-04-02
MPIGI,MAWOKOTA COUNTY SOUTH,KITUNTU,LUWUNGA,LUWUNGA CENTRAL,651,4,1,13,121,320,459,15,474,0,O-30-163-03-05-01
MPIGI,MAWOKOTA COUNTY SOUTH,KITUNTU,LUWUNGA,BUSAGAZI,201,1,1,4,30,130,166,10,176,0,O-30-163-03-05-02
MPIGI,MAWOKOTA COUNTY SOUTH,KITUNTU,MIGAMBA,MIGAMBA,595,2,1,11,112,290,416,15,431,0,O-30-163-03-06-01
MPIGI,MAWOKOTA COUNTY SOUTH,KITUNTU,MIGAMBA,KITUNTU,333,0,2,20,80,131,233,13,246,0,O-30-163-03-06-02
MPIGI,MAWOKOTA COUNTY SOUTH,NKASI,MIGAMBA,NKASI,270,0,0,10,59,132,201,8,209,0,O-30-163-04-01-03
MPIGI,MAWOKOTA COUNTY SOUTH,NKASI,MIGAMBA,MUGUNGU,393,0,0,5,55,253,313,5,318,0,O-30-163-04-01-04
MPIGI,MAWOKOTA COUNTY SOUTH,NKOZI,BUKUNGE,KITOKOLO,558,3,0,14,83,296,396,15,411,0,O-30-163-05-01-01
MPIGI,MAWOKOTA COUNTY SOUTH,NKOZI,BUKUNGE,BUKUNGE,421,1,1,28,88,217,335,0,335,0,O-30-163-05-01-02
MPIGI,MAWOKOTA COUNTY SOUTH,NKOZI,BUSESE,NKOZI A,739,5,1,38,221,178,443,7,450,0,O-30-163-05-02-01
MPIGI,MAWOKOTA COUNTY SOUTH,NKOZI,BUSESE,BUSESE,477,1,0,15,86,245,347,9,356,0,O-30-163-05-02-02
MPIGI,MAWOKOTA COUNTY SOUTH,NKOZI,BUSESE,NKOZI B,291,1,0,11,67,87,166,0,166,0,O-30-163-05-02-03
MPIGI,MAWOKOTA COUNTY SOUTH,NKOZI,NABUSANKE,KWABA,122,0,1,10,18,59,88,2,90,0,O-30-163-05-03-01
MPIGI,MAWOKOTA COUNTY SOUTH,NKOZI,NAKIBANGA,NAKIBANGA,352,0,0,6,113,133,252,5,257,0,O-30-163-05-04-01
MPIGI,MAWOKOTA COUNTY SOUTH,NKOZI,NAKIBANGA,KAWANGO,500,1,2,17,97,250,367,15,382,0,O-30-163-05-04-02
MPIGI,MAWOKOTA COUNTY SOUTH,NKOZI,NINDYE,KAKONI T.C,748,0,2,37,103,372,514,16,530,0,O-30-163-05-05-01
MPIGI,MAWOKOTA COUNTY SOUTH,NKOZI,NINDYE,NINDYE A,567,2,1,44,55,280,382,6,388,0,O-30-163-05-05-02
MPIGI,MAWOKOTA COUNTY SOUTH,NKOZI,NINDYE,NINDYE B,660,1,2,19,66,376,464,31,495,0,O-30-163-05-05-03
MPIGI,MAWOKOTA COUNTY SOUTH,NKOZI,NINDYE,BUKIBIRA,225,0,0,2,28,151,181,2,183,0,O-30-163-05-05-04
MUBENDE,BUWEKULA COUNTY,BAGEZZA,BUSAALE,KISAGAZI R/C CHURCH A/KISINDIZ,589,3,0,5,34,344,386,26,412,0,O-31-166-01-01-01
MUBENDE,BUWEKULA COUNTY,BAGEZZA,BUSAALE,KISINDIZI TRADING CENTRE,536,2,1,3,36,259,301,9,310,0,O-31-166-01-01-02
MUBENDE,BUWEKULA COUNTY,BAGEZZA,GAYAZA,GAYAZA,858,9,4,11,94,417,535,39,574,0,O-31-166-01-02-01
MUBENDE,BUWEKULA COUNTY,BAGEZZA,GAYAZA,KYEJUNGA,539,1,2,6,49,320,378,10,388,0,O-31-166-01-02-02
MUBENDE,BUWEKULA COUNTY,BAGEZZA,KABOWA,KALONGO,514,0,0,2,7,294,303,9,312,0,O-31-166-01-03-01
MUBENDE,BUWEKULA COUNTY,BAGEZZA,KABOWA,KABUBBU T.C,1139,3,1,3,9,579,595,14,609,0,O-31-166-01-03-02
MUBENDE,BUWEKULA COUNTY,BAGEZZA,KABOWA,KABOWA T.C,658,0,1,3,16,436,456,16,472,0,O-31-166-01-03-03
MUBENDE,BUWEKULA COUNTY,BAGEZZA,KABOWA,KALENZI T.C,297,0,0,0,4,176,180,3,183,0,O-31-166-01-03-04
MUBENDE,BUWEKULA COUNTY,BAGEZZA,KAWERI,KAWERI MODEL P.S. A/BUKALUNG,334,1,2,4,39,114,160,10,170,0,O-31-166-01-04-01
MUBENDE,BUWEKULA COUNTY,BAGEZZA,KAWERI,KAWERI MODEL P.S B /KASAMBY,535,1,0,5,46,260,312,13,325,0,O-31-166-01-04-02
MUBENDE,BUWEKULA COUNTY,BAGEZZA,KAWERI,KAWERI MODEL P.S. A/BUKALUNG,262,3,0,8,41,162,214,3,217,0,O-31-166-01-04-03
MUBENDE,BUWEKULA COUNTY,BAGEZZA,KIBALINGA,NGOMA ZA MUKASA P\SCH,500,2,2,3,7,344,358,1,359,0,O-31-166-01-05-01
MUBENDE,BUWEKULA COUNTY,BAGEZZA,KIBALINGA,KIBALINGA A,1019,1,1,19,31,565,617,13,630,0,O-31-166-01-05-02
MUBENDE,BUWEKULA COUNTY,BAGEZZA,KIBALINGA,LWOBWANA,394,0,0,2,29,245,276,12,288,0,O-31-166-01-05-03
MUBENDE,BUWEKULA COUNTY,BAGEZZA,KIBALINGA,KABANYI CHURCH,263,0,0,3,11,187,201,0,201,0,O-31-166-01-05-04
MUBENDE,BUWEKULA COUNTY,BAGEZZA,KISEKENDE,LWABAGABO PARISH CENTRE B/L,814,3,1,9,47,410,470,12,482,0,O-31-166-01-06-01
MUBENDE,BUWEKULA COUNTY,BAGEZZA,KISEKENDE,KISEKENDE T.C,372,1,1,1,48,173,224,3,227,0,O-31-166-01-06-02
MUBENDE,BUWEKULA COUNTY,BAGEZZA,KISEKENDE,NAMAGOGO P.S/NAMAGOGO,596,4,4,6,64,299,377,15,392,0,O-31-166-01-06-03
MUBENDE,BUWEKULA COUNTY,BAGEZZA,KISUJJA (BIWANGA),BIWANGA P/S A/BIWANGA,320,2,0,7,38,152,199,9,208,0,O-31-166-01-07-01
MUBENDE,BUWEKULA COUNTY,BAGEZZA,KISUJJA (BIWANGA),NABIBUNGO,644,3,0,4,22,438,467,14,481,0,O-31-166-01-07-02
MUBENDE,BUWEKULA COUNTY,BAGEZZA,KISUJJA (BIWANGA),KISUJJA,382,4,0,5,16,248,273,10,283,0,O-31-166-01-07-03
MUBENDE,BUWEKULA COUNTY,BAGEZZA,MUGUNGULU,MUGUNGULU/NABUKAKALA A,1527,0,1,6,42,568,617,18,635,0,O-31-166-01-08-01
MUBENDE,BUWEKULA COUNTY,BAGEZZA,MUGUNGULU,MUGUNGULU/NABUKAKALA B,1195,1,2,4,25,333,365,12,377,0,O-31-166-01-08-02
MUBENDE,BUWEKULA COUNTY,BAGEZZA,NABIKAKALA,KIBUTAMU R.C.II CENTRE/KYAMU,621,5,4,3,36,370,418,11,429,0,O-31-166-01-09-01
MUBENDE,BUWEKULA COUNTY,BAGEZZA,NABIKAKALA,BAGEZZA/BULISA,683,1,1,5,29,360,396,10,406,0,O-31-166-01-09-02
MUBENDE,BUWEKULA COUNTY,BAGEZZA,NTUNGAMO,NTUNGAMO A/KASAANA A,597,3,0,6,28,325,362,16,378,0,O-31-166-01-10-01
MUBENDE,BUWEKULA COUNTY,BAGEZZA,NTUNGAMO,KYAMBAZIRA TRADING CENTRE,595,1,0,7,17,296,321,6,327,0,O-31-166-01-10-02
MUBENDE,BUWEKULA COUNTY,BAGEZZA,NTUNGAMO,NTUNGAMO A/KASAANA B,716,6,0,7,23,423,459,11,470,0,O-31-166-01-10-03
MUBENDE,BUWEKULA COUNTY,BAGEZZA,NTUNGAMO,KYAMBAZIRA TC,220,1,0,2,8,126,137,13,150,0,O-31-166-01-10-04
MUBENDE,BUWEKULA COUNTY,BAGEZZA,NTUNGAMO,NKANDWA A,382,1,1,4,23,238,267,11,278,0,O-31-166-01-10-05
MUBENDE,BUWEKULA COUNTY,BAGEZZA,NTUNGAMO,NKANDWA B,283,1,0,2,18,183,204,8,212,0,O-31-166-01-10-06
MUBENDE,BUWEKULA COUNTY,BAGEZZA,NTUNGAMO,NTUNGAMO (D-M),438,0,0,1,19,266,286,3,289,0,O-31-166-01-10-07
MUBENDE,BUWEKULA COUNTY,BAGEZZA,NTUNGAMO,NTUNGAMO (A-C),527,3,0,3,19,325,350,5,355,0,O-31-166-01-10-08
MUBENDE,BUWEKULA COUNTY,BAGEZZA,NTUNGAMO,NTUNGAMO (N-Z),643,1,1,4,23,325,354,5,359,0,O-31-166-01-10-09
MUBENDE,BUWEKULA COUNTY,BUTOLOGO,KALAMA,BUTOLOOGO S.C HQRS,381,5,0,4,17,235,261,7,268,0,O-31-166-02-01-01
MUBENDE,BUWEKULA COUNTY,BUTOLOGO,KALAMA,KITOKOTA P.S.,231,2,4,4,4,164,178,6,184,0,O-31-166-02-01-02
MUBENDE,BUWEKULA COUNTY,BUTOLOGO,KALAMA,KIFUMBIRA/MUGAMBA CHURCH,221,0,0,0,0,149,149,3,152,0,O-31-166-02-01-03
MUBENDE,BUWEKULA COUNTY,BUTOLOGO,KANYOGOGA,KANYOGOGA,567,0,4,1,11,368,384,21,405,0,O-31-166-02-02-01
MUBENDE,BUWEKULA COUNTY,BUTOLOGO,KANYOGOGA,KYAKAJJA,473,0,0,4,7,295,306,3,309,0,O-31-166-02-02-02
MUBENDE,BUWEKULA COUNTY,BUTOLOGO,KANYOGOGA,BIWALWE,405,2,0,1,13,258,274,37,311,0,O-31-166-02-02-03
MUBENDE,BUWEKULA COUNTY,BUTOLOGO,KASOLOKAMPONYE,KIRUUMA P/S,676,3,2,11,42,426,484,21,505,0,O-31-166-02-03-01
MUBENDE,BUWEKULA COUNTY,BUTOLOGO,KASOLOKAMPONYE,KIJAAGI PRIMARY SCHOOL,266,0,0,0,17,209,226,3,229,0,O-31-166-02-03-02
MUBENDE,BUWEKULA COUNTY,BUTOLOGO,KIDONGO,KIDONGO,904,1,0,6,9,606,622,6,628,0,O-31-166-02-04-01
MUBENDE,BUWEKULA COUNTY,BUTOLOGO,KIDONGO,NSANVU CHURCH,613,4,1,6,17,380,408,23,431,0,O-31-166-02-04-02
MUBENDE,BUWEKULA COUNTY,BUTOLOGO,KISAGAZI,KISAGAZI R/C CHURCH,618,0,2,3,11,363,379,22,401,0,O-31-166-02-05-01
MUBENDE,BUWEKULA COUNTY,BUTOLOGO,KISAGAZI,KAWOLOLO TC,339,1,2,2,5,199,209,6,215,0,O-31-166-02-05-02
MUBENDE,BUWEKULA COUNTY,BUTOLOGO,KITUULE,KAMWANZA KITAWULUZI,706,2,3,4,44,520,573,5,578,0,O-31-166-02-06-01
MUBENDE,BUWEKULA COUNTY,BUTOLOGO,KITUULE,KIRWANYI CHURCH,201,1,0,2,10,149,162,5,167,0,O-31-166-02-06-02
MUBENDE,BUWEKULA COUNTY,BUTOLOGO,MAKUUKUULU,MAKUKULU P.S.,508,0,0,1,30,309,340,2,342,0,O-31-166-02-07-01
MUBENDE,BUWEKULA COUNTY,BUTOLOGO,MAKUUKUULU,KAKONYI,964,3,0,7,20,671,701,16,717,0,O-31-166-02-07-02
MUBENDE,BUWEKULA COUNTY,KASAMBYA,BUBANDA,BUBANDA,570,0,1,2,37,411,451,4,455,0,O-31-166-03-01-01
MUBENDE,BUWEKULA COUNTY,KASAMBYA,BUBANDA,KABAALE,303,0,0,0,7,202,209,3,212,0,O-31-166-03-01-02
MUBENDE,BUWEKULA COUNTY,KASAMBYA,KABALUNGI,NKOKONJERU P/S,671,4,1,2,30,467,504,7,511,0,O-31-166-03-02-01
MUBENDE,BUWEKULA COUNTY,KASAMBYA,KABALUNGI,KASASA P. S. / KASASA A,701,1,0,1,20,427,449,8,457,0,O-31-166-03-02-02
MUBENDE,BUWEKULA COUNTY,KASAMBYA,KABALUNGI,KASASA P. S. / KASASA B,865,3,1,1,12,643,660,0,660,0,O-31-166-03-02-03
MUBENDE,BUWEKULA COUNTY,KASAMBYA,KABALUNGI,KABALUNGI,327,0,0,0,8,206,214,5,219,0,O-31-166-03-02-04
MUBENDE,BUWEKULA COUNTY,KASAMBYA,KABBO,KANYARUGIRI TRADING CENTRE,602,1,0,1,90,348,440,3,443,0,O-31-166-03-03-01
MUBENDE,BUWEKULA COUNTY,KASAMBYA,KABBO,KISONGORA P. SCHOOL A,754,0,0,2,39,547,588,9,597,0,O-31-166-03-03-02
MUBENDE,BUWEKULA COUNTY,KASAMBYA,KABBO,NAKAWALA PRIAMRY SCHOOL A/,759,2,0,2,75,372,451,15,466,0,O-31-166-03-03-03
MUBENDE,BUWEKULA COUNTY,KASAMBYA,KABBO,NAKAWALA PRIMARY SCHOOL B/,973,0,0,2,70,492,564,12,576,0,O-31-166-03-03-04
MUBENDE,BUWEKULA COUNTY,KASAMBYA,KABBO,KISONGORA P. SCHOOL B,622,1,1,2,32,427,463,11,474,0,O-31-166-03-03-05
MUBENDE,BUWEKULA COUNTY,KASAMBYA,KABBO,NAKAWALA PRIAMRY SCHOOL A/,597,1,1,4,64,283,353,7,360,0,O-31-166-03-03-06
MUBENDE,BUWEKULA COUNTY,KASAMBYA,KABBO,KANYARUGIRI OUTSIDE GUARD (,486,1,0,1,90,348,440,3,443,0,O-31-166-03-03-07
MUBENDE,BUWEKULA COUNTY,KASAMBYA,KABBO,KANYARUGIRI OUTSIDE GUARD(M,519,1,0,0,31,420,452,48,500,0,O-31-166-03-03-08
MUBENDE,BUWEKULA COUNTY,KASAMBYA,KASAMBYA,NAKASAGGA,689,1,0,4,53,434,492,3,495,0,O-31-166-03-04-01
MUBENDE,BUWEKULA COUNTY,KASAMBYA,KASAMBYA,KISIZIRE PRI. SCHOOL,435,3,1,1,25,279,309,4,313,0,O-31-166-03-04-02
MUBENDE,BUWEKULA COUNTY,KASAMBYA,KASAMBYA,KASAMBYA S.C HQRS C,1009,4,0,2,153,558,717,10,727,0,O-31-166-03-04-03
MUBENDE,BUWEKULA COUNTY,KASAMBYA,KASAMBYA,KASAMBYA MOSLEM PRI. SCHOO,1039,1,2,4,107,393,507,14,521,0,O-31-166-03-04-04
MUBENDE,BUWEKULA COUNTY,KASAMBYA,KASAMBYA,BUTUTI TC,488,1,1,1,25,316,344,10,354,0,O-31-166-03-04-05
MUBENDE,BUWEKULA COUNTY,KASAMBYA,KASAMBYA,BULONZI TC,301,1,0,0,21,190,212,3,215,0,O-31-166-03-04-06
MUBENDE,BUWEKULA COUNTY,KASAMBYA,KIGANDO,BUWATA P.S. A,895,5,0,1,32,603,641,11,652,0,O-31-166-03-05-01
MUBENDE,BUWEKULA COUNTY,KASAMBYA,KIGANDO,BUWATA P.S. B/KIGANDO A,888,2,3,7,56,523,591,13,604,0,O-31-166-03-05-02
MUBENDE,BUWEKULA COUNTY,KASAMBYA,KIGANDO,BUWATA P.S. C/MUGOLODDE,629,1,0,1,18,424,444,8,452,0,O-31-166-03-05-03
MUBENDE,BUWEKULA COUNTY,KASAMBYA,KIGANDO,LWAKILAGALA,295,2,0,2,13,217,234,3,237,0,O-31-166-03-05-04
MUBENDE,BUWEKULA COUNTY,KASAMBYA,KIGANDO,KISIITA,351,0,1,1,14,284,300,6,306,0,O-31-166-03-05-05
MUBENDE,BUWEKULA COUNTY,KASAMBYA,KIGANDO,BUWATA P.S. B/KIGANDO B,437,0,2,4,27,279,312,9,321,0,O-31-166-03-05-06
MUBENDE,BUWEKULA COUNTY,KASAMBYA,KIRUME,KIWUBA,435,2,1,2,16,210,231,2,233,0,O-31-166-03-06-01
MUBENDE,BUWEKULA COUNTY,KASAMBYA,KIRUME,KIRUME,366,0,0,0,37,190,227,6,233,0,O-31-166-03-06-02
MUBENDE,BUWEKULA COUNTY,KASAMBYA,KIRUME,NDEEBA TC,346,1,1,5,24,221,252,2,254,0,O-31-166-03-06-03
MUBENDE,BUWEKULA COUNTY,KASAMBYA,KIRUME,KIRANGIRA,500,0,1,0,20,319,340,3,343,0,O-31-166-03-06-04
MUBENDE,BUWEKULA COUNTY,KASAMBYA,KIRUME,RUBONA A,419,2,0,3,14,261,280,12,292,0,O-31-166-03-06-05
MUBENDE,BUWEKULA COUNTY,KASAMBYA,KIRUME,RUBONA,768,0,0,4,43,463,510,0,510,0,O-31-166-03-06-06
MUBENDE,BUWEKULA COUNTY,KASAMBYA,KIYITA,NANGABO,344,1,1,0,30,207,239,9,248,0,O-31-166-03-07-01
MUBENDE,BUWEKULA COUNTY,KASAMBYA,KIYITA,KIYITA HALL,674,1,0,5,30,400,436,13,449,0,O-31-166-03-07-02
MUBENDE,BUWEKULA COUNTY,KASAMBYA,KIYITA,KITERA MARKET,842,3,0,3,11,625,642,9,651,0,O-31-166-03-07-03
MUBENDE,BUWEKULA COUNTY,KASAMBYA,KIYITA,KIWAMIREMBE,263,0,2,0,5,160,167,4,171,0,O-31-166-03-07-04
MUBENDE,BUWEKULA COUNTY,KASAMBYA,KIYITA,KIZIZI,293,0,0,2,14,148,164,7,171,0,O-31-166-03-07-05
MUBENDE,BUWEKULA COUNTY,KASAMBYA,KIYITA,BAMUSUTA,267,0,0,1,21,168,190,1,191,0,O-31-166-03-07-06
MUBENDE,BUWEKULA COUNTY,KASAMBYA,KIYONGA,IKULA,509,1,0,0,9,394,404,6,410,0,O-31-166-03-08-01
MUBENDE,BUWEKULA COUNTY,KASAMBYA,KIYONGA,KATTAMBOGO,411,1,0,2,7,343,353,0,353,0,O-31-166-03-08-02
MUBENDE,BUWEKULA COUNTY,KASAMBYA,KYAKASA,KYAKASA,511,1,0,1,2,100,104,0,104,0,O-31-166-03-09-01
MUBENDE,BUWEKULA COUNTY,KASAMBYA,KYAKASA,RUKOBA TC,644,2,1,1,15,592,611,11,622,0,O-31-166-03-09-02
MUBENDE,BUWEKULA COUNTY,KASAMBYA,KYAKASA,KASHENYI,110,1,0,1,2,100,104,0,104,0,O-31-166-03-09-03
MUBENDE,BUWEKULA COUNTY,KASAMBYA,LUBIMBIRI,LWEMISEGU,912,2,1,4,24,579,610,18,628,0,O-31-166-03-10-01
MUBENDE,BUWEKULA COUNTY,KASAMBYA,LUBIMBIRI,LUBIMBIRI,971,0,0,3,12,370,385,8,393,0,O-31-166-03-10-02
MUBENDE,BUWEKULA COUNTY,KASAMBYA,LUBIMBIRI,KAROKALUNGI TC,38,0,0,0,1,13,14,0,14,0,O-31-166-03-10-03
MUBENDE,BUWEKULA COUNTY,KASAMBYA,LUBIMBIRI,KAFUNDEZI,398,0,0,2,25,257,284,0,284,0,O-31-166-03-10-04
MUBENDE,BUWEKULA COUNTY,KASAMBYA,LUSIBA,KYAMUGULUMA A,814,1,1,2,46,437,487,25,512,0,O-31-166-03-11-01
MUBENDE,BUWEKULA COUNTY,KASAMBYA,LUSIBA,MAWUJJO (A-L),521,1,0,5,12,324,342,10,352,0,O-31-166-03-11-02
MUBENDE,BUWEKULA COUNTY,KASAMBYA,LUSIBA,KATEGA KITAWULUZI/KATEGA A,461,1,2,0,8,297,308,9,317,0,O-31-166-03-11-03
MUBENDE,BUWEKULA COUNTY,KASAMBYA,LUSIBA,KACWAMANGU,894,1,0,10,39,544,594,21,615,0,O-31-166-03-11-04
MUBENDE,BUWEKULA COUNTY,KASAMBYA,LUSIBA,KYAMUGULUMA B,646,1,0,6,37,338,382,21,403,0,O-31-166-03-11-05
MUBENDE,BUWEKULA COUNTY,KASAMBYA,LUSIBA,KATEGA KITAWULUZI/KATEGA B,701,1,1,1,18,489,510,8,518,0,O-31-166-03-11-06
MUBENDE,BUWEKULA COUNTY,KASAMBYA,LUSIBA,MAWUJJO (M-Z),499,2,2,2,24,316,346,5,351,0,O-31-166-03-11-07
MUBENDE,BUWEKULA COUNTY,KASAMBYA,MAYINAYINA,KILOLERO A,533,2,0,7,30,300,339,3,342,0,O-31-166-03-12-01
MUBENDE,BUWEKULA COUNTY,KASAMBYA,MAYINAYINA,MUYINAYINA P.S. B/KITONZI,611,0,0,2,25,358,385,11,396,0,O-31-166-03-12-02
MUBENDE,BUWEKULA COUNTY,KASAMBYA,MAYINAYINA,NKINGA TC,848,3,0,3,22,338,366,9,375,0,O-31-166-03-12-03
MUBENDE,BUWEKULA COUNTY,KASAMBYA,MAYINAYINA,MUYINAYINA P.S. A/KILOLERO B,969,2,0,4,21,382,409,19,428,0,O-31-166-03-12-04
MUBENDE,BUWEKULA COUNTY,KASAMBYA,NABINGOLA,KASEESA P.S.,593,2,1,0,20,442,465,12,477,0,O-31-166-03-13-01
MUBENDE,BUWEKULA COUNTY,KASAMBYA,NABINGOLA,NABINGOOLA P.S.,670,1,1,0,38,362,402,10,412,0,O-31-166-03-13-02
MUBENDE,BUWEKULA COUNTY,KASAMBYA,NABINGOLA,GWANIKA,476,1,0,1,28,304,334,10,344,0,O-31-166-03-13-03
MUBENDE,BUWEKULA COUNTY,KASAMBYA,NABINGOLA,KIBAALE TC,477,0,0,2,25,300,327,2,329,0,O-31-166-03-13-04
MUBENDE,BUWEKULA COUNTY,KASAMBYA,NABINGOLA,LWEMIVUBO,374,0,0,0,29,237,266,6,272,0,O-31-166-03-13-05
MUBENDE,BUWEKULA COUNTY,KITENGA,BUGONZI,KIBUYE COMM. CENTER,225,3,1,0,12,169,185,4,189,0,O-31-166-04-01-01
MUBENDE,BUWEKULA COUNTY,KITENGA,BUGONZI,KABUNYONYI P.S. A/NAKASEETA,263,0,0,3,27,148,178,2,180,0,O-31-166-04-01-02
MUBENDE,BUWEKULA COUNTY,KITENGA,BUGONZI,KABUNYONYI P/S B/BUGONZI,397,1,3,3,40,242,289,3,292,0,O-31-166-04-01-03
MUBENDE,BUWEKULA COUNTY,KITENGA,BUGONZI,KABUNYONYI P.S. C/KABUNYONY,517,1,1,5,60,260,327,7,334,0,O-31-166-04-01-04
MUBENDE,BUWEKULA COUNTY,KITENGA,BUGONZI,KITAAMA P.S.,252,0,0,3,17,67,87,1,88,0,O-31-166-04-01-05
MUBENDE,BUWEKULA COUNTY,KITENGA,BUGONZI,KATETE,317,0,0,1,18,174,193,2,195,0,O-31-166-04-01-06
MUBENDE,BUWEKULA COUNTY,KITENGA,BUGONZI,BUSWABWERA,149,0,0,0,4,141,145,4,149,0,O-31-166-04-01-07
MUBENDE,BUWEKULA COUNTY,KITENGA,BUGONZI,NSENGWE,344,1,0,3,24,194,222,11,233,0,O-31-166-04-01-08
MUBENDE,BUWEKULA COUNTY,KITENGA,BUGONZI,BUZOOBA,370,0,0,2,45,199,246,0,246,0,O-31-166-04-01-09
MUBENDE,BUWEKULA COUNTY,KITENGA,BUSOBA (KAYEBE),KAWUMULO P.S./KAWUMULO A,779,1,0,1,30,433,465,6,471,0,O-31-166-04-02-01
MUBENDE,BUWEKULA COUNTY,KITENGA,BUSOBA (KAYEBE),BUTAYUNJA,399,2,0,1,6,295,304,4,308,0,O-31-166-04-02-02
MUBENDE,BUWEKULA COUNTY,KITENGA,BUSOBA (KAYEBE),KIVELA (A-L),327,1,0,2,21,197,221,4,225,0,O-31-166-04-02-03
MUBENDE,BUWEKULA COUNTY,KITENGA,BUSOBA (KAYEBE),KIVELA (M-Z),430,2,0,5,26,245,278,5,283,0,O-31-166-04-02-04
MUBENDE,BUWEKULA COUNTY,KITENGA,KABYUMA,BUSHENYA P.S. A,668,4,4,4,45,363,420,6,426,0,O-31-166-04-03-01
MUBENDE,BUWEKULA COUNTY,KITENGA,KABYUMA,SUNGA A,738,11,3,10,49,335,408,9,417,0,O-31-166-04-03-02
MUBENDE,BUWEKULA COUNTY,KITENGA,KABYUMA,GOGWA TRADING CENTRE,596,5,1,9,22,375,412,7,419,0,O-31-166-04-03-03
MUBENDE,BUWEKULA COUNTY,KITENGA,KABYUMA,BUSHENYA P.S. B,647,4,0,8,25,364,401,6,407,0,O-31-166-04-03-04
MUBENDE,BUWEKULA COUNTY,KITENGA,KABYUMA,SUNGA B,802,2,4,10,38,413,467,23,490,0,O-31-166-04-03-05
MUBENDE,BUWEKULA COUNTY,KITENGA,KABYUMA,KAMUSENENE,384,3,0,4,19,269,295,2,297,0,O-31-166-04-03-06
MUBENDE,BUWEKULA COUNTY,KITENGA,KAGOMA,KITENGA S.C HQRS I,636,3,1,6,38,392,440,5,445,0,O-31-166-04-04-01
MUBENDE,BUWEKULA COUNTY,KITENGA,KAGOMA,KATTABALANGA P.S. A,916,5,1,6,84,538,634,9,643,0,O-31-166-04-04-02
MUBENDE,BUWEKULA COUNTY,KITENGA,KAGOMA,KITENGA DISPENSARY A,738,0,3,2,64,336,405,0,405,0,O-31-166-04-04-03
MUBENDE,BUWEKULA COUNTY,KITENGA,KAGOMA,BUGALYA,692,1,2,6,23,460,492,0,492,0,O-31-166-04-04-04
MUBENDE,BUWEKULA COUNTY,KITENGA,KAGOMA,KITENGA DISPENSARY B,814,6,4,7,75,358,450,17,467,0,O-31-166-04-04-05
MUBENDE,BUWEKULA COUNTY,KITENGA,KAGOMA,BULYANA,301,0,0,1,28,160,189,4,193,0,O-31-166-04-04-06
MUBENDE,BUWEKULA COUNTY,KITENGA,KALONGA (KABINGA),KIRUMBI PRIMARY SCHOOL A,437,2,0,3,24,219,248,4,252,0,O-31-166-04-05-01
MUBENDE,BUWEKULA COUNTY,KITENGA,KALONGA (KABINGA),KALONGA T.C. (A-M),424,1,2,4,84,156,247,6,253,0,O-31-166-04-05-02
MUBENDE,BUWEKULA COUNTY,KITENGA,KALONGA (KABINGA),KALEMBE TC,583,2,0,1,50,288,341,3,344,0,O-31-166-04-05-03
MUBENDE,BUWEKULA COUNTY,KITENGA,KALONGA (KABINGA),BUWUNIRO A,583,3,1,7,43,386,440,5,445,0,O-31-166-04-05-04
MUBENDE,BUWEKULA COUNTY,KITENGA,KALONGA (KABINGA),KINYIGA B,624,3,0,4,64,304,375,4,379,0,O-31-166-04-05-05
MUBENDE,BUWEKULA COUNTY,KITENGA,KALONGA (KABINGA),KIRUMBI PRIMARY SCHOOL B,535,3,3,1,26,276,309,14,323,0,O-31-166-04-05-06
MUBENDE,BUWEKULA COUNTY,KITENGA,KALONGA (KABINGA),BUWUNIRO B,613,3,1,7,43,386,440,5,445,0,O-31-166-04-05-07
MUBENDE,BUWEKULA COUNTY,KITENGA,KALONGA (KABINGA),KINYIGA,431,3,1,10,33,270,317,7,324,0,O-31-166-04-05-08
MUBENDE,BUWEKULA COUNTY,KITENGA,KALONGA (KABINGA),KALONGA T.C (N-Z),468,1,0,2,77,205,285,14,299,0,O-31-166-04-05-09
MUBENDE,BUWEKULA COUNTY,KITENGA,KALONGA (KABINGA),KIJUUYA,182,1,1,2,8,115,127,1,128,0,O-31-166-04-05-10
MUBENDE,BUWEKULA COUNTY,KIYUNI,KANSEERA,KANSEERA P.S . /KANSEERA,508,4,1,12,48,280,345,19,364,0,O-31-166-05-01-01
MUBENDE,BUWEKULA COUNTY,KIYUNI,KANSEERA,KAWUULA PRI. SCHOOL,389,0,1,3,16,241,261,0,261,0,O-31-166-05-01-02
MUBENDE,BUWEKULA COUNTY,KIYUNI,KATENTE,KIYUUNI S/C HQTRS A,637,2,3,0,44,322,371,17,388,0,O-31-166-05-02-01
MUBENDE,BUWEKULA COUNTY,KIYUNI,KATENTE,KYAWOGA,383,0,0,0,12,237,249,3,252,0,O-31-166-05-02-02
MUBENDE,BUWEKULA COUNTY,KIYUNI,KATENTE,KAWALALA,283,1,1,1,12,182,197,13,210,0,O-31-166-05-02-03
MUBENDE,BUWEKULA COUNTY,KIYUNI,KATENTE,BUWANDE,213,2,0,1,19,111,133,7,140,0,O-31-166-05-02-04
MUBENDE,BUWEKULA COUNTY,KIYUNI,KATENTE,BUTUMI,303,1,1,2,14,175,193,12,205,0,O-31-166-05-02-05
MUBENDE,BUWEKULA COUNTY,KIYUNI,KATENTE,KIGAMBA,452,3,0,3,16,264,286,18,304,0,O-31-166-05-02-06
MUBENDE,BUWEKULA COUNTY,KIYUNI,KAWUMULWA,MAZOOBA STORE,466,2,0,5,18,275,300,18,318,0,O-31-166-05-03-01
MUBENDE,BUWEKULA COUNTY,KIYUNI,KAWUMULWA,KAWUMULWA PRI. SCHOOL,292,2,1,8,18,166,195,8,203,0,O-31-166-05-03-02
MUBENDE,BUWEKULA COUNTY,KIYUNI,KAWUMULWA,MUWOKO,326,3,0,1,19,222,245,17,262,0,O-31-166-05-03-03
MUBENDE,BUWEKULA COUNTY,KIYUNI,KAWUMULWA,KIYUYA,391,3,0,5,44,226,278,12,290,0,O-31-166-05-03-04
MUBENDE,BUWEKULA COUNTY,KIYUNI,KAYINJA,BUKOBA P.S.,861,1,0,4,34,588,627,12,639,0,O-31-166-05-04-01
MUBENDE,BUWEKULA COUNTY,KIYUNI,KAYINJA,KATOMA P.S.,499,3,3,4,52,313,375,6,381,0,O-31-166-05-04-02
MUBENDE,BUWEKULA COUNTY,KIYUNI,KIJUMBA,GOMERO P.W.D. A/GOMERO,427,1,0,2,5,292,300,10,310,0,O-31-166-05-05-01
MUBENDE,BUWEKULA COUNTY,KIYUNI,KIJUMBA,GOMERO P.W.D. B/KIJUMBA,610,2,0,0,31,405,438,13,451,0,O-31-166-05-05-02
MUBENDE,BUWEKULA COUNTY,KIYUNI,KIJUMBA,KAKIGANDO,623,7,2,3,21,444,477,11,488,0,O-31-166-05-05-03
MUBENDE,BUWEKULA COUNTY,KIYUNI,MIJUNWA,MIJUNWA TODDAMABEGA STORE,475,4,1,4,30,322,361,0,361,0,O-31-166-05-06-01
MUBENDE,BUWEKULA COUNTY,KIYUNI,MIJUNWA,MIJUNWA TODDAMABEGA STORE,502,1,0,4,21,320,346,18,364,0,O-31-166-05-06-02
MUBENDE,BUWEKULA COUNTY,MADUDU,KABULAMULIRO,KABULAMULIRO P.S. A/KABULAMU,887,3,0,14,83,545,645,11,656,0,O-31-166-06-01-01
MUBENDE,BUWEKULA COUNTY,MADUDU,KABULAMULIRO,KABULAMULIRO P.S. B/BUKADDE,1278,6,2,9,41,797,855,53,908,0,O-31-166-06-01-02
MUBENDE,BUWEKULA COUNTY,MADUDU,KABULAMULIRO,KASAMBYA,896,2,2,3,54,651,712,12,724,0,O-31-166-06-01-03
MUBENDE,BUWEKULA COUNTY,MADUDU,KABULAMULIRO,BUKOBA LEARNING CENTRE,316,0,0,3,25,221,249,7,256,0,O-31-166-06-01-04
MUBENDE,BUWEKULA COUNTY,MADUDU,KABULAMULIRO,LUTEETE,721,3,0,3,13,550,569,25,594,0,O-31-166-06-01-05
MUBENDE,BUWEKULA COUNTY,MADUDU,KAKENZI,KAKENZI,705,7,0,6,55,386,454,27,481,0,O-31-166-06-02-01
MUBENDE,BUWEKULA COUNTY,MADUDU,KAKENZI,NGABANO T.C.,546,3,1,8,40,344,396,3,399,0,O-31-166-06-02-02
MUBENDE,BUWEKULA COUNTY,MADUDU,KIKOMA,KIKOMA P.S.,302,1,1,2,9,176,189,11,200,0,O-31-166-06-03-01
MUBENDE,BUWEKULA COUNTY,MADUDU,KIKOMA,KAKINDU TC,482,0,0,5,15,315,335,19,354,0,O-31-166-06-03-02
MUBENDE,BUWEKULA COUNTY,MADUDU,NALUWONDWA,NALUWONDWA TC,793,3,0,9,72,430,514,19,533,0,O-31-166-06-04-01
MUBENDE,BUWEKULA COUNTY,MADUDU,NALUWONDWA,KITEMBA,1164,5,0,8,137,549,699,68,767,0,O-31-166-06-04-02
MUBENDE,BUWEKULA COUNTY,MADUDU,NALUWONDWA,KISOOLO,445,1,3,6,11,307,328,2,330,0,O-31-166-06-04-03
MUBENDE,BUWEKULA COUNTY,MADUDU,NALUWONDWA,NAKASOZI TC,368,4,1,4,4,253,266,16,282,0,O-31-166-06-04-04
MUBENDE,BUWEKULA COUNTY,MUBENDE T.C.,KASAANA,KASAANA PLAY GROUND (A-L),952,5,0,5,179,264,453,3,456,0,O-31-166-07-01-01
MUBENDE,BUWEKULA COUNTY,MUBENDE T.C.,KASAANA,KASAANA PLAY GROUND (M-NAM),1134,8,2,1,94,355,460,8,468,0,O-31-166-07-01-02
MUBENDE,BUWEKULA COUNTY,MUBENDE T.C.,KASAANA,KASAANA PLAY GROUND C/MAIN,999,2,1,2,114,269,388,13,401,0,O-31-166-07-01-03
MUBENDE,BUWEKULA COUNTY,MUBENDE T.C.,KASAANA,KASENYI P/S,448,3,0,4,52,147,206,4,210,0,O-31-166-07-01-04
MUBENDE,BUWEKULA COUNTY,MUBENDE T.C.,KASAANA,MAYORS GARDEN,549,2,0,2,62,204,270,11,281,0,O-31-166-07-01-05
MUBENDE,BUWEKULA COUNTY,MUBENDE T.C.,KASAANA,KASAANA PLAY GROUND (NAN-Z),921,3,2,4,160,284,453,5,458,0,O-31-166-07-01-06
MUBENDE,BUWEKULA COUNTY,MUBENDE T.C.,KASENYI/CALTEX,DISTRICT LABOUR OFFICES,675,5,1,4,91,237,338,14,352,0,O-31-166-07-02-01
MUBENDE,BUWEKULA COUNTY,MUBENDE T.C.,KASENYI/CALTEX,DISTRICT LABOUR OFFICES B,983,10,0,5,165,345,525,15,540,0,O-31-166-07-02-02
MUBENDE,BUWEKULA COUNTY,MUBENDE T.C.,KASENYI/CALTEX,KIBYAYI,389,3,0,0,40,234,277,23,300,0,O-31-166-07-02-03
MUBENDE,BUWEKULA COUNTY,MUBENDE T.C.,KASENYI/CALTEX,TIGER P.SCHOOL (A-A),690,2,5,2,37,192,238,7,245,0,O-31-166-07-02-04
MUBENDE,BUWEKULA COUNTY,MUBENDE T.C.,KASENYI/CALTEX,TIGER P.SCHOOL (B-J),532,1,0,0,36,217,254,3,257,0,O-31-166-07-02-05
MUBENDE,BUWEKULA COUNTY,MUBENDE T.C.,KASENYI/CALTEX,TIGER P.SCHOOL (L-N),776,3,0,4,42,272,321,9,330,0,O-31-166-07-02-06
MUBENDE,BUWEKULA COUNTY,MUBENDE T.C.,KASENYI/CALTEX,TIGER P.SCHOOL (P-Z),383,0,0,0,24,160,184,6,190,0,O-31-166-07-02-07
MUBENDE,BUWEKULA COUNTY,MUBENDE T.C.,KASENYI/CALTEX,TIGER P.SCHOOL ( K ),443,0,0,1,25,179,205,1,206,0,O-31-166-07-02-08
MUBENDE,BUWEKULA COUNTY,MUBENDE T.C.,KASENYI/CALTEX,TIGER P. SCHOOL ( O ),631,0,2,1,65,202,270,1,271,0,O-31-166-07-02-09
MUBENDE,BUWEKULA COUNTY,MUBENDE T.C.,KYATEREKERA,ST.MARY'S PLAYGROUND A/KYAT,169,3,1,1,32,54,91,0,91,0,O-31-166-07-03-01
MUBENDE,BUWEKULA COUNTY,MUBENDE T.C.,KYATEREKERA,ST.MARY'S PLAYGROUND B/KATW,551,2,0,4,66,229,301,11,312,0,O-31-166-07-03-02
MUBENDE,BUWEKULA COUNTY,MUBENDE T.C.,KYATEREKERA,ST.MARY'S PLAYGROUND A/KYAT,346,2,0,4,62,124,192,1,193,0,O-31-166-07-03-03
MUKONO,MUKONO CTY NORTH,GOMA,BUKERERE,BUKERERE,571,4,1,36,120,216,377,14,391,0,O-32-176-01-01-01
MUKONO,MUKONO CTY NORTH,GOMA,BUKERERE,NAKAGERE,618,0,0,17,159,259,435,6,441,0,O-32-176-01-01-02
MUKONO,MUKONO CTY NORTH,GOMA,BUKERERE,KYESEREKA,740,5,1,33,146,324,509,16,525,0,O-32-176-01-01-03
MUKONO,MUKONO CTY NORTH,GOMA,BUKERERE,NAMASIGA,317,2,0,14,61,165,242,5,247,0,O-32-176-01-01-04
MUKONO,MUKONO CTY NORTH,GOMA,BUKERERE,KIWANGO,377,1,0,10,151,132,294,4,298,0,O-32-176-01-01-05
MUKONO,MUKONO CTY NORTH,GOMA,BUKERERE,PAPAATI,382,2,3,3,83,162,253,3,256,0,O-32-176-01-01-06
MUKONO,MUKONO CTY NORTH,GOMA,MISINDYE,LUMULI,419,2,1,12,100,150,265,9,274,0,O-32-176-01-02-01
MUKONO,MUKONO CTY NORTH,GOMA,MISINDYE,SONDE,789,3,1,14,241,276,535,8,543,0,O-32-176-01-02-02
MUKONO,MUKONO CTY NORTH,GOMA,MISINDYE,JINJA,498,1,0,14,141,189,345,7,352,0,O-32-176-01-02-03
MUKONO,MUKONO CTY NORTH,GOMA,MISINDYE,JOGO PRIMARY SCHOOL,663,5,2,15,170,271,463,17,480,0,O-32-176-01-02-04
MUKONO,MUKONO CTY NORTH,GOMA,MISINDYE,MISINDYE,512,0,2,19,146,177,344,7,351,0,O-32-176-01-02-05
MUKONO,MUKONO CTY NORTH,GOMA,NANTABULIRWA,NAMILYANGO,745,3,1,12,146,285,447,2,449,0,O-32-176-01-03-01
MUKONO,MUKONO CTY NORTH,GOMA,NANTABULIRWA,KIWANGA I,1046,6,2,18,255,288,569,11,580,0,O-32-176-01-03-02
MUKONO,MUKONO CTY NORTH,GOMA,NANTABULIRWA,KIWANGA II,758,4,2,12,194,191,403,7,410,0,O-32-176-01-03-03
MUKONO,MUKONO CTY NORTH,GOMA,NANTABULIRWA,NANTABILIRWA I (A - M),384,2,1,11,118,127,259,0,259,0,O-32-176-01-03-04
MUKONO,MUKONO CTY NORTH,GOMA,NANTABULIRWA,NANTABULIRWA II,345,0,2,9,89,134,234,9,243,0,O-32-176-01-03-05
MUKONO,MUKONO CTY NORTH,GOMA,NANTABULIRWA,DEGEYA CHURCH,163,1,2,4,33,73,113,3,116,0,O-32-176-01-03-06
MUKONO,MUKONO CTY NORTH,GOMA,NANTABULIRWA,NANTABILIRWA I (N - Z),473,3,0,12,124,168,307,6,313,0,O-32-176-01-03-07
MUKONO,MUKONO CTY NORTH,GOMA,NANTABULIRWA,KIWANGA UMEA P/S,322,1,0,8,81,80,170,2,172,0,O-32-176-01-03-08
MUKONO,MUKONO CTY NORTH,GOMA,NYENJE,NYENJE,706,3,1,17,217,264,502,12,514,0,O-32-176-01-04-01
MUKONO,MUKONO CTY NORTH,GOMA,NYENJE,BAJJO,583,3,3,16,189,192,403,6,409,0,O-32-176-01-04-02
MUKONO,MUKONO CTY NORTH,GOMA,NYENJE,NSAMBWE,267,2,0,9,62,114,187,3,190,0,O-32-176-01-04-03
MUKONO,MUKONO CTY NORTH,GOMA,NYENJE,KIGUNGA (PAUL MUKASA SS),988,9,3,16,358,275,661,12,673,0,O-32-176-01-04-04
MUKONO,MUKONO CTY NORTH,GOMA,SEETA,SEETA I,992,3,3,23,308,233,570,5,575,0,O-32-176-01-05-01
MUKONO,MUKONO CTY NORTH,GOMA,SEETA,SEETA II A,788,5,1,18,283,164,471,1,472,0,O-32-176-01-05-02
MUKONO,MUKONO CTY NORTH,GOMA,SEETA,SEETA III A,642,0,1,8,193,112,314,5,319,0,O-32-176-01-05-03
MUKONO,MUKONO CTY NORTH,GOMA,SEETA,SEETA IV,843,2,1,11,252,195,461,2,463,0,O-32-176-01-05-04
MUKONO,MUKONO CTY NORTH,GOMA,SEETA,SSEKATAWA'S JUNCTION,770,2,4,23,237,256,522,2,524,0,O-32-176-01-05-05
MUKONO,MUKONO CTY NORTH,GOMA,SEETA,SEETA NTINDA I,744,2,1,16,204,176,399,2,401,0,O-32-176-01-05-06
MUKONO,MUKONO CTY NORTH,GOMA,SEETA,KIROWOOZA,769,0,1,20,250,234,505,8,513,0,O-32-176-01-05-07
MUKONO,MUKONO CTY NORTH,GOMA,SEETA,SEETA II B,941,7,3,16,258,215,499,10,509,0,O-32-176-01-05-08
MUKONO,MUKONO CTY NORTH,GOMA,SEETA,SEETA III B,973,0,2,6,258,206,472,7,479,0,O-32-176-01-05-09
MUKONO,MUKONO CTY NORTH,GOMA,SEETA,BAGGALA,653,1,0,9,180,118,308,0,308,0,O-32-176-01-05-10
MUKONO,MUKONO CTY NORTH,GOMA,SEETA,BUGOBA MT. ELIIJAH JUNIOR SCH,488,0,1,10,159,156,326,4,330,0,O-32-176-01-05-11
MUKONO,MUKONO CTY NORTH,GOMA,SEETA,SEETA NTINDA II,519,1,0,17,147,95,260,2,262,0,O-32-176-01-05-12
MUKONO,MUKONO CTY NORTH,KYAMPISI,BULIJJO,NAMMERE,619,3,1,8,128,252,392,15,407,0,O-32-176-02-01-01
MUKONO,MUKONO CTY NORTH,KYAMPISI,BULIJJO,BUNYIRI,684,3,4,5,213,168,393,7,400,0,O-32-176-02-01-02
MUKONO,MUKONO CTY NORTH,KYAMPISI,BULIJJO,KASOZI,634,4,1,1,121,241,368,25,393,0,O-32-176-02-01-03
MUKONO,MUKONO CTY NORTH,KYAMPISI,DDUNDU,KALAGALA,597,0,0,8,135,256,399,12,411,0,O-32-176-02-02-01
MUKONO,MUKONO CTY NORTH,KYAMPISI,DDUNDU,BUNTABA,446,4,0,15,95,197,311,17,328,0,O-32-176-02-02-02
MUKONO,MUKONO CTY NORTH,KYAMPISI,DDUNDU,NAKASAJJA,507,0,0,20,182,180,382,12,394,0,O-32-176-02-02-03
MUKONO,MUKONO CTY NORTH,KYAMPISI,DDUNDU,KASAYI,783,4,4,15,144,316,483,21,504,0,O-32-176-02-02-04
MUKONO,MUKONO CTY NORTH,KYAMPISI,KABEMBE,KIYUNGA,748,2,0,6,194,232,434,2,436,0,O-32-176-02-03-01
MUKONO,MUKONO CTY NORTH,KYAMPISI,KABEMBE,KABEMBE (A - M),518,2,0,6,166,151,325,5,330,0,O-32-176-02-03-02
MUKONO,MUKONO CTY NORTH,KYAMPISI,KABEMBE,MBALIGA,683,1,1,11,102,333,448,6,454,0,O-32-176-02-03-03
MUKONO,MUKONO CTY NORTH,KYAMPISI,KABEMBE,KIKANDWA,426,4,0,6,60,226,296,2,298,0,O-32-176-02-03-04
MUKONO,MUKONO CTY NORTH,KYAMPISI,KABEMBE,NAMIREMBE,302,1,0,3,53,121,178,12,190,0,O-32-176-02-03-05
MUKONO,MUKONO CTY NORTH,KYAMPISI,KABEMBE,KABEMBE (N - Z),446,1,0,6,87,166,260,8,268,0,O-32-176-02-03-06
MUKONO,MUKONO CTY NORTH,KYAMPISI,KYABAKADDE,KALAGI,808,2,0,7,208,279,496,10,506,0,O-32-176-02-04-01
MUKONO,MUKONO CTY NORTH,KYAMPISI,KYABAKADDE,KYABAKADDE,676,3,2,17,186,255,463,8,471,0,O-32-176-02-04-02
MUKONO,MUKONO CTY NORTH,KYAMPISI,KYABAKADDE,NAMANGANGA,409,2,1,12,66,182,263,5,268,0,O-32-176-02-04-03
MUKONO,MUKONO CTY NORTH,KYAMPISI,KYABAKADDE,NKONGE,311,2,1,5,64,105,177,11,188,0,O-32-176-02-04-04
MUKONO,MUKONO CTY NORTH,KYAMPISI,NTONTO,LUGUZI,555,1,2,4,186,187,380,20,400,0,O-32-176-02-05-01
MUKONO,MUKONO CTY NORTH,KYAMPISI,NTONTO,KWABA,356,1,3,3,98,109,214,5,219,0,O-32-176-02-05-02
MUKONO,MUKONO CTY NORTH,KYAMPISI,NTONTO,MULUNGI-OMU,334,3,0,3,65,128,199,19,218,0,O-32-176-02-05-03
MUKONO,MUKONO CTY NORTH,KYAMPISI,NTONTO,KIWUMU,529,1,0,7,116,200,324,28,352,0,O-32-176-02-05-04
MUKONO,MUKONO CTY NORTH,MUKONO T.C,GULU,NGANDU A,692,8,2,20,231,186,447,5,452,0,O-32-176-03-01-01
MUKONO,MUKONO CTY NORTH,MUKONO T.C,GULU,GULU A (A - M),610,3,0,38,238,115,394,2,396,0,O-32-176-03-01-02
MUKONO,MUKONO CTY NORTH,MUKONO T.C,GULU,COLLINE,837,3,1,34,286,228,552,9,561,0,O-32-176-03-01-03
MUKONO,MUKONO CTY NORTH,MUKONO T.C,GULU,KITETE (A - M),598,1,0,21,247,141,410,2,412,0,O-32-176-03-01-04
MUKONO,MUKONO CTY NORTH,MUKONO T.C,GULU,HAMU MUKASA,919,3,2,36,305,274,620,13,633,0,O-32-176-03-01-05
MUKONO,MUKONO CTY NORTH,MUKONO T.C,GULU,TOTAL A,549,3,1,19,205,130,358,3,361,0,O-32-176-03-01-06
MUKONO,MUKONO CTY NORTH,MUKONO T.C,GULU,TOTAL B,253,1,3,6,103,66,179,4,183,0,O-32-176-03-01-07
MUKONO,MUKONO CTY NORTH,MUKONO T.C,GULU,SSAZA,474,2,0,23,167,126,318,4,322,0,O-32-176-03-01-08
MUKONO,MUKONO CTY NORTH,MUKONO T.C,GULU,NGANDU B,721,7,1,29,206,228,471,8,479,0,O-32-176-03-01-09
MUKONO,MUKONO CTY NORTH,MUKONO T.C,GULU,GULU A (N - Z),512,0,0,23,158,96,277,20,297,0,O-32-176-03-01-10
MUKONO,MUKONO CTY NORTH,MUKONO T.C,GULU,KITETE (N - Z),361,3,0,6,120,98,227,3,230,0,O-32-176-03-01-11
MUKONO,MUKONO CTY NORTH,MUKONO T.C,NAMUMIRA/ANTHONY,KITEGA A,776,3,1,22,293,172,491,1,492,0,O-32-176-03-02-01
MUKONO,MUKONO CTY NORTH,MUKONO T.C,NAMUMIRA/ANTHONY,KITEGA B,484,4,0,13,153,112,282,12,294,0,O-32-176-03-02-02
MUKONO,MUKONO CTY NORTH,MUKONO T.C,NAMUMIRA/ANTHONY,KIKOOZA A (A - M),621,1,0,31,259,132,423,2,425,0,O-32-176-03-02-03
MUKONO,MUKONO CTY NORTH,MUKONO T.C,NAMUMIRA/ANTHONY,GULU B,417,0,1,11,128,130,270,0,270,0,O-32-176-03-02-04
MUKONO,MUKONO CTY NORTH,MUKONO T.C,NAMUMIRA/ANTHONY,NAMUMIRA,583,10,0,16,181,211,418,10,428,0,O-32-176-03-02-05
MUKONO,MUKONO CTY NORTH,MUKONO T.C,NAMUMIRA/ANTHONY,MUKONO ACADEMY/KIKOOZA/NAB,413,2,0,21,165,92,280,1,281,0,O-32-176-03-02-06
MUKONO,MUKONO CTY NORTH,MUKONO T.C,NAMUMIRA/ANTHONY,NAME_MISSING,684,3,1,36,247,180,467,8,475,0,O-32-176-03-02-07
MUKONO,MUKONO CTY NORTH,MUKONO T.C,NAMUMIRA/ANTHONY,KIGOMBYA,443,2,1,26,121,117,267,6,273,0,O-32-176-03-02-08
MUKONO,MUKONO CTY NORTH,MUKONO T.C,NAMUMIRA/ANTHONY,GGUNGA,538,3,3,16,197,151,370,3,373,0,O-32-176-03-02-09
MUKONO,MUKONO CTY NORTH,MUKONO T.C,NAMUMIRA/ANTHONY,ST PAUL CHURCH (A - NAM),748,2,1,20,259,192,474,3,477,0,O-32-176-03-02-10
MUKONO,MUKONO CTY NORTH,MUKONO T.C,NAMUMIRA/ANTHONY,KIKOOZA A (A - M),859,1,2,30,251,248,532,2,534,0,O-32-176-03-02-11
MUKONO,MUKONO CTY NORTH,MUKONO T.C,NAMUMIRA/ANTHONY,ST PAUL CHURCH (NAN - Z),298,1,1,13,106,71,192,2,194,0,O-32-176-03-02-12
MUKONO,MUKONO CTY NORTH,MUKONO T.C,NAMUMIRA/ANTHONY,NSUUBE 'A',221,1,0,4,80,71,156,1,157,0,O-32-176-03-02-13
MUKONO,MUKONO CTY NORTH,MUKONO T.C,NSUUBE/KAUGA,NABUTI I,740,6,1,36,239,215,497,8,505,0,O-32-176-03-03-01
MUKONO,MUKONO CTY NORTH,MUKONO T.C,NSUUBE/KAUGA,NABUTI II,731,5,0,24,217,198,444,2,446,0,O-32-176-03-03-02
MUKONO,MUKONO CTY NORTH,MUKONO T.C,NSUUBE/KAUGA,NSUUBE,388,0,1,11,117,110,239,2,241,0,O-32-176-03-03-03
MUKONO,MUKONO CTY NORTH,MUKONO T.C,NSUUBE/KAUGA,UPPER KAUGA (A - M),573,11,1,27,207,190,436,15,451,0,O-32-176-03-03-04
MUKONO,MUKONO CTY NORTH,MUKONO T.C,NSUUBE/KAUGA,UPPER KAUGA (N - Z),761,4,0,16,160,129,309,6,315,0,O-32-176-03-03-05
MUKONO,MUKONO CTY NORTH,MUKONO T.C,NSUUBE/KAUGA,MATERNITY,762,8,3,14,236,157,418,4,422,0,O-32-176-03-03-06
MUKONO,MUKONO CTY NORTH,MUKONO T.C,NSUUBE/KAUGA,KYUNGU,400,2,1,6,78,210,297,7,304,0,O-32-176-03-03-07
MUKONO,MUKONO CTY NORTH,MUKONO T.C,NSUUBE/KAUGA,MUKONO HILL,699,12,1,5,212,119,349,3,352,0,O-32-176-03-03-08
MUKONO,MUKONO CTY NORTH,MUKONO T.C,NSUUBE/KAUGA,BUGUJJU,815,4,4,37,246,230,521,9,530,0,O-32-176-03-03-09
MUKONO,MUKONO CTY NORTH,MUKONO T.C,NTAWO,NTAWO,491,0,1,12,122,212,347,10,357,0,O-32-176-03-04-01
MUKONO,MUKONO CTY NORTH,MUKONO T.C,NTAWO,BUTEBE (A - M),544,3,2,12,177,142,336,3,339,0,O-32-176-03-04-02
MUKONO,MUKONO CTY NORTH,MUKONO T.C,NTAWO,NAKABAGO,764,1,6,35,247,200,489,11,500,0,O-32-176-03-04-03
MUKONO,MUKONO CTY NORTH,MUKONO T.C,NTAWO,MULAGO,733,4,1,20,299,164,488,4,492,0,O-32-176-03-04-04
MUKONO,MUKONO CTY NORTH,MUKONO T.C,NTAWO,NASUUTI (A - M),922,4,0,33,312,273,622,5,627,0,O-32-176-03-04-05
MUKONO,MUKONO CTY NORTH,MUKONO T.C,NTAWO,LOWER KAUGA,375,3,0,22,143,100,268,0,268,0,O-32-176-03-04-06
MUKONO,MUKONO CTY NORTH,MUKONO T.C,NTAWO,NSAMBWE,232,1,0,14,73,87,175,2,177,0,O-32-176-03-04-07
MUKONO,MUKONO CTY NORTH,MUKONO T.C,NTAWO,INDUSTRIAL AREA,611,7,0,18,255,99,379,4,383,0,O-32-176-03-04-08
MUKONO,MUKONO CTY NORTH,MUKONO T.C,NTAWO,BUTEBE (N - Z),396,3,0,12,104,91,210,19,229,0,O-32-176-03-04-09
MUKONO,MUKONO CTY NORTH,MUKONO T.C,NTAWO,NASUUTI (N - Z),468,2,1,11,137,147,298,2,300,0,O-32-176-03-04-10
MUKONO,MUKONO CTY NORTH,NAMA,BULIIKA,LUTENGO A,551,3,0,7,106,247,363,2,365,0,O-32-176-04-01-01
MUKONO,MUKONO CTY NORTH,NAMA,BULIIKA,WAKISO,712,1,1,9,115,355,481,7,488,0,O-32-176-04-01-02
MUKONO,MUKONO CTY NORTH,NAMA,BULIIKA,BULLIKA,492,1,2,14,100,223,340,15,355,0,O-32-176-04-01-03
MUKONO,MUKONO CTY NORTH,NAMA,BULIIKA,LUTENGO B,529,5,2,4,80,276,367,12,379,0,O-32-176-04-01-04
MUKONO,MUKONO CTY NORTH,NAMA,KASENGE,NAKAPINYI (A - M),475,3,1,3,129,157,293,19,312,0,O-32-176-04-02-01
MUKONO,MUKONO CTY NORTH,NAMA,KASENGE,KIVUVU,394,4,1,2,151,55,213,1,214,0,O-32-176-04-02-02
MUKONO,MUKONO CTY NORTH,NAMA,KASENGE,KASENGE B,372,1,0,15,106,95,217,3,220,0,O-32-176-04-02-03
MUKONO,MUKONO CTY NORTH,NAMA,KASENGE,KAPEKE,329,1,0,11,64,173,249,4,253,0,O-32-176-04-02-04
MUKONO,MUKONO CTY NORTH,NAMA,KASENGE,NAKAPINYI (N - Z),489,2,2,8,76,195,283,16,299,0,O-32-176-04-02-05
MUKONO,MUKONO CTY NORTH,NAMA,KASENGE,KASENGE A,792,9,0,11,205,254,479,17,496,0,O-32-176-04-02-06
MUKONO,MUKONO CTY NORTH,NAMA,KATOOGO,SAMUUKA TRADING CENTRE,523,2,1,3,78,227,311,11,322,0,O-32-176-04-03-01
MUKONO,MUKONO CTY NORTH,NAMA,KATOOGO,KATOOGO HEALTH CENTRE,508,1,2,2,74,219,298,12,310,0,O-32-176-04-03-02
MUKONO,MUKONO CTY NORTH,NAMA,KATOOGO,KATOOGO,620,3,2,4,124,283,416,9,425,0,O-32-176-04-03-03
MUKONO,MUKONO CTY NORTH,NAMA,MPOMA,KISOWERA,948,15,0,13,179,335,542,6,548,0,O-32-176-04-04-01
MUKONO,MUKONO CTY NORTH,NAMA,MPOMA,NAMA I,664,2,2,8,167,260,439,17,456,0,O-32-176-04-04-02
MUKONO,MUKONO CTY NORTH,NAMA,MPOMA,MPOMA TRADING CENTRE,175,0,2,0,33,87,122,2,124,0,O-32-176-04-04-03
MUKONO,MUKONO CTY NORTH,NAMA,MPOMA,NSANVU,219,0,0,1,27,123,151,3,154,0,O-32-176-04-04-04
MUKONO,MUKONO CTY NORTH,NAMA,MPOMA,MABUYE CHURCH OF UGANDA,110,0,0,4,24,51,79,2,81,0,O-32-176-04-04-05
MUKONO,MUKONO CTY NORTH,NAMA,MPOMA,KITUBA,288,1,0,3,38,137,179,2,181,0,O-32-176-04-04-06
MUKONO,MUKONO CTY NORTH,NAMA,MPOMA,BUYUKI T/C,426,2,0,3,69,203,277,9,286,0,O-32-176-04-04-07
MUKONO,MUKONO CTY NORTH,NAMA,MPOMA,KISOWERA OUTSIDE Q.GUARD,477,0,0,6,34,107,147,4,151,0,O-32-176-04-04-08
MUKONO,MUKONO CTY NORTH,NAMA,NAMAWOJJOLO,WALUSIBI,640,2,2,6,137,279,426,20,446,0,O-32-176-04-05-01
MUKONO,MUKONO CTY NORTH,NAMA,NAMAWOJJOLO,NAMAWOJJOLO ISLAMIC P/S,571,2,1,2,144,216,365,1,366,0,O-32-176-04-05-02
MUKONO,MUKONO CTY NORTH,NAMA,NAMAWOJJOLO,NAMAWOJJOLO WEST,610,3,0,9,120,209,341,4,345,0,O-32-176-04-05-03
MUKONO,MUKONO CTY NORTH,NAMA,NAMAWOJJOLO,BWEFULUMYA T/C,217,0,0,2,25,106,133,2,135,0,O-32-176-04-05-04
MUKONO,MUKONO CTY NORTH,NAMA,NAMUBIRU,LWANYONYI,702,2,6,9,156,301,474,17,491,0,O-32-176-04-06-01
MUKONO,MUKONO CTY NORTH,NAMA,NAMUBIRU,TAKAJJUNGE I,906,2,3,4,175,288,472,5,477,0,O-32-176-04-06-02
MUKONO,MUKONO CTY NORTH,NAMA,NAMUBIRU,TAKAJJUNGE II,730,4,0,21,143,232,400,5,405,0,O-32-176-04-06-03
MUKONO,MUKONO CTY NORTH,NAMA,NAMUBIRU,KIRANGIRA CATHORIC CHURCH,220,0,0,7,55,76,138,1,139,0,O-32-176-04-06-04
MUKONO,MUKONO CTY SOUTH,KKOME ISL,BUGOMBE,BUGAZI,299,2,0,11,61,151,225,5,230,0,O-32-177-01-01-01
MUKONO,MUKONO CTY SOUTH,KKOME ISL,BUGOMBE,NZINGOOLA,337,0,0,2,80,92,174,10,184,0,O-32-177-01-01-02
MUKONO,MUKONO CTY SOUTH,KKOME ISL,BUGOMBE,BULAGO,334,1,0,4,42,66,113,5,118,0,O-32-177-01-01-03
MUKONO,MUKONO CTY SOUTH,KKOME ISL,BUSANGA,KIMMI,831,2,2,1,204,177,386,4,390,0,O-32-177-01-02-01
MUKONO,MUKONO CTY SOUTH,KKOME ISL,BUSANGA,KYAZIMBA,235,1,0,0,30,85,116,0,116,0,O-32-177-01-02-02
MUKONO,MUKONO CTY SOUTH,KKOME ISL,BUSANGA,NSAZI,809,4,0,11,197,234,446,4,450,0,O-32-177-01-02-03
MUKONO,MUKONO CTY SOUTH,KKOME ISL,BUSANGA,MYENDE,182,0,0,2,39,50,91,4,95,0,O-32-177-01-02-04
MUKONO,MUKONO CTY SOUTH,KKOME ISL,BUSANGA,NGANGA,188,2,0,1,42,40,85,4,89,0,O-32-177-01-02-05
MUKONO,MUKONO CTY SOUTH,KKOME ISL,LWOMOLO,KASENYI,242,0,0,0,55,72,127,4,131,0,O-32-177-01-03-01
MUKONO,MUKONO CTY SOUTH,KKOME ISL,LWOMOLO,KAKUNYU,342,1,0,4,62,53,120,7,127,0,O-32-177-01-03-02
MUKONO,MUKONO CTY SOUTH,KKOME ISL,LWOMOLO,BUYANA,486,2,0,6,36,47,91,7,98,0,O-32-177-01-03-03
MUKONO,MUKONO CTY SOUTH,KKOME ISL,LWOMOLO,LWANGA-MUTO,399,1,0,2,118,81,202,5,207,0,O-32-177-01-03-04
MUKONO,MUKONO CTY SOUTH,KKOME ISL,MUBEMBE,BATWALA,299,1,1,2,57,103,164,9,173,0,O-32-177-01-04-01
MUKONO,MUKONO CTY SOUTH,KKOME ISL,MUBEMBE,MUWOMA,389,2,0,2,73,88,165,5,170,0,O-32-177-01-04-02
MUKONO,MUKONO CTY SOUTH,KKOME ISL,MUBEMBE,KATORO,128,0,0,9,36,19,64,2,66,0,O-32-177-01-04-03
MUKONO,MUKONO CTY SOUTH,KKOME ISL,MUBEMBE,KALYAMBUZI,380,1,1,4,107,74,187,0,187,0,O-32-177-01-04-04
MUKONO,MUKONO CTY SOUTH,KKOME ISL,MUBEMBE,NYANAMA,322,2,1,4,78,76,161,4,165,0,O-32-177-01-04-05
MUKONO,MUKONO CTY SOUTH,KKOME ISL,MUBEMBE,BUSIRO,130,1,0,0,30,42,73,2,75,0,O-32-177-01-04-06
MUKONO,MUKONO CTY SOUTH,NAKISUNGA,KATENTE,KATWE,696,2,3,29,206,211,451,23,474,0,O-32-177-02-01-01
MUKONO,MUKONO CTY SOUTH,NAKISUNGA,KATENTE,NTOVE,271,1,0,10,61,118,190,8,198,0,O-32-177-02-01-02
MUKONO,MUKONO CTY SOUTH,NAKISUNGA,KATENTE,KATENTE,595,2,1,21,133,283,440,12,452,0,O-32-177-02-01-03
MUKONO,MUKONO CTY SOUTH,NAKISUNGA,KATENTE,GAMBA CHURCH OF UGANDA,173,0,0,1,19,112,132,5,137,0,O-32-177-02-01-04
MUKONO,MUKONO CTY SOUTH,NAKISUNGA,KIYOOLA,NSONGA,652,4,0,15,137,269,425,22,447,0,O-32-177-02-02-01
MUKONO,MUKONO CTY SOUTH,NAKISUNGA,KIYOOLA,KIYOOLA,715,3,0,8,193,287,491,6,497,0,O-32-177-02-02-02
MUKONO,MUKONO CTY SOUTH,NAKISUNGA,KIYOOLA,NANTULA,416,1,1,12,138,138,290,3,293,0,O-32-177-02-02-03
MUKONO,MUKONO CTY SOUTH,NAKISUNGA,KIYOOLA,KISOZI,398,0,1,9,94,171,275,12,287,0,O-32-177-02-02-04
MUKONO,MUKONO CTY SOUTH,NAKISUNGA,KIYOOLA,NASAKA,142,0,0,3,46,71,120,2,122,0,O-32-177-02-02-05
MUKONO,MUKONO CTY SOUTH,NAKISUNGA,KYABALOGO,NAKISUNGA,579,1,0,22,160,207,390,9,399,0,O-32-177-02-03-01
MUKONO,MUKONO CTY SOUTH,NAKISUNGA,KYABALOGO,NAMAKWA,495,4,1,23,134,200,362,9,371,0,O-32-177-02-03-02
MUKONO,MUKONO CTY SOUTH,NAKISUNGA,KYABALOGO,BUGENDERA,503,0,0,11,88,244,343,9,352,0,O-32-177-02-03-03
MUKONO,MUKONO CTY SOUTH,NAKISUNGA,KYETUME,NTALE,229,1,1,4,73,95,174,3,177,0,O-32-177-02-04-01
MUKONO,MUKONO CTY SOUTH,NAKISUNGA,KYETUME,KYETUME,936,4,1,10,342,247,604,38,642,0,O-32-177-02-04-02
MUKONO,MUKONO CTY SOUTH,NAKISUNGA,KYETUME,BUKASA,438,1,0,4,134,175,314,11,325,0,O-32-177-02-04-03
MUKONO,MUKONO CTY SOUTH,NAKISUNGA,NAMAYIBA,NAMAYIBA I,409,1,1,12,136,131,281,13,294,0,O-32-177-02-05-01
MUKONO,MUKONO CTY SOUTH,NAKISUNGA,NAMAYIBA,NAMAYIBA II,498,1,0,5,140,158,304,9,313,0,O-32-177-02-05-02
MUKONO,MUKONO CTY SOUTH,NAKISUNGA,NAMAYIBA,LUBUGUMU,723,6,0,21,254,228,509,26,535,0,O-32-177-02-05-03
MUKONO,MUKONO CTY SOUTH,NAKISUNGA,NAMAYIBA,KITYABULE,448,2,0,12,91,159,264,17,281,0,O-32-177-02-05-04
MUKONO,MUKONO CTY SOUTH,NAKISUNGA,NAMAYIBA,KATUBA,401,0,1,3,85,162,251,13,264,0,O-32-177-02-05-05
MUKONO,MUKONO CTY SOUTH,NAKISUNGA,NAMUYENJE,NANGWA,658,4,0,8,143,300,455,14,469,0,O-32-177-02-06-01
MUKONO,MUKONO CTY SOUTH,NAKISUNGA,NAMUYENJE,NAMUYENJE (A - M),506,1,1,36,165,162,365,11,376,0,O-32-177-02-06-02
MUKONO,MUKONO CTY SOUTH,NAKISUNGA,NAMUYENJE,NTULUMUKO,558,2,1,18,149,233,403,14,417,0,O-32-177-02-06-03
MUKONO,MUKONO CTY SOUTH,NAKISUNGA,NAMUYENJE,NAMUYENJE (N - Z),355,1,0,23,110,117,251,6,257,0,O-32-177-02-06-04
MUKONO,MUKONO CTY SOUTH,NAKISUNGA,SEETA-NAZIGO,KIRONDO,501,1,0,10,109,238,358,2,360,0,O-32-177-02-07-01
MUKONO,MUKONO CTY SOUTH,NAKISUNGA,SEETA-NAZIGO,KIRIJJA,458,1,0,14,113,180,308,13,321,0,O-32-177-02-07-02
MUKONO,MUKONO CTY SOUTH,NAKISUNGA,SEETA-NAZIGO,SEETA - NAZIGO,668,2,1,6,203,260,472,9,481,0,O-32-177-02-07-03
MUKONO,MUKONO CTY SOUTH,NAKISUNGA,SEETA-NAZIGO,KAVULE,570,0,0,3,83,275,361,13,374,0,O-32-177-02-07-04
MUKONO,MUKONO CTY SOUTH,NAKISUNGA,SEETA-NAZIGO,KITEBE,187,2,0,6,37,100,145,5,150,0,O-32-177-02-07-05
MUKONO,MUKONO CTY SOUTH,NAKISUNGA,SEETA-NAZIGO,BUSIMBE,199,1,0,5,53,86,145,4,149,0,O-32-177-02-07-06
MUKONO,MUKONO CTY SOUTH,NAKISUNGA,WANKOBA,NALUVULE,321,2,0,4,43,146,195,3,198,0,O-32-177-02-08-01
MUKONO,MUKONO CTY SOUTH,NAKISUNGA,WANKOBA,WANKOBA,450,1,0,13,83,209,306,5,311,0,O-32-177-02-08-02
MUKONO,MUKONO CTY SOUTH,NAKISUNGA,WANKOBA,BUSIBA,374,1,0,4,49,206,260,6,266,0,O-32-177-02-08-03
MUKONO,MUKONO CTY SOUTH,NAKISUNGA,WANKOBA,NAWANJUKI,488,2,0,5,99,260,366,6,372,0,O-32-177-02-08-04
MUKONO,MUKONO CTY SOUTH,NAKISUNGA,WANKOBA,KISOLOZA,446,1,0,2,86,250,339,6,345,0,O-32-177-02-08-05
MUKONO,MUKONO CTY SOUTH,NAKISUNGA,WANKOBA,KERITA,218,1,0,1,51,77,130,4,134,0,O-32-177-02-08-06
MUKONO,MUKONO CTY SOUTH,NTENJERU,BUGOYE,KIWAFU,397,2,0,15,77,185,279,5,284,0,O-32-177-03-01-01
MUKONO,MUKONO CTY SOUTH,NTENJERU,BUGOYE,BUGOYE,653,4,2,11,132,329,478,12,490,0,O-32-177-03-01-02
MUKONO,MUKONO CTY SOUTH,NTENJERU,BUGOYE,BANGA,676,2,3,16,150,284,455,21,476,0,O-32-177-03-01-03
MUKONO,MUKONO CTY SOUTH,NTENJERU,BUNAKIJJA,KULUBBI,469,2,0,2,94,236,334,19,353,0,O-32-177-03-02-01
MUKONO,MUKONO CTY SOUTH,NTENJERU,BUNAKIJJA,LUGAZI,753,3,0,9,162,254,428,10,438,0,O-32-177-03-02-02
MUKONO,MUKONO CTY SOUTH,NTENJERU,BUNAKIJJA,BUNAKIJJA,613,2,0,7,99,325,433,9,442,0,O-32-177-03-02-03
MUKONO,MUKONO CTY SOUTH,NTENJERU,KABANGA,KABANGA,480,0,0,5,111,243,359,7,366,0,O-32-177-03-03-01
MUKONO,MUKONO CTY SOUTH,NTENJERU,KABANGA,MAKUSU,275,0,0,0,80,64,144,3,147,0,O-32-177-03-03-02
MUKONO,MUKONO CTY SOUTH,NTENJERU,KABANGA,BUTERE,489,4,0,11,135,189,339,6,345,0,O-32-177-03-03-03
MUKONO,MUKONO CTY SOUTH,NTENJERU,KABANGA,LWEZA,490,2,1,9,111,205,328,8,336,0,O-32-177-03-03-04
MUKONO,MUKONO CTY SOUTH,NTENJERU,KABANGA,KISINSI,508,1,1,5,122,207,336,35,371,0,O-32-177-03-03-05
MUKONO,MUKONO CTY SOUTH,NTENJERU,KABANGA,BUWUNGA,855,1,4,4,130,423,562,19,581,0,O-32-177-03-03-06
MUKONO,MUKONO CTY SOUTH,NTENJERU,KABANGA,SSOWE,285,1,0,2,67,50,120,4,124,0,O-32-177-03-03-07
MUKONO,MUKONO CTY SOUTH,NTENJERU,MPATTA,NAKALANDA,703,4,3,11,146,324,488,5,493,0,O-32-177-03-04-01
MUKONO,MUKONO CTY SOUTH,NTENJERU,MPATTA,SSOZI,595,2,0,8,175,291,476,2,478,0,O-32-177-03-04-02
MUKONO,MUKONO CTY SOUTH,NTENJERU,MPATTA,MPATTA A,431,0,0,13,95,196,304,13,317,0,O-32-177-03-04-03
MUKONO,MUKONO CTY SOUTH,NTENJERU,MPATTA,MPATTA B,408,1,0,5,55,241,302,7,309,0,O-32-177-03-04-04
MUKONO,MUKONO CTY SOUTH,NTENJERU,MPUNGE,BULEBI,788,4,2,7,232,243,488,28,516,0,O-32-177-03-05-01
MUKONO,MUKONO CTY SOUTH,NTENJERU,MPUNGE,MPUNGE,872,6,3,6,221,197,433,22,455,0,O-32-177-03-05-02
MUKONO,MUKONO CTY SOUTH,NTENJERU,MPUNGE,MUVO,942,2,1,13,229,238,483,2,485,0,O-32-177-03-05-03
MUKONO,MUKONO CTY SOUTH,NTENJERU,MPUNGE,MBALE,677,0,1,21,203,223,448,12,460,0,O-32-177-03-05-04
MUKONO,MUKONO CTY SOUTH,NTENJERU,MPUNGE,NGOMBERE,737,4,0,52,177,254,487,12,499,0,O-32-177-03-05-05
MUKONO,MUKONO CTY SOUTH,NTENJERU,MPUNGE,SANGO STAGE,219,1,0,0,60,76,137,1,138,0,O-32-177-03-05-06
MUKONO,MUKONO CTY SOUTH,NTENJERU,MPUNGE,MPUNGE B,293,3,1,6,57,143,210,3,213,0,O-32-177-03-05-07
MUKONO,MUKONO CTY SOUTH,NTENJERU,MPUNGE,LULAGWE,391,0,0,3,76,150,229,12,241,0,O-32-177-03-05-08
MUKONO,MUKONO CTY SOUTH,NTENJERU,NSANJA,GONVE,477,1,1,10,172,132,316,6,322,0,O-32-177-03-06-01
MUKONO,MUKONO CTY SOUTH,NTENJERU,NSANJA,NSANJA,684,1,0,36,238,202,477,9,486,0,O-32-177-03-06-02
MUKONO,MUKONO CTY SOUTH,NTENJERU,NSANJA,KALENGERA,620,0,0,25,156,236,417,14,431,0,O-32-177-03-06-03
MUKONO,MUKONO CTY SOUTH,NTENJERU,NSANJA,KATOSI I (A - M),697,3,1,20,254,134,412,5,417,0,O-32-177-03-06-04
MUKONO,MUKONO CTY SOUTH,NTENJERU,NSANJA,KATOSI II,520,1,0,6,146,131,284,12,296,0,O-32-177-03-06-05
MUKONO,MUKONO CTY SOUTH,NTENJERU,NSANJA,KATOSI III A,480,0,0,10,120,123,253,7,260,0,O-32-177-03-06-06
MUKONO,MUKONO CTY SOUTH,NTENJERU,NSANJA,KATOSI I (N - Z),678,3,0,8,194,156,361,8,369,0,O-32-177-03-06-07
MUKONO,MUKONO CTY SOUTH,NTENJERU,NSANJA,KATOSI III B,614,3,1,14,135,154,307,7,314,0,O-32-177-03-06-08
MUKONO,MUKONO CTY SOUTH,NTENJERU,NTANZI,MPUMU,664,3,0,13,124,295,435,9,444,0,O-32-177-03-07-01
MUKONO,MUKONO CTY SOUTH,NTENJERU,NTANZI,NTENJERU,721,2,2,47,221,199,471,8,479,0,O-32-177-03-07-02
MUKONO,MUKONO CTY SOUTH,NTENJERU,NTANZI,KISOGA C,737,2,2,47,221,199,471,8,479,0,O-32-177-03-07-03
MUKONO,MUKONO CTY SOUTH,NTENJERU,NTANZI,KIGANDA,788,5,0,43,256,173,477,12,489,0,O-32-177-03-07-04
MUKONO,MUKONO CTY SOUTH,NTENJERU,NTANZI,LUGA,307,0,0,4,43,146,193,9,202,0,O-32-177-03-07-05
MUKONO,MUKONO CTY SOUTH,NTENJERU,NTANZI,BUGOLOMBE,660,3,1,29,171,286,490,8,498,0,O-32-177-03-07-06
MUKONO,MUKONO CTY SOUTH,NTENJERU,NTANZI,BULONDA,249,2,0,5,71,92,170,1,171,0,O-32-177-03-07-07
MUKONO,MUKONO CTY SOUTH,NTENJERU,SSAAYI,MUVUNIKIRE,444,2,0,14,98,194,308,6,314,0,O-32-177-03-08-01
MUKONO,MUKONO CTY SOUTH,NTENJERU,SSAAYI,KAZO,522,2,1,25,128,206,362,5,367,0,O-32-177-03-08-02
MUKONO,MUKONO CTY SOUTH,NTENJERU,SSAAYI,NAKIBANGA II,367,0,0,16,107,148,271,6,277,0,O-32-177-03-08-03
MUKONO,MUKONO CTY SOUTH,NTENJERU,TERERE,BUNANKANDA,434,3,1,5,114,202,325,10,335,0,O-32-177-03-09-01
MUKONO,MUKONO CTY SOUTH,NTENJERU,TERERE,TERERE/BUTININDI,453,2,1,7,105,226,341,17,358,0,O-32-177-03-09-02
MUKONO,NAKIFUMA COUNTY,KASAWO,KABIMBIRI,SSINDA,219,1,1,0,67,97,166,2,168,0,O-32-178-01-01-01
MUKONO,NAKIFUMA COUNTY,KASAWO,KABIMBIRI,KABIMBIRI I,569,1,0,3,216,171,391,11,402,0,O-32-178-01-01-02
MUKONO,NAKIFUMA COUNTY,KASAWO,KABIMBIRI,KABIMBIRI II,540,3,2,2,196,148,351,9,360,0,O-32-178-01-01-03
MUKONO,NAKIFUMA COUNTY,KASAWO,KABIMBIRI,KIGAYAZA,750,4,3,12,160,245,424,14,438,0,O-32-178-01-01-04
MUKONO,NAKIFUMA COUNTY,KASAWO,KABIMBIRI,KIKANDWA,364,1,0,7,98,172,278,8,286,0,O-32-178-01-01-05
MUKONO,NAKIFUMA COUNTY,KASAWO,KABIMBIRI,NASSEJJOBE/KALYOWA/KABEMB,342,2,1,5,100,142,250,10,260,0,O-32-178-01-01-06
MUKONO,NAKIFUMA COUNTY,KASAWO,KAKUKUULU,NKOKO/NAKIDUDUMA,374,3,0,1,113,136,253,17,270,0,O-32-178-01-02-01
MUKONO,NAKIFUMA COUNTY,KASAWO,KAKUKUULU,NAKASWA UMEA P/S,358,4,2,6,112,111,235,6,241,0,O-32-178-01-02-02
MUKONO,NAKIFUMA COUNTY,KASAWO,KAKUKUULU,NAKASWA C/U P/S,363,1,0,5,109,138,253,11,264,0,O-32-178-01-02-03
MUKONO,NAKIFUMA COUNTY,KASAWO,KAKUKUULU,KIKUBE C/U P/S,277,1,0,2,66,129,198,3,201,0,O-32-178-01-02-04
MUKONO,NAKIFUMA COUNTY,KASAWO,KAKUKUULU,KAKUKUULU RC P/S,319,1,1,2,86,138,228,9,237,0,O-32-178-01-02-05
MUKONO,NAKIFUMA COUNTY,KASAWO,KASANA,KISALA/NDIIBA,414,2,2,4,118,183,309,11,320,0,O-32-178-01-03-01
MUKONO,NAKIFUMA COUNTY,KASAWO,KASANA,KIYAGI/KASANA,646,2,3,7,156,232,400,11,411,0,O-32-178-01-03-02
MUKONO,NAKIFUMA COUNTY,KASAWO,KASANA,KAKIRA COMM P/S,425,0,0,4,82,231,317,17,334,0,O-32-178-01-03-03
MUKONO,NAKIFUMA COUNTY,KASAWO,KASANA,BUTEYONGERA C/U P/S,404,0,1,7,73,213,294,8,302,0,O-32-178-01-03-04
MUKONO,NAKIFUMA COUNTY,KASAWO,KIGOGOLA,NSANVU/KIGOGOLA/NAKASWA,410,1,2,3,69,199,274,8,282,0,O-32-178-01-04-01
MUKONO,NAKIFUMA COUNTY,KASAWO,KIGOGOLA,NONGO/KATETE,601,5,1,9,149,255,419,11,430,0,O-32-178-01-04-02
MUKONO,NAKIFUMA COUNTY,KASAWO,KIGOGOLA,KIBAMBA/BUYUKI/KISONZI,715,3,4,10,175,241,433,17,450,0,O-32-178-01-04-03
MUKONO,NAKIFUMA COUNTY,KASAWO,KITOVU,KASAWO,841,0,0,14,226,253,493,14,507,0,O-32-178-01-05-01
MUKONO,NAKIFUMA COUNTY,KASAWO,KITOVU,MUBANDA/KASENGE,537,3,0,6,159,180,348,9,357,0,O-32-178-01-05-02
MUKONO,NAKIFUMA COUNTY,KASAWO,KITOVU,KITOVU/KITEGULA,485,2,0,8,134,160,304,7,311,0,O-32-178-01-05-03
MUKONO,NAKIFUMA COUNTY,KASAWO,KITOVU,KITUNTU,419,3,1,5,95,172,276,11,287,0,O-32-178-01-05-04
MUKONO,NAKIFUMA COUNTY,KASAWO,NAMALIRI,NDESE/KAWUTUTU,749,0,2,6,245,261,514,16,530,0,O-32-178-01-06-01
MUKONO,NAKIFUMA COUNTY,KASAWO,NAMALIRI,KIGULU,409,1,0,2,107,164,274,7,281,0,O-32-178-01-06-02
MUKONO,NAKIFUMA COUNTY,KASAWO,NAMALIRI,GAAVU/NAMALIRI,672,0,3,15,188,244,450,7,457,0,O-32-178-01-06-03
MUKONO,NAKIFUMA COUNTY,KIMENYEDDE,BUKASA,KAWUKU,616,3,1,7,147,174,332,9,341,0,O-32-178-02-01-01
MUKONO,NAKIFUMA COUNTY,KIMENYEDDE,BUKASA,KIREKU,319,1,0,5,100,122,228,8,236,0,O-32-178-02-01-02
MUKONO,NAKIFUMA COUNTY,KIMENYEDDE,BUKASA,KISOGA,549,1,1,3,91,295,391,12,403,0,O-32-178-02-01-03
MUKONO,NAKIFUMA COUNTY,KIMENYEDDE,BUKASA,BUKASA,518,1,1,8,120,192,322,19,341,0,O-32-178-02-01-04
MUKONO,NAKIFUMA COUNTY,KIMENYEDDE,BUKASA,NAMAKOMO,335,1,1,6,83,147,238,5,243,0,O-32-178-02-01-05
MUKONO,NAKIFUMA COUNTY,KIMENYEDDE,KAWONGO,KAWONGO,356,1,1,9,84,145,240,6,246,0,O-32-178-02-02-01
MUKONO,NAKIFUMA COUNTY,KIMENYEDDE,KAWONGO,MAYANGAYANGA,650,3,0,10,108,254,375,15,390,0,O-32-178-02-02-02
MUKONO,NAKIFUMA COUNTY,KIMENYEDDE,KAWONGO,WANJEYO,410,0,0,10,104,174,288,10,298,0,O-32-178-02-02-03
MUKONO,NAKIFUMA COUNTY,KIMENYEDDE,KAWONGO,WABUSANKE,279,0,2,9,55,109,175,6,181,0,O-32-178-02-02-04
MUKONO,NAKIFUMA COUNTY,KIMENYEDDE,KAWONGO,NAKIBANO,308,2,0,4,64,132,202,2,204,0,O-32-178-02-02-05
MUKONO,NAKIFUMA COUNTY,KIMENYEDDE,KIWAFU,KIWAFU,567,2,2,7,163,196,370,25,395,0,O-32-178-02-03-01
MUKONO,NAKIFUMA COUNTY,KIMENYEDDE,KIWAFU,KIMENYEDDE,563,2,0,8,145,196,351,15,366,0,O-32-178-02-03-02
MUKONO,NAKIFUMA COUNTY,KIMENYEDDE,KIWAFU,JUMBA,724,4,4,4,172,247,431,35,466,0,O-32-178-02-03-03
MUKONO,NAKIFUMA COUNTY,KIMENYEDDE,KIWAFU,KAWUKU,440,1,0,2,73,192,268,13,281,0,O-32-178-02-03-04
MUKONO,NAKIFUMA COUNTY,KIMENYEDDE,NAMALIGA,KAAMA,639,0,1,14,138,206,359,11,370,0,O-32-178-02-04-01
MUKONO,NAKIFUMA COUNTY,KIMENYEDDE,NAMALIGA,NAKIFUMA 1 (A - M),393,0,1,5,136,94,236,1,237,0,O-32-178-02-04-02
MUKONO,NAKIFUMA COUNTY,KIMENYEDDE,NAMALIGA,NAKIFUMA II,521,2,1,5,164,133,305,1,306,0,O-32-178-02-04-03
MUKONO,NAKIFUMA COUNTY,KIMENYEDDE,NAMALIGA,NAMALIGA,423,2,0,5,81,158,246,47,293,0,O-32-178-02-04-04
MUKONO,NAKIFUMA COUNTY,KIMENYEDDE,NAMALIGA,BUSENYA,293,5,0,10,74,116,205,3,208,0,O-32-178-02-04-05
MUKONO,NAKIFUMA COUNTY,KIMENYEDDE,NAMALIGA,NAKIFUMA 1 (N - Z),591,0,1,9,134,165,309,17,326,0,O-32-178-02-04-06
MUKONO,NAKIFUMA COUNTY,KIMENYEDDE,NAMALIGA,NEKOYEDDE,199,1,0,2,58,63,124,8,132,0,O-32-178-02-04-07
MUKONO,NAKIFUMA COUNTY,KIMENYEDDE,NANGA,NANGA,404,1,0,8,89,184,282,8,290,0,O-32-178-02-05-01
MUKONO,NAKIFUMA COUNTY,KIMENYEDDE,NANGA,KIYIRIBWA,310,3,1,4,55,153,216,7,223,0,O-32-178-02-05-02
MUKONO,NAKIFUMA COUNTY,KIMENYEDDE,NANGA,KAKAKALA,312,2,3,9,99,89,202,7,209,0,O-32-178-02-05-03
MUKONO,NAKIFUMA COUNTY,KIMENYEDDE,NANGA,KABIRIBIRI,345,2,0,3,164,93,262,9,271,0,O-32-178-02-05-04
MUKONO,NAKIFUMA COUNTY,KIMENYEDDE,NANGA,GIRINYA,196,1,0,4,61,77,143,0,143,0,O-32-178-02-05-05
MUKONO,NAKIFUMA COUNTY,NABBALE,BAMUSUUTA,BUMUSUUTA,606,5,0,3,223,186,417,25,442,0,O-32-178-03-01-01
MUKONO,NAKIFUMA COUNTY,NABBALE,BAMUSUUTA,KAKAKALA/KAYUNGA/KIYAGI/NAL,495,1,0,8,155,154,318,15,333,0,O-32-178-03-01-02
MUKONO,NAKIFUMA COUNTY,NABBALE,BAMUSUUTA,NAMYOYA/BUSABALA/KYANKIMA/,478,2,0,9,115,179,305,6,311,0,O-32-178-03-01-03
MUKONO,NAKIFUMA COUNTY,NABBALE,BAMUSUUTA,NDESE T/C,201,1,0,7,46,84,138,3,141,0,O-32-178-03-01-04
MUKONO,NAKIFUMA COUNTY,NABBALE,MAKUKUBA,CONVE/KIZIMA,502,2,0,9,109,208,328,11,339,0,O-32-178-03-02-01
MUKONO,NAKIFUMA COUNTY,NABBALE,MAKUKUBA,MAKUKUBA/KABULO,657,4,2,9,126,282,423,9,432,0,O-32-178-03-02-02
MUKONO,NAKIFUMA COUNTY,NABBALE,MAKUKUBA,KAWOMYA/BUGEREKA/NABAALE/,584,4,1,10,94,316,425,20,445,0,O-32-178-03-02-03
MUKONO,NAKIFUMA COUNTY,NABBALE,NABBALANGA,NABALANGA/KAKINZI,647,1,2,10,203,219,435,25,460,0,O-32-178-03-03-01
MUKONO,NAKIFUMA COUNTY,NABBALE,NABBALANGA,NABAWALA/NKULAGIRIRE,551,1,2,7,172,173,355,15,370,0,O-32-178-03-03-02
MUKONO,NAKIFUMA COUNTY,NABBALE,NABBALANGA,MAGOGO/LUSANJA,357,3,1,2,114,104,224,10,234,0,O-32-178-03-03-03
MUKONO,NAKIFUMA COUNTY,NABBALE,NAGGALAMA,NAGGALAMA I,509,1,0,5,179,140,325,10,335,0,O-32-178-03-04-01
MUKONO,NAKIFUMA COUNTY,NABBALE,NAGGALAMA,NAGGALAMA II/GOMBA/KAZINGA,464,3,1,3,148,131,286,0,286,0,O-32-178-03-04-02
MUKONO,NAKIFUMA COUNTY,NABBALE,NAGGALAMA,MISSION/LUTENGO/KIWANGWA/W,614,2,0,17,148,167,334,5,339,0,O-32-178-03-04-03
MUKONO,NAKIFUMA COUNTY,NABBALE,NAGGALAMA,KALAGI + OTHERS,572,2,1,3,182,191,379,2,381,0,O-32-178-03-04-04
MUKONO,NAKIFUMA COUNTY,NABBALE,NAGGALAMA,LUTENGO,174,1,0,7,42,65,115,4,119,0,O-32-178-03-04-05
MUKONO,NAKIFUMA COUNTY,NABBALE,NAKANYONYI,KIJJO/KITTO/LUKYAMU,561,2,4,6,136,217,365,12,377,0,O-32-178-03-05-01
MUKONO,NAKIFUMA COUNTY,NABBALE,NAKANYONYI,NAKANYONYI ABM,659,4,2,8,84,329,427,6,433,0,O-32-178-03-05-02
MUKONO,NAKIFUMA COUNTY,NABBALE,NAKANYONYI,NAKIWAATE/NAKULABYE,620,2,0,17,163,247,429,12,441,0,O-32-178-03-05-03
MUKONO,NAKIFUMA COUNTY,NABBALE,NAKANYONYI,BUBIIRO/NENYODE/BUZIRANDUR,703,3,1,20,180,276,480,3,483,0,O-32-178-03-05-04
MUKONO,NAKIFUMA COUNTY,NAGOJJE,KYAJA,KYAJJA/BUKUKU/BULANGA,716,3,3,8,143,291,448,36,484,0,O-32-178-04-01-01
MUKONO,NAKIFUMA COUNTY,NAGOJJE,KYAJA,BUBIRO/NAMANYAMA/KIWALA,615,1,0,2,50,153,206,6,212,0,O-32-178-04-01-02
MUKONO,NAKIFUMA COUNTY,NAGOJJE,NAGOJJE,NAGOJJE,716,2,1,4,153,303,463,17,480,0,O-32-178-04-02-01
MUKONO,NAKIFUMA COUNTY,NAGOJJE,NAGOJJE,MAGADA,529,1,2,4,65,255,327,18,345,0,O-32-178-04-02-02
MUKONO,NAKIFUMA COUNTY,NAGOJJE,NAGOJJE,NATYOLE,595,2,0,5,99,246,352,6,358,0,O-32-178-04-02-03
MUKONO,NAKIFUMA COUNTY,NAGOJJE,NAKIBANO,MANGIRA,320,0,0,5,81,132,218,9,227,0,O-32-178-04-03-01
MUKONO,NAKIFUMA COUNTY,NAGOJJE,NAKIBANO,WABULONGO,420,1,0,4,71,145,221,0,221,0,O-32-178-04-03-02
MUKONO,NAKIFUMA COUNTY,NAGOJJE,NAKIBANO,NAMASINDA,313,0,0,6,96,110,212,4,216,0,O-32-178-04-03-03
MUKONO,NAKIFUMA COUNTY,NAGOJJE,NAKIBANO,KASANA,447,3,0,8,123,130,264,11,275,0,O-32-178-04-03-04
MUKONO,NAKIFUMA COUNTY,NAGOJJE,NAMAGUNGA,NAMAGUNGA,625,2,1,10,114,260,387,17,404,0,O-32-178-04-04-01
MUKONO,NAKIFUMA COUNTY,NAGOJJE,NAMAGUNGA,KAYANJA A,657,0,0,13,150,223,386,21,407,0,O-32-178-04-04-02
MUKONO,NAKIFUMA COUNTY,NAGOJJE,NAMAGUNGA,KAYANJA B,705,4,0,5,121,288,418,11,429,0,O-32-178-04-04-03
MUKONO,NAKIFUMA COUNTY,NAGOJJE,NAMATABA,NAMATABA I,918,8,0,4,299,274,585,11,596,0,O-32-178-04-05-01
MUKONO,NAKIFUMA COUNTY,NAGOJJE,NAMATABA,NAMATABA II,484,1,0,8,116,174,299,11,310,0,O-32-178-04-05-02
MUKONO,NAKIFUMA COUNTY,NAGOJJE,NAMATABA,NAMATABA III,371,3,1,11,106,151,272,14,286,0,O-32-178-04-05-03
MUKONO,NAKIFUMA COUNTY,NAGOJJE,NAMATABA,KANYOGOGA,682,2,6,12,129,317,466,16,482,0,O-32-178-04-05-04
MUKONO,NAKIFUMA COUNTY,NAGOJJE,WAGALA,WAGGALA,334,3,0,4,44,170,221,7,228,0,O-32-178-04-06-01
MUKONO,NAKIFUMA COUNTY,NAGOJJE,WAGALA,KITO,734,7,2,6,64,384,463,21,484,0,O-32-178-04-06-02
MUKONO,NAKIFUMA COUNTY,NAGOJJE,WAGALA,KISOOBA,561,1,58,2,0,274,335,0,335,0,O-32-178-04-06-03
MUKONO,NAKIFUMA COUNTY,NAGOJJE,WAGALA,KYEGALAASO,662,3,2,3,168,186,362,22,384,0,O-32-178-04-06-04
MUKONO,NAKIFUMA COUNTY,NAGOJJE,WAGALA,WASSWA,354,1,0,1,61,194,257,4,261,0,O-32-178-04-06-05
MUKONO,NAKIFUMA COUNTY,NAMUGANGA,KAYINI,BWEGIRE,551,2,2,7,130,217,358,11,369,0,O-32-178-05-01-01
MUKONO,NAKIFUMA COUNTY,NAMUGANGA,KAYINI,KAYINI I,328,2,1,6,91,91,191,22,213,0,O-32-178-05-01-02
MUKONO,NAKIFUMA COUNTY,NAMUGANGA,KAYINI,KAYINI II,576,1,1,8,112,228,350,0,350,0,O-32-178-05-01-03
MUKONO,NAKIFUMA COUNTY,NAMUGANGA,KAYINI,KIKOMA,194,0,0,0,50,86,136,11,147,0,O-32-178-05-01-04
MUKONO,NAKIFUMA COUNTY,NAMUGANGA,KAYINI,NACKEEKE,351,3,0,1,55,198,257,10,267,0,O-32-178-05-01-05
MUKONO,NAKIFUMA COUNTY,NAMUGANGA,KITALE,KASIISO,488,4,0,8,126,178,316,13,329,0,O-32-178-05-02-01
MUKONO,NAKIFUMA COUNTY,NAMUGANGA,KITALE,KITALE A,508,3,0,10,95,203,311,12,323,0,O-32-178-05-02-02
MUKONO,NAKIFUMA COUNTY,NAMUGANGA,KITALE,KITALE B,504,1,0,2,93,196,292,18,310,0,O-32-178-05-02-03
MUKONO,NAKIFUMA COUNTY,NAMUGANGA,KITALE,NAKASENYI,492,2,1,2,95,277,377,7,384,0,O-32-178-05-02-04
MUKONO,NAKIFUMA COUNTY,NAMUGANGA,KITALE,KITALE C,529,4,1,3,117,141,266,6,272,0,O-32-178-05-02-05
MUKONO,NAKIFUMA COUNTY,NAMUGANGA,KITUULA,KITUULA,332,0,1,12,86,133,232,7,239,0,O-32-178-05-03-01
MUKONO,NAKIFUMA COUNTY,NAMUGANGA,KITUULA,LUGALA,466,5,0,5,149,152,311,10,321,0,O-32-178-05-03-02
MUKONO,NAKIFUMA COUNTY,NAMUGANGA,KITUULA,KYEWANISE,241,0,0,2,64,82,148,6,154,0,O-32-178-05-03-03
MUKONO,NAKIFUMA COUNTY,NAMUGANGA,KITUULA,KYANIKA,304,0,0,3,98,113,214,15,229,0,O-32-178-05-03-04
MUKONO,NAKIFUMA COUNTY,NAMUGANGA,KITUULA,GIMBI,428,3,0,6,137,126,272,8,280,0,O-32-178-05-03-05
MUKONO,NAKIFUMA COUNTY,NAMUGANGA,KITUULA,MBULAMUTI,137,0,0,5,25,57,87,0,87,0,O-32-178-05-03-06
MUKONO,NAKIFUMA COUNTY,NAMUGANGA,NAMANOGA,BULONGO,567,4,1,2,103,224,334,37,371,0,O-32-178-05-04-01
MUKONO,NAKIFUMA COUNTY,NAMUGANGA,NAMANOGA,MAWOTTO,654,0,3,8,141,260,412,18,430,0,O-32-178-05-04-02
MUKONO,NAKIFUMA COUNTY,NAMUGANGA,NAMANOGA,NAKASEJJERE,445,2,1,2,65,231,301,11,312,0,O-32-178-05-04-03
MUKONO,NAKIFUMA COUNTY,NAMUGANGA,NAMANOGA,MAKENKE,491,0,0,5,79,248,332,22,354,0,O-32-178-05-04-04
MUKONO,NAKIFUMA COUNTY,NAMUGANGA,NAMANOGA,NAMANOGA,554,5,0,6,111,231,353,22,375,0,O-32-178-05-04-05
MUKONO,NAKIFUMA COUNTY,NAMUGANGA,NAMUGANGA,NAMUGANGA,785,4,1,4,138,312,459,29,488,0,O-32-178-05-05-01
MUKONO,NAKIFUMA COUNTY,NAMUGANGA,NAMUGANGA,NSAGI,377,2,0,5,67,177,251,9,260,0,O-32-178-05-05-02
MUKONO,NAKIFUMA COUNTY,NAMUGANGA,NAMUGANGA,BUTUMBIRI,419,0,1,4,64,195,264,31,295,0,O-32-178-05-05-03
MUKONO,NAKIFUMA COUNTY,NAMUGANGA,NAMUGANGA,KIBUYE,458,7,2,7,103,212,331,8,339,0,O-32-178-05-05-04
MUKONO,NAKIFUMA COUNTY,NAMUGANGA,NAMUGANGA,KYAMBOGO,286,1,1,2,49,137,190,8,198,0,O-32-178-05-05-05
MUKONO,NAKIFUMA COUNTY,NTUNDA,KATETE,KATETE,525,1,4,2,64,291,362,22,384,0,O-32-178-06-01-01
MUKONO,NAKIFUMA COUNTY,NTUNDA,KATETE,KALAGALA,130,0,0,1,9,90,100,3,103,0,O-32-178-06-01-02
MUKONO,NAKIFUMA COUNTY,NTUNDA,KYABAZAALA,BULYANTI,425,2,0,7,79,190,278,12,290,0,O-32-178-06-02-01
MUKONO,NAKIFUMA COUNTY,NTUNDA,KYABAZAALA,KITEREDDE,312,2,4,9,66,114,195,7,202,0,O-32-178-06-02-02
MUKONO,NAKIFUMA COUNTY,NTUNDA,KYABAZAALA,KYABAZAALA,693,5,15,11,119,293,443,8,451,0,O-32-178-06-02-03
MUKONO,NAKIFUMA COUNTY,NTUNDA,KYABAZAALA,KAWUKU PENTECOASTAL CHURC,166,3,0,2,19,94,118,4,122,0,O-32-178-06-02-04
MUKONO,NAKIFUMA COUNTY,NTUNDA,NAMAYUBA,NAMAYUBA,374,2,1,0,43,207,253,2,255,0,O-32-178-06-03-01
MUKONO,NAKIFUMA COUNTY,NTUNDA,NAMAYUBA,NTONTO,370,0,4,3,89,135,231,18,249,0,O-32-178-06-03-02
MUKONO,NAKIFUMA COUNTY,NTUNDA,NAMAYUBA,WALUBIRA,285,3,4,1,51,141,200,0,200,0,O-32-178-06-03-03
MUKONO,NAKIFUMA COUNTY,NTUNDA,NTUNDA,NTUNDA,723,5,4,9,167,258,443,30,473,0,O-32-178-06-04-01
MUKONO,NAKIFUMA COUNTY,NTUNDA,NTUNDA,JOY AND JOLLY PRIMARY SCHOO,499,2,1,4,73,214,294,17,311,0,O-32-178-06-04-02
MUKONO,NAKIFUMA COUNTY,NTUNDA,NTUNDA,NAMUKUPA,212,3,0,2,68,71,144,2,146,0,O-32-178-06-04-03
MUKONO,NAKIFUMA COUNTY,NTUNDA,NTUNDA,KITAYUNJA,385,4,2,7,65,184,262,8,270,0,O-32-178-06-04-04
RAKAI,KAKUUTO COUNTY,KAKUUTO,BIGADA,BIGADA,851,3,0,9,102,414,528,27,555,0,O-36-192-01-01-01
RAKAI,KAKUUTO COUNTY,KAKUUTO,BIGADA,KAKUUTO,606,4,1,10,82,313,410,23,433,0,O-36-192-01-01-02
RAKAI,KAKUUTO COUNTY,KAKUUTO,KAKUUTO,KAKUUTO TOWN,538,3,1,4,122,219,349,8,357,0,O-36-192-01-02-01
RAKAI,KAKUUTO COUNTY,KAKUUTO,KAKUUTO,KAKUUTO VILLAGE (A-M),459,2,1,14,64,241,322,15,337,0,O-36-192-01-02-02
RAKAI,KAKUUTO COUNTY,KAKUUTO,KAKUUTO,KITASIBA C,739,2,1,12,177,330,522,26,548,0,O-36-192-01-02-03
RAKAI,KAKUUTO COUNTY,KAKUUTO,KAKUUTO,KASOGA P/S,426,2,0,9,61,233,305,15,320,0,O-36-192-01-02-04
RAKAI,KAKUUTO COUNTY,KAKUUTO,KAKUUTO,KAKUUTO VILLAGE (N-Z),465,1,0,12,135,187,335,24,359,0,O-36-192-01-02-05
RAKAI,KAKUUTO COUNTY,KAKUUTO,KATOVU,MATENGETO,609,1,0,4,62,382,449,12,461,0,O-36-192-01-03-01
RAKAI,KAKUUTO COUNTY,KAKUUTO,KATOVU,KIBAALE,607,3,0,4,103,323,433,16,449,0,O-36-192-01-03-02
RAKAI,KAKUUTO COUNTY,KAKUUTO,KATOVU,KAWERIMIDDE/MULUKA HQTRS (A,469,3,0,3,68,230,304,8,312,0,O-36-192-01-03-03
RAKAI,KAKUUTO COUNTY,KAKUUTO,KATOVU,KAWERIMIDDE/MULUKA HQTRS (N,601,8,0,4,68,280,360,26,386,0,O-36-192-01-03-04
RAKAI,KAKUUTO COUNTY,KAKUUTO,KYEBISAGAZI,KYAKATUUMA,461,0,0,1,50,222,273,26,299,0,O-36-192-01-04-01
RAKAI,KAKUUTO COUNTY,KAKUUTO,KYEBISAGAZI,KYASSIMBI,1149,1,0,12,79,615,707,59,766,0,O-36-192-01-04-02
RAKAI,KAKUUTO COUNTY,KAKUUTO,KYEBISAGAZI,BIWA,412,3,1,0,19,194,217,8,225,0,O-36-192-01-04-03
RAKAI,KAKUUTO COUNTY,KAKUUTO,MAYANJA,MAYANJA(KIGEYE),666,2,1,4,105,322,434,44,478,0,O-36-192-01-05-01
RAKAI,KAKUUTO COUNTY,KAKUUTO,MAYANJA,KAMUGANJA,593,6,0,9,109,311,435,26,461,0,O-36-192-01-05-02
RAKAI,KAKUUTO COUNTY,KAKUUTO,MAYANJA,KYAMUBEJJA,587,4,0,7,96,307,414,8,422,0,O-36-192-01-05-03
RAKAI,KAKUUTO COUNTY,KAKUUTO,MUTUKULA,MUTUKULA (A-M),905,3,1,2,101,392,499,27,526,0,O-36-192-01-06-01
RAKAI,KAKUUTO COUNTY,KAKUUTO,MUTUKULA,MUTUKULA (N-Z),668,1,0,1,113,270,385,10,395,0,O-36-192-01-06-02
RAKAI,KAKUUTO COUNTY,KAKUUTO,SANGO BAY,KABONERA,886,2,1,7,115,509,634,9,643,0,O-36-192-01-07-01
RAKAI,KAKUUTO COUNTY,KASASA,KIJONJO,NAKATOOKE T.C,507,0,1,6,67,280,354,28,382,0,O-36-192-02-01-01
RAKAI,KAKUUTO COUNTY,KASASA,KIJONJO,HEALTH CENTRE II,554,0,0,0,102,316,418,21,439,0,O-36-192-02-01-02
RAKAI,KAKUUTO COUNTY,KASASA,KIMUKUNDA,KIMUKUNDA,612,2,2,4,86,342,436,11,447,0,O-36-192-02-02-01
RAKAI,KAKUUTO COUNTY,KASASA,KIMUKUNDA,KISAALIZI,255,1,0,2,60,133,196,3,199,0,O-36-192-02-02-02
RAKAI,KAKUUTO COUNTY,KASASA,KISUULA,KISUULA,602,0,0,2,167,304,473,10,483,0,O-36-192-02-03-01
RAKAI,KAKUUTO COUNTY,KASASA,MITYEBIRI,KASASA,518,0,0,5,91,297,393,11,404,0,O-36-192-02-04-01
RAKAI,KAKUUTO COUNTY,KASASA,MITYEBIRI,MITYEBIRI,435,3,2,6,96,228,335,25,360,0,O-36-192-02-04-02
RAKAI,KAKUUTO COUNTY,KASASA,SSANJE/KABANO,KABAALE,567,2,1,6,150,228,387,40,427,0,O-36-192-02-05-01
RAKAI,KAKUUTO COUNTY,KASASA,SSANJE/KABANO,KITAWULIZI,834,2,0,18,260,290,570,18,588,0,O-36-192-02-05-02
RAKAI,KAKUUTO COUNTY,KASASA,SSANJE/KABANO,SSANJE TECHNICAL,515,1,1,8,166,170,346,16,362,0,O-36-192-02-05-03
RAKAI,KAKUUTO COUNTY,KIBANDA,BBALE,BUSHENYI,380,1,0,1,43,231,276,12,288,0,O-36-192-03-01-01
RAKAI,KAKUUTO COUNTY,KIBANDA,BBALE,GUNDA,200,0,0,2,25,135,162,6,168,0,O-36-192-03-01-02
RAKAI,KAKUUTO COUNTY,KIBANDA,BBALE,LUSAASA,381,2,0,3,35,255,295,4,299,0,O-36-192-03-01-03
RAKAI,KAKUUTO COUNTY,KIBANDA,KAKINGA,BYOKYA,415,0,0,4,23,270,297,10,307,0,O-36-192-03-02-01
RAKAI,KAKUUTO COUNTY,KIBANDA,KAKINGA,KYAKAGO P/S,480,0,1,2,71,284,358,0,358,0,O-36-192-03-02-02
RAKAI,KAKUUTO COUNTY,KIBANDA,KAKINGA,KIBANDA S/C,450,0,3,5,78,232,318,11,329,0,O-36-192-03-02-03
RAKAI,KAKUUTO COUNTY,KIBANDA,KAKINGA,LWENSAMBYA,170,0,0,2,32,105,139,2,141,0,O-36-192-03-02-04
RAKAI,KAKUUTO COUNTY,KIBANDA,KAKINGA,NAKULABYE,596,1,1,6,48,368,424,1,425,0,O-36-192-03-02-05
RAKAI,KAKUUTO COUNTY,KIBANDA,KYABIWA,KYABIWA,646,0,0,0,38,372,410,7,417,0,O-36-192-03-03-01
RAKAI,KAKUUTO COUNTY,KIBANDA,KYABIWA,OWINO,562,0,1,4,84,292,381,6,387,0,O-36-192-03-03-02
RAKAI,KAKUUTO COUNTY,KIBANDA,KYABIWA,KANAZI,305,0,0,3,25,246,274,1,275,0,O-36-192-03-03-03
RAKAI,KAKUUTO COUNTY,KIBANDA,KYALUGABA,KYALUGABA,417,1,2,6,24,273,306,11,317,0,O-36-192-03-04-01
RAKAI,KAKUUTO COUNTY,KIBANDA,KYALUGABA,KISWERE A,413,0,3,4,31,268,306,25,331,0,O-36-192-03-04-02
RAKAI,KAKUUTO COUNTY,KIBANDA,KYALUGABA,KISWERE B,365,0,1,1,29,232,263,21,284,0,O-36-192-03-04-03
RAKAI,KAKUUTO COUNTY,KIBANDA,KYALUGABA,KABWAASA,319,0,0,4,39,229,272,9,281,0,O-36-192-03-04-04
RAKAI,KAKUUTO COUNTY,KIBANDA,MAGABI,KITEREDDE,530,2,1,5,42,366,416,18,434,0,O-36-192-03-05-01
RAKAI,KAKUUTO COUNTY,KIBANDA,MAGABI,GAYAZA,278,0,1,2,26,193,222,6,228,0,O-36-192-03-05-02
RAKAI,KAKUUTO COUNTY,KIFAMBA,KABALA,MBIRIZI,683,0,0,3,128,414,545,21,566,0,O-36-192-04-01-01
RAKAI,KAKUUTO COUNTY,KIFAMBA,KABALA,KABALA,338,1,0,5,59,186,251,20,271,0,O-36-192-04-01-02
RAKAI,KAKUUTO COUNTY,KIFAMBA,KAWUNGULI,MANYA,764,2,0,7,196,329,534,32,566,0,O-36-192-04-02-01
RAKAI,KAKUUTO COUNTY,KIFAMBA,KAWUNGULI,KAGONGERO,595,2,1,3,80,363,449,24,473,0,O-36-192-04-02-02
RAKAI,KAKUUTO COUNTY,KIFAMBA,KIFAMBA,KIFAMBA,732,0,0,3,177,319,499,19,518,0,O-36-192-04-03-01
RAKAI,KAKUUTO COUNTY,KIFAMBA,KIFAMBA,NABUNGA,239,1,0,2,58,140,201,5,206,0,O-36-192-04-03-02
RAKAI,KAKUUTO COUNTY,KIFAMBA,KIFAMBA,KIJUMBA,352,1,0,3,55,196,255,16,271,0,O-36-192-04-03-03
RAKAI,KAKUUTO COUNTY,KIFAMBA,KISAASA,KISAASA,467,0,0,2,81,235,318,6,324,0,O-36-192-04-04-01
RAKAI,KAKUUTO COUNTY,KIFAMBA,KISAASA,KIRULI,688,2,0,4,84,394,484,21,505,0,O-36-192-04-04-02
RAKAI,KAKUUTO COUNTY,KYEBE,GWANDA,GWANDA,595,2,0,19,137,315,473,9,482,0,O-36-192-05-01-01
RAKAI,KAKUUTO COUNTY,KYEBE,GWANDA,KINYIGA,857,3,0,12,185,377,577,15,592,0,O-36-192-05-01-02
RAKAI,KAKUUTO COUNTY,KYEBE,KANABULEMU,KYEBE,521,1,1,11,200,153,366,8,374,0,O-36-192-05-02-01
RAKAI,KAKUUTO COUNTY,KYEBE,KANABULEMU,KIBUMBA-BALOOLE,659,3,0,17,273,202,495,21,516,0,O-36-192-05-02-02
RAKAI,KAKUUTO COUNTY,KYEBE,KANABULEMU,MUZZI TOWN,522,2,0,14,118,256,390,15,405,0,O-36-192-05-02-03
RAKAI,KAKUUTO COUNTY,KYEBE,KASENSERO,KASENSERO P/S (A-M),311,0,0,1,49,104,154,8,162,0,O-36-192-05-03-01
RAKAI,KAKUUTO COUNTY,KYEBE,KASENSERO,KASENSERO,1467,4,1,10,285,409,709,18,727,0,O-36-192-05-03-02
RAKAI,KAKUUTO COUNTY,KYEBE,KASENSERO,KASENSERO P/S (N-Z),281,1,0,3,38,98,140,5,145,0,O-36-192-05-03-03
RAKAI,KAKUUTO COUNTY,KYEBE,MINZIRO,KAMPANGI-KISAZI,878,4,0,11,117,514,646,41,687,0,O-36-192-05-04-01
RAKAI,KAKUUTO COUNTY,KYEBE,NANGOMA,NANGOMA,845,0,0,1,32,590,623,22,645,0,O-36-192-05-05-01
RAKAI,KOOKI COUNTY,BYAKABANDA,BYAKABANDA,BYAKABANDA,462,0,0,6,76,235,317,6,323,0,O-36-193-01-01-01
RAKAI,KOOKI COUNTY,BYAKABANDA,BYAKABANDA,KATERERO,695,0,2,18,114,377,511,16,527,0,O-36-193-01-01-02
RAKAI,KOOKI COUNTY,BYAKABANDA,BYAKABANDA,KAGEYE,352,0,1,8,53,210,272,3,275,0,O-36-193-01-01-03
RAKAI,KOOKI COUNTY,BYAKABANDA,BYAKABANDA,KAKUMBIRO,528,2,1,5,70,338,416,6,422,0,O-36-193-01-01-04
RAKAI,KOOKI COUNTY,BYAKABANDA,KAMUKALO,KAMUKALO,815,2,0,4,148,454,608,20,628,0,O-36-193-01-02-01
RAKAI,KOOKI COUNTY,BYAKABANDA,KAMUKALO,KIBINDA,650,5,0,6,85,388,484,23,507,0,O-36-193-01-02-02
RAKAI,KOOKI COUNTY,BYAKABANDA,KAMUKALO,KYEMPEWO,856,3,1,6,109,512,631,43,674,0,O-36-193-01-02-03
RAKAI,KOOKI COUNTY,BYAKABANDA,KAMUKALO,LUKYAMU KASOMOLO,610,4,0,3,82,394,483,14,497,0,O-36-193-01-02-04
RAKAI,KOOKI COUNTY,BYAKABANDA,KITAASA,KITAASA,521,0,0,4,31,350,385,7,392,0,O-36-193-01-03-01
RAKAI,KOOKI COUNTY,BYAKABANDA,KITAASA,MICUNGIRO,294,2,0,4,29,198,233,9,242,0,O-36-193-01-03-02
RAKAI,KOOKI COUNTY,DDWANIRO,BUYAMBA,BUYAMBA,588,0,0,5,148,252,405,7,412,0,O-36-193-02-01-01
RAKAI,KOOKI COUNTY,DDWANIRO,BUYAMBA,BULONGO,530,1,1,2,112,266,382,16,398,0,O-36-193-02-01-02
RAKAI,KOOKI COUNTY,DDWANIRO,BUYAMBA,KYONDO,586,4,0,6,135,289,434,6,440,0,O-36-193-02-01-03
RAKAI,KOOKI COUNTY,DDWANIRO,BUYAMBA,LUTUMBA CENTRAL,341,2,1,8,52,181,244,16,260,0,O-36-193-02-01-04
RAKAI,KOOKI COUNTY,DDWANIRO,DDWANIRO,MARKET PLACE,549,3,1,2,75,341,422,10,432,0,O-36-193-02-02-01
RAKAI,KOOKI COUNTY,DDWANIRO,DDWANIRO,DDWANIRO T/C,716,0,0,2,144,330,476,22,498,0,O-36-193-02-02-02
RAKAI,KOOKI COUNTY,DDWANIRO,DDWANIRO,BUYAMO,366,2,0,2,30,265,299,9,308,0,O-36-193-02-02-03
RAKAI,KOOKI COUNTY,DDWANIRO,DDWANIRO,KASEKERE,525,1,0,7,94,305,407,23,430,0,O-36-193-02-02-04
RAKAI,KOOKI COUNTY,DDWANIRO,DDWANIRO,NATEETE,658,1,1,4,77,398,481,10,491,0,O-36-193-02-02-05
RAKAI,KOOKI COUNTY,DDWANIRO,KAYONZA,KAYONZA MULUKA HQTRS.,639,1,0,5,89,371,466,12,478,0,O-36-193-02-03-01
RAKAI,KOOKI COUNTY,DDWANIRO,KAYONZA,KAYONZA T/C,629,1,0,3,69,379,452,42,494,0,O-36-193-02-03-02
RAKAI,KOOKI COUNTY,DDWANIRO,KAYONZA,MALEMBA PS,626,3,1,1,40,413,458,12,470,0,O-36-193-02-03-03
RAKAI,KOOKI COUNTY,DDWANIRO,LWAKALOLO,KISAAYI T/C,476,0,1,7,115,210,333,5,338,0,O-36-193-02-04-01
RAKAI,KOOKI COUNTY,DDWANIRO,LWAKALOLO,NAMIYAGA/KITAWULUZI,690,0,0,4,111,359,474,26,500,0,O-36-193-02-04-02
RAKAI,KOOKI COUNTY,DDWANIRO,LWAKALOLO,LWENDAULA,534,1,0,4,123,244,372,14,386,0,O-36-193-02-04-03
RAKAI,KOOKI COUNTY,DDWANIRO,LWAKALOLO,NTUNTU,472,3,0,6,66,253,328,12,340,0,O-36-193-02-04-04
RAKAI,KOOKI COUNTY,DDWANIRO,MALEMBA/KALEERE,KICWAMANGO,706,0,0,5,81,417,503,25,528,0,O-36-193-02-05-01
RAKAI,KOOKI COUNTY,DDWANIRO,MALEMBA/KALEERE,SEMUTO PS (A-M),426,3,0,2,56,243,304,18,322,0,O-36-193-02-05-02
RAKAI,KOOKI COUNTY,DDWANIRO,MALEMBA/KALEERE,NSONSO,208,2,0,0,38,128,168,4,172,0,O-36-193-02-05-03
RAKAI,KOOKI COUNTY,DDWANIRO,MALEMBA/KALEERE,SEMUTO PS (N-Z),615,6,0,4,62,358,430,18,448,0,O-36-193-02-05-04
RAKAI,KOOKI COUNTY,KACHEERA,KAJJU,KAJJU,414,2,0,4,61,230,297,10,307,0,O-36-193-03-01-01
RAKAI,KOOKI COUNTY,KACHEERA,KAJJU,KATOVU,780,1,0,7,47,460,515,30,545,0,O-36-193-03-01-02
RAKAI,KOOKI COUNTY,KACHEERA,KAJJU,KACHEERA,686,4,0,7,77,360,448,18,466,0,O-36-193-03-01-03
RAKAI,KOOKI COUNTY,KACHEERA,KAKIRI,LWEBIRIBA,799,2,0,2,42,481,527,24,551,0,O-36-193-03-02-01
RAKAI,KOOKI COUNTY,KACHEERA,KAKIRI,KACHEERA MIXED P/S,473,1,0,1,34,256,292,13,305,0,O-36-193-03-02-02
RAKAI,KOOKI COUNTY,KACHEERA,KATATENGA,RWENTARE,319,1,0,2,39,223,265,0,265,0,O-36-193-03-03-01
RAKAI,KOOKI COUNTY,KACHEERA,KATATENGA,KATATENGA,366,1,0,2,30,199,232,2,234,0,O-36-193-03-03-02
RAKAI,KOOKI COUNTY,KACHEERA,KATATENGA,RWAMULONKO,360,4,0,2,54,216,276,7,283,0,O-36-193-03-03-03
RAKAI,KOOKI COUNTY,KACHEERA,KAYONZA,KAYONZA,527,4,1,2,46,293,346,24,370,0,O-36-193-03-04-01
RAKAI,KOOKI COUNTY,KACHEERA,KAYONZA,KYAKATAMARA,494,0,0,6,41,302,349,23,372,0,O-36-193-03-04-02
RAKAI,KOOKI COUNTY,KACHEERA,LWANGA,LWANGA P/S (A-M),498,1,0,5,70,229,305,4,309,0,O-36-193-03-05-01
RAKAI,KOOKI COUNTY,KACHEERA,LWANGA,LWANGA P/S (N-Z),478,0,0,2,42,238,282,17,299,0,O-36-193-03-05-02
RAKAI,KOOKI COUNTY,KACHEERA,LYAKISANA,KATOOGO,784,1,2,4,48,473,528,2,530,0,O-36-193-03-06-01
RAKAI,KOOKI COUNTY,KACHEERA,LYAKISANA,LYAKISANA,632,0,0,2,53,394,449,5,454,0,O-36-193-03-06-02
RAKAI,KOOKI COUNTY,KACHEERA,LYAKISANA,NAKASENYI,561,0,1,3,43,312,359,16,375,0,O-36-193-03-06-03
RAKAI,KOOKI COUNTY,KAGAMBA (BUYAMBA),KAGAMBA,KAGAMBA,556,3,0,3,75,278,359,13,372,0,O-36-193-04-01-01
RAKAI,KOOKI COUNTY,KAGAMBA (BUYAMBA),KAGAMBA,KIMINDI,474,0,0,0,66,243,309,33,342,0,O-36-193-04-01-02
RAKAI,KOOKI COUNTY,KAGAMBA (BUYAMBA),KAGAMBA,KIYAMBA,310,0,0,2,66,155,223,8,231,0,O-36-193-04-01-03
RAKAI,KOOKI COUNTY,KAGAMBA (BUYAMBA),KAGAMBA,KIZIRA,344,0,0,2,17,229,248,6,254,0,O-36-193-04-01-04
RAKAI,KOOKI COUNTY,KAGAMBA (BUYAMBA),KASANKALA,KYAMA KANANGA P/S,395,2,0,2,56,257,317,4,321,0,O-36-193-04-02-01
RAKAI,KOOKI COUNTY,KAGAMBA (BUYAMBA),KASANKALA,KASANKALA P/S,545,1,0,5,19,387,412,8,420,0,O-36-193-04-02-02
RAKAI,KOOKI COUNTY,KAGAMBA (BUYAMBA),KASANKALA,NKONGOOTA,484,2,2,1,16,333,354,1,355,0,O-36-193-04-02-03
RAKAI,KOOKI COUNTY,KAGAMBA (BUYAMBA),KASANKALA,KIBINGO P/S,454,1,0,4,13,317,335,15,350,0,O-36-193-04-02-04
RAKAI,KOOKI COUNTY,KAGAMBA (BUYAMBA),KASANKALA,KASANKALA (A-M),460,1,0,0,42,274,317,14,331,0,O-36-193-04-02-05
RAKAI,KOOKI COUNTY,KAGAMBA (BUYAMBA),KASANKALA,KASANKALA (N-Z),391,0,0,2,22,284,308,6,314,0,O-36-193-04-02-06
RAKAI,KOOKI COUNTY,KAGAMBA (BUYAMBA),KIMULI,KITUNTU,761,1,0,2,32,452,487,37,524,0,O-36-193-04-03-01
RAKAI,KOOKI COUNTY,KAGAMBA (BUYAMBA),KIMULI,KIMULI,411,1,0,4,88,188,281,12,293,0,O-36-193-04-03-02
RAKAI,KOOKI COUNTY,KAGAMBA (BUYAMBA),KIMULI,MWERUKA,791,0,0,5,64,454,523,35,558,0,O-36-193-04-03-03
RAKAI,KOOKI COUNTY,KAGAMBA (BUYAMBA),KIMULI,LWENTUREGE,713,0,0,5,63,377,445,18,463,0,O-36-193-04-03-04
RAKAI,KOOKI COUNTY,KAGAMBA (BUYAMBA),KIRANGIRA,KANYOGOGA,294,0,0,0,25,166,191,3,194,0,O-36-193-04-04-01
RAKAI,KOOKI COUNTY,KAGAMBA (BUYAMBA),KIRANGIRA,KENYOKI,492,1,0,1,44,271,317,6,323,0,O-36-193-04-04-02
RAKAI,KOOKI COUNTY,KAGAMBA (BUYAMBA),KIRANGIRA,KIRANGIRA,882,0,1,3,102,417,523,23,546,0,O-36-193-04-04-03
RAKAI,KOOKI COUNTY,KAGAMBA (BUYAMBA),LWABAKOBA,KATUNTU,641,1,1,5,51,392,450,7,457,0,O-36-193-04-05-01
RAKAI,KOOKI COUNTY,KAGAMBA (BUYAMBA),LWABAKOBA,BBAALE,713,2,0,2,79,436,519,19,538,0,O-36-193-04-05-02
RAKAI,KOOKI COUNTY,KAGAMBA (BUYAMBA),LWABAKOBA,LUGANDO,383,0,1,2,29,261,293,12,305,0,O-36-193-04-05-03
RAKAI,KOOKI COUNTY,KAGAMBA (BUYAMBA),LWABAKOBA,LWABAKOBA,601,0,0,11,40,399,450,13,463,0,O-36-193-04-05-04
RAKAI,KOOKI COUNTY,KAGAMBA (BUYAMBA),LWABAKOBA,BANYORO,253,0,0,1,6,192,199,4,203,0,O-36-193-04-05-05
RAKAI,KOOKI COUNTY,KAGAMBA (BUYAMBA),LWABAKOBA,NABIZZI,603,0,2,5,50,355,412,14,426,0,O-36-193-04-05-06
RAKAI,KOOKI COUNTY,KYALULANGIRA,DYANGO,KABUKURURA,649,1,0,3,17,395,416,18,434,0,O-36-193-05-01-01
RAKAI,KOOKI COUNTY,KYALULANGIRA,DYANGO,DYANGO,753,2,0,2,44,414,462,32,494,0,O-36-193-05-01-02
RAKAI,KOOKI COUNTY,KYALULANGIRA,KALUNGI,BUZZA,687,2,0,7,87,427,523,27,550,0,O-36-193-05-02-01
RAKAI,KOOKI COUNTY,KYALULANGIRA,KALUNGI,KEZEKIYA P/S,268,0,0,0,69,142,211,7,218,0,O-36-193-05-02-02
RAKAI,KOOKI COUNTY,KYALULANGIRA,KALUNGI,KIBAALE,860,2,0,8,174,401,585,37,622,0,O-36-193-05-02-03
RAKAI,KOOKI COUNTY,KYALULANGIRA,KALUNGI,TOLERO,494,3,1,8,89,257,358,27,385,0,O-36-193-05-02-04
RAKAI,KOOKI COUNTY,KYALULANGIRA,KASULA,NTEBEZZADDUNGU,854,1,2,4,94,536,637,14,651,0,O-36-193-05-03-01
RAKAI,KOOKI COUNTY,KYALULANGIRA,KASULA,KAYAGO,691,8,1,9,125,370,513,10,523,0,O-36-193-05-03-02
RAKAI,KOOKI COUNTY,KYALULANGIRA,KASULA,SANJE P/S,791,3,1,5,91,477,577,14,591,0,O-36-193-05-03-03
RAKAI,KOOKI COUNTY,KYALULANGIRA,KIZIBA,MWERUKA A,449,0,2,2,76,258,338,7,345,0,O-36-193-05-04-01
RAKAI,KOOKI COUNTY,KYALULANGIRA,KIZIBA,KALWAI,608,4,2,5,57,472,540,16,556,0,O-36-193-05-04-02
RAKAI,KOOKI COUNTY,KYALULANGIRA,KIZIBA,NDAGGA,518,2,0,5,88,355,450,5,455,0,O-36-193-05-04-03
RAKAI,KOOKI COUNTY,KYALULANGIRA,KIZIBA,MWERUKA B,635,2,0,1,63,335,401,14,415,0,O-36-193-05-04-04
RAKAI,KOOKI COUNTY,KYALULANGIRA,LUKERERE,RYERU,312,1,1,4,28,198,232,20,252,0,O-36-193-05-05-01
RAKAI,KOOKI COUNTY,KYALULANGIRA,LUKERERE,NSAMBYA,306,0,0,2,15,226,243,15,258,0,O-36-193-05-05-02
RAKAI,KOOKI COUNTY,KYALULANGIRA,LUKERERE,LUKERERE,492,0,0,0,26,337,363,8,371,0,O-36-193-05-05-03
RAKAI,KOOKI COUNTY,KYALULANGIRA,LWENSINGA,LWENSINGA,781,0,0,1,75,519,595,6,601,0,O-36-193-05-06-01
RAKAI,KOOKI COUNTY,KYALULANGIRA,LWENSINGA,KIJJONJO,301,0,1,2,20,200,223,6,229,0,O-36-193-05-06-02
RAKAI,KOOKI COUNTY,KYALULANGIRA,LWENSINGA,RWAKACUUCU,613,2,0,2,36,390,430,7,437,0,O-36-193-05-06-03
RAKAI,KOOKI COUNTY,KYALULANGIRA,RWAMBAJJO,RWABAGANDA,533,1,0,0,52,350,403,10,413,0,O-36-193-05-07-01
RAKAI,KOOKI COUNTY,KYALULANGIRA,RWAMBAJJO,RWANBAJJO,729,2,2,6,68,591,669,8,677,0,O-36-193-05-07-02
RAKAI,KOOKI COUNTY,KYALULANGIRA,RWAMBAJJO,KIZINGA,695,3,0,4,90,337,434,9,443,0,O-36-193-05-07-03
RAKAI,KOOKI COUNTY,LWAMAGGWA,BUGONA,LWENGO,730,4,2,11,76,447,540,20,560,0,O-36-193-06-01-01
RAKAI,KOOKI COUNTY,LWAMAGGWA,BUGONA,KALAWULA PLAY GROUND,711,2,0,4,74,357,437,51,488,0,O-36-193-06-01-02
RAKAI,KOOKI COUNTY,LWAMAGGWA,BUGONA,KISAMBA (A-M),528,0,0,3,48,348,399,25,424,0,O-36-193-06-01-03
RAKAI,KOOKI COUNTY,LWAMAGGWA,BUGONA,KABALE,870,6,2,5,80,512,605,30,635,0,O-36-193-06-01-04
RAKAI,KOOKI COUNTY,LWAMAGGWA,BUGONA,KISAMBA (N-Z),522,1,0,2,20,324,347,33,380,0,O-36-193-06-01-05
RAKAI,KOOKI COUNTY,LWAMAGGWA,KABUSOTA,KABUSOTTA,615,5,0,8,43,393,449,28,477,0,O-36-193-06-02-01
RAKAI,KOOKI COUNTY,LWAMAGGWA,KABUSOTA,BWENYEGE,437,0,0,2,46,281,329,3,332,0,O-36-193-06-02-02
RAKAI,KOOKI COUNTY,LWAMAGGWA,KABUSOTA,KATUULO,455,0,0,3,50,293,346,10,356,0,O-36-193-06-02-03
RAKAI,KOOKI COUNTY,LWAMAGGWA,KAKUNDI,KAKUUNDI,654,2,0,3,28,444,477,14,491,0,O-36-193-06-03-01
RAKAI,KOOKI COUNTY,LWAMAGGWA,KAKUNDI,LUSONGI,544,3,1,1,57,334,396,27,423,0,O-36-193-06-03-02
RAKAI,KOOKI COUNTY,LWAMAGGWA,KAKUNDI,LUGALAMA,440,2,0,3,39,271,315,22,337,0,O-36-193-06-03-03
RAKAI,KOOKI COUNTY,LWAMAGGWA,KAKUNDI,KIGOTO,363,1,0,3,54,222,280,10,290,0,O-36-193-06-03-04
RAKAI,KOOKI COUNTY,LWAMAGGWA,KIBUUKA,LUTEETE,772,4,0,8,109,391,512,34,546,0,O-36-193-06-04-01
RAKAI,KOOKI COUNTY,LWAMAGGWA,KIBUUKA,KYANIKA,622,3,0,7,90,317,417,33,450,0,O-36-193-06-04-02
RAKAI,KOOKI COUNTY,LWAMAGGWA,KIBUUKA,LWOYO,786,2,0,9,80,442,533,34,567,0,O-36-193-06-04-03
RAKAI,KOOKI COUNTY,LWAMAGGWA,KIBUUKA,KAMUNUNKA,577,2,0,2,54,393,451,21,472,0,O-36-193-06-04-04
RAKAI,KOOKI COUNTY,LWAMAGGWA,KIWEEKA,KIKEBEZI COU P/S,396,1,0,1,39,194,235,29,264,0,O-36-193-06-05-01
RAKAI,KOOKI COUNTY,LWAMAGGWA,KIWEEKA,BYEZITIRE,498,2,0,5,74,246,327,0,327,0,O-36-193-06-05-02
RAKAI,KOOKI COUNTY,LWAMAGGWA,KIWEEKA,LWAMAGGWA P/S,671,0,0,3,112,285,400,14,414,0,O-36-193-06-05-03
RAKAI,KOOKI COUNTY,LWAMAGGWA,KIWEEKA,KAKABAGYO,455,1,0,3,71,220,295,5,300,0,O-36-193-06-05-04
RAKAI,KOOKI COUNTY,LWAMAGGWA,KYABIGONDO,MPAAMA,612,2,0,2,45,315,364,32,396,0,O-36-193-06-06-01
RAKAI,KOOKI COUNTY,LWAMAGGWA,KYABIGONDO,MUDAALA,784,5,1,7,77,422,512,0,512,0,O-36-193-06-06-02
RAKAI,KOOKI COUNTY,LWAMAGGWA,KYABIGONDO,NDEEBA,352,1,0,0,43,181,225,7,232,0,O-36-193-06-06-03
RAKAI,KOOKI COUNTY,LWAMAGGWA,KYABIGONDO,NTOKOTA,629,1,0,1,89,325,416,21,437,0,O-36-193-06-06-04
RAKAI,KOOKI COUNTY,LWAMAGGWA,KYABIGONDO,LUNOONI,537,4,1,4,45,326,380,9,389,0,O-36-193-06-06-05
RAKAI,KOOKI COUNTY,LWAMAGGWA,KYABIGONDO,KAYABWE,361,1,1,2,32,201,237,15,252,0,O-36-193-06-06-06
RAKAI,KOOKI COUNTY,LWANDA,BITABAGO,BUTULA,619,0,1,6,157,279,443,18,461,0,O-36-193-07-01-01
RAKAI,KOOKI COUNTY,LWANDA,BITABAGO,KAKOMA,584,0,0,2,109,274,385,10,395,0,O-36-193-07-01-02
RAKAI,KOOKI COUNTY,LWANDA,BITABAGO,LUMBUGU,425,4,0,5,106,160,275,30,305,0,O-36-193-07-01-03
RAKAI,KOOKI COUNTY,LWANDA,BUTIITI,KABINGO,567,0,2,7,84,282,375,33,408,0,O-36-193-07-02-01
RAKAI,KOOKI COUNTY,LWANDA,BUTIITI,BUTITI (A-M),291,2,0,2,90,110,204,4,208,0,O-36-193-07-02-02
RAKAI,KOOKI COUNTY,LWANDA,BUTIITI,KIWENDA,379,2,0,3,109,130,244,35,279,0,O-36-193-07-02-03
RAKAI,KOOKI COUNTY,LWANDA,BUTIITI,LUTUNGU P/S,368,1,0,9,44,221,275,7,282,0,O-36-193-07-02-04
RAKAI,KOOKI COUNTY,LWANDA,BUTIITI,BUTITI (N-Z),503,1,0,4,87,234,326,9,335,0,O-36-193-07-02-05
RAKAI,KOOKI COUNTY,LWANDA,KANONI,LUTEEBE,649,1,0,8,152,301,462,11,473,0,O-36-193-07-03-01
RAKAI,KOOKI COUNTY,LWANDA,KANONI,KANONI,503,0,1,2,98,277,378,14,392,0,O-36-193-07-03-02
RAKAI,KOOKI COUNTY,LWANDA,KASENSERO,KIWAGUZI,521,1,1,9,187,169,367,11,378,0,O-36-193-07-04-01
RAKAI,KOOKI COUNTY,LWANDA,KASENSERO,KAMENGO,628,1,1,5,119,263,389,6,395,0,O-36-193-07-04-02
RAKAI,KOOKI COUNTY,LWANDA,KASENSERO,NSOZIBBIRI,505,1,1,1,111,293,407,9,416,0,O-36-193-07-04-03
RAKAI,KOOKI COUNTY,LWANDA,KASENSERO,KYENGEZA MOSQUE,438,2,0,3,133,186,324,8,332,0,O-36-193-07-04-04
RAKAI,KOOKI COUNTY,LWANDA,KIYOVU,LWANDA TOWN,837,1,0,7,308,276,592,24,616,0,O-36-193-07-05-01
RAKAI,KOOKI COUNTY,LWANDA,KIYOVU,MBUYE P/S,544,0,0,5,178,226,409,14,423,0,O-36-193-07-05-02
RAKAI,KOOKI COUNTY,LWANDA,KIYOVU,KIGANDA,568,1,1,2,50,344,398,16,414,0,O-36-193-07-05-03
RAKAI,KOOKI COUNTY,LWANDA,KIYOVU,KIJIMBI,401,0,2,6,56,224,288,11,299,0,O-36-193-07-05-04
RAKAI,KOOKI COUNTY,RAKAI T.C.,KATUNTU,KATUNTU,476,3,1,11,78,233,326,18,344,0,O-36-193-08-01-01
RAKAI,KOOKI COUNTY,RAKAI T.C.,KATUNTU,KATWETWE,415,0,1,2,56,257,316,12,328,0,O-36-193-08-01-02
RAKAI,KOOKI COUNTY,RAKAI T.C.,KIBONA,RAKAI (A-M),480,2,2,14,118,153,289,8,297,0,O-36-193-08-02-01
RAKAI,KOOKI COUNTY,RAKAI T.C.,KIBONA,KIBONA,707,6,0,5,101,386,498,26,524,0,O-36-193-08-02-02
RAKAI,KOOKI COUNTY,RAKAI T.C.,KIBONA,KAJOKI C.O.U,176,1,0,2,22,103,128,4,132,0,O-36-193-08-02-03
RAKAI,KOOKI COUNTY,RAKAI T.C.,KIBONA,RAKAI (N-Z),738,1,0,12,138,271,422,11,433,0,O-36-193-08-02-04
NAKASONGOLA,NAKASONGOLA COUNTY,KAKOOGE,KAKOOGE,AKOOGE GOMBOLOLA HQTRS A,546,3,0,4,93,214,314,13,327,0,O-44-106-01-01-01
NAKASONGOLA,NAKASONGOLA COUNTY,KAKOOGE,KAKOOGE,KAKOOGE PR. SCH.,220,2,0,3,46,97,148,3,151,0,O-44-106-01-01-02
NAKASONGOLA,NAKASONGOLA COUNTY,KAKOOGE,KAKOOGE,KABAALE CATHOLIC CHURCH,655,7,3,5,59,359,433,9,442,0,O-44-106-01-01-03
NAKASONGOLA,NAKASONGOLA COUNTY,KAKOOGE,KAKOOGE,KAKOOGE GOMBOLOLA HQTRS B,815,4,1,5,100,405,515,0,515,0,O-44-106-01-01-04
NAKASONGOLA,NAKASONGOLA COUNTY,KAKOOGE,KATUUGO,KATUUGO FOREST STATION A,711,2,3,1,79,409,494,15,509,0,O-44-106-01-02-01
NAKASONGOLA,NAKASONGOLA COUNTY,KAKOOGE,KATUUGO,KABUKONYOGO LC I HQRS,143,0,1,1,4,107,113,2,115,0,O-44-106-01-02-02
NAKASONGOLA,NAKASONGOLA COUNTY,KAKOOGE,KATUUGO,KILARAMBA STATION,530,1,1,3,23,356,384,7,391,0,O-44-106-01-02-03
NAKASONGOLA,NAKASONGOLA COUNTY,KAKOOGE,KYABUTEIKA,KYABUTAIKA PRIMARY SCHOOL,605,0,0,2,26,385,413,7,420,0,O-44-106-01-03-01
NAKASONGOLA,NAKASONGOLA COUNTY,KAKOOGE,KYABUTEIKA,WAKAKOLI P.SCHOOL,163,0,0,2,7,104,113,4,117,0,O-44-106-01-03-02
NAKASONGOLA,NAKASONGOLA COUNTY,KAKOOGE,KYABUTEIKA,BAMUSUUTA,206,0,0,0,6,132,138,5,143,0,O-44-106-01-03-03
NAKASONGOLA,NAKASONGOLA COUNTY,KAKOOGE,KYABUTEIKA,KINONI,286,2,1,0,12,188,203,3,206,0,O-44-106-01-03-04
NAKASONGOLA,NAKASONGOLA COUNTY,KAKOOGE,KYABUTEIKA,KYANAKA T/C,136,1,0,0,4,75,80,3,83,0,O-44-106-01-03-05
NAKASONGOLA,NAKASONGOLA COUNTY,KAKOOGE,KYAMBOGO,KYAMBOGO P.SCH. A,636,3,2,1,51,399,456,5,461,0,O-44-106-01-04-01
NAKASONGOLA,NAKASONGOLA COUNTY,KAKOOGE,KYAMBOGO,KYAMBOGO P.SCH. B,535,0,1,1,24,199,225,3,228,0,O-44-106-01-04-02
NAKASONGOLA,NAKASONGOLA COUNTY,KAKOOGE,KYAMBOGO,BUSEBWE P/S,314,0,1,1,24,199,225,3,228,0,O-44-106-01-04-03
NAKASONGOLA,NAKASONGOLA COUNTY,KAKOOGE,KYAMBOGO,BUVUMA P/S,189,1,1,0,13,120,135,2,137,0,O-44-106-01-04-04
NAKASONGOLA,NAKASONGOLA COUNTY,KAKOOGE,KYANKONWA,KYALUWEZA T/C,277,0,0,0,19,181,200,3,203,0,O-44-106-01-05-01
NAKASONGOLA,NAKASONGOLA COUNTY,KAKOOGE,KYANKONWA,KYANDYAGA,212,0,1,0,1,122,124,9,133,0,O-44-106-01-05-02
NAKASONGOLA,NAKASONGOLA COUNTY,KAKOOGE,KYANKONWA,KYANKONWA TOWN,466,2,2,2,17,297,320,9,329,0,O-44-106-01-05-03
NAKASONGOLA,NAKASONGOLA COUNTY,KAKOOGE,KYANKONWA,KABAKAZI P.S.,217,0,0,0,3,213,216,0,216,0,O-44-106-01-05-04
NAKASONGOLA,NAKASONGOLA COUNTY,KAKOOGE,KYEYINDULA,NTUUTI T/C,617,1,2,2,49,303,357,9,366,0,O-44-106-01-06-01
NAKASONGOLA,NAKASONGOLA COUNTY,KAKOOGE,KYEYINDULA,KYEYINDULA PARISH HQRS. B,444,0,1,2,42,265,310,5,315,0,O-44-106-01-06-02
NAKASONGOLA,NAKASONGOLA COUNTY,KAKOOGE,KYEYINDULA,RWANJUKI P/S,138,0,0,1,8,90,99,3,102,0,O-44-106-01-06-03
NAKASONGOLA,NAKASONGOLA COUNTY,KALONGO,BAMUGOLODDE,BUGOLOMODDE PRIMARY SCHOO,399,1,0,2,34,206,243,4,247,0,O-44-106-02-01-01
NAKASONGOLA,NAKASONGOLA COUNTY,KALONGO,BAMUGOLODDE,KIGEJJO PRIMARY SCHOOL,398,0,0,1,5,280,286,8,294,0,O-44-106-02-01-02
NAKASONGOLA,NAKASONGOLA COUNTY,KALONGO,BAMUGOLODDE,KIRANGA,182,0,0,2,15,116,133,10,143,0,O-44-106-02-01-03
NAKASONGOLA,NAKASONGOLA COUNTY,KALONGO,BAMUGOLODDE,BULWANDI P/S,331,1,0,0,17,204,222,4,226,0,O-44-106-02-01-04
NAKASONGOLA,NAKASONGOLA COUNTY,KALONGO,KAMILAMPANGO,KALALU P/S,342,0,0,0,23,227,250,8,258,0,O-44-106-02-02-01
NAKASONGOLA,NAKASONGOLA COUNTY,KALONGO,KAMILAMPANGO,KAMIRAMPANGO P/S,701,1,3,4,9,578,595,8,603,0,O-44-106-02-02-02
NAKASONGOLA,NAKASONGOLA COUNTY,KALONGO,KISWEERA-MAYINDA,KAKOOLA T\C,497,1,1,3,31,307,343,2,345,0,O-44-106-02-03-01
NAKASONGOLA,NAKASONGOLA COUNTY,KALONGO,KISWEERA-MAYINDA,KISWERA MAINDA STATION,148,0,0,0,12,81,93,3,96,0,O-44-106-02-03-02
NAKASONGOLA,NAKASONGOLA COUNTY,KALONGO,KISWEERA-MAYINDA,KALEIRE P/S,168,0,0,2,3,93,98,0,98,0,O-44-106-02-03-03
NAKASONGOLA,NAKASONGOLA COUNTY,KALONGO,KISWEERA-MAYINDA,NAKINYAMA P/S,131,1,1,1,18,70,91,6,97,0,O-44-106-02-03-04
NAKASONGOLA,NAKASONGOLA COUNTY,KALONGO,KIWAMBYA,KIWABYA PRIMARY SCHOOL,193,2,0,3,24,102,131,4,135,0,O-44-106-02-04-01
NAKASONGOLA,NAKASONGOLA COUNTY,KALONGO,KIWAMBYA,NALUBOBYA T\C,272,0,0,0,24,152,176,1,177,0,O-44-106-02-04-02
NAKASONGOLA,NAKASONGOLA COUNTY,KALONGO,KIWAMBYA,BUDENGEDDE,126,2,1,0,3,85,91,4,95,0,O-44-106-02-04-03
NAKASONGOLA,NAKASONGOLA COUNTY,KALONGO,MAYIRIKITI,MAYIRIKITI P.S A,575,1,0,3,6,415,425,13,438,0,O-44-106-02-05-01
NAKASONGOLA,NAKASONGOLA COUNTY,KALONGO,MAYIRIKITI,KABAZI,301,0,1,0,7,237,245,2,247,0,O-44-106-02-05-02
NAKASONGOLA,NAKASONGOLA COUNTY,KALONGO,MAYIRIKITI,KAYISOLO NURSERY SCHOOL,223,0,0,0,1,175,176,4,180,0,O-44-106-02-05-03
NAKASONGOLA,NAKASONGOLA COUNTY,KALONGO,MAYIRIKITI,BAGAYA PRIMARY SCHOOL,493,1,1,0,10,341,353,9,362,0,O-44-106-02-05-04
NAKASONGOLA,NAKASONGOLA COUNTY,KALONGO,MAYIRIKITI,KIBBANJA T/C,221,1,0,0,12,171,184,1,185,0,O-44-106-02-05-05
NAKASONGOLA,NAKASONGOLA COUNTY,KALUNGI,IRIMA,KYALUSAKA T\C,272,1,0,0,7,210,218,8,226,0,O-44-106-03-01-01
NAKASONGOLA,NAKASONGOLA COUNTY,KALUNGI,IRIMA,IRIMA PRIMARY SCHOOL,402,1,0,0,13,312,326,9,335,0,O-44-106-03-01-02
NAKASONGOLA,NAKASONGOLA COUNTY,KALUNGI,IRIMA,JUNDA PRIMARY SCHOOL A,364,2,0,0,5,301,308,6,314,0,O-44-106-03-01-03
NAKASONGOLA,NAKASONGOLA COUNTY,KALUNGI,KAZWAAMA,KAZWAAMA COMMUNITY CENTRE,296,1,0,1,10,205,217,9,226,0,O-44-106-03-02-01
NAKASONGOLA,NAKASONGOLA COUNTY,KALUNGI,KAZWAAMA,RUKOOGE,130,0,0,1,2,111,114,4,118,0,O-44-106-03-02-02
NAKASONGOLA,NAKASONGOLA COUNTY,KALUNGI,KAZWAAMA,KAPUNDO T\C,684,4,1,2,31,488,526,20,546,0,O-44-106-03-02-03
NAKASONGOLA,NAKASONGOLA COUNTY,KALUNGI,KAZWAAMA,NINGA P/S,325,2,0,0,18,239,259,9,268,0,O-44-106-03-02-04
NAKASONGOLA,NAKASONGOLA COUNTY,KALUNGI,KISENYI,RUNYU T/C,246,0,0,0,7,189,196,1,197,0,O-44-106-03-03-01
NAKASONGOLA,NAKASONGOLA COUNTY,KALUNGI,KISENYI,BUTEMANYA PRIMARY SCHOOL,393,3,0,1,26,268,298,25,323,0,O-44-106-03-03-02
NAKASONGOLA,NAKASONGOLA COUNTY,KALUNGI,KISENYI,KISENYI PR. SCHOOL B,562,5,1,4,23,387,420,13,433,0,O-44-106-03-03-03
NAKASONGOLA,NAKASONGOLA COUNTY,KALUNGI,NAMUNGOLO,NAMBOLE T/C,479,1,0,2,23,357,383,4,387,0,O-44-106-03-04-01
NAKASONGOLA,NAKASONGOLA COUNTY,KALUNGI,NAMUNGOLO,NAKATAKA P/S,524,1,0,1,16,402,420,7,427,0,O-44-106-03-04-02
NAKASONGOLA,NAKASONGOLA COUNTY,KALUNGI,WANZOGI,KATALEEBA T/C,620,0,1,1,4,452,458,12,470,0,O-44-106-03-05-01
NAKASONGOLA,NAKASONGOLA COUNTY,KALUNGI,WANZOGI,WANZOGI PRIMARY SCHOOL B,794,0,2,2,28,558,590,9,599,0,O-44-106-03-05-02
NAKASONGOLA,NAKASONGOLA COUNTY,LWAMPANGA,KIKOIRO,KASENYI MARKET,411,2,5,5,45,244,301,9,310,0,O-44-106-04-01-01
NAKASONGOLA,NAKASONGOLA COUNTY,LWAMPANGA,KIKOIRO,KIKOIRO CENTRE,552,2,0,1,45,286,334,76,410,0,O-44-106-04-01-02
NAKASONGOLA,NAKASONGOLA COUNTY,LWAMPANGA,KIKOIRO,KIBUYE F\L A,306,3,1,3,47,118,172,12,184,0,O-44-106-04-01-03
NAKASONGOLA,NAKASONGOLA COUNTY,LWAMPANGA,KIKOIRO,KIBUYE F\L B,291,2,1,2,58,113,176,9,185,0,O-44-106-04-01-04
NAKASONGOLA,NAKASONGOLA COUNTY,LWAMPANGA,KISAALIZI,KYAWAKATA TRADING CENTRE,646,2,2,1,21,483,509,17,526,0,O-44-106-04-02-01
NAKASONGOLA,NAKASONGOLA COUNTY,LWAMPANGA,KISAALIZI,MUKASA'S COMPOUND,438,0,2,3,9,317,331,26,357,0,O-44-106-04-02-02
NAKASONGOLA,NAKASONGOLA COUNTY,LWAMPANGA,KISAALIZI,KIKALAGANYA P/S,414,1,0,0,19,210,230,46,276,0,O-44-106-04-02-03
NAKASONGOLA,NAKASONGOLA COUNTY,LWAMPANGA,KIWEMBI,NAMUKAGO P.S.,552,2,2,2,33,390,429,14,443,0,O-44-106-04-03-01
NAKASONGOLA,NAKASONGOLA COUNTY,LWAMPANGA,KIWEMBI,IRIMBA MARKET,410,2,0,0,1,350,353,8,361,0,O-44-106-04-03-02
NAKASONGOLA,NAKASONGOLA COUNTY,LWAMPANGA,KIWEMBI,NABWIITA MARKET,331,0,1,0,2,276,279,7,286,0,O-44-106-04-03-03
NAKASONGOLA,NAKASONGOLA COUNTY,LWAMPANGA,LWAMPANGA,LWAMPANGA P. SCHOOL,548,1,1,1,15,421,439,18,457,0,O-44-106-04-04-01
NAKASONGOLA,NAKASONGOLA COUNTY,LWAMPANGA,LWAMPANGA,KISENYI KIDANDALI MKT,300,0,0,0,21,223,244,0,244,0,O-44-106-04-04-02
NAKASONGOLA,NAKASONGOLA COUNTY,LWAMPANGA,LWAMPANGA,LWAMPANGA TRADING CENTRE,313,1,0,0,35,168,204,2,206,0,O-44-106-04-04-03
NAKASONGOLA,NAKASONGOLA COUNTY,LWAMPANGA,WAJJALA,WAJJALA P/S A,254,0,0,3,35,151,189,11,200,0,O-44-106-04-05-01
NAKASONGOLA,NAKASONGOLA COUNTY,LWAMPANGA,WAJJALA,WAJJALA P/S B,359,1,1,7,12,222,243,30,273,0,O-44-106-04-05-02
NAKASONGOLA,NAKASONGOLA COUNTY,LWAMPANGA,WAJJALA,WAJJALA P/S C,87,1,0,3,6,39,49,1,50,0,O-44-106-04-05-03
NAKASONGOLA,NAKASONGOLA COUNTY,LWAMPANGA,WAJJALA,KIGULI ARMY PRIMARY SCHOOL A,519,1,2,5,56,353,417,11,428,0,O-44-106-04-05-04
NAKASONGOLA,NAKASONGOLA COUNTY,LWAMPANGA,WAJJALA,AIRFIELD (A-D),930,3,2,2,81,207,295,6,301,0,O-44-106-04-05-05
NAKASONGOLA,NAKASONGOLA COUNTY,LWAMPANGA,WAJJALA,AIRFIELD (E-L),818,0,0,0,57,195,252,5,257,0,O-44-106-04-05-06
NAKASONGOLA,NAKASONGOLA COUNTY,LWAMPANGA,WAJJALA,AIRFIELD (M-N),864,3,1,1,56,265,326,5,331,0,O-44-106-04-05-07
NAKASONGOLA,NAKASONGOLA COUNTY,LWAMPANGA,WAJJALA,AIRFIELD (P-Z),487,2,0,0,37,136,175,7,182,0,O-44-106-04-05-08
NAKASONGOLA,NAKASONGOLA COUNTY,LWAMPANGA,WAJJALA,AIRFIELD (O),780,1,2,0,84,97,184,18,202,0,O-44-106-04-05-09
NAKASONGOLA,NAKASONGOLA COUNTY,LWAMPANGA,ZENGEBE,ZENGEBE R/C,532,1,2,1,62,303,369,13,382,0,O-44-106-04-06-01
NAKASONGOLA,NAKASONGOLA COUNTY,LWAMPANGA,ZENGEBE,KIYANJA MARKET,108,0,0,0,3,83,86,12,98,0,O-44-106-04-06-02
NAKASONGOLA,NAKASONGOLA COUNTY,LWAMPANGA,ZENGEBE,ZENGEBE TRADING CENTRE,465,0,3,3,19,345,370,7,377,0,O-44-106-04-06-03
NAKASONGOLA,NAKASONGOLA COUNTY,NABISWERA,KALENGEDE,KALENGEDE STATION,316,0,0,0,4,260,264,2,266,0,O-44-106-05-01-01
NAKASONGOLA,NAKASONGOLA COUNTY,NABISWERA,KALENGEDE,NAMMASA STATION,305,0,1,0,7,249,257,4,261,0,O-44-106-05-01-02
NAKASONGOLA,NAKASONGOLA COUNTY,NABISWERA,KALENGEDE,WABUSANA P/S,106,0,1,0,5,99,105,1,106,0,O-44-106-05-01-03
NAKASONGOLA,NAKASONGOLA COUNTY,NABISWERA,KALENGEDE,KATEEBE P/S,246,0,0,0,3,234,237,2,239,0,O-44-106-05-01-04
NAKASONGOLA,NAKASONGOLA COUNTY,NABISWERA,KALENGEDE,WALUSI T/C,502,4,1,2,10,350,367,6,373,0,O-44-106-05-01-05
NAKASONGOLA,NAKASONGOLA COUNTY,NABISWERA,KATTUBA,MOONE T/C,429,0,2,0,55,211,268,11,279,0,O-44-106-05-02-01
NAKASONGOLA,NAKASONGOLA COUNTY,NABISWERA,KATTUBA,BUSONE FISH LANDING SITE,154,0,1,0,17,109,127,8,135,0,O-44-106-05-02-02
NAKASONGOLA,NAKASONGOLA COUNTY,NABISWERA,KATTUBA,KATUBBA,260,0,0,0,5,219,224,9,233,0,O-44-106-05-02-03
NAKASONGOLA,NAKASONGOLA COUNTY,NABISWERA,KYAMUKONDA,KYABALAMUKYA,247,0,0,1,8,186,195,8,203,0,O-44-106-05-03-01
NAKASONGOLA,NAKASONGOLA COUNTY,NABISWERA,KYAMUKONDA,KYAMUKONDA P.SCHOOL A,373,1,1,2,22,226,252,9,261,0,O-44-106-05-03-02
NAKASONGOLA,NAKASONGOLA COUNTY,NABISWERA,KYAMUKONDA,BUYAMBA,232,0,0,0,2,178,180,7,187,0,O-44-106-05-03-03
NAKASONGOLA,NAKASONGOLA COUNTY,NABISWERA,KYANGOGOLO,NABISWERA S/C HQTRS. A,643,4,0,0,36,423,463,1,464,0,O-44-106-05-04-01
NAKASONGOLA,NAKASONGOLA COUNTY,NABISWERA,KYANGOGOLO,KANYONYI P/S,137,1,0,0,6,101,108,3,111,0,O-44-106-05-04-02
NAKASONGOLA,NAKASONGOLA COUNTY,NABISWERA,KYANGOGOLO,KYADOBO PRIMARY SCHOOL,229,0,0,1,5,153,159,5,164,0,O-44-106-05-04-03
NAKASONGOLA,NAKASONGOLA COUNTY,NABISWERA,MIGYERA T.B.,MIGYERA ROMAN CATH. P.S. A,622,1,0,7,137,305,450,3,453,0,O-44-106-05-05-01
NAKASONGOLA,NAKASONGOLA COUNTY,NABISWERA,MIGYERA T.B.,MIGYERA ROMAN CATHOLIC PR S,444,3,0,0,88,197,288,9,297,0,O-44-106-05-05-02
NAKASONGOLA,NAKASONGOLA COUNTY,NABISWERA,MIGYERA T.B.,UWESO OFFICES,277,0,1,5,7,158,171,7,178,0,O-44-106-05-05-03
NAKASONGOLA,NAKASONGOLA COUNTY,NABISWERA,MIGYERA T.B.,KIRUMUKO P/S,33,0,0,0,2,18,20,1,21,0,O-44-106-05-05-04
NAKASONGOLA,NAKASONGOLA COUNTY,NABISWERA,MULONZI,MULONZI P.SCHOOL,291,1,0,2,30,159,192,4,196,0,O-44-106-05-06-01
NAKASONGOLA,NAKASONGOLA COUNTY,NABISWERA,MULONZI,NAMBAJU,205,0,0,0,9,167,176,2,178,0,O-44-106-05-06-02
NAKASONGOLA,NAKASONGOLA COUNTY,NABISWERA,MULONZI,KABAALA CHANCE SCHOOL,168,1,0,1,5,102,109,5,114,0,O-44-106-05-06-03
NAKASONGOLA,NAKASONGOLA COUNTY,NAKASONGOLA TOWN COUNCI,NAKASONGOLA CEN,NAKASONGOLA,983,2,1,8,205,350,566,11,577,0,O-44-106-06-01-01
NAKASONGOLA,NAKASONGOLA COUNTY,NAKASONGOLA TOWN COUNCI,NAKASONGOLA CEN,BURULI QUARTERS,660,10,5,5,112,341,473,5,478,0,O-44-106-06-01-02
NAKASONGOLA,NAKASONGOLA COUNTY,NAKASONGOLA TOWN COUNCI,NAKASONGOLA EAST,WABINYONYI A,770,4,1,5,104,411,525,9,534,0,O-44-106-06-02-01
NAKASONGOLA,NAKASONGOLA COUNTY,NAKASONGOLA TOWN COUNCI,NAKASONGOLA EAST,NAKAJOOGA CHANCE SCHOOL,319,2,0,0,34,203,239,1,240,0,O-44-106-06-02-02
NAKASONGOLA,NAKASONGOLA COUNTY,NAKASONGOLA TOWN COUNCI,NAKASONGOLA WES,KIBIRA P/S,614,4,2,1,30,436,473,14,487,0,O-44-106-06-03-01
NAKASONGOLA,NAKASONGOLA COUNTY,NAKITOMA,BUJJABE,KAIKANGA P/S,251,1,0,0,5,167,173,19,192,0,O-44-106-07-01-01
NAKASONGOLA,NAKASONGOLA COUNTY,NAKITOMA,BUJJABE,KAFU PRIMARY SCHOOL,505,3,1,0,43,274,321,16,337,0,O-44-106-07-01-02
NAKASONGOLA,NAKASONGOLA COUNTY,NAKITOMA,BUJJABE,WANGOIRO,429,0,1,0,7,328,336,1,337,0,O-44-106-07-01-03
NAKASONGOLA,NAKASONGOLA COUNTY,NAKITOMA,BUJJABE,NAKITOMA T.C,730,0,1,5,64,409,479,11,490,0,O-44-106-07-01-04
NAKASONGOLA,NAKASONGOLA COUNTY,NAKITOMA,KAGWERI,KIDDUGALA,236,1,0,0,4,172,177,12,189,0,O-44-106-07-02-01
NAKASONGOLA,NAKASONGOLA COUNTY,NAKITOMA,KAGWERI,KYAKATONO,469,3,1,1,7,306,318,4,322,0,O-44-106-07-02-02
NAKASONGOLA,NAKASONGOLA COUNTY,NAKITOMA,KAGWERI,NAKITOMA P.SCHOOL A,553,2,0,2,60,344,408,7,415,0,O-44-106-07-02-03
NAKASONGOLA,NAKASONGOLA COUNTY,NAKITOMA,KASOZI,KASOZI,406,0,0,0,39,235,274,6,280,0,O-44-106-07-03-01
NAKASONGOLA,NAKASONGOLA COUNTY,NAKITOMA,KASOZI,KALYAMPANDE,87,0,0,0,7,42,49,0,49,0,O-44-106-07-03-02
NAKASONGOLA,NAKASONGOLA COUNTY,NAKITOMA,NJERU,NJERU T/C,333,0,1,0,4,217,222,5,227,0,O-44-106-07-04-01
NAKASONGOLA,NAKASONGOLA COUNTY,NAKITOMA,NJERU,BUTUUTI,92,1,0,0,1,67,69,2,71,0,O-44-106-07-04-02
NAKASONGOLA,NAKASONGOLA COUNTY,NAKITOMA,NJERU,KIROORO P/S,253,1,0,0,9,183,193,5,198,0,O-44-106-07-04-03
NAKASONGOLA,NAKASONGOLA COUNTY,NAKITOMA,NJERU,MALOMBWE,125,0,0,1,2,104,107,0,107,0,O-44-106-07-04-04
NAKASONGOLA,NAKASONGOLA COUNTY,RWABIYATA,KANSIRA,KIKOOGE STATION,476,5,3,2,80,203,293,12,305,0,O-44-106-08-01-01
NAKASONGOLA,NAKASONGOLA COUNTY,RWABIYATA,KANSIRA,KANSIRA P.SCHOOL,316,0,1,1,24,182,208,2,210,0,O-44-106-08-01-02
NAKASONGOLA,NAKASONGOLA COUNTY,RWABIYATA,KANSIRA,NDAYIGA,248,0,0,0,2,243,245,3,248,0,O-44-106-08-01-03
NAKASONGOLA,NAKASONGOLA COUNTY,RWABIYATA,KANSIRA,MPUMWIRE T/C,296,0,0,1,2,244,247,4,251,0,O-44-106-08-01-04
NAKASONGOLA,NAKASONGOLA COUNTY,RWABIYATA,NALUKONGE,NALUKONGE MARKET,494,0,1,1,10,392,404,2,406,0,O-44-106-08-02-01
NAKASONGOLA,NAKASONGOLA COUNTY,RWABIYATA,NALUKONGE,NAKATOOGO P/S,206,0,0,0,5,162,167,4,171,0,O-44-106-08-02-02
NAKASONGOLA,NAKASONGOLA COUNTY,RWABIYATA,NALUKONGE,LWABIYATA P/S,250,0,0,1,2,229,232,0,232,0,O-44-106-08-02-03
NAKASONGOLA,NAKASONGOLA COUNTY,RWABIYATA,NALUKONGE,TUMBA F/L,326,1,1,0,23,205,230,3,233,0,O-44-106-08-02-04
NAKASONGOLA,NAKASONGOLA COUNTY,RWABIYATA,NAMIIKA,KYAMBOGO MARKET,422,1,0,0,2,350,353,9,362,0,O-44-106-08-03-01
NAKASONGOLA,NAKASONGOLA COUNTY,RWABIYATA,NAMIIKA,NAMIKA P.SCH.B,373,0,0,0,0,323,323,4,327,0,O-44-106-08-03-02
NAKASONGOLA,NAKASONGOLA COUNTY,RWABIYATA,NAMIIKA,NAKAYONZA PRIMARY SCHOOL,360,0,0,0,4,301,305,16,321,0,O-44-106-08-03-03
NAKASONGOLA,NAKASONGOLA COUNTY,RWABIYATA,NAMIIKA,KIRENGE MARKET,270,0,0,1,0,236,237,4,241,0,O-44-106-08-03-04
NAKASONGOLA,NAKASONGOLA COUNTY,WABINYONYI,KAGERI,KYAKADOKO P/S,147,0,1,1,9,110,121,1,122,0,O-44-106-09-01-01
NAKASONGOLA,NAKASONGOLA COUNTY,WABINYONYI,KAGERI,KAGERI PRIMARY SCHOOL,239,0,0,2,14,175,191,5,196,0,O-44-106-09-01-02
NAKASONGOLA,NAKASONGOLA COUNTY,WABINYONYI,KAGERI,KABUGENDA BOWA,225,1,1,1,15,141,159,8,167,0,O-44-106-09-01-03
NAKASONGOLA,NAKASONGOLA COUNTY,WABINYONYI,KAGERI,MWOLWE P/S,185,0,1,0,7,130,138,3,141,0,O-44-106-09-01-04
NAKASONGOLA,NAKASONGOLA COUNTY,WABINYONYI,KAMUNIINA,KAMUNINA P.S.,365,0,0,1,9,198,208,6,214,0,O-44-106-09-02-01
NAKASONGOLA,NAKASONGOLA COUNTY,WABINYONYI,KAMUNIINA,MITANZI PRIMARY SCHOOL,433,1,0,2,18,257,278,9,287,0,O-44-106-09-02-02
NAKASONGOLA,NAKASONGOLA COUNTY,WABINYONYI,KIWONGOIRE,SIKYE P.SCHOOL,654,1,0,0,14,477,492,5,497,0,O-44-106-09-03-01
NAKASONGOLA,NAKASONGOLA COUNTY,WABINYONYI,KIWONGOIRE,WABULIME,212,2,0,1,15,140,158,8,166,0,O-44-106-09-03-02
NAKASONGOLA,NAKASONGOLA COUNTY,WABINYONYI,KIWONGOIRE,RWENYANA,89,0,0,0,0,46,46,1,47,0,O-44-106-09-03-03
NAKASONGOLA,NAKASONGOLA COUNTY,WABINYONYI,KYAMUYINGO,KYABAGANGA,358,0,0,0,1,283,284,5,289,0,O-44-106-09-04-01
NAKASONGOLA,NAKASONGOLA COUNTY,WABINYONYI,KYAMUYINGO,KYAMUYINGO CHURCH,288,0,0,2,2,196,200,4,204,0,O-44-106-09-04-02
NAKASONGOLA,NAKASONGOLA COUNTY,WABINYONYI,SASIIRA,SAASIRA PR.SCHOOL,635,1,0,2,28,441,472,8,480,0,O-44-106-09-05-01
NAKASONGOLA,NAKASONGOLA COUNTY,WABINYONYI,WABIGALO,WABIGALO P.SCHOOL A,701,1,1,0,36,436,474,10,484,0,O-44-106-09-06-01
NAKASONGOLA,NAKASONGOLA COUNTY,WABINYONYI,WABIGALO,WABIGALO P/S B,179,2,0,0,7,124,133,1,134,0,O-44-106-09-06-02
NAKASONGOLA,NAKASONGOLA COUNTY,WABINYONYI,WAMPITI,WAMPITI P. SCHOOL A,385,4,0,1,15,225,245,11,256,0,O-44-106-09-07-01
NAKASONGOLA,NAKASONGOLA COUNTY,WABINYONYI,WAMPITI,WAMPITI P. SCHOOL B,263,0,0,0,5,139,144,3,147,0,O-44-106-09-07-02
NAKASONGOLA,NAKASONGOLA COUNTY,WABINYONYI,WAMPITI,MBALYE R.C. SCHOOL,505,1,2,2,5,351,361,10,371,0,O-44-106-09-07-03
SSEMBABULE,LWEMIYAGA COUNTY,LWEMIYAGA,KAKOMA,KAKOMA,517,0,0,1,27,368,396,9,405,0,O-45-119-01-01-01
SSEMBABULE,LWEMIYAGA COUNTY,LWEMIYAGA,KAKOMA,NJARWE,468,0,0,2,27,322,351,9,360,0,O-45-119-01-01-02
SSEMBABULE,LWEMIYAGA COUNTY,LWEMIYAGA,KAKOMA,LWEMBWERA P/S,333,2,0,1,17,233,253,9,262,0,O-45-119-01-01-03
SSEMBABULE,LWEMIYAGA COUNTY,LWEMIYAGA,KAKOMA,LWEMBWERA PRI-SCH,135,0,1,0,3,95,99,2,101,0,O-45-119-01-01-04
SSEMBABULE,LWEMIYAGA COUNTY,LWEMIYAGA,KAMPALA,BUGOROGORO,455,0,1,0,16,368,385,5,390,0,O-45-119-01-02-01
SSEMBABULE,LWEMIYAGA COUNTY,LWEMIYAGA,KAMPALA,KAMPALA,121,0,0,1,8,91,100,1,101,0,O-45-119-01-02-02
SSEMBABULE,LWEMIYAGA COUNTY,LWEMIYAGA,KAMPALA,LUGAMBA,719,1,1,5,62,436,505,14,519,0,O-45-119-01-02-03
SSEMBABULE,LWEMIYAGA COUNTY,LWEMIYAGA,LUBAALE,KYEERA,559,2,2,1,55,339,399,5,404,0,O-45-119-01-03-01
SSEMBABULE,LWEMIYAGA COUNTY,LWEMIYAGA,LUBAALE,LUBAALE,790,1,4,4,53,699,761,0,761,0,O-45-119-01-03-02
SSEMBABULE,LWEMIYAGA COUNTY,LWEMIYAGA,LUBAALE,KINONI,479,1,0,1,44,306,352,10,362,0,O-45-119-01-03-03
SSEMBABULE,LWEMIYAGA COUNTY,LWEMIYAGA,LWEMIBU,LWEMIYAGA,704,2,2,2,67,445,518,7,525,0,O-45-119-01-04-01
SSEMBABULE,LWEMIYAGA COUNTY,LWEMIYAGA,LWEMIBU,KAKOMBE,298,1,0,1,16,182,200,2,202,0,O-45-119-01-04-02
SSEMBABULE,LWEMIYAGA COUNTY,LWEMIYAGA,LWEMIBU,LUMEGERE,221,0,0,1,15,168,184,5,189,0,O-45-119-01-04-03
SSEMBABULE,LWEMIYAGA COUNTY,LWEMIYAGA,LWEMIBU,KASHUNGA TC,266,0,0,1,12,50,63,0,63,0,O-45-119-01-04-04
SSEMBABULE,LWEMIYAGA COUNTY,LWEMIYAGA,LWENSANKALA,MAYIKALO PS,273,0,0,0,27,198,225,8,233,0,O-45-119-01-05-01
SSEMBABULE,LWEMIYAGA COUNTY,LWEMIYAGA,LWENSANKALA,MAKUKULU,422,0,0,1,23,395,419,0,419,0,O-45-119-01-05-02
SSEMBABULE,LWEMIYAGA COUNTY,LWEMIYAGA,LWENSANKALA,KAZOOBA,679,2,0,0,33,537,572,0,572,0,O-45-119-01-05-03
SSEMBABULE,LWEMIYAGA COUNTY,LWEMIYAGA,LWENSANKALA,LWESANKALA,403,2,1,0,24,284,311,4,315,0,O-45-119-01-05-04
SSEMBABULE,LWEMIYAGA COUNTY,LWEMIYAGA,LWENSANKALA,LWENSEKE COU,182,0,0,0,12,146,158,3,161,0,O-45-119-01-05-05
SSEMBABULE,LWEMIYAGA COUNTY,LWEMIYAGA,MAKOOLE,MAKOOLE,375,2,0,1,27,245,275,5,280,0,O-45-119-01-06-01
SSEMBABULE,LWEMIYAGA COUNTY,LWEMIYAGA,MAKOOLE,NKONGE,462,1,0,6,30,326,363,13,376,0,O-45-119-01-06-02
SSEMBABULE,LWEMIYAGA COUNTY,LWEMIYAGA,MAKOOLE,MAGEGE,435,0,0,2,13,416,431,4,435,0,O-45-119-01-06-03
SSEMBABULE,LWEMIYAGA COUNTY,LWEMIYAGA,MAKOOLE,KYAKACUNDA,320,2,0,1,22,195,220,7,227,0,O-45-119-01-06-04
SSEMBABULE,LWEMIYAGA COUNTY,NTUUSI,BULONGO,KYATTUBA,351,1,0,1,16,305,323,5,328,0,O-45-119-02-01-01
SSEMBABULE,LWEMIYAGA COUNTY,NTUUSI,BULONGO,KABEWO,391,0,1,1,23,280,305,1,306,0,O-45-119-02-01-02
SSEMBABULE,LWEMIYAGA COUNTY,NTUUSI,BULONGO,LUKOMA,129,2,0,0,4,117,123,0,123,0,O-45-119-02-01-03
SSEMBABULE,LWEMIYAGA COUNTY,NTUUSI,BULONGO,KABUKONGOTE P/S,152,0,0,1,9,91,101,0,101,0,O-45-119-02-01-04
SSEMBABULE,LWEMIYAGA COUNTY,NTUUSI,KABAALE,KABAALE,238,0,1,1,3,230,235,1,236,0,O-45-119-02-02-01
SSEMBABULE,LWEMIYAGA COUNTY,NTUUSI,KABAALE,KABINGO,272,0,0,0,8,189,197,1,198,0,O-45-119-02-02-02
SSEMBABULE,LWEMIYAGA COUNTY,NTUUSI,KARUSHONSHOMEZI,KAKINGA,286,1,0,0,4,238,243,5,248,0,O-45-119-02-03-01
SSEMBABULE,LWEMIYAGA COUNTY,NTUUSI,KARUSHONSHOMEZI,KALUSONSOMEZI,373,0,0,0,14,229,243,8,251,0,O-45-119-02-03-02
SSEMBABULE,LWEMIYAGA COUNTY,NTUUSI,KARUSHONSHOMEZI,KASHEBWONGERA,168,0,0,0,0,118,118,2,120,0,O-45-119-02-03-03
SSEMBABULE,LWEMIYAGA COUNTY,NTUUSI,KYAMBOGO,KIRAMA,940,2,2,1,71,473,549,12,561,0,O-45-119-02-04-01
SSEMBABULE,LWEMIYAGA COUNTY,NTUUSI,KYAMBOGO,NSOZI A,235,0,0,0,1,219,220,9,229,0,O-45-119-02-04-02
SSEMBABULE,LWEMIYAGA COUNTY,NTUUSI,KYAMBOGO,KYEMBOGO T/C,164,0,0,1,13,114,128,2,130,0,O-45-119-02-04-03
SSEMBABULE,LWEMIYAGA COUNTY,NTUUSI,NABITANGA,NABITANGA,431,0,0,4,40,265,309,9,318,0,O-45-119-02-05-01
SSEMBABULE,LWEMIYAGA COUNTY,NTUUSI,NABITANGA,KYANJA,474,4,0,3,36,282,325,11,336,0,O-45-119-02-05-02
SSEMBABULE,LWEMIYAGA COUNTY,NTUUSI,NABITANGA,NTYAZO,157,0,0,0,13,136,149,4,153,0,O-45-119-02-05-03
SSEMBABULE,LWEMIYAGA COUNTY,NTUUSI,NABITANGA,BAYIMA,94,0,0,1,2,82,85,2,87,0,O-45-119-02-05-04
SSEMBABULE,LWEMIYAGA COUNTY,NTUUSI,NTUUSI,NTUUSI,956,4,0,11,85,510,610,22,632,0,O-45-119-02-06-01
SSEMBABULE,LWEMIYAGA COUNTY,NTUUSI,NTUUSI,KANONI,422,0,0,1,36,252,289,4,293,0,O-45-119-02-06-02
SSEMBABULE,LWEMIYAGA COUNTY,NTUUSI,NTUUSI,MERU-MERU,521,0,0,1,39,321,361,26,387,0,O-45-119-02-06-03
SSEMBABULE,LWEMIYAGA COUNTY,NTUUSI,NTUUSI,KAWUNGERA,398,0,0,1,22,343,366,15,381,0,O-45-119-02-06-04
SSEMBABULE,MAWOGOLA COUNTY,LUGUSULU,KAIRASHA,KANJUNJU PS,263,0,0,0,3,245,248,2,250,0,O-45-120-01-01-01
SSEMBABULE,MAWOGOLA COUNTY,LUGUSULU,KAIRASHA,KAIRASYA,675,0,0,0,0,594,594,6,600,0,O-45-120-01-01-02
SSEMBABULE,MAWOGOLA COUNTY,LUGUSULU,KAWANDA,KYAMABOGO A,585,1,2,3,165,254,425,8,433,0,O-45-120-01-02-01
SSEMBABULE,MAWOGOLA COUNTY,LUGUSULU,KAWANDA,KAWANDA,772,3,0,5,121,380,509,5,514,0,O-45-120-01-02-02
SSEMBABULE,MAWOGOLA COUNTY,LUGUSULU,KAWANDA,LUKWASI,585,0,1,2,105,336,444,4,448,0,O-45-120-01-02-03
SSEMBABULE,MAWOGOLA COUNTY,LUGUSULU,KAWANDA,LWENDAYI P/S,324,1,0,1,17,162,181,4,185,0,O-45-120-01-02-04
SSEMBABULE,MAWOGOLA COUNTY,LUGUSULU,KAWANDA,LUTUNKU B,817,0,2,0,46,681,729,0,729,0,O-45-120-01-02-05
SSEMBABULE,MAWOGOLA COUNTY,LUGUSULU,KAWANDA,NKOMA,595,0,0,6,64,278,348,2,350,0,O-45-120-01-02-06
SSEMBABULE,MAWOGOLA COUNTY,LUGUSULU,KAWANDA,MBUYE/KATIKAMU,718,0,0,0,41,641,682,7,689,0,O-45-120-01-02-07
SSEMBABULE,MAWOGOLA COUNTY,LUGUSULU,KAWANDA,KYAMABOGO B,424,0,2,3,85,174,264,10,274,0,O-45-120-01-02-08
SSEMBABULE,MAWOGOLA COUNTY,LUGUSULU,LWENTALE,KASONGI,711,3,4,12,112,395,526,14,540,0,O-45-120-01-03-01
SSEMBABULE,MAWOGOLA COUNTY,LUGUSULU,LWENTALE,SSERINNYA,552,1,0,1,71,305,378,5,383,0,O-45-120-01-03-02
SSEMBABULE,MAWOGOLA COUNTY,LUGUSULU,LWENTALE,KAGANGO,821,1,3,3,77,416,500,12,512,0,O-45-120-01-03-03
SSEMBABULE,MAWOGOLA COUNTY,LUGUSULU,LWENTALE,KIDANDALI,356,1,0,4,79,145,229,4,233,0,O-45-120-01-03-04
SSEMBABULE,MAWOGOLA COUNTY,LUGUSULU,MITIMA,KATAHIRA,427,0,1,1,1,422,425,2,427,0,O-45-120-01-04-01
SSEMBABULE,MAWOGOLA COUNTY,LUGUSULU,MITIMA,MITIMA,591,1,0,0,9,567,577,9,586,0,O-45-120-01-04-02
SSEMBABULE,MAWOGOLA COUNTY,LUGUSULU,MITIMA,KYEBANDO,311,0,0,2,0,291,293,15,308,0,O-45-120-01-04-03
SSEMBABULE,MAWOGOLA COUNTY,LUGUSULU,MITIMA,KISANSA,194,0,0,0,0,191,191,1,192,0,O-45-120-01-04-04
SSEMBABULE,MAWOGOLA COUNTY,LUGUSULU,MUSSI,KABALEKERA,423,1,0,0,15,269,285,2,287,0,O-45-120-01-05-01
SSEMBABULE,MAWOGOLA COUNTY,LUGUSULU,MUSSI,LUGUSULU,496,0,0,1,20,322,343,4,347,0,O-45-120-01-05-02
SSEMBABULE,MAWOGOLA COUNTY,LUGUSULU,MUSSI,MUSSI,367,0,0,3,18,236,257,9,266,0,O-45-120-01-05-03
SSEMBABULE,MAWOGOLA COUNTY,LWEBITAKULI,KABAALE,KABAALE,540,1,0,2,37,358,398,4,402,0,O-45-120-02-01-01
SSEMBABULE,MAWOGOLA COUNTY,LWEBITAKULI,KABAALE,KIREBE,594,1,0,1,50,326,378,10,388,0,O-45-120-02-01-02
SSEMBABULE,MAWOGOLA COUNTY,LWEBITAKULI,KABAALE,LWENDEZI,549,0,0,1,41,327,369,0,369,0,O-45-120-02-01-03
SSEMBABULE,MAWOGOLA COUNTY,LWEBITAKULI,KABAALE,LYABUGUMA,421,1,0,1,65,224,291,2,293,0,O-45-120-02-01-04
SSEMBABULE,MAWOGOLA COUNTY,LWEBITAKULI,KABAALE,NAMIREMBE,307,0,0,0,13,191,204,21,225,0,O-45-120-02-01-05
SSEMBABULE,MAWOGOLA COUNTY,LWEBITAKULI,KASAMBYA,NANTUNGA,511,1,0,2,54,281,338,3,341,0,O-45-120-02-02-01
SSEMBABULE,MAWOGOLA COUNTY,LWEBITAKULI,KASAMBYA,NABISEKE,373,2,0,0,40,229,271,4,275,0,O-45-120-02-02-02
SSEMBABULE,MAWOGOLA COUNTY,LWEBITAKULI,KASAMBYA,LWEMBOGO,326,0,0,3,50,177,230,2,232,0,O-45-120-02-02-03
SSEMBABULE,MAWOGOLA COUNTY,LWEBITAKULI,KASAMBYA,KIZIMIZA,397,0,2,5,52,229,288,3,291,0,O-45-120-02-02-04
SSEMBABULE,MAWOGOLA COUNTY,LWEBITAKULI,KASAMBYA,KIGANDA,335,0,0,1,59,203,263,6,269,0,O-45-120-02-02-05
SSEMBABULE,MAWOGOLA COUNTY,LWEBITAKULI,KASAMBYA,KASAMBYA,578,2,1,2,96,285,386,18,404,0,O-45-120-02-02-06
SSEMBABULE,MAWOGOLA COUNTY,LWEBITAKULI,KASAMBYA,MPUMUDDE,446,1,0,2,50,245,298,34,332,0,O-45-120-02-02-07
SSEMBABULE,MAWOGOLA COUNTY,LWEBITAKULI,KASAMBYA,KIWOGO,684,2,0,6,56,453,517,5,522,0,O-45-120-02-02-08
SSEMBABULE,MAWOGOLA COUNTY,LWEBITAKULI,KASAMBYA,BUYONZA,256,0,0,0,15,162,177,4,181,0,O-45-120-02-02-09
SSEMBABULE,MAWOGOLA COUNTY,LWEBITAKULI,KINYWAMAZZI,KINYWAMAZZI,909,4,1,6,144,321,476,108,584,0,O-45-120-02-03-01
SSEMBABULE,MAWOGOLA COUNTY,LWEBITAKULI,KINYWAMAZZI,KAMBULALA,523,2,0,6,102,258,368,16,384,0,O-45-120-02-03-02
SSEMBABULE,MAWOGOLA COUNTY,LWEBITAKULI,KINYWAMAZZI,KITEMBA,376,1,0,3,40,256,300,16,316,0,O-45-120-02-03-03
SSEMBABULE,MAWOGOLA COUNTY,LWEBITAKULI,KINYWAMAZZI,MASAMBYA,442,1,0,1,196,142,340,8,348,0,O-45-120-02-03-04
SSEMBABULE,MAWOGOLA COUNTY,LWEBITAKULI,KINYWAMAZZI,KYALWANYA,758,2,1,5,122,400,530,15,545,0,O-45-120-02-03-05
SSEMBABULE,MAWOGOLA COUNTY,LWEBITAKULI,LUGUSULU,KATWE,777,1,3,12,104,449,569,17,586,0,O-45-120-02-04-01
SSEMBABULE,MAWOGOLA COUNTY,LWEBITAKULI,LUGUSULU,NNONGO,628,0,0,17,91,326,434,9,443,0,O-45-120-02-04-02
SSEMBABULE,MAWOGOLA COUNTY,LWEBITAKULI,LUGUSULU,KENZIGA,562,4,1,2,29,395,431,7,438,0,O-45-120-02-04-03
SSEMBABULE,MAWOGOLA COUNTY,LWEBITAKULI,LUGUSULU,RWOBUSISI,351,1,0,3,55,218,277,5,282,0,O-45-120-02-04-04
SSEMBABULE,MAWOGOLA COUNTY,LWEBITAKULI,LUGUSULU,VUNZA,325,2,1,1,23,255,282,1,283,0,O-45-120-02-04-05
SSEMBABULE,MAWOGOLA COUNTY,LWEBITAKULI,LUGUSULU,KIRUNGI,102,0,0,0,7,74,81,2,83,0,O-45-120-02-04-06
SSEMBABULE,MAWOGOLA COUNTY,LWEBITAKULI,LUGUSULU,KITEMBO,325,0,0,6,40,152,198,23,221,0,O-45-120-02-04-07
SSEMBABULE,MAWOGOLA COUNTY,LWEBITAKULI,LWEBITAKULI,KATOMA,582,3,1,5,72,350,431,5,436,0,O-45-120-02-05-01
SSEMBABULE,MAWOGOLA COUNTY,LWEBITAKULI,LWEBITAKULI,LWEBITAKULI,713,1,2,7,126,284,420,1,421,0,O-45-120-02-05-02
SSEMBABULE,MAWOGOLA COUNTY,LWEBITAKULI,LWEBITAKULI,SEETAMUGOGO,572,0,0,0,43,375,418,5,423,0,O-45-120-02-05-03
SSEMBABULE,MAWOGOLA COUNTY,LWEBITAKULI,LWEBITAKULI,BUDDEBUTAKYA,601,0,3,2,79,379,463,8,471,0,O-45-120-02-05-04
SSEMBABULE,MAWOGOLA COUNTY,LWEBITAKULI,LWEBITAKULI,KATUNTU,912,0,0,3,35,590,628,0,628,0,O-45-120-02-05-05
SSEMBABULE,MAWOGOLA COUNTY,LWEBITAKULI,LWEBITAKULI,NANKONDO,608,3,1,1,67,305,377,14,391,0,O-45-120-02-05-06
SSEMBABULE,MAWOGOLA COUNTY,LWEBITAKULI,LWEBITAKULI,MUGULUKA,562,4,0,2,55,348,409,19,428,0,O-45-120-02-05-07
SSEMBABULE,MAWOGOLA COUNTY,LWEBITAKULI,NAKASENYI,KIKONDEKA,632,2,1,5,60,327,395,21,416,0,O-45-120-02-06-01
SSEMBABULE,MAWOGOLA COUNTY,LWEBITAKULI,NAKASENYI,NTETE,827,4,3,9,130,457,603,7,610,0,O-45-120-02-06-02
SSEMBABULE,MAWOGOLA COUNTY,LWEBITAKULI,NAKASENYI,LWAMATENGO,691,0,0,9,45,390,444,30,474,0,O-45-120-02-06-03
SSEMBABULE,MAWOGOLA COUNTY,LWEBITAKULI,NAKASENYI,KYABUWAMBA,645,2,0,3,90,381,476,11,487,0,O-45-120-02-06-04
SSEMBABULE,MAWOGOLA COUNTY,LWEBITAKULI,NAKASENYI,KANONI,574,0,0,2,91,330,423,13,436,0,O-45-120-02-06-05
SSEMBABULE,MAWOGOLA COUNTY,LWEBITAKULI,NAKASENYI,KATOOGO,207,0,0,0,19,125,144,15,159,0,O-45-120-02-06-06
SSEMBABULE,MAWOGOLA COUNTY,LWEBITAKULI,NAKASENYI,BWOGERO,315,0,1,2,50,121,174,10,184,0,O-45-120-02-06-07
SSEMBABULE,MAWOGOLA COUNTY,LWEBITAKULI,NAKASENYI,NDAIGA,420,0,0,0,41,248,289,2,291,0,O-45-120-02-06-08
SSEMBABULE,MAWOGOLA COUNTY,LWEBITAKULI,NAKASENYI,NYANGE,587,1,2,2,53,362,420,8,428,0,O-45-120-02-06-09
SSEMBABULE,MAWOGOLA COUNTY,MATEETE,KASAMBYA,LUSAALIRA,510,2,1,7,127,217,354,0,354,0,O-45-120-03-01-01
SSEMBABULE,MAWOGOLA COUNTY,MATEETE,KASAMBYA,KALUBUBBU,720,8,1,0,179,321,509,7,516,0,O-45-120-03-01-02
SSEMBABULE,MAWOGOLA COUNTY,MATEETE,KASAMBYA,KIBULALA,428,1,1,1,110,177,290,7,297,0,O-45-120-03-01-03
SSEMBABULE,MAWOGOLA COUNTY,MATEETE,KASAMBYA,KIBENGO,852,4,2,6,285,301,598,15,613,0,O-45-120-03-01-04
SSEMBABULE,MAWOGOLA COUNTY,MATEETE,KASAMBYA,LUWUNGA,384,1,4,1,85,169,260,11,271,0,O-45-120-03-01-05
SSEMBABULE,MAWOGOLA COUNTY,MATEETE,KASAMBYA,KASAMBYA,454,1,1,7,147,121,277,14,291,0,O-45-120-03-01-06
SSEMBABULE,MAWOGOLA COUNTY,MATEETE,KAYUNGA,BUGENGE,488,3,0,7,189,154,353,10,363,0,O-45-120-03-02-01
SSEMBABULE,MAWOGOLA COUNTY,MATEETE,KAYUNGA,BUYONGO,260,1,1,4,72,118,196,4,200,0,O-45-120-03-02-02
SSEMBABULE,MAWOGOLA COUNTY,MATEETE,KAYUNGA,NKANDWA,290,2,0,20,120,96,238,11,249,0,O-45-120-03-02-03
SSEMBABULE,MAWOGOLA COUNTY,MATEETE,KAYUNGA,BUKULULA,551,2,2,6,164,177,351,9,360,0,O-45-120-03-02-04
SSEMBABULE,MAWOGOLA COUNTY,MATEETE,KAYUNGA,KASAANA,746,2,2,12,145,366,527,8,535,0,O-45-120-03-02-05
SSEMBABULE,MAWOGOLA COUNTY,MATEETE,KAYUNGA,KIRYABULO,382,2,1,12,132,131,278,4,282,0,O-45-120-03-02-06
SSEMBABULE,MAWOGOLA COUNTY,MATEETE,KAYUNGA,KASAMBYA,312,1,0,12,122,113,248,4,252,0,O-45-120-03-02-07
SSEMBABULE,MAWOGOLA COUNTY,MATEETE,KAYUNGA,KITAGABANA,603,3,0,8,165,279,455,7,462,0,O-45-120-03-02-08
SSEMBABULE,MAWOGOLA COUNTY,MATEETE,KAYUNGA,KAYUNGA,264,0,1,4,49,137,191,2,193,0,O-45-120-03-02-09
SSEMBABULE,MAWOGOLA COUNTY,MATEETE,MANYAMA,KITEREDDE,247,1,0,3,56,108,168,9,177,0,O-45-120-03-03-01
SSEMBABULE,MAWOGOLA COUNTY,MATEETE,MANYAMA,LWEMISEGE,372,0,1,1,83,180,265,2,267,0,O-45-120-03-03-02
SSEMBABULE,MAWOGOLA COUNTY,MATEETE,MANYAMA,KYEBONDOKOTO,541,0,0,3,124,265,392,6,398,0,O-45-120-03-03-03
SSEMBABULE,MAWOGOLA COUNTY,MATEETE,MANYAMA,KAYUNGA,535,1,1,4,170,206,382,20,402,0,O-45-120-03-03-04
SSEMBABULE,MAWOGOLA COUNTY,MATEETE,MANYAMA,LUUMA,346,0,0,2,87,151,240,0,240,0,O-45-120-03-03-05
SSEMBABULE,MAWOGOLA COUNTY,MATEETE,MANYAMA,KASEERUTWE,232,1,0,9,32,131,173,3,176,0,O-45-120-03-03-06
SSEMBABULE,MAWOGOLA COUNTY,MATEETE,MANYAMA,MANYAMA,508,2,0,3,202,181,388,17,405,0,O-45-120-03-03-07
SSEMBABULE,MAWOGOLA COUNTY,MATEETE,MANYAMA,NSANGALA,401,0,1,6,127,125,259,4,263,0,O-45-120-03-03-08
SSEMBABULE,MAWOGOLA COUNTY,MATEETE,MATEETE,KATIMBA A P/S,416,1,0,20,84,159,264,6,270,0,O-45-120-03-04-01
SSEMBABULE,MAWOGOLA COUNTY,MATEETE,MATEETE,KYABAJANJA,235,0,0,0,33,142,175,9,184,0,O-45-120-03-04-02
SSEMBABULE,MAWOGOLA COUNTY,MATEETE,MATEETE,KASAANA,365,0,0,4,39,201,244,1,245,0,O-45-120-03-04-03
SSEMBABULE,MAWOGOLA COUNTY,MATEETE,MATEETE,MATEETE A P/S,867,3,3,8,185,248,447,15,462,0,O-45-120-03-04-04
SSEMBABULE,MAWOGOLA COUNTY,MATEETE,MATEETE,MATEETE B P/S,697,3,1,5,162,206,377,9,386,0,O-45-120-03-04-05
SSEMBABULE,MAWOGOLA COUNTY,MATEETE,MATEETE,KATIMBA B P/S,370,4,0,8,83,137,232,11,243,0,O-45-120-03-04-06
SSEMBABULE,MAWOGOLA COUNTY,MATEETE,MATEETE,KABULASOKE,503,0,1,5,91,244,341,16,357,0,O-45-120-03-04-07
SSEMBABULE,MAWOGOLA COUNTY,MATEETE,MATEETE,MATEETE C,806,2,1,13,157,247,420,16,436,0,O-45-120-03-04-08
SSEMBABULE,MAWOGOLA COUNTY,MATEETE,MITEETE,MITETE,607,2,1,2,136,287,428,6,434,0,O-45-120-03-05-01
SSEMBABULE,MAWOGOLA COUNTY,MATEETE,MITEETE,NABIYAGI,534,2,1,5,141,241,390,21,411,0,O-45-120-03-05-02
SSEMBABULE,MAWOGOLA COUNTY,MATEETE,MITEETE,LUKAKKA,637,3,3,19,126,296,447,15,462,0,O-45-120-03-05-03
SSEMBABULE,MAWOGOLA COUNTY,MATEETE,MITEETE,NAKASEETA,263,0,0,7,64,133,204,7,211,0,O-45-120-03-05-04
SSEMBABULE,MAWOGOLA COUNTY,MATEETE,MITEETE,KANYOGOGA,565,0,0,4,173,236,413,8,421,0,O-45-120-03-05-05
SSEMBABULE,MAWOGOLA COUNTY,MATEETE,MITEETE,KALUBUBBU,563,3,0,7,225,187,422,2,424,0,O-45-120-03-05-06
SSEMBABULE,MAWOGOLA COUNTY,MATEETE,MITEETE,KIJU,829,1,0,8,318,251,578,15,593,0,O-45-120-03-05-07
SSEMBABULE,MAWOGOLA COUNTY,MATEETE,NAKAGONGO,KITEREDDE,471,2,3,1,95,216,317,5,322,0,O-45-120-03-06-01
SSEMBABULE,MAWOGOLA COUNTY,MATEETE,NAKAGONGO,MISOJJO,674,1,2,5,153,309,470,14,484,0,O-45-120-03-06-02
SSEMBABULE,MAWOGOLA COUNTY,MATEETE,NAKAGONGO,NSUMBA,712,2,0,3,96,379,480,10,490,0,O-45-120-03-06-03
SSEMBABULE,MAWOGOLA COUNTY,MATEETE,NAKAGONGO,BUKAANA,501,0,1,2,122,233,358,8,366,0,O-45-120-03-06-04
SSEMBABULE,MAWOGOLA COUNTY,MATEETE,NAKAGONGO,LWENKAKALA,190,3,0,1,47,91,142,5,147,0,O-45-120-03-06-05
SSEMBABULE,MAWOGOLA COUNTY,MATEETE,NAKAGONGO,NAKAGONGO,397,0,0,3,30,233,266,6,272,0,O-45-120-03-06-06
SSEMBABULE,MAWOGOLA COUNTY,MATEETE,NAKAGONGO,MBAALE,180,0,1,0,60,74,135,0,135,0,O-45-120-03-06-07
SSEMBABULE,MAWOGOLA COUNTY,MATEETE,NAKAGONGO,LWAMWENDE,492,2,0,3,133,198,336,0,336,0,O-45-120-03-06-08
SSEMBABULE,MAWOGOLA COUNTY,MIJWALA,KIDOKOLO,KANONI,760,0,0,1,19,521,541,7,548,0,O-45-120-04-01-01
SSEMBABULE,MAWOGOLA COUNTY,MIJWALA,KIDOKOLO,KIWULA,290,0,0,1,44,173,218,5,223,0,O-45-120-04-01-02
SSEMBABULE,MAWOGOLA COUNTY,MIJWALA,KIDOKOLO,KYANIKA,107,0,0,0,3,73,76,0,76,0,O-45-120-04-01-03
SSEMBABULE,MAWOGOLA COUNTY,MIJWALA,KIDOKOLO,BUSHEKA,593,2,1,0,38,399,440,13,453,0,O-45-120-04-01-04
SSEMBABULE,MAWOGOLA COUNTY,MIJWALA,KIDOKOLO,KIDOKORO,1141,1,1,1,49,753,805,5,810,0,O-45-120-04-01-05
SSEMBABULE,MAWOGOLA COUNTY,MIJWALA,MABINDO,KAWANGA,645,2,0,7,91,333,433,18,451,0,O-45-120-04-02-01
SSEMBABULE,MAWOGOLA COUNTY,MIJWALA,MABINDO,MISENYI,370,0,0,3,39,212,254,0,254,0,O-45-120-04-02-02
SSEMBABULE,MAWOGOLA COUNTY,MIJWALA,MABINDO,MABINDO,567,1,1,5,69,327,403,7,410,0,O-45-120-04-02-03
SSEMBABULE,MAWOGOLA COUNTY,MIJWALA,MABINDO,KINONI,284,2,0,3,62,134,201,6,207,0,O-45-120-04-02-04
SSEMBABULE,MAWOGOLA COUNTY,MIJWALA,MABINDO,KIKOMA,579,3,0,2,92,296,393,5,398,0,O-45-120-04-02-05
SSEMBABULE,MAWOGOLA COUNTY,MIJWALA,MABINDO,KINYANSI,247,2,0,2,52,139,195,12,207,0,O-45-120-04-02-06
SSEMBABULE,MAWOGOLA COUNTY,MIJWALA,MABINDO,KIGEJJO,362,1,1,5,61,197,265,12,277,0,O-45-120-04-02-07
SSEMBABULE,MAWOGOLA COUNTY,MIJWALA,MABINDO,KASAALU,518,0,1,1,104,279,385,7,392,0,O-45-120-04-02-08
SSEMBABULE,MAWOGOLA COUNTY,MIJWALA,MABINDO,KANDI NANSEKO,342,2,1,5,71,173,252,8,260,0,O-45-120-04-02-09
SSEMBABULE,MAWOGOLA COUNTY,MIJWALA,NSOGA,LWABAANA,695,1,1,2,194,265,463,8,471,0,O-45-120-04-03-01
SSEMBABULE,MAWOGOLA COUNTY,MIJWALA,NSOGA,KASEKERA,527,1,0,5,162,199,367,0,367,0,O-45-120-04-03-02
SSEMBABULE,MAWOGOLA COUNTY,MIJWALA,NSOGA,KYEMANDWA,729,0,1,7,119,360,487,13,500,0,O-45-120-04-03-03
SSEMBABULE,MAWOGOLA COUNTY,MIJWALA,NSOGA,NAMBIRIZI A,651,1,2,3,147,329,482,26,508,0,O-45-120-04-03-04
SSEMBABULE,MAWOGOLA COUNTY,MIJWALA,NSOGA,KYATUULO,397,1,0,0,80,224,305,10,315,0,O-45-120-04-03-05
SSEMBABULE,MAWOGOLA COUNTY,MIJWALA,NSOGA,KIGANDO C.O.U,303,2,0,1,74,160,237,9,246,0,O-45-120-04-03-06
SSEMBABULE,MAWOGOLA COUNTY,MIJWALA,NSOGA,KYAMAYUBA,419,3,0,6,113,185,307,8,315,0,O-45-120-04-03-07
SSEMBABULE,MAWOGOLA COUNTY,SSEMBABULE T.C,DISPENSARY WARD,SSEMBABULE PARENTS SCHOOL,879,0,1,6,221,312,540,9,549,0,O-45-120-05-01-01
SSEMBABULE,MAWOGOLA COUNTY,SSEMBABULE T.C,MARKET WARD,SSEMBABULE C. O. U,598,1,0,7,140,191,339,9,348,0,O-45-120-05-02-01
SSEMBABULE,MAWOGOLA COUNTY,SSEMBABULE T.C,MARKET WARD,KYOLOLA T.C,426,1,1,1,72,238,313,1,314,0,O-45-120-05-02-02
SSEMBABULE,MAWOGOLA COUNTY,SSEMBABULE T.C,PARISH WARD,SSEMBABULE,669,2,2,10,94,319,427,2,429,0,O-45-120-05-03-01
KAYUNGA,BBALE COUNTY,BBAALE,BBAALE,BAALE WEST (SSAZA HQTRS),819,0,1,5,78,427,511,14,525,0,O-47-171-01-01-01
KAYUNGA,BBALE COUNTY,BBAALE,BBAALE,BAALE EAST (S/C HQTRS),517,0,2,5,49,256,312,12,324,0,O-47-171-01-01-02
KAYUNGA,BBALE COUNTY,BBAALE,BBAALE,AMIREMBE TRADING CENTRE,248,1,0,2,24,156,183,16,199,0,O-47-171-01-01-03
KAYUNGA,BBALE COUNTY,BBAALE,KAVULE,UGEMBO TRADING CENTRE,299,1,0,5,14,157,177,16,193,0,O-47-171-01-02-01
KAYUNGA,BBALE COUNTY,BBAALE,KAVULE,AMATALA TRADING CENTRE,470,0,2,1,30,301,334,4,338,0,O-47-171-01-02-02
KAYUNGA,BBALE COUNTY,BBAALE,KAVULE,AYAZA TRADING CENTRE,318,1,0,2,17,197,217,8,225,0,O-47-171-01-02-03
KAYUNGA,BBALE COUNTY,BBAALE,KOKOTERO,ANGOYE TRADING CENTRE,232,0,1,1,20,139,161,10,171,0,O-47-171-01-03-01
KAYUNGA,BBALE COUNTY,BBAALE,KOKOTERO,YAKWAMBALA L.C MEETING PLA,143,0,0,2,6,71,79,5,84,0,O-47-171-01-03-02
KAYUNGA,BBALE COUNTY,BBAALE,MISANGA,ISANGA P/S,567,0,0,1,56,195,252,25,277,0,O-47-171-01-04-01
KAYUNGA,BBALE COUNTY,BBAALE,MISANGA,SUUBE CENTRE,170,0,0,0,4,93,97,3,100,0,O-47-171-01-04-02
KAYUNGA,BBALE COUNTY,BBAALE,MUGONGO,UGONGO P/S,388,2,0,0,16,198,216,12,228,0,O-47-171-01-05-01
KAYUNGA,BBALE COUNTY,BBAALE,MUGONGO,IIRA TRADING CENTRE,277,0,1,0,12,162,175,5,180,0,O-47-171-01-05-02
KAYUNGA,BBALE COUNTY,BBAALE,NAKITOKOLO,IKALASA CENTRE,373,3,0,1,34,208,246,3,249,0,O-47-171-01-06-01
KAYUNGA,BBALE COUNTY,GALIRAYA,GALIRAYA,ALIRAYA MARKET PLACE,381,1,0,0,20,235,256,6,262,0,O-47-171-02-01-01
KAYUNGA,BBALE COUNTY,GALIRAYA,GALIRAYA,USUNGERE P/S,649,1,3,7,40,375,426,35,461,0,O-47-171-02-01-02
KAYUNGA,BBALE COUNTY,GALIRAYA,GWERO-NAMAYUGE,AIZO T/C,746,2,1,2,35,423,463,7,470,0,O-47-171-02-02-01
KAYUNGA,BBALE COUNTY,GALIRAYA,GWERO-NAMAYUGE,WERO MARKET PLACE,798,2,2,5,72,498,579,19,598,0,O-47-171-02-02-02
KAYUNGA,BBALE COUNTY,GALIRAYA,GWERO-NAMAYUGE,AMAYUGE P/S,457,2,2,5,39,248,296,16,312,0,O-47-171-02-02-03
KAYUNGA,BBALE COUNTY,GALIRAYA,KASOKWE,IRYOLA CENTRE,320,2,2,1,48,84,137,0,137,0,O-47-171-02-03-01
KAYUNGA,BBALE COUNTY,GALIRAYA,KASOKWE,ASOKWE P/S,709,1,0,2,40,315,358,9,367,0,O-47-171-02-03-02
KAYUNGA,BBALE COUNTY,GALIRAYA,KIRASA,ISARIZI T/C,314,0,0,1,29,144,174,3,177,0,O-47-171-02-04-01
KAYUNGA,BBALE COUNTY,GALIRAYA,KIRASA,IRASA T/C,230,1,1,5,13,166,186,2,188,0,O-47-171-02-04-02
KAYUNGA,BBALE COUNTY,GALIRAYA,NAMALERE,AKITOMA T/C,579,0,4,2,37,362,405,4,409,0,O-47-171-02-05-01
KAYUNGA,BBALE COUNTY,GALIRAYA,NAMALERE,WEYALE CENTRE,326,1,1,3,31,151,187,1,188,0,O-47-171-02-05-02
KAYUNGA,BBALE COUNTY,GALIRAYA,NTIMBA,TIMBA P/S,322,0,0,0,27,169,196,0,196,0,O-47-171-02-06-01
KAYUNGA,BBALE COUNTY,GALIRAYA,NTIMBA,AWONGO T/C A (A-M),481,2,0,3,65,154,224,10,234,0,O-47-171-02-06-02
KAYUNGA,BBALE COUNTY,GALIRAYA,NTIMBA,IKOOTA LANDING SITE,197,1,0,2,32,81,116,0,116,0,O-47-171-02-06-03
KAYUNGA,BBALE COUNTY,GALIRAYA,NTIMBA,AWONGO T/C B (N-Z),526,0,0,3,63,186,252,6,258,0,O-47-171-02-06-04
KAYUNGA,BBALE COUNTY,KAYONZA,BALISANGA,KABALANGAJA CHURCH,417,1,1,0,40,228,270,6,276,0,O-47-171-03-01-01
KAYUNGA,BBALE COUNTY,KAYONZA,BALISANGA,NSAMBYA T/C,569,0,1,0,54,359,414,2,416,0,O-47-171-03-01-02
KAYUNGA,BBALE COUNTY,KAYONZA,KAFUMBA,NYONDO P/S,797,2,4,4,115,367,492,43,535,0,O-47-171-03-02-01
KAYUNGA,BBALE COUNTY,KAYONZA,KAFUMBA,BUKOMBA PLAY GROUND,565,1,2,3,28,288,322,52,374,0,O-47-171-03-02-02
KAYUNGA,BBALE COUNTY,KAYONZA,KAFUMBA,KIZINGA T/C,413,1,1,0,23,257,282,17,299,0,O-47-171-03-02-03
KAYUNGA,BBALE COUNTY,KAYONZA,KAMUSABI,UKONDA T/C,735,4,0,16,113,358,491,13,504,0,O-47-171-03-03-01
KAYUNGA,BBALE COUNTY,KAYONZA,KAMUSABI,UGONYA T/C,458,2,0,1,122,191,316,13,329,0,O-47-171-03-03-02
KAYUNGA,BBALE COUNTY,KAYONZA,KAMUSABI,UGASA C/U,374,1,0,4,41,210,256,15,271,0,O-47-171-03-03-03
KAYUNGA,BBALE COUNTY,KAYONZA,KAMUSABI,ABUNYONYI P/S,594,1,0,7,98,277,383,19,402,0,O-47-171-03-03-04
KAYUNGA,BBALE COUNTY,KAYONZA,KAMUSABI,AMUSABI T/C,616,3,0,3,94,287,387,16,403,0,O-47-171-03-03-05
KAYUNGA,BBALE COUNTY,KAYONZA,KAMUSABI,ASOLO CATHOLIC CHURCH,611,1,1,5,110,286,403,12,415,0,O-47-171-03-03-06
KAYUNGA,BBALE COUNTY,KAYONZA,KANYWERO,AMPANYI T/C,281,1,2,1,28,174,206,4,210,0,O-47-171-03-04-01
KAYUNGA,BBALE COUNTY,KAYONZA,KANYWERO,WABYATA P/S,563,4,7,3,51,309,374,32,406,0,O-47-171-03-04-02
KAYUNGA,BBALE COUNTY,KAYONZA,KANYWERO,ITWE EAST T/C,783,2,0,5,96,363,466,24,490,0,O-47-171-03-04-03
KAYUNGA,BBALE COUNTY,KAYONZA,KANYWERO,UNGA CATHOLIC CHURCH,434,2,2,5,44,266,319,23,342,0,O-47-171-03-04-04
KAYUNGA,BBALE COUNTY,KAYONZA,KANYWERO,AZINGA T/C,269,1,1,3,8,174,187,4,191,0,O-47-171-03-04-05
KAYUNGA,BBALE COUNTY,KAYONZA,KANYWERO,INDIANI PLAY GROUND,395,0,0,4,48,246,298,8,306,0,O-47-171-03-04-06
KAYUNGA,BBALE COUNTY,KAYONZA,KITWE,YAMUGONGO C/U A,402,1,0,1,60,193,255,3,258,0,O-47-171-03-05-01
KAYUNGA,BBALE COUNTY,KAYONZA,KITWE,SALAAMA T/C,628,0,0,2,78,313,393,10,403,0,O-47-171-03-05-02
KAYUNGA,BBALE COUNTY,KAYONZA,KITWE,KYAMUGONGO C/U B,443,0,0,0,51,201,252,16,268,0,O-47-171-03-05-03
KAYUNGA,BBALE COUNTY,KAYONZA,NAKYESA,NAKYESA DAY & BOARDING P/S A,365,1,0,2,61,151,215,4,219,0,O-47-171-03-06-01
KAYUNGA,BBALE COUNTY,KAYONZA,NAKYESA,KAVULE LC MEETING PLACE,358,1,0,0,50,196,247,11,258,0,O-47-171-03-06-02
KAYUNGA,BBALE COUNTY,KAYONZA,NAKYESA,NAMATOGONYA P/S,644,1,1,6,78,340,426,16,442,0,O-47-171-03-06-03
KAYUNGA,BBALE COUNTY,KAYONZA,NAKYESA,NAKYESA REVIVAL CHURCH,191,0,1,0,16,113,130,7,137,0,O-47-171-03-06-04
KAYUNGA,BBALE COUNTY,KAYONZA,NAKYESA,NAKYESA DAY AND BOARDING P/,454,1,2,2,64,195,264,7,271,0,O-47-171-03-06-05
KAYUNGA,BBALE COUNTY,KAYONZA,NAKYESANJA,NAMANOGA T/C,629,1,0,5,66,362,434,7,441,0,O-47-171-03-07-01
KAYUNGA,BBALE COUNTY,KAYONZA,NAKYESANJA,NAKYESANJA MARKET,772,0,2,4,72,416,494,19,513,0,O-47-171-03-07-02
KAYUNGA,BBALE COUNTY,KAYONZA,NAMALIRI,KAWOLOKOTA R/C P/S A,501,4,5,5,56,236,306,19,325,0,O-47-171-03-08-01
KAYUNGA,BBALE COUNTY,KAYONZA,NAMALIRI,KAYONZA P/S,571,2,0,1,64,260,327,6,333,0,O-47-171-03-08-02
KAYUNGA,BBALE COUNTY,KAYONZA,NAMALIRI,KAYONZA S/C HQTRS,603,1,1,2,59,336,399,2,401,0,O-47-171-03-08-03
KAYUNGA,BBALE COUNTY,KAYONZA,NAMALIRI,LUGASA P/S,85,0,0,0,15,33,48,2,50,0,O-47-171-03-08-04
KAYUNGA,BBALE COUNTY,KAYONZA,NAMALIRI,KYATO 3,152,1,0,1,19,99,120,1,121,0,O-47-171-03-08-05
KAYUNGA,BBALE COUNTY,KAYONZA,NAMALIRI,KAWOLOKOTA R/C P/S B,377,2,0,2,41,190,235,14,249,0,O-47-171-03-08-06
KAYUNGA,BBALE COUNTY,KAYONZA,NAMIZO,KITATAWULUZI (UMEA),771,0,4,3,59,446,512,19,531,0,O-47-171-03-09-01
KAYUNGA,BBALE COUNTY,KAYONZA,NAMIZO,NAMAVUNDU P/S,654,1,4,1,101,288,395,9,404,0,O-47-171-03-09-02
KAYUNGA,BBALE COUNTY,KAYONZA,NAMIZO,BUJWAYA P/S,565,2,5,3,45,331,386,10,396,0,O-47-171-03-09-03
KAYUNGA,BBALE COUNTY,KAYONZA,NAMIZO,KAWOLOKOTA C/U,660,8,1,7,59,321,396,44,440,0,O-47-171-03-09-04
KAYUNGA,BBALE COUNTY,KITIMBWA,KITATYA,SEMBUYA'S HOUSE,452,1,0,1,93,194,289,16,305,0,O-47-171-04-01-01
KAYUNGA,BBALE COUNTY,KITIMBWA,KITATYA,KITATYA C/U P/S,367,1,0,3,53,175,232,14,246,0,O-47-171-04-01-02
KAYUNGA,BBALE COUNTY,KITIMBWA,KITATYA,KITATYA R/C P/S,584,0,0,2,81,305,388,36,424,0,O-47-171-04-01-03
KAYUNGA,BBALE COUNTY,KITIMBWA,KITATYA,SEKAMWA'S PLACE,319,0,1,1,52,150,204,9,213,0,O-47-171-04-01-04
KAYUNGA,BBALE COUNTY,KITIMBWA,KYERIMA,NAKASEETA P/S,389,2,1,2,54,184,243,5,248,0,O-47-171-04-02-01
KAYUNGA,BBALE COUNTY,KITIMBWA,KYERIMA,KYERIMA C/U P/S,673,4,8,6,81,378,477,9,486,0,O-47-171-04-02-02
KAYUNGA,BBALE COUNTY,KITIMBWA,KYERIMA,KYERIMA UMEA,662,2,0,5,110,306,423,16,439,0,O-47-171-04-02-03
KAYUNGA,BBALE COUNTY,KITIMBWA,KYERIMA,BALOKOLE CHURCH,506,2,1,3,99,247,352,3,355,0,O-47-171-04-02-04
KAYUNGA,BBALE COUNTY,KITIMBWA,KYERIMA,BWERAMONDO T/C,459,1,2,0,71,240,314,9,323,0,O-47-171-04-02-05
KAYUNGA,BBALE COUNTY,KITIMBWA,NAKIVUBO,BISAKA P/S,770,5,6,9,70,417,507,30,537,0,O-47-171-04-03-01
KAYUNGA,BBALE COUNTY,KITIMBWA,NAKIVUBO,NAKIVUBO T/C,662,9,0,9,84,322,424,11,435,0,O-47-171-04-03-02
KAYUNGA,BBALE COUNTY,KITIMBWA,NAKIVUBO,KIVOOGA T/C,327,1,1,4,24,192,222,12,234,0,O-47-171-04-03-03
KAYUNGA,BBALE COUNTY,KITIMBWA,NAKIVUBO,KABALIRA T/C,555,2,0,2,58,284,346,21,367,0,O-47-171-04-03-04
KAYUNGA,BBALE COUNTY,KITIMBWA,NAKIVUBO,NONGO LUZIRA'S HOUSE,363,2,2,2,85,137,228,6,234,0,O-47-171-04-03-05
KAYUNGA,BBALE COUNTY,KITIMBWA,NAMULABA,NONGO P/S,465,2,1,1,131,167,302,17,319,0,O-47-171-04-04-01
KAYUNGA,BBALE COUNTY,KITIMBWA,NAMULABA,NAMULABA C/U P/S,383,3,1,4,91,128,227,17,244,0,O-47-171-04-04-02
KAYUNGA,BBALE COUNTY,KITIMBWA,NAMULABA,MAASA T/C,549,0,1,2,120,246,369,10,379,0,O-47-171-04-04-03
KAYUNGA,BBALE COUNTY,KITIMBWA,NAMULABA,NAMULABA UMEA P/S,432,3,0,2,74,181,260,8,268,0,O-47-171-04-04-04
KAYUNGA,BBALE COUNTY,KITIMBWA,NAMULABA,KIDANDALI,273,3,1,3,38,136,181,11,192,0,O-47-171-04-04-05
KAYUNGA,BBALE COUNTY,KITIMBWA,NKOKONJERU,BULAULA MOSQUE,630,5,2,5,147,246,405,21,426,0,O-47-171-04-05-01
KAYUNGA,BBALE COUNTY,KITIMBWA,NKOKONJERU,BUALAULA B (BORE-HOLE),210,1,0,2,48,98,149,4,153,0,O-47-171-04-05-02
KAYUNGA,BBALE COUNTY,KITIMBWA,NKOKONJERU,NKOKONJERU DISPENSARY,662,6,1,8,123,281,419,16,435,0,O-47-171-04-05-03
KAYUNGA,BBALE COUNTY,KITIMBWA,NKOKONJERU,TWEYAGALIRE R/C P/S,570,1,2,1,83,294,381,30,411,0,O-47-171-04-05-04
KAYUNGA,BBALE COUNTY,KITIMBWA,WABUYINJA,WABUYINJA MOSQUE,305,1,0,4,23,179,207,11,218,0,O-47-171-04-06-01
KAYUNGA,BBALE COUNTY,KITIMBWA,WABUYINJA,SERUWAGI'S HOME PLACE,153,0,0,0,23,87,110,1,111,0,O-47-171-04-06-02
KAYUNGA,BBALE COUNTY,KITIMBWA,WABUYINJA,KITIMBWA C/U P/S,697,2,1,6,148,282,439,7,446,0,O-47-171-04-06-03
KAYUNGA,BBALE COUNTY,KITIMBWA,WABUYINJA,KITIMBWA CATHOLIC,660,0,1,0,127,288,416,19,435,0,O-47-171-04-06-04
KAYUNGA,BBALE COUNTY,KITIMBWA,WABUYINJA,KYETUME HIGH A,447,2,3,6,43,257,311,12,323,0,O-47-171-04-06-05
KAYUNGA,BBALE COUNTY,KITIMBWA,WABUYINJA,KYETUME HIGH B,405,4,1,3,40,207,255,9,264,0,O-47-171-04-06-06
KAYUNGA,BBALE COUNTY,KITIMBWA,WABWOKO,WABWOKO HEALTH CENTRE,515,6,0,5,59,236,306,31,337,0,O-47-171-04-07-01
KAYUNGA,BBALE COUNTY,KITIMBWA,WABWOKO,WABWOKO MOSQUE,411,1,0,5,52,211,269,20,289,0,O-47-171-04-07-02
KAYUNGA,BBALE COUNTY,KITIMBWA,WABWOKO,KIRIMAMPOKYA T/C,428,0,1,1,73,201,276,8,284,0,O-47-171-04-07-03
KAYUNGA,BBALE COUNTY,KITIMBWA,WABWOKO,WABUTI T/C,466,3,0,5,76,231,315,2,317,0,O-47-171-04-07-04
KAYUNGA,NTENJERU CTY NORTH,BUSAANA,KASANA,SABABU T/C,480,3,2,4,62,244,315,9,324,0,O-47-179-01-01-01
KAYUNGA,NTENJERU CTY NORTH,BUSAANA,KASANA,KASANA T/C,516,2,3,3,59,290,357,20,377,0,O-47-179-01-01-02
KAYUNGA,NTENJERU CTY NORTH,BUSAANA,KASANA,BUSAANA C/U A (A-M),488,2,0,3,119,154,278,8,286,0,O-47-179-01-01-03
KAYUNGA,NTENJERU CTY NORTH,BUSAANA,KASANA,BUKOLWA T/C,747,6,3,4,50,469,532,15,547,0,O-47-179-01-01-04
KAYUNGA,NTENJERU CTY NORTH,BUSAANA,KASANA,BUGOBERO,285,3,0,2,58,140,203,2,205,0,O-47-179-01-01-05
KAYUNGA,NTENJERU CTY NORTH,BUSAANA,KASANA,BUGADU TC,283,1,0,1,46,132,180,10,190,0,O-47-179-01-01-06
KAYUNGA,NTENJERU CTY NORTH,BUSAANA,KASANA,BUSAANA C/U B (N-Z),469,1,1,2,79,178,261,0,261,0,O-47-179-01-01-07
KAYUNGA,NTENJERU CTY NORTH,BUSAANA,KIWANGULA,BUYUNGIRIZI R/C,810,3,2,9,197,316,527,17,544,0,O-47-179-01-02-01
KAYUNGA,NTENJERU CTY NORTH,BUSAANA,KIWANGULA,KIWANGULA C/U P/S (A),375,2,0,1,71,181,255,3,258,0,O-47-179-01-02-02
KAYUNGA,NTENJERU CTY NORTH,BUSAANA,KIWANGULA,WANTEETE T/C,759,2,1,5,180,351,539,15,554,0,O-47-179-01-02-03
KAYUNGA,NTENJERU CTY NORTH,BUSAANA,KIWANGULA,KIWANGULA C/U P/S (B),378,0,1,0,72,187,260,5,265,0,O-47-179-01-02-04
KAYUNGA,NTENJERU CTY NORTH,BUSAANA,LUSENKE,BUGADDU C/U P/S,537,2,8,1,91,251,353,23,376,0,O-47-179-01-03-01
KAYUNGA,NTENJERU CTY NORTH,BUSAANA,LUSENKE,LUSENKE T/C,476,1,13,5,93,211,323,30,353,0,O-47-179-01-03-02
KAYUNGA,NTENJERU CTY NORTH,BUSAANA,LUSENKE,KUFU,267,5,0,4,48,137,194,7,201,0,O-47-179-01-03-03
KAYUNGA,NTENJERU CTY NORTH,BUSAANA,LUSENKE,KYENGERA C/U,392,1,1,1,79,186,268,12,280,0,O-47-179-01-03-04
KAYUNGA,NTENJERU CTY NORTH,BUSAANA,LUSENKE,KIBUZI R/C P/S,463,4,2,3,131,197,337,13,350,0,O-47-179-01-03-05
KAYUNGA,NTENJERU CTY NORTH,BUSAANA,LUSENKE,BAKUTTA,271,0,1,3,60,133,197,4,201,0,O-47-179-01-03-06
KAYUNGA,NTENJERU CTY NORTH,BUSAANA,LUSENKE,BUNZIBIRIDDE,449,4,7,7,108,204,330,17,347,0,O-47-179-01-03-07
KAYUNGA,NTENJERU CTY NORTH,BUSAANA,NABUGANYI,NAMATOGONYA T/C,475,2,5,5,29,274,315,19,334,0,O-47-179-01-04-01
KAYUNGA,NTENJERU CTY NORTH,BUSAANA,NABUGANYI,BUMALI T/C,413,1,0,4,46,231,282,20,302,0,O-47-179-01-04-02
KAYUNGA,NTENJERU CTY NORTH,BUSAANA,NABUGANYI,MUTUKULA T/C,431,1,1,3,59,215,279,14,293,0,O-47-179-01-04-03
KAYUNGA,NTENJERU CTY NORTH,BUSAANA,NABUGANYI,NABUGANYI C/U,441,4,0,3,16,243,266,7,273,0,O-47-179-01-04-04
KAYUNGA,NTENJERU CTY NORTH,BUSAANA,NAMIREMBE,KAUKU T/C,612,4,1,6,52,321,384,29,413,0,O-47-179-01-05-01
KAYUNGA,NTENJERU CTY NORTH,BUSAANA,NAMIREMBE,WAMPOLOGOMA T/C,352,4,0,4,43,188,239,13,252,0,O-47-179-01-05-02
KAYUNGA,NTENJERU CTY NORTH,BUSAANA,NAMIREMBE,NAMIREMBE T/C,734,5,3,17,139,268,432,23,455,0,O-47-179-01-05-03
KAYUNGA,NTENJERU CTY NORTH,BUSAANA,NAMIREMBE,NAMIREMBE C/U,540,8,4,8,95,199,314,15,329,0,O-47-179-01-05-04
KAYUNGA,NTENJERU CTY NORTH,BUSAANA,NAMIREMBE,WAMPLOGOMA T/C B,428,9,2,3,49,219,282,7,289,0,O-47-179-01-05-05
KAYUNGA,NTENJERU CTY NORTH,BUSAANA,NAMPANYI,KIREKU T/C,524,3,5,4,63,290,365,7,372,0,O-47-179-01-06-01
KAYUNGA,NTENJERU CTY NORTH,BUSAANA,NAMPANYI,NAKAKANDWA P/S,408,0,1,0,68,212,281,14,295,0,O-47-179-01-06-02
KAYUNGA,NTENJERU CTY NORTH,BUSAANA,NAMPANYI,NAMPANYI T/C,632,1,3,5,136,288,433,17,450,0,O-47-179-01-06-03
KAYUNGA,NTENJERU CTY NORTH,BUSAANA,NAMPANYI,BUKUNGULU MUSLIM P/S,379,1,3,5,84,176,269,16,285,0,O-47-179-01-06-04
KAYUNGA,NTENJERU CTY NORTH,BUSAANA,NAMUKUMA,KYENGERA C/U P/S,574,4,2,6,116,230,358,8,366,0,O-47-179-01-07-01
KAYUNGA,NTENJERU CTY NORTH,BUSAANA,NAMUKUMA,KITALA T/C,675,2,4,4,79,346,435,23,458,0,O-47-179-01-07-02
KAYUNGA,NTENJERU CTY NORTH,BUSAANA,NAMUKUMA,NANGABO C/U P/S,471,2,1,2,70,214,289,9,298,0,O-47-179-01-07-03
KAYUNGA,NTENJERU CTY NORTH,BUSAANA,NAMUKUMA,KAYONJO T/C,487,0,5,5,110,186,306,18,324,0,O-47-179-01-07-04
KAYUNGA,NTENJERU CTY NORTH,BUSAANA,NAMUKUMA,KYAYAAYE R/C,497,2,5,8,101,221,337,12,349,0,O-47-179-01-07-05
KAYUNGA,NTENJERU CTY NORTH,BUSAANA,NAMUSAALA,NAMUTYA T/C,640,3,3,8,85,283,382,32,414,0,O-47-179-01-08-01
KAYUNGA,NTENJERU CTY NORTH,BUSAANA,NAMUSAALA,NAMUSAALA C/U P/S,336,1,0,1,30,173,205,5,210,0,O-47-179-01-08-02
KAYUNGA,NTENJERU CTY NORTH,BUSAANA,NAMUSAALA,LUSENKE,425,1,2,3,66,186,258,11,269,0,O-47-179-01-08-03
KAYUNGA,NTENJERU CTY NORTH,BUSAANA,NAMUSAALA,BISAKA T/C,311,2,3,4,62,158,229,14,243,0,O-47-179-01-08-04
KAYUNGA,NTENJERU CTY NORTH,BUSAANA,NAMUSAALA,MASEMBE CENTRE,503,5,1,7,61,298,372,33,405,0,O-47-179-01-08-05
KAYUNGA,NTENJERU CTY NORTH,KAYUNGA,BUBAJJWE,KAAZI P/S,582,3,1,8,122,232,366,13,379,0,O-47-179-02-01-01
KAYUNGA,NTENJERU CTY NORTH,KAYUNGA,BUBAJJWE,BUBAJJWE T/C,571,1,1,4,166,215,387,30,417,0,O-47-179-02-01-02
KAYUNGA,NTENJERU CTY NORTH,KAYUNGA,BUBAJJWE,NAMATOGONYA CATHOLIC CHUR,371,1,1,3,95,126,226,26,252,0,O-47-179-02-01-03
KAYUNGA,NTENJERU CTY NORTH,KAYUNGA,BUKOLOTO,SSEZIBWA P/S,455,1,0,9,103,166,279,24,303,0,O-47-179-02-02-01
KAYUNGA,NTENJERU CTY NORTH,KAYUNGA,BUKOLOTO,KYAMPISI T/C,668,5,2,10,182,230,429,19,448,0,O-47-179-02-02-02
KAYUNGA,NTENJERU CTY NORTH,KAYUNGA,BUKOLOTO,BWETYABA T/C (SOLOMONS),449,0,0,7,152,145,304,10,314,0,O-47-179-02-02-03
KAYUNGA,NTENJERU CTY NORTH,KAYUNGA,BUKOLOTO,BWETYABA P/S - GAAZA,491,0,2,15,120,188,325,14,339,0,O-47-179-02-02-04
KAYUNGA,NTENJERU CTY NORTH,KAYUNGA,BUKOLOTO,NAWANDAGALA P/S,303,1,0,2,87,122,212,8,220,0,O-47-179-02-02-05
KAYUNGA,NTENJERU CTY NORTH,KAYUNGA,BUKOLOTO,NDEEBA NURSARY,279,0,1,4,59,117,181,3,184,0,O-47-179-02-02-06
KAYUNGA,NTENJERU CTY NORTH,KAYUNGA,BUKUJU,BUKUJJU UMEA,401,1,1,0,69,198,269,12,281,0,O-47-179-02-03-01
KAYUNGA,NTENJERU CTY NORTH,KAYUNGA,BUKUJU,KYAMIMBI CATHOLIC CHURCH,397,0,3,8,107,140,258,21,279,0,O-47-179-02-03-02
KAYUNGA,NTENJERU CTY NORTH,KAYUNGA,BUKUJU,NALWEWETA T/C,360,2,0,1,35,212,250,3,253,0,O-47-179-02-03-03
KAYUNGA,NTENJERU CTY NORTH,KAYUNGA,BUKUJU,BUSOLO T/C,567,0,2,7,96,237,342,5,347,0,O-47-179-02-03-04
KAYUNGA,NTENJERU CTY NORTH,KAYUNGA,BUSAALE,BUSAALE DISPENSARY,728,2,1,2,179,276,460,23,483,0,O-47-179-02-04-01
KAYUNGA,NTENJERU CTY NORTH,KAYUNGA,BUSAALE,KYEBANJA STORE,401,2,1,2,68,208,281,13,294,0,O-47-179-02-04-02
KAYUNGA,NTENJERU CTY NORTH,KAYUNGA,BUSAALE,KATIKAMU GROUND,296,1,0,2,68,133,204,10,214,0,O-47-179-02-04-03
KAYUNGA,NTENJERU CTY NORTH,KAYUNGA,BUYOBE,BUWUNGIRO C/U P/S,279,0,1,0,36,131,168,7,175,0,O-47-179-02-05-01
KAYUNGA,NTENJERU CTY NORTH,KAYUNGA,BUYOBE,KYANYA C/U,607,3,2,9,80,265,359,22,381,0,O-47-179-02-05-02
KAYUNGA,NTENJERU CTY NORTH,KAYUNGA,BUYOBE,BUYOBE KITAWULUZI,465,3,1,6,95,198,303,17,320,0,O-47-179-02-05-03
KAYUNGA,NTENJERU CTY NORTH,KAYUNGA,BUYOBE,KANJUKI UMEA,635,0,1,7,102,312,422,7,429,0,O-47-179-02-05-04
KAYUNGA,NTENJERU CTY NORTH,KAYUNGA,BUYOBE,KOKOTERO GROUND,250,0,0,0,46,142,188,4,192,0,O-47-179-02-05-05
KAYUNGA,NTENJERU CTY NORTH,KAYUNGA,BUYOBE,KAUKU GROUND,281,0,1,2,41,149,193,7,200,0,O-47-179-02-05-06
KAYUNGA,NTENJERU CTY NORTH,KAYUNGA,KITEREDDE,KITEREDDE C/U,354,3,1,2,80,172,258,16,274,0,O-47-179-02-06-01
KAYUNGA,NTENJERU CTY NORTH,KAYUNGA,KITEREDDE,BUGOGGE,653,2,3,4,107,324,440,23,463,0,O-47-179-02-06-02
KAYUNGA,NTENJERU CTY NORTH,KAYUNGA,KITEREDDE,KISAGAZI GROUND,185,0,1,5,43,88,137,4,141,0,O-47-179-02-06-03
KAYUNGA,NTENJERU CTY NORTH,KAYUNGA,NAKASEETA,NAKASEETA BWETYABA STORE,473,2,0,6,98,208,314,7,321,0,O-47-179-02-07-01
KAYUNGA,NTENJERU CTY NORTH,KAYUNGA,NAKASEETA,NAKAZIBA MOSQUE,526,2,2,7,149,192,352,8,360,0,O-47-179-02-07-02
KAYUNGA,NTENJERU CTY NORTH,KAYUNGA,NAKASEETA,KISOMBWA STORE,533,2,1,6,95,255,359,0,359,0,O-47-179-02-07-03
KAYUNGA,NTENJERU CTY NORTH,KAYUNGA,NSOTOKA,BUNYUMYA CHURCH,443,1,0,12,177,82,272,9,281,0,O-47-179-02-08-01
KAYUNGA,NTENJERU CTY NORTH,KAYUNGA,NSOTOKA,SSUKA GREEN VALLEY S.S.S,658,3,1,8,199,173,384,16,400,0,O-47-179-02-08-02
KAYUNGA,NTENJERU CTY NORTH,KAYUNGA,NSOTOKA,NSOTOKA MUSLIM,443,2,4,5,160,116,287,17,304,0,O-47-179-02-08-03
KAYUNGA,NTENJERU CTY NORTH,KAYUNGA,NSOTOKA,NAMULANDA C/U,523,2,1,4,133,169,309,18,327,0,O-47-179-02-08-04
KAYUNGA,NTENJERU CTY NORTH,KAYUNGA,NSOTOKA,MATABA ISLAMIC,638,0,2,4,227,178,411,13,424,0,O-47-179-02-08-05
KAYUNGA,NTENJERU CTY NORTH,KAYUNGA,NSOTOKA,MATABA GROUND,294,0,0,2,100,80,182,5,187,0,O-47-179-02-08-06
KAYUNGA,NTENJERU CTY NORTH,KAYUNGA T.C,BUKOLOTO T/C,NDEEBA P/S,418,3,1,4,115,172,295,11,306,0,O-47-179-03-01-01
KAYUNGA,NTENJERU CTY NORTH,KAYUNGA T.C,BUKOLOTO T/C,BWETYABA G. C. S,706,2,1,3,236,226,468,10,478,0,O-47-179-03-01-02
KAYUNGA,NTENJERU CTY NORTH,KAYUNGA T.C,BUKOLOTO T/C,LATE JIMMY MASAKA LUGO PLAC,563,2,1,10,186,203,402,14,416,0,O-47-179-03-01-03
KAYUNGA,NTENJERU CTY NORTH,KAYUNGA T.C,BUKOLOTO T/C,KAKOWEKOOWE L.C MEETING PL,276,0,1,1,101,86,189,0,189,0,O-47-179-03-01-04
KAYUNGA,NTENJERU CTY NORTH,KAYUNGA T.C,BUKOLOTO T/C,BUKOLOOTO MARKET,480,3,1,3,110,191,308,1,309,0,O-47-179-03-01-05
KAYUNGA,NTENJERU CTY NORTH,KAYUNGA T.C,KAYUNGA CENTRAL,HOSPITAL PLAY GROUND-A,383,3,1,2,124,107,237,26,263,0,O-47-179-03-02-01
KAYUNGA,NTENJERU CTY NORTH,KAYUNGA T.C,KAYUNGA CENTRAL,HOSPITAL PLAY GROUND-B,195,3,0,1,71,51,126,4,130,0,O-47-179-03-02-02
KAYUNGA,NTENJERU CTY NORTH,KAYUNGA T.C,KAYUNGA CENTRAL,MAYOR'S COMPOUND A,425,3,2,3,137,116,261,4,265,0,O-47-179-03-02-03
KAYUNGA,NTENJERU CTY NORTH,KAYUNGA T.C,KAYUNGA CENTRAL,DDUMBA'S COMPOUND,361,1,1,5,157,89,253,5,258,0,O-47-179-03-02-04
KAYUNGA,NTENJERU CTY NORTH,KAYUNGA T.C,KAYUNGA CENTRAL,KIBIRA MU-LINE,640,1,3,9,178,272,463,18,481,0,O-47-179-03-02-05
KAYUNGA,NTENJERU CTY NORTH,KAYUNGA T.C,KAYUNGA CENTRAL,HOSPITAL PLAY GROUND C,635,3,1,3,179,187,373,7,380,0,O-47-179-03-02-06
KAYUNGA,NTENJERU CTY NORTH,KAYUNGA T.C,KAYUNGA CENTRAL,MAYOR'S COMPOUND B,592,2,1,3,158,190,354,11,365,0,O-47-179-03-02-07
KAYUNGA,NTENJERU CTY NORTH,KAYUNGA T.C,KAYUNGA CENTRAL,DDUMBA'S COMPUND B,505,3,2,4,165,138,312,9,321,0,O-47-179-03-02-08
KAYUNGA,NTENJERU CTY NORTH,KAYUNGA T.C,NAMAGABI,KAYUNGA R/C P.SCH.,702,5,0,13,206,232,456,13,469,0,O-47-179-03-03-01
KAYUNGA,NTENJERU CTY NORTH,KAYUNGA T.C,NAMAGABI,NAMAGABI UMEA,590,1,2,6,180,200,389,11,400,0,O-47-179-03-03-02
KAYUNGA,NTENJERU CTY NORTH,KAYUNGA T.C,NAMAGABI,KISAABA NURSERY,301,3,5,8,84,106,206,4,210,0,O-47-179-03-03-03
KAYUNGA,NTENJERU CTY NORTH,KAYUNGA T.C,NTENJERU,TENTE P/S,510,0,0,3,120,226,349,12,361,0,O-47-179-03-04-01
KAYUNGA,NTENJERU CTY NORTH,KAYUNGA T.C,NTENJERU,SSAZA HQTRS,622,1,0,5,156,283,445,3,448,0,O-47-179-03-04-02
KAYUNGA,NTENJERU CTY NORTH,KAYUNGA T.C,NTENJERU,LIGHT COLLEGE S.S.S,488,4,0,3,102,153,262,13,275,0,O-47-179-03-04-03
KAYUNGA,NTENJERU CTY SOUTH,KANGULUMIRA,KANGULUMIRA,SOONA ISLAMIC SCHOOL,383,0,0,3,71,193,267,14,281,0,O-47-180-01-01-01
KAYUNGA,NTENJERU CTY SOUTH,KANGULUMIRA,KANGULUMIRA,KANGULUMIRA R/C,592,3,3,6,150,218,380,22,402,0,O-47-180-01-01-02
KAYUNGA,NTENJERU CTY SOUTH,KANGULUMIRA,KANGULUMIRA,KALAGALA T/C,409,1,4,1,99,177,282,8,290,0,O-47-180-01-01-03
KAYUNGA,NTENJERU CTY SOUTH,KANGULUMIRA,KANGULUMIRA,KASAMBYA UMEA,611,1,1,1,102,275,380,31,411,0,O-47-180-01-01-04
KAYUNGA,NTENJERU CTY SOUTH,KANGULUMIRA,KANGULUMIRA,KANGULUMIRA S/C HQTRS,691,2,3,4,212,179,400,4,404,0,O-47-180-01-01-05
KAYUNGA,NTENJERU CTY SOUTH,KANGULUMIRA,KANGULUMIRA,KANGULIMIRA CATHERINE P/S A,499,0,1,3,175,147,326,3,329,0,O-47-180-01-01-06
KAYUNGA,NTENJERU CTY SOUTH,KANGULUMIRA,KANGULUMIRA,KANGULUMIRA C/U P/S,432,2,4,1,86,194,287,8,295,0,O-47-180-01-01-07
KAYUNGA,NTENJERU CTY SOUTH,KANGULUMIRA,KANGULUMIRA,KALAGALA B,558,2,0,2,85,258,347,16,363,0,O-47-180-01-01-08
KAYUNGA,NTENJERU CTY SOUTH,KANGULUMIRA,KANGULUMIRA,KANGULUMIRA S/C HQTRS B,905,2,1,7,237,293,540,12,552,0,O-47-180-01-01-09
KAYUNGA,NTENJERU CTY SOUTH,KANGULUMIRA,KANGULUMIRA,KANGULUMIRA CATHERINE P/S B,579,1,1,0,155,184,341,0,341,0,O-47-180-01-01-10
KAYUNGA,NTENJERU CTY SOUTH,KANGULUMIRA,KAWOMYA,BUKEEKA MOSLEM P/S A,398,0,1,2,151,122,276,5,281,0,O-47-180-01-02-01
KAYUNGA,NTENJERU CTY SOUTH,KANGULUMIRA,KAWOMYA,KAWOOMYA PARISH HQTRS,448,3,4,3,124,147,281,16,297,0,O-47-180-01-02-02
KAYUNGA,NTENJERU CTY SOUTH,KANGULUMIRA,KAWOMYA,MIREMBE T/C,561,6,7,6,136,234,389,12,401,0,O-47-180-01-02-03
KAYUNGA,NTENJERU CTY SOUTH,KANGULUMIRA,KAWOMYA,KKUNGU C/U P/S,627,4,0,4,180,198,386,30,416,0,O-47-180-01-02-04
KAYUNGA,NTENJERU CTY SOUTH,KANGULUMIRA,KAWOMYA,MALIGITA P/S,439,1,1,5,105,158,270,10,280,0,O-47-180-01-02-05
KAYUNGA,NTENJERU CTY SOUTH,KANGULUMIRA,KAWOMYA,BUKEEKA MOSLEM P/S B,547,1,1,3,155,188,348,16,364,0,O-47-180-01-02-06
KAYUNGA,NTENJERU CTY SOUTH,KANGULUMIRA,KIGAYAZA,KAMIRA PUBLIC S.S,483,0,1,2,104,222,329,24,353,0,O-47-180-01-03-01
KAYUNGA,NTENJERU CTY SOUTH,KANGULUMIRA,KIGAYAZA,NAKATUNDU T/C,524,1,3,4,86,230,324,19,343,0,O-47-180-01-03-02
KAYUNGA,NTENJERU CTY SOUTH,KANGULUMIRA,KIGAYAZA,KIGAYAZA P/S,541,0,5,1,139,196,341,21,362,0,O-47-180-01-03-03
KAYUNGA,NTENJERU CTY SOUTH,KANGULUMIRA,KIGAYAZA,KIGAYAZA SEVENTH DAY ADV. P/,342,0,2,3,75,120,200,9,209,0,O-47-180-01-03-04
KAYUNGA,NTENJERU CTY SOUTH,KANGULUMIRA,KIKWANYA,KIMOOLI P/S,357,2,0,5,93,122,222,8,230,0,O-47-180-01-04-01
KAYUNGA,NTENJERU CTY SOUTH,KANGULUMIRA,KIKWANYA,NALUWERERE T/C,637,2,1,8,118,284,413,11,424,0,O-47-180-01-04-02
KAYUNGA,NTENJERU CTY SOUTH,KANGULUMIRA,KIKWANYA,KIKWANYA C/U P/SCHOOL,487,2,2,1,101,204,310,10,320,0,O-47-180-01-04-03
KAYUNGA,NTENJERU CTY SOUTH,KANGULUMIRA,NAKATUNDU,WABUKWA T/C,368,2,1,0,122,124,249,11,260,0,O-47-180-01-05-01
KAYUNGA,NTENJERU CTY SOUTH,KANGULUMIRA,NAKATUNDU,KAMULI UMEA,683,3,4,4,138,293,442,9,451,0,O-47-180-01-05-02
KAYUNGA,NTENJERU CTY SOUTH,KANGULUMIRA,NAKATUNDU,MBULAKATI- MADARASAT,358,0,3,1,89,137,230,2,232,0,O-47-180-01-05-03
KAYUNGA,NTENJERU CTY SOUTH,KANGULUMIRA,NAKATUNDU,KISEGA HIGH SCHOOL,802,3,0,2,215,307,527,17,544,0,O-47-180-01-05-04
KAYUNGA,NTENJERU CTY SOUTH,KANGULUMIRA,NAKATUNDU,RWANDA T/C,716,2,2,11,140,330,485,6,491,0,O-47-180-01-05-05
KAYUNGA,NTENJERU CTY SOUTH,KANGULUMIRA,SEETA-NYIIZE,SEETA T/C,739,4,10,3,184,246,447,82,529,0,O-47-180-01-06-01
KAYUNGA,NTENJERU CTY SOUTH,KANGULUMIRA,SEETA-NYIIZE,BUKASA T/C,603,0,4,5,164,206,379,21,400,0,O-47-180-01-06-02
KAYUNGA,NTENJERU CTY SOUTH,KANGULUMIRA,SEETA-NYIIZE,NYIIZE R/C,526,2,3,4,124,176,309,17,326,0,O-47-180-01-06-03
KAYUNGA,NTENJERU CTY SOUTH,KANGULUMIRA,SEETA-NYIIZE,NAKIRUBI T/C A,409,4,1,3,120,135,263,18,281,0,O-47-180-01-06-04
KAYUNGA,NTENJERU CTY SOUTH,KANGULUMIRA,SEETA-NYIIZE,NAMAKANDWA CENTRE,628,6,2,5,127,240,380,25,405,0,O-47-180-01-06-05
KAYUNGA,NTENJERU CTY SOUTH,KANGULUMIRA,SEETA-NYIIZE,NYIIZE C/U P/S,511,3,6,3,120,170,302,15,317,0,O-47-180-01-06-06
KAYUNGA,NTENJERU CTY SOUTH,KANGULUMIRA,SEETA-NYIIZE,NAKIRUBI T/C B,595,2,4,4,123,243,376,20,396,0,O-47-180-01-06-07
KAYUNGA,NTENJERU CTY SOUTH,NAZIGO,BUKAMBA,BUKAMBA C/U P/S,786,4,4,3,150,367,528,14,542,0,O-47-180-02-01-01
KAYUNGA,NTENJERU CTY SOUTH,NAZIGO,BUKAMBA,NAMIREMBE,628,1,3,8,138,291,441,8,449,0,O-47-180-02-01-02
KAYUNGA,NTENJERU CTY SOUTH,NAZIGO,BUKAMBA,KISWA R/C P/S,462,2,2,4,94,220,322,7,329,0,O-47-180-02-01-03
KAYUNGA,NTENJERU CTY SOUTH,NAZIGO,KATIKANYONYI,KITEREDDE T/C,761,5,5,3,118,385,516,22,538,0,O-47-180-02-02-01
KAYUNGA,NTENJERU CTY SOUTH,NAZIGO,KATIKANYONYI,BUDOODA T/C,541,2,0,2,110,236,350,11,361,0,O-47-180-02-02-02
KAYUNGA,NTENJERU CTY SOUTH,NAZIGO,KATIKANYONYI,KIWUBA,708,3,3,8,114,385,513,10,523,0,O-47-180-02-02-03
KAYUNGA,NTENJERU CTY SOUTH,NAZIGO,KIMANYA,GANGAMA C/U,419,1,1,1,120,151,274,9,283,0,O-47-180-02-03-01
KAYUNGA,NTENJERU CTY SOUTH,NAZIGO,KIMANYA,KIMANYA MOSQUE,322,3,0,7,60,141,211,12,223,0,O-47-180-02-03-02
KAYUNGA,NTENJERU CTY SOUTH,NAZIGO,KIMANYA,KIZIIKA C/U P/S,400,5,1,2,105,145,258,3,261,0,O-47-180-02-03-03
KAYUNGA,NTENJERU CTY SOUTH,NAZIGO,KIMANYA,KISOGA CATHOLIC CHURCH,774,1,2,13,221,280,517,0,517,0,O-47-180-02-03-04
KAYUNGA,NTENJERU CTY SOUTH,NAZIGO,KIRINDI,NAKAKONGE CHURCH,639,2,2,10,113,300,427,13,440,0,O-47-180-02-04-01
KAYUNGA,NTENJERU CTY SOUTH,NAZIGO,KIRINDI,KASEGA T/C,521,1,1,1,134,209,346,5,351,0,O-47-180-02-04-02
KAYUNGA,NTENJERU CTY SOUTH,NAZIGO,KIRINDI,KIRINDI C/U B,348,2,0,4,123,113,242,8,250,0,O-47-180-02-04-03
KAYUNGA,NTENJERU CTY SOUTH,NAZIGO,KIRINDI,MUSIITWA P/S,402,1,1,3,113,121,239,7,246,0,O-47-180-02-04-04
KAYUNGA,NTENJERU CTY SOUTH,NAZIGO,KIRINDI,KIRINDI C/U B,441,0,4,1,138,150,293,14,307,0,O-47-180-02-04-05
KAYUNGA,NTENJERU CTY SOUTH,NAZIGO,NATTETA,NAZIGO R/C,629,3,0,12,178,173,366,22,388,0,O-47-180-02-05-01
KAYUNGA,NTENJERU CTY SOUTH,NAZIGO,NATTETA,NAZIGO JACK & JILL,716,3,0,8,238,167,416,3,419,0,O-47-180-02-05-02
KAYUNGA,NTENJERU CTY SOUTH,NAZIGO,NATTETA,NATTETA C/U,579,0,1,8,184,166,359,12,371,0,O-47-180-02-05-03
KAYUNGA,NTENJERU CTY SOUTH,NAZIGO,NATTETA,NAKATOVU L.C. OFFICE,267,0,1,1,58,120,180,6,186,0,O-47-180-02-05-04
KAYUNGA,NTENJERU CTY SOUTH,NAZIGO,NATTETA,KIRIBEDDA C/U,279,1,2,2,74,96,175,4,179,0,O-47-180-02-05-05
KAYUNGA,NTENJERU CTY SOUTH,NAZIGO,NATTETA,BUSAGAZI SERUGGA'S PLACE,332,2,0,2,64,163,231,6,237,0,O-47-180-02-05-06
KAYUNGA,NTENJERU CTY SOUTH,NAZIGO,NATTETA,WABIROGO,420,0,0,6,81,194,281,21,302,0,O-47-180-02-05-07
KAYUNGA,NTENJERU CTY SOUTH,NAZIGO,NATTETA,NAZIGO TOWN S.S,609,4,0,10,154,149,317,10,327,0,O-47-180-02-05-08
KAYUNGA,NTENJERU CTY SOUTH,NAZIGO,NATTETA,NAZIGO MOSQUE,489,1,0,4,160,103,268,12,280,0,O-47-180-02-05-09
KAYUNGA,NTENJERU CTY SOUTH,NAZIGO,NAZIGO,NAKAKONGE CENTRE,650,3,3,16,202,185,409,3,412,0,O-47-180-02-06-01
KAYUNGA,NTENJERU CTY SOUTH,NAZIGO,NAZIGO,SENDA MOSQUE,692,3,1,6,157,213,380,25,405,0,O-47-180-02-06-02
KAYUNGA,NTENJERU CTY SOUTH,NAZIGO,NAZIGO,NAZIGO DEMONSTRATION,336,3,1,5,111,68,188,0,188,0,O-47-180-02-06-03
KAYUNGA,NTENJERU CTY SOUTH,NAZIGO,NAZIGO,KYAMPISI QURAN SCHOOL,261,0,0,3,86,58,147,8,155,0,O-47-180-02-06-04
KAYUNGA,NTENJERU CTY SOUTH,NAZIGO,NAZIGO,MAGALA R/C P/S,569,1,1,10,146,196,354,14,368,0,O-47-180-02-06-05
KAYUNGA,NTENJERU CTY SOUTH,NAZIGO,NSIIMA,SALAAMA KIBIRIGE'S PLACE,447,1,0,6,143,146,296,4,300,0,O-47-180-02-07-01
KAYUNGA,NTENJERU CTY SOUTH,NAZIGO,NSIIMA,KIREMEZI CENTRE,602,4,1,17,137,226,385,14,399,0,O-47-180-02-07-02
WAKISO,BUSIRO CTY EAST,NSANGI(MUKONO),BUDDO,BUDDO JUNIOR SCHOOL,538,3,0,24,132,168,327,35,362,0,O-52-154-01-01-01
WAKISO,BUSIRO CTY EAST,NSANGI(MUKONO),BUDDO,KING'S COLLEGE BUDDO,637,1,0,21,130,203,355,11,366,0,O-52-154-01-01-02
WAKISO,BUSIRO CTY EAST,NSANGI(MUKONO),BUDDO,MAGWA LCI MEETING PLACE,403,0,0,13,87,152,252,46,298,0,O-52-154-01-01-03
WAKISO,BUSIRO CTY EAST,NSANGI(MUKONO),KASENGE,DELIGHT P/S (KINAAWA A),847,2,1,14,273,176,466,64,530,0,O-52-154-01-02-01
WAKISO,BUSIRO CTY EAST,NSANGI(MUKONO),KASENGE,DELIGHT P/S (KINAAWA B),576,0,1,21,206,146,374,2,376,0,O-52-154-01-02-02
WAKISO,BUSIRO CTY EAST,NSANGI(MUKONO),KASENGE,KABOJJA COFFEE FACTORY,842,2,2,29,296,212,541,6,547,0,O-52-154-01-02-03
WAKISO,BUSIRO CTY EAST,NSANGI(MUKONO),KASENGE,BANDWE P/S (A - M),491,1,0,18,176,151,346,7,353,0,O-52-154-01-02-04
WAKISO,BUSIRO CTY EAST,NSANGI(MUKONO),KASENGE,MUGONGO PRIMARY SCHOOL (A -,620,1,1,37,238,131,408,9,417,0,O-52-154-01-02-05
WAKISO,BUSIRO CTY EAST,NSANGI(MUKONO),KASENGE,KASENGE C.O.U,1133,3,0,47,406,272,728,29,757,0,O-52-154-01-02-06
WAKISO,BUSIRO CTY EAST,NSANGI(MUKONO),KASENGE,MUGONGO 'B' SEN SEC SCH,458,0,0,18,120,131,269,30,299,0,O-52-154-01-02-07
WAKISO,BUSIRO CTY EAST,NSANGI(MUKONO),KASENGE,BANDWE P/S (N - Z),692,1,0,20,215,221,457,3,460,0,O-52-154-01-02-08
WAKISO,BUSIRO CTY EAST,NSANGI(MUKONO),KASENGE,MUGONGO PRIMARY SCHOOL (N -,843,2,1,25,276,245,549,5,554,0,O-52-154-01-02-09
WAKISO,BUSIRO CTY EAST,NSANGI(MUKONO),KATEREKE,KATEREKE-MUZINDA-NKONYA,475,1,0,12,143,218,374,9,383,0,O-52-154-01-03-01
WAKISO,BUSIRO CTY EAST,NSANGI(MUKONO),KATEREKE,NSANGI COMMUNITY CENTRE,314,0,0,17,93,94,204,13,217,0,O-52-154-01-03-02
WAKISO,BUSIRO CTY EAST,NSANGI(MUKONO),KATEREKE,KATEREKE PRISON DITCH,294,2,2,10,68,117,199,5,204,0,O-52-154-01-03-03
WAKISO,BUSIRO CTY EAST,NSANGI(MUKONO),KIKAJJO,KIKAJJO SDA,642,2,0,31,218,154,405,11,416,0,O-52-154-01-04-01
WAKISO,BUSIRO CTY EAST,NSANGI(MUKONO),KIKAJJO,KASENGE CATHOLIC CHURCH,850,3,1,33,259,252,548,8,556,0,O-52-154-01-04-02
WAKISO,BUSIRO CTY EAST,NSANGI(MUKONO),KIKAJJO,NAKIRAMA TRADOMG CENTRE,593,2,1,25,191,194,413,21,434,0,O-52-154-01-04-03
WAKISO,BUSIRO CTY EAST,NSANGI(MUKONO),KIKAJJO,BUKWENDA CHURCH,467,2,1,15,156,126,300,16,316,0,O-52-154-01-04-04
WAKISO,BUSIRO CTY EAST,NSANGI(MUKONO),KIKAJJO,BUSAWULA PRIMARY SCHOOL (A,599,6,1,20,183,145,355,21,376,0,O-52-154-01-04-05
WAKISO,BUSIRO CTY EAST,NSANGI(MUKONO),KIKAJJO,BUGEMA TRADING CENTRE,554,4,0,9,165,208,386,9,395,0,O-52-154-01-04-06
WAKISO,BUSIRO CTY EAST,NSANGI(MUKONO),KIKAJJO,BUSAWULA PRIMARY SCHOOL (N,710,2,2,30,186,238,458,3,461,0,O-52-154-01-04-07
WAKISO,BUSIRO CTY EAST,NSANGI(MUKONO),KISOZI,BUDDO GROWERS (KITEMU A),962,2,0,47,308,198,555,0,555,0,O-52-154-01-05-01
WAKISO,BUSIRO CTY EAST,NSANGI(MUKONO),KISOZI,MUSANGE BETTY'S RESIDENCE (K,480,5,0,33,144,147,329,15,344,0,O-52-154-01-05-02
WAKISO,BUSIRO CTY EAST,NSANGI(MUKONO),KISOZI,NAMAGOMA UMEA PRI SCH,749,1,1,33,257,190,482,0,482,0,O-52-154-01-05-03
WAKISO,BUSIRO CTY EAST,NSANGI(MUKONO),KISOZI,KISOZI P/SCH,526,5,1,36,80,252,374,4,378,0,O-52-154-01-05-04
WAKISO,BUSIRO CTY EAST,NSANGI(MUKONO),KISOZI,SSUMBA PLAYGROUND,273,2,0,18,33,173,226,8,234,0,O-52-154-01-05-05
WAKISO,BUSIRO CTY EAST,NSANGI(MUKONO),KISOZI,NAKITOKOLO P/SCHOOL,328,4,0,15,108,106,233,8,241,0,O-52-154-01-05-06
WAKISO,BUSIRO CTY EAST,NSANGI(MUKONO),KYENGERA,ALPHA & OMEGA SECONDARY SC,1012,4,0,24,336,226,590,19,609,0,O-52-154-01-06-01
WAKISO,BUSIRO CTY EAST,NSANGI(MUKONO),KYENGERA,ST. ALOYSIOUS P/ SCH - KYENGE,748,0,2,33,294,118,447,9,456,0,O-52-154-01-06-02
WAKISO,BUSIRO CTY EAST,NSANGI(MUKONO),KYENGERA,HAJI KAWASI'S RESIDENCE (A - M),513,5,1,9,212,138,365,3,368,0,O-52-154-01-06-03
WAKISO,BUSIRO CTY EAST,NSANGI(MUKONO),KYENGERA,CAMBRIDGE COLLEGE(A - M),553,2,0,22,249,105,378,5,383,0,O-52-154-01-06-04
WAKISO,BUSIRO CTY EAST,NSANGI(MUKONO),KYENGERA,NABAZIZA PLAY GROUND,1292,5,2,95,392,225,719,19,738,0,O-52-154-01-06-05
WAKISO,BUSIRO CTY EAST,NSANGI(MUKONO),KYENGERA,KYENGERA CATHOLIC CHURCH (A,519,2,1,29,174,109,315,6,321,0,O-52-154-01-06-06
WAKISO,BUSIRO CTY EAST,NSANGI(MUKONO),KYENGERA,ST. ALOYSIOUS P/S KYENGERA I (,910,6,0,36,263,225,530,15,545,0,O-52-154-01-06-07
WAKISO,BUSIRO CTY EAST,NSANGI(MUKONO),KYENGERA,ST. ALOYSIOUS P/S KYENGERA I (,678,3,0,28,257,113,401,4,405,0,O-52-154-01-06-08
WAKISO,BUSIRO CTY EAST,NSANGI(MUKONO),KYENGERA,MASAGAZI'S RESIDENCE,238,2,0,12,77,70,161,4,165,0,O-52-154-01-06-09
WAKISO,BUSIRO CTY EAST,NSANGI(MUKONO),KYENGERA,HAJI KAWASI'S RESIDENCE (N - Z),630,2,0,15,195,202,414,16,430,0,O-52-154-01-06-10
WAKISO,BUSIRO CTY EAST,NSANGI(MUKONO),KYENGERA,CAMBRIDGE COLLEGE(N - Z),742,0,1,32,247,161,441,6,447,0,O-52-154-01-06-11
WAKISO,BUSIRO CTY EAST,NSANGI(MUKONO),KYENGERA,KYENGERA CATHOLIC CHURCH (,757,2,1,27,213,169,412,16,428,0,O-52-154-01-06-12
WAKISO,BUSIRO CTY EAST,NSANGI(MUKONO),MAYA,BUJAASI TRADING CENTRE (A - M),436,1,0,13,155,122,291,17,308,0,O-52-154-01-07-01
WAKISO,BUSIRO CTY EAST,NSANGI(MUKONO),MAYA,MAYA P/SCH (NEGAMBIDDA),578,2,0,34,160,219,415,11,426,0,O-52-154-01-07-02
WAKISO,BUSIRO CTY EAST,NSANGI(MUKONO),MAYA,BUJAASI TRADING CENTRE (N - Z,541,4,0,13,124,175,316,4,320,0,O-52-154-01-07-03
WAKISO,BUSIRO CTY EAST,NSANGI(MUKONO),NABBINGO,GALWAGO'S STEN'S PLACE,509,3,0,63,164,117,347,11,358,0,O-52-154-01-08-01
WAKISO,BUSIRO CTY EAST,NSANGI(MUKONO),NABBINGO,MATUTU PRIMARY SCHOOL (A - M,408,0,1,15,176,85,277,6,283,0,O-52-154-01-08-02
WAKISO,BUSIRO CTY EAST,NSANGI(MUKONO),NABBINGO,NABBINGO POLICE POST (KIYANJ,658,1,0,62,171,164,398,9,407,0,O-52-154-01-08-03
WAKISO,BUSIRO CTY EAST,NSANGI(MUKONO),NABBINGO,NABBINGO CATHOLIC CHURCH (K,393,0,1,24,116,103,244,0,244,0,O-52-154-01-08-04
WAKISO,BUSIRO CTY EAST,NSANGI(MUKONO),NABBINGO,NABBINGO KITAWULUZI [TTEGA (,402,0,0,25,120,103,248,3,251,0,O-52-154-01-08-05
WAKISO,BUSIRO CTY EAST,NSANGI(MUKONO),NABBINGO,MATUTU PRIMARY SCHOOL (N - Z),540,2,0,18,177,158,355,7,362,0,O-52-154-01-08-06
WAKISO,BUSIRO CTY EAST,NSANGI(MUKONO),NABBINGO,NABBINGO KITAWULUZI [TTEGA (,569,0,0,25,152,147,324,6,330,0,O-52-154-01-08-07
WAKISO,BUSIRO CTY EAST,NSANGI(MUKONO),NANZIGA,NANZIGA PRIMARY SCHOOL,351,1,1,11,94,110,217,32,249,0,O-52-154-01-09-01
WAKISO,BUSIRO CTY EAST,NSANGI(MUKONO),NANZIGA,KATULAGE T/CENTRE,437,1,2,12,94,182,291,12,303,0,O-52-154-01-09-02
WAKISO,BUSIRO CTY EAST,NSANGI(MUKONO),NANZIGA,TAMBA'S RESIDENCE,245,0,0,1,26,152,179,4,183,0,O-52-154-01-09-03
WAKISO,BUSIRO CTY EAST,NSANGI(MUKONO),NSANGI,MUKONO/KYAMBAZI (NSANGI S/C,751,2,1,54,181,185,423,7,430,0,O-52-154-01-10-01
WAKISO,BUSIRO CTY EAST,NSANGI(MUKONO),NSANGI,SSERUNKUMA BRUNO'S RESIDEN,225,0,0,19,63,72,154,11,165,0,O-52-154-01-10-02
WAKISO,BUSIRO CTY EAST,NSANGI(MUKONO),NSANGI,NSANGI PRIMARY SCHOOL,830,2,0,47,288,199,536,15,551,0,O-52-154-01-10-03
WAKISO,BUSIRO CTY EAST,NSANGI(MUKONO),NSANGI,KYAMBAZI PLAY GROUND,303,0,0,17,92,102,211,7,218,0,O-52-154-01-10-04
WAKISO,BUSIRO CTY EAST,WAKISO,BAKA,BAKKA P/S BULEZA,609,0,0,10,86,307,403,12,415,0,O-52-154-02-01-01
WAKISO,BUSIRO CTY EAST,WAKISO,BAKA,BAKKA P/S KONGOJJE,616,1,0,8,100,313,422,13,435,0,O-52-154-02-01-02
WAKISO,BUSIRO CTY EAST,WAKISO,BAKA,BAKKA P/S BUJJUKO,804,2,1,17,184,374,578,22,600,0,O-52-154-02-01-03
WAKISO,BUSIRO CTY EAST,WAKISO,BBANDA,BBANDA C/U KATUBWE,491,5,1,14,89,216,325,14,339,0,O-52-154-02-02-01
WAKISO,BUSIRO CTY EAST,WAKISO,BBANDA,BBANDA C/U BBANDA,308,1,1,4,70,120,196,31,227,0,O-52-154-02-02-02
WAKISO,BUSIRO CTY EAST,WAKISO,BUKASA,BUKASA MIXED P/SCH,754,4,1,25,244,245,519,13,532,0,O-52-154-02-03-01
WAKISO,BUSIRO CTY EAST,WAKISO,BUKASA,KAWOKO C/U,604,3,1,19,137,249,409,10,419,0,O-52-154-02-03-02
WAKISO,BUSIRO CTY EAST,WAKISO,BUKASA,KANADDA PLAYGROUND BUYERA,737,3,2,25,179,272,481,6,487,0,O-52-154-02-03-03
WAKISO,BUSIRO CTY EAST,WAKISO,BUKASA,KITASA MOSQUE P/S,227,0,0,6,74,83,163,5,168,0,O-52-154-02-03-04
WAKISO,BUSIRO CTY EAST,WAKISO,BULOBA,BWOTANSIMBI P/SCHOOL,570,4,0,24,200,185,413,4,417,0,O-52-154-02-04-01
WAKISO,BUSIRO CTY EAST,WAKISO,BULOBA,BULOBA T/CENTRE,745,1,2,53,228,189,473,11,484,0,O-52-154-02-04-02
WAKISO,BUSIRO CTY EAST,WAKISO,BULOBA,KASERO C/U KIWUMU,886,3,2,35,312,204,556,4,560,0,O-52-154-02-04-03
WAKISO,BUSIRO CTY EAST,WAKISO,BULOBA,KASERO C/U KIRIMAMBOGA,960,5,1,32,314,249,601,17,618,0,O-52-154-02-04-04
WAKISO,BUSIRO CTY EAST,WAKISO,KALIITI,KABABI P/S,643,6,2,10,197,241,456,15,471,0,O-52-154-02-05-01
WAKISO,BUSIRO CTY EAST,WAKISO,KALIITI,NKOWE FULL GOSPEL CHURCH,587,3,0,21,203,176,403,5,408,0,O-52-154-02-05-02
WAKISO,BUSIRO CTY EAST,WAKISO,KALIITI,KITAWULUZI SERINYA,659,1,3,19,226,247,496,3,499,0,O-52-154-02-05-03
WAKISO,BUSIRO CTY EAST,WAKISO,KALIITI,MABOMBWE P/S,271,0,2,6,63,109,180,8,188,0,O-52-154-02-05-04
WAKISO,BUSIRO CTY EAST,WAKISO,KASENGEJJE,KASSENGEJJE P/SCHOOL,618,1,1,48,138,181,369,12,381,0,O-52-154-02-06-01
WAKISO,BUSIRO CTY EAST,WAKISO,KASENGEJJE,KASENGEJJE P/SCHOOL NAJJEMB,277,1,0,12,51,115,179,1,180,0,O-52-154-02-06-02
WAKISO,BUSIRO CTY EAST,WAKISO,KYEBANDO,KYEBANDO UMEA P/SCHOOL,1037,0,4,41,385,243,673,14,687,0,O-52-154-02-07-01
WAKISO,BUSIRO CTY EAST,WAKISO,KYEBANDO,NSUMBI CU (A-M),609,2,0,22,279,125,428,6,434,0,O-52-154-02-07-02
WAKISO,BUSIRO CTY EAST,WAKISO,KYEBANDO,GGANDA (A-M),547,1,0,17,226,121,365,19,384,0,O-52-154-02-07-03
WAKISO,BUSIRO CTY EAST,WAKISO,KYEBANDO,TWAHA MASJID MOSQUE BUJUUK,477,6,0,23,113,161,303,5,308,0,O-52-154-02-07-04
WAKISO,BUSIRO CTY EAST,WAKISO,KYEBANDO,NSUMBI CU(N-Z),834,3,0,33,287,190,513,11,524,0,O-52-154-02-07-05
WAKISO,BUSIRO CTY EAST,WAKISO,KYEBANDO,GGANDA (N-Z),724,3,0,17,246,205,471,11,482,0,O-52-154-02-07-06
WAKISO,BUSIRO CTY EAST,WAKISO,LUKWANGA,LUKWANGA GOOD HOPE P/SCHO,635,1,0,18,148,277,444,14,458,0,O-52-154-02-08-01
WAKISO,BUSIRO CTY EAST,WAKISO,LUKWANGA,NABUKALU SECONDARY SCHOOL,441,2,0,12,81,220,315,10,325,0,O-52-154-02-08-02
WAKISO,BUSIRO CTY EAST,WAKISO,LUKWANGA,GIMBO PRI. SCHOOL,308,3,0,21,72,102,198,1,199,0,O-52-154-02-08-03
WAKISO,BUSIRO CTY EAST,WAKISO,LUKWANGA,KKONA MOSQUE,459,2,4,14,136,196,352,11,363,0,O-52-154-02-08-04
WAKISO,BUSIRO CTY EAST,WAKISO,MENDE,MENDE KALEMA SEC. SCHOOL,437,0,1,7,107,162,277,23,300,0,O-52-154-02-09-01
WAKISO,BUSIRO CTY EAST,WAKISO,MENDE,BBUNGA/SANDA (A-M),300,0,0,4,74,128,206,7,213,0,O-52-154-02-09-02
WAKISO,BUSIRO CTY EAST,WAKISO,MENDE,BULONDO CATHOLIC CHURCH,358,1,0,1,122,149,273,4,277,0,O-52-154-02-09-03
WAKISO,BUSIRO CTY EAST,WAKISO,MENDE,BBUNGA/SANDA (N-Z),461,0,0,5,77,228,310,12,322,0,O-52-154-02-09-04
WAKISO,BUSIRO CTY EAST,WAKISO,NAKABUGO,ST. JAMES BULAGA S.S.S,511,3,0,21,160,98,282,5,287,0,O-52-154-02-10-01
WAKISO,BUSIRO CTY EAST,WAKISO,NAKABUGO,KIREKA T / CENTRE,422,2,0,21,118,139,280,0,280,0,O-52-154-02-10-02
WAKISO,BUSIRO CTY EAST,WAKISO,NAKABUGO,BBERA PRI. SCHOOL,889,2,3,32,262,222,521,7,528,0,O-52-154-02-10-03
WAKISO,BUSIRO CTY EAST,WAKISO,NAKABUGO,NAKAWUDDE SUB-PARISH CATHO,657,3,2,28,203,172,408,13,421,0,O-52-154-02-10-04
WAKISO,BUSIRO CTY EAST,WAKISO,NAKABUGO,BULENGA GOLD MAX S.S.S,651,0,2,18,153,135,308,4,312,0,O-52-154-02-10-05
WAKISO,BUSIRO CTY EAST,WAKISO,NAKABUGO,NAKAWUDDE SUB-PARISH CATHO,952,4,1,42,241,281,569,26,595,0,O-52-154-02-10-06
WAKISO,BUSIRO CTY EAST,WAKISO,NALUVULE,NALUVULE (A-M),730,3,1,8,280,181,473,12,485,0,O-52-154-02-11-01
WAKISO,BUSIRO CTY EAST,WAKISO,NALUVULE,SSENGE,539,1,1,19,137,220,378,15,393,0,O-52-154-02-11-02
WAKISO,BUSIRO CTY EAST,WAKISO,NALUVULE,NALUVULE (N-Z),432,3,1,8,123,102,237,2,239,0,O-52-154-02-11-03
WAKISO,BUSIRO CTY EAST,WAKISO,NAMUSERA,NAMUSERA UMEA BUKASA,333,2,2,3,88,107,202,11,213,0,O-52-154-02-12-01
WAKISO,BUSIRO CTY EAST,WAKISO,NAMUSERA,NAMUSERA UMEA NSEKWA,337,1,0,5,59,172,237,10,247,0,O-52-154-02-12-02
WAKISO,BUSIRO CTY EAST,WAKISO,SUMBWE,SUMBWE P SCH. BULAGA (A-M),387,1,0,16,145,91,253,2,255,0,O-52-154-02-13-01
WAKISO,BUSIRO CTY EAST,WAKISO,SUMBWE,NICARAGUA P/SCH BULENGA (A-M,1041,2,0,31,260,171,464,7,471,0,O-52-154-02-13-02
WAKISO,BUSIRO CTY EAST,WAKISO,SUMBWE,KIKAAYA AUNTIE CISSY NURSERY,602,3,0,25,254,134,416,7,423,0,O-52-154-02-13-03
WAKISO,BUSIRO CTY EAST,WAKISO,SUMBWE,SSUMBWE PRI SCHOOL,783,2,0,27,268,177,474,11,485,0,O-52-154-02-13-04
WAKISO,BUSIRO CTY EAST,WAKISO,SUMBWE,NICARAGUA P/SCH BULENGA (N-Z,681,1,0,24,181,161,367,7,374,0,O-52-154-02-13-05
WAKISO,BUSIRO CTY EAST,WAKISO,SUMBWE,SUMBWE P SCH. BULAGA (N-Z),520,1,0,14,145,143,303,1,304,0,O-52-154-02-13-06
WAKISO,BUSIRO CTY EAST,WAKISO,SUMBWE,KIKAAYA AUNTIE CISSY NURSERY,976,2,1,27,299,260,589,9,598,0,O-52-154-02-13-07
WAKISO,BUSIRO CTY EAST,WAKISO TOWN COUNCIL,WARD A,INTERLECTUAL SEC SCHOOL,622,1,0,14,209,207,431,6,437,0,O-52-154-03-01-01
WAKISO,BUSIRO CTY EAST,WAKISO TOWN COUNCIL,WARD A,NAMUSERA UMEA PR. SCHOOL,612,2,0,22,187,190,401,7,408,0,O-52-154-03-01-02
WAKISO,BUSIRO CTY EAST,WAKISO TOWN COUNCIL,WARD B,WAKISO H/ CENTRE (A-M),807,1,0,15,360,180,556,9,565,0,O-52-154-03-02-01
WAKISO,BUSIRO CTY EAST,WAKISO TOWN COUNCIL,WARD B,WAKISO H/ CENTRE (N-N),835,3,0,13,220,271,507,5,512,0,O-52-154-03-02-02
WAKISO,BUSIRO CTY EAST,WAKISO TOWN COUNCIL,WARD B,KIKIKILO LC 1 OFFICE,622,3,0,7,161,234,405,21,426,0,O-52-154-03-02-03
WAKISO,BUSIRO CTY EAST,WAKISO TOWN COUNCIL,WARD B,WAKISO H/ CENTRE (O-Z),344,1,0,13,138,72,224,6,230,0,O-52-154-03-02-04
WAKISO,BUSIRO CTY EAST,WAKISO TOWN COUNCIL,WARD C,KAYUNGA C UGANDA,642,1,0,12,237,190,440,4,444,0,O-52-154-03-03-01
WAKISO,BUSIRO CTY EAST,WAKISO TOWN COUNCIL,WARD C,GOMBE KAYUNGA P/SCHOOL,725,0,1,19,253,241,514,5,519,0,O-52-154-03-03-02
WAKISO,BUSIRO CTY EAST,WAKISO TOWN COUNCIL,WARD D,KAVUMBA PRIMARY SCHOOL,563,2,0,25,172,210,409,13,422,0,O-52-154-03-04-01
WAKISO,BUSIRO CTY EAST,WAKISO TOWN COUNCIL,WARD D,SSALA,352,2,7,14,114,150,287,10,297,0,O-52-154-03-04-02
WAKISO,BUSIRO CTY EAST,WAKISO TOWN COUNCIL,WARD E,KASANGOMBE KASAWE (A-M),592,1,2,12,219,142,376,8,384,0,O-52-154-03-05-01
WAKISO,BUSIRO CTY EAST,WAKISO TOWN COUNCIL,WARD E,KASANGOMBE KASAWE (N-Z),467,0,0,8,150,132,290,21,311,0,O-52-154-03-05-02
WAKISO,BUSIRO CTY SOUTH,KASANJE,BULUMBU,BUGOGO T.C,359,1,0,14,44,192,251,23,274,0,O-52-156-01-01-01
WAKISO,BUSIRO CTY SOUTH,KASANJE,BULUMBU,BULUMBU T.C,412,0,0,16,67,204,287,14,301,0,O-52-156-01-01-02
WAKISO,BUSIRO CTY SOUTH,KASANJE,BULUMBU,SSUMBA P/SCH,611,0,0,23,66,323,412,15,427,0,O-52-156-01-01-03
WAKISO,BUSIRO CTY SOUTH,KASANJE,BUSSI,KIDAYO DISPENSARY,658,1,3,64,139,226,433,11,444,0,O-52-156-01-02-01
WAKISO,BUSIRO CTY SOUTH,KASANJE,BUSSI,BWANYIISE P/S,541,0,1,40,77,252,370,7,377,0,O-52-156-01-02-02
WAKISO,BUSIRO CTY SOUTH,KASANJE,BUSSI,GOMBE P/SCHOOL,323,0,0,13,44,187,244,6,250,0,O-52-156-01-02-03
WAKISO,BUSIRO CTY SOUTH,KASANJE,BUSSI,GULWE LANDING SITE,576,2,0,13,101,230,346,36,382,0,O-52-156-01-02-04
WAKISO,BUSIRO CTY SOUTH,KASANJE,BUSSI,KINWANTE P/SCH,224,3,0,6,34,108,151,3,154,0,O-52-156-01-02-05
WAKISO,BUSIRO CTY SOUTH,KASANJE,BUSSI,BUGERA P/SCH,483,0,1,15,50,265,331,14,345,0,O-52-156-01-02-06
WAKISO,BUSIRO CTY SOUTH,KASANJE,BUSSI,KAVA LANDING SITE,840,3,2,15,159,164,343,30,373,0,O-52-156-01-02-07
WAKISO,BUSIRO CTY SOUTH,KASANJE,JUNGO,JJUNGO P/SCHOOL,675,2,1,38,156,288,485,26,511,0,O-52-156-01-03-01
WAKISO,BUSIRO CTY SOUTH,KASANJE,JUNGO,SAGALA P/SCHOOL,569,4,0,14,104,307,429,18,447,0,O-52-156-01-03-02
WAKISO,BUSIRO CTY SOUTH,KASANJE,JUNGO,BUVVI P/SCHOOL,592,1,0,10,78,345,434,19,453,0,O-52-156-01-03-03
WAKISO,BUSIRO CTY SOUTH,KASANJE,KASANJE,KASANJE S/C HQTRS,918,1,1,52,218,355,627,10,637,0,O-52-156-01-04-01
WAKISO,BUSIRO CTY SOUTH,KASANJE,KASANJE,KKOBA T.C,397,1,0,28,75,202,306,7,313,0,O-52-156-01-04-02
WAKISO,BUSIRO CTY SOUTH,KASANJE,KASANJE,BUYEGE BOYS P/S,506,1,0,40,95,187,323,14,337,0,O-52-156-01-04-03
WAKISO,BUSIRO CTY SOUTH,KASANJE,KASANJE,BUKALAAZA MOSQUE,242,1,0,11,35,135,182,11,193,0,O-52-156-01-04-04
WAKISO,BUSIRO CTY SOUTH,KASANJE,MAKO,TTABA P/S,347,0,1,7,41,176,225,56,281,0,O-52-156-01-05-01
WAKISO,BUSIRO CTY SOUTH,KASANJE,MAKO,KASAAMU P/SCHOOL,583,0,0,42,130,267,439,3,442,0,O-52-156-01-05-02
WAKISO,BUSIRO CTY SOUTH,KASANJE,SAZI,KIKAAYA T/C,683,6,0,37,224,209,476,12,488,0,O-52-156-01-06-01
WAKISO,BUSIRO CTY SOUTH,KASANJE,SAZI,GAYAZA C.O.U,547,6,0,14,112,234,366,23,389,0,O-52-156-01-06-02
WAKISO,BUSIRO CTY SOUTH,KASANJE,SAZI,ELIPHAL P/S,440,2,0,25,88,155,270,16,286,0,O-52-156-01-06-03
WAKISO,BUSIRO CTY SOUTH,KASANJE,SOKOLO,SOKOLO P/SCHOOL,481,3,0,14,98,244,359,6,365,0,O-52-156-01-07-01
WAKISO,BUSIRO CTY SOUTH,KASANJE,SOKOLO,SOKOLO P/SCHOOL LUWULE,455,0,0,10,104,216,330,5,335,0,O-52-156-01-07-02
WAKISO,BUSIRO CTY SOUTH,KASANJE,SOKOLO,LUWULE T.C,311,0,1,13,56,156,226,10,236,0,O-52-156-01-07-03
WAKISO,BUSIRO CTY SOUTH,KASANJE,SOKOLO,KIKALAALA T/C,155,0,0,14,23,74,111,5,116,0,O-52-156-01-07-04
WAKISO,BUSIRO CTY SOUTH,KASANJE,ZIBA,MABAMBA LANDING SITE,777,1,1,24,106,394,526,20,546,0,O-52-156-01-08-01
WAKISO,BUSIRO CTY SOUTH,KASANJE,ZIBA,NAKASOZI P/SCHOOL,257,0,0,18,50,119,187,4,191,0,O-52-156-01-08-02
WAKISO,BUSIRO CTY SOUTH,KASANJE,ZZINGA,BUKASI LANDING SITE,455,2,1,9,68,187,267,48,315,0,O-52-156-01-09-01
WAKISO,BUSIRO CTY SOUTH,KASANJE,ZZINGA,BALABALA LANDING SITE,268,2,2,0,36,132,172,8,180,0,O-52-156-01-09-02
WAKISO,BUSIRO CTY SOUTH,KASANJE,ZZINGA,BUGANGA LANDING SITE,705,1,1,4,113,267,386,8,394,0,O-52-156-01-09-03
WAKISO,BUSIRO CTY SOUTH,KASANJE,ZZINGA,KOJJA LANDING SITE,212,1,0,1,34,95,131,19,150,0,O-52-156-01-09-04
WAKISO,BUSIRO CTY SOUTH,KATABI,KABAALE,ST. JUDE KELEZIA P/S,847,3,3,43,312,166,527,9,536,0,O-52-156-02-01-01
WAKISO,BUSIRO CTY SOUTH,KATABI,KABAALE,KABALE C.O.U,672,4,1,36,191,185,417,9,426,0,O-52-156-02-01-02
WAKISO,BUSIRO CTY SOUTH,KATABI,KABAALE,KASOONS S.S KAWAFU,615,5,1,28,231,166,431,4,435,0,O-52-156-02-01-03
WAKISO,BUSIRO CTY SOUTH,KATABI,KABAALE,ENTEBBE UMEA P/S A-L KITUBULU,746,3,2,8,301,177,491,10,501,0,O-52-156-02-01-04
WAKISO,BUSIRO CTY SOUTH,KATABI,KABAALE,ENTEBBE UMEA BUNONO P/S,1170,4,1,51,345,298,699,16,715,0,O-52-156-02-01-05
WAKISO,BUSIRO CTY SOUTH,KATABI,KABAALE,ENTEBBE UMEA P/S KITUBULU N-,620,0,1,12,197,153,363,8,371,0,O-52-156-02-01-06
WAKISO,BUSIRO CTY SOUTH,KATABI,KABAALE,KABAALE A (N-Z),609,2,2,33,200,139,376,9,385,0,O-52-156-02-01-07
WAKISO,BUSIRO CTY SOUTH,KATABI,KABAALE,KAWAFU (N-Z),665,2,0,28,221,164,415,12,427,0,O-52-156-02-01-08
WAKISO,BUSIRO CTY SOUTH,KATABI,KISUBI,MAPEERA P/S A,1600,2,0,64,348,364,778,11,789,0,O-52-156-02-02-01
WAKISO,BUSIRO CTY SOUTH,KATABI,KISUBI,MAPEERA P/S B,696,0,0,44,174,197,415,12,427,0,O-52-156-02-02-02
WAKISO,BUSIRO CTY SOUTH,KATABI,KISUBI,MAPEERA P/S C,691,1,0,32,166,165,364,5,369,0,O-52-156-02-02-03
WAKISO,BUSIRO CTY SOUTH,KATABI,KISUBI,BUGIRI/BUKASA PLAY GROUND,950,1,4,29,140,363,537,13,550,0,O-52-156-02-02-04
WAKISO,BUSIRO CTY SOUTH,KATABI,KISUBI,KIWULWE PLAY GROUND,742,2,0,34,170,242,448,7,455,0,O-52-156-02-02-05
WAKISO,BUSIRO CTY SOUTH,KATABI,KISUBI,BWERENGA RADIO STATION,798,3,1,15,157,296,472,27,499,0,O-52-156-02-02-06
WAKISO,BUSIRO CTY SOUTH,KATABI,KISUBI,NAMUGONDE P/S KAKINDU,896,6,2,39,179,374,600,24,624,0,O-52-156-02-02-07
WAKISO,BUSIRO CTY SOUTH,KATABI,KISUBI,SEBUGWAWO HALL COMPOUND,1120,2,1,109,288,199,599,36,635,0,O-52-156-02-02-08
WAKISO,BUSIRO CTY SOUTH,KATABI,KISUBI,KISUBI A (N-Z),557,1,0,33,96,157,287,5,292,0,O-52-156-02-02-09
WAKISO,BUSIRO CTY SOUTH,KATABI,KISUBI,KISUBI C (N-Z),502,2,0,21,89,146,258,4,262,0,O-52-156-02-02-10
WAKISO,BUSIRO CTY SOUTH,KATABI,KISUBI,BWERENGA (N-Z),428,2,1,6,47,178,234,13,247,0,O-52-156-02-02-11
WAKISO,BUSIRO CTY SOUTH,KATABI,KITALA,KITALA P/S A (A-M),540,2,0,37,140,111,290,9,299,0,O-52-156-02-03-01
WAKISO,BUSIRO CTY SOUTH,KATABI,KITALA,KITALA P/S B (A-M),440,1,1,36,130,116,284,2,286,0,O-52-156-02-03-02
WAKISO,BUSIRO CTY SOUTH,KATABI,KITALA,KITALA P/S C (A-M),577,0,1,41,186,140,368,3,371,0,O-52-156-02-03-03
WAKISO,BUSIRO CTY SOUTH,KATABI,KITALA,LYAMUTUNDWE (A-M),647,0,2,29,237,183,451,3,454,0,O-52-156-02-03-04
WAKISO,BUSIRO CTY SOUTH,KATABI,KITALA,MPALA P/S (A-M),590,4,0,55,240,132,431,8,439,0,O-52-156-02-03-05
WAKISO,BUSIRO CTY SOUTH,KATABI,KITALA,KITALA P/S A (N-Z),798,3,1,53,169,160,386,16,402,0,O-52-156-02-03-06
WAKISO,BUSIRO CTY SOUTH,KATABI,KITALA,KITALA P/S B (N-Z),532,1,2,28,144,144,319,4,323,0,O-52-156-02-03-07
WAKISO,BUSIRO CTY SOUTH,KATABI,KITALA,KITALA P/S C (N-Z),740,0,1,40,181,188,410,12,422,0,O-52-156-02-03-08
WAKISO,BUSIRO CTY SOUTH,KATABI,KITALA,MPALA P/S (N-Z),712,9,0,50,223,191,473,9,482,0,O-52-156-02-03-09
WAKISO,BUSIRO CTY SOUTH,KATABI,KITALA,LYAMUTUNDWE (N-Z),669,3,0,32,220,176,431,4,435,0,O-52-156-02-03-10
WAKISO,BUSIRO CTY SOUTH,KATABI,NALUGALA,NALUGALA CATHOLIC CHURCH,388,3,0,41,138,80,262,6,268,0,O-52-156-02-04-01
WAKISO,BUSIRO CTY SOUTH,KATABI,NALUGALA,SINDE P/S BUGABO,682,2,0,75,172,210,459,5,464,0,O-52-156-02-04-02
WAKISO,BUSIRO CTY SOUTH,KATABI,NALUGALA,GERENGE PLAY GROUND BULEG,660,1,2,28,165,128,324,9,333,0,O-52-156-02-04-03
WAKISO,BUSIRO CTY SOUTH,KATABI,NALUGALA,BULEGA P/S B,610,0,2,33,152,160,347,10,357,0,O-52-156-02-04-04
WAKISO,BUSIRO CTY SOUTH,KATABI,NALUGALA,NALUGALA CATHOLIC CHURCH (N,537,1,2,59,160,123,345,10,355,0,O-52-156-02-04-05
WAKISO,BUSIRO CTY SOUTH,KATABI,NALUGALA,GERENGE PLAY GROUND (N-Z),774,2,1,33,141,179,356,19,375,0,O-52-156-02-04-06
WAKISO,BUSIRO CTY SOUTH,KATABI,NKUMBA,ABAITA T.C A,1099,1,0,48,334,214,597,6,603,0,O-52-156-02-05-01
WAKISO,BUSIRO CTY SOUTH,KATABI,NKUMBA,ABAITA T.C B,783,2,1,30,276,161,470,7,477,0,O-52-156-02-05-02
WAKISO,BUSIRO CTY SOUTH,KATABI,NKUMBA,KITINDA C.O.U,657,3,2,24,195,176,400,11,411,0,O-52-156-02-05-03
WAKISO,BUSIRO CTY SOUTH,KATABI,NKUMBA,DIVINE P/S A,1116,6,0,36,337,323,702,11,713,0,O-52-156-02-05-04
WAKISO,BUSIRO CTY SOUTH,KATABI,NKUMBA,DIVINE P/S B,827,5,2,39,204,239,489,9,498,0,O-52-156-02-05-05
WAKISO,BUSIRO CTY SOUTH,KATABI,NKUMBA,KIGERO P/S (A-M),519,2,0,15,119,128,264,7,271,0,O-52-156-02-05-06
WAKISO,BUSIRO CTY SOUTH,KATABI,NKUMBA,KITAWULUZI (BUFULA A),963,4,1,42,245,277,569,23,592,0,O-52-156-02-05-07
WAKISO,BUSIRO CTY SOUTH,KATABI,NKUMBA,KIGERO P/S (BUFULA B),515,2,1,16,102,171,292,1,293,0,O-52-156-02-05-08
WAKISO,BUSIRO CTY SOUTH,KATABI,NKUMBA,NKUMBA P/S BUKOLWA,959,3,1,45,273,283,605,6,611,0,O-52-156-02-05-09
WAKISO,BUSIRO CTY SOUTH,KATABI,NKUMBA,ABAITA T.C B (M-NAL),769,3,2,25,216,177,423,5,428,0,O-52-156-02-05-10
WAKISO,BUSIRO CTY SOUTH,KATABI,NKUMBA,ABAITA T.C (NAM - Z),900,3,1,29,291,152,476,3,479,0,O-52-156-02-05-11
WAKISO,BUSIRO CTY SOUTH,KATABI,NKUMBA,KIGERO P/S (N-Z),785,2,1,23,119,201,346,8,354,0,O-52-156-02-05-12
WAKISO,BUSIRO CTY SOUTH,KATABI,NKUMBA,NKUMBA UNIVERSITY,609,6,0,6,197,188,397,5,402,0,O-52-156-02-05-13
WAKISO,BUSIRO CTY SOUTH,KATABI,NKUMBA,KASENYI OUTSIDE Q. GUARD,375,1,0,1,11,336,349,3,352,0,O-52-156-02-05-14
WAKISO,BUSIRO CTY SOUTH,SSISA,BULWANYI,BULWANYI T.C,305,0,0,5,69,152,226,6,232,0,O-52-156-03-01-01
WAKISO,BUSIRO CTY SOUTH,SSISA,BULWANYI,BULWANYI T.C KAAMA/LUKOSE,500,0,0,20,87,272,379,9,388,0,O-52-156-03-01-02
WAKISO,BUSIRO CTY SOUTH,SSISA,BWEYA,BWEYA MOSLEM P/S,636,2,1,34,185,206,428,3,431,0,O-52-156-03-02-01
WAKISO,BUSIRO CTY SOUTH,SSISA,BWEYA,BWEYA MOSLEM P/S BULONDE,522,2,0,18,168,184,372,4,376,0,O-52-156-03-02-02
WAKISO,BUSIRO CTY SOUTH,SSISA,BWEYA,KITENDE (A-M),755,1,0,31,299,139,470,10,480,0,O-52-156-03-02-03
WAKISO,BUSIRO CTY SOUTH,SSISA,BWEYA,JJANJI PLAY GROUND,645,2,2,25,207,142,378,11,389,0,O-52-156-03-02-04
WAKISO,BUSIRO CTY SOUTH,SSISA,BWEYA,KITENDE (N-Z),892,4,2,34,261,185,486,18,504,0,O-52-156-03-02-05
WAKISO,BUSIRO CTY SOUTH,SSISA,BWEYA,JJANYI P/S (N-Z),372,2,0,15,87,109,213,8,221,0,O-52-156-03-02-06
WAKISO,BUSIRO CTY SOUTH,SSISA,KITENDE,KAJJANSI PLAY GROUND,950,1,0,29,189,255,474,6,480,0,O-52-156-03-03-01
WAKISO,BUSIRO CTY SOUTH,SSISA,KITENDE,MUWANA P/S KAWOTTO A,1488,2,0,49,319,317,687,0,687,0,O-52-156-03-03-02
WAKISO,BUSIRO CTY SOUTH,SSISA,KITENDE,NSAMBU'S PLACE KAJJANSI B,636,1,0,28,194,137,360,2,362,0,O-52-156-03-03-03
WAKISO,BUSIRO CTY SOUTH,SSISA,KITENDE,KAJJANSI DISPENSARY,453,0,2,21,147,103,273,2,275,0,O-52-156-03-03-04
WAKISO,BUSIRO CTY SOUTH,SSISA,KITENDE,FAITH TRUST P/S KAWOTTO B,835,3,3,34,228,184,452,0,452,0,O-52-156-03-03-05
WAKISO,BUSIRO CTY SOUTH,SSISA,KITENDE,FAITH TRUST P/S KAWOTTO C,489,0,0,24,99,120,243,3,246,0,O-52-156-03-03-06
WAKISO,BUSIRO CTY SOUTH,SSISA,KITENDE,KITENDE P.S A,1281,2,3,55,340,289,689,9,698,0,O-52-156-03-03-07
WAKISO,BUSIRO CTY SOUTH,SSISA,KITENDE,KITENDE COMMUNITY CENTRE,1235,3,2,63,401,295,764,16,780,0,O-52-156-03-03-08
WAKISO,BUSIRO CTY SOUTH,SSISA,KITENDE,TUZUKUKE P.S.,499,1,1,49,101,210,362,3,365,0,O-52-156-03-03-09
WAKISO,BUSIRO CTY SOUTH,SSISA,KITENDE,MUKWAYA MEMORIAL,825,1,8,24,137,370,540,14,554,0,O-52-156-03-03-10
WAKISO,BUSIRO CTY SOUTH,SSISA,NAKAWUKA,KATWE SQUARE,417,1,4,40,78,163,286,0,286,0,O-52-156-03-04-01
WAKISO,BUSIRO CTY SOUTH,SSISA,NAKAWUKA,NAKAWUKA PLAYGROUND (A-M),532,1,1,16,131,215,364,4,368,0,O-52-156-03-04-02
WAKISO,BUSIRO CTY SOUTH,SSISA,NAKAWUKA,MPUMUDDE HEALTH CENTRE,698,4,1,24,138,349,516,20,536,0,O-52-156-03-04-03
WAKISO,BUSIRO CTY SOUTH,SSISA,NAKAWUKA,NAKAWUKA PLAYGROUND (N-Z),856,0,1,21,146,424,592,10,602,0,O-52-156-03-04-04
WAKISO,BUSIRO CTY SOUTH,SSISA,NAMULANDA,NAMULANDA A LC I MEETING PLA,876,4,0,42,284,206,536,4,540,0,O-52-156-03-05-01
WAKISO,BUSIRO CTY SOUTH,SSISA,NAMULANDA,NAMULANDA C LC I MEETING PLA,874,6,1,82,259,207,555,6,561,0,O-52-156-03-05-02
WAKISO,BUSIRO CTY SOUTH,SSISA,NAMULANDA,SEKIWUNGA T.C,375,1,2,30,82,139,254,0,254,0,O-52-156-03-05-03
WAKISO,BUSIRO CTY SOUTH,SSISA,NAMULANDA,BUZZI,552,2,0,55,162,168,387,17,404,0,O-52-156-03-05-04
WAKISO,BUSIRO CTY SOUTH,SSISA,NAMULANDA,NGANJO T.C,337,3,0,31,95,95,224,3,227,0,O-52-156-03-05-05
WAKISO,BUSIRO CTY SOUTH,SSISA,NAMULANDA,NAMULANDA B LC I MEETING PLA,638,0,0,39,206,137,382,7,389,0,O-52-156-03-05-06
WAKISO,BUSIRO CTY SOUTH,SSISA,NAMULANDA,NAMULANDA B LC I MEETING PLA,835,1,0,35,200,236,472,13,485,0,O-52-156-03-05-07
WAKISO,BUSIRO CTY SOUTH,SSISA,NANKONGE,NANKONGE P/S,401,2,1,23,66,231,323,4,327,0,O-52-156-03-06-01
WAKISO,BUSIRO CTY SOUTH,SSISA,NANKONGE,BUTTAKESU PLAY GROUND,348,2,0,7,84,178,271,4,275,0,O-52-156-03-06-02
WAKISO,BUSIRO CTY SOUTH,SSISA,NGONGOLO,NGONGOLO T.C,666,1,1,19,115,299,435,0,435,0,O-52-156-03-07-01
WAKISO,BUSIRO CTY SOUTH,SSISA,NGONGOLO,SSANDA P/S,464,1,1,19,88,225,334,5,339,0,O-52-156-03-07-02
WAKISO,BUSIRO CTY SOUTH,SSISA,NKUNGULUTALE,NKUNGULUTALE,377,2,1,23,82,157,265,4,269,0,O-52-156-03-08-01
WAKISO,BUSIRO CTY SOUTH,SSISA,NKUNGULUTALE,NAKIGALALA T.C,490,0,0,5,61,267,333,14,347,0,O-52-156-03-08-02
WAKISO,BUSIRO CTY SOUTH,SSISA,NKUNGULUTALE,MUNKABIRA (N-Z),382,1,0,19,47,177,244,4,248,0,O-52-156-03-08-03
WAKISO,BUSIRO CTY SOUTH,SSISA,NSANGU,NSAGU T.C,762,3,1,61,124,395,584,4,588,0,O-52-156-03-09-01
WAKISO,BUSIRO CTY SOUTH,SSISA,NSANGU,BUTENGA T.C,238,0,0,9,36,145,190,3,193,0,O-52-156-03-09-02
WAKISO,BUSIRO CTY SOUTH,SSISA,NSANGU,SSISA S/C HQRS,660,7,2,32,163,296,500,15,515,0,O-52-156-03-09-03
WAKISO,BUSIRO CTY SOUTH,SSISA,NSANGU,SSISA P/S,451,3,0,41,118,195,357,12,369,0,O-52-156-03-09-04
WAKISO,BUSIRO CTY SOUTH,SSISA,WAMALA,ZZIRU P/S,695,0,0,75,208,266,549,28,577,0,O-52-156-03-10-01
WAKISO,BUSIRO NORTH,KAKIRI,BUWANUKA,KIKUGI T CENTRE,555,0,2,10,99,217,328,11,339,0,O-52-155-01-01-01
WAKISO,BUSIRO NORTH,KAKIRI,BUWANUKA,NAGGULU P/SCHOOL,631,2,0,5,30,408,445,11,456,0,O-52-155-01-01-02
WAKISO,BUSIRO NORTH,KAKIRI,BUWANUKA,BUWANUKA P.SCHOOL,367,0,1,4,33,207,245,11,256,0,O-52-155-01-01-03
WAKISO,BUSIRO NORTH,KAKIRI,BUWANUKA,KABAGEZI P.SCHOOL,156,0,0,0,14,118,132,3,135,0,O-52-155-01-01-04
WAKISO,BUSIRO NORTH,KAKIRI,KAKIRI,KAKIRI I (A-M),685,2,1,11,158,182,354,6,360,0,O-52-155-01-02-01
WAKISO,BUSIRO NORTH,KAKIRI,KAKIRI,KAKIRI II (A-M),819,3,1,7,207,133,351,1,352,0,O-52-155-01-02-02
WAKISO,BUSIRO NORTH,KAKIRI,KAKIRI,BUKALANGO PLAY GROUND P/S,668,2,1,29,111,261,404,12,416,0,O-52-155-01-02-03
WAKISO,BUSIRO NORTH,KAKIRI,KAKIRI,LUGEYE PLAY GROUND,203,0,1,3,18,115,137,0,137,0,O-52-155-01-02-04
WAKISO,BUSIRO NORTH,KAKIRI,KAKIRI,KAKIRI I (N-Z),856,3,1,9,167,242,422,11,433,0,O-52-155-01-02-05
WAKISO,BUSIRO NORTH,KAKIRI,KAKIRI,KAKIRI II (N-Z),824,2,1,3,161,205,372,8,380,0,O-52-155-01-02-06
WAKISO,BUSIRO NORTH,KAKIRI,KAMULI,KAMULI P/SCHOOL,472,2,1,10,92,177,282,6,288,0,O-52-155-01-03-01
WAKISO,BUSIRO NORTH,KAKIRI,KAMULI,DDAMBWE T/CENTRE,305,1,0,9,74,119,203,19,222,0,O-52-155-01-03-02
WAKISO,BUSIRO NORTH,KAKIRI,KIKANDWA,KIKANDWA PRI SCHOOL,601,4,0,14,62,184,264,73,337,0,O-52-155-01-04-01
WAKISO,BUSIRO NORTH,KAKIRI,KIKANDWA,BUKEREKERE T/CENTRE,539,1,1,37,125,144,308,10,318,0,O-52-155-01-04-02
WAKISO,BUSIRO NORTH,KAKIRI,KIKANDWA,MWERA T/CENTRE,535,1,1,9,65,178,254,21,275,0,O-52-155-01-04-03
WAKISO,BUSIRO NORTH,KAKIRI,LUBBE,LUBBE/WAGABA,779,4,2,14,106,397,523,16,539,0,O-52-155-01-05-01
WAKISO,BUSIRO NORTH,KAKIRI,LUWUNGA,KIBUYE T/CENTRE,376,3,1,2,45,234,285,6,291,0,O-52-155-01-06-01
WAKISO,BUSIRO NORTH,KAKIRI,LUWUNGA,LUWUNGA T/CENTRE,663,2,0,24,64,266,356,57,413,0,O-52-155-01-06-02
WAKISO,BUSIRO NORTH,KAKIRI,LUWUNGA,LUWUNGA OUTSIDE Q.GUARD (A-,1021,1,1,1,95,394,492,12,504,0,O-52-155-01-06-03
WAKISO,BUSIRO NORTH,KAKIRI,LUWUNGA,LUWUNGA OUTSIDE Q.GUARD (N-,656,1,2,1,100,267,371,10,381,0,O-52-155-01-06-04
WAKISO,BUSIRO NORTH,KAKIRI,MAGOGGO,MAGOGGO T/C,683,1,3,22,87,373,486,3,489,0,O-52-155-01-07-01
WAKISO,BUSIRO NORTH,KAKIRI,MAGOGGO,KIRUGANGA P/S,478,0,1,9,122,214,346,5,351,0,O-52-155-01-07-02
WAKISO,BUSIRO NORTH,KAKIRI,MAGOGGO,KYEGOBO T/CENTRE,624,3,1,6,57,382,449,18,467,0,O-52-155-01-07-03
WAKISO,BUSIRO NORTH,KAKIRI,NAKYERONGOSA,NAKYERONGOSA INFANT SCHOO,753,2,0,23,163,271,459,11,470,0,O-52-155-01-08-01
WAKISO,BUSIRO NORTH,KAKIRI,NAKYERONGOSA,BUSUJJA CHURCH,538,1,0,11,85,225,322,15,337,0,O-52-155-01-08-02
WAKISO,BUSIRO NORTH,KAKIRI,NAMPUNGE,KATITI/GOBERO,753,6,2,16,109,366,499,28,527,0,O-52-155-01-09-01
WAKISO,BUSIRO NORTH,KAKIRI,NAMPUNGE,NAMPUNGE T/C,681,3,0,10,130,284,427,11,438,0,O-52-155-01-09-02
WAKISO,BUSIRO NORTH,KAKIRI,SENTEMA,SENTEMA SAZA HQTRS,495,4,1,15,96,189,305,32,337,0,O-52-155-01-10-01
WAKISO,BUSIRO NORTH,KAKIRI,SENTEMA,KAKOOGE P/SCHOOL,643,1,1,10,109,293,414,0,414,0,O-52-155-01-10-02
WAKISO,BUSIRO NORTH,KAKIRI,SENTEMA,GAYAZA PENTECOSTAL CHURCH,517,2,0,5,82,257,346,31,377,0,O-52-155-01-10-03
WAKISO,BUSIRO NORTH,KIZIBA(MASULIITA),BBALE,BBAALE MUKWENDA PRIMARY SC,433,3,1,8,83,216,311,4,315,0,O-52-155-02-01-01
WAKISO,BUSIRO NORTH,KIZIBA(MASULIITA),BBALE,WOLOLO NALUMOSO'S HOME,160,1,1,9,14,78,103,4,107,0,O-52-155-02-01-02
WAKISO,BUSIRO NORTH,KIZIBA(MASULIITA),BBIKKA,KABAALE PRIMARY SCHOOL,436,1,0,6,62,250,319,7,326,0,O-52-155-02-02-01
WAKISO,BUSIRO NORTH,KIZIBA(MASULIITA),BBIKKA,KABAALE PRIMARY SCHOOL BBIK,407,3,3,7,93,140,246,7,253,0,O-52-155-02-02-02
WAKISO,BUSIRO NORTH,KIZIBA(MASULIITA),KANZIZE,KANZIZE PRIMARY SCHOOL,745,4,1,11,107,369,492,22,514,0,O-52-155-02-03-01
WAKISO,BUSIRO NORTH,KIZIBA(MASULIITA),KANZIZE,KALONGERO JUNIOR SCHOOL,291,1,1,2,27,168,199,7,206,0,O-52-155-02-03-02
WAKISO,BUSIRO NORTH,KIZIBA(MASULIITA),KATIKAMU,NABALANGA AID POST,209,0,1,7,18,126,152,7,159,0,O-52-155-02-04-01
WAKISO,BUSIRO NORTH,KIZIBA(MASULIITA),KATIKAMU,JOMBA,308,2,0,11,17,218,248,12,260,0,O-52-155-02-04-02
WAKISO,BUSIRO NORTH,KIZIBA(MASULIITA),KATIKAMU,KATIKAMU PLAY GROUND,546,0,0,11,64,176,251,7,258,0,O-52-155-02-04-03
WAKISO,BUSIRO NORTH,KIZIBA(MASULIITA),KYENGEZA,KASUDDE PRIMAY SCHOOL,481,0,1,7,130,190,328,14,342,0,O-52-155-02-05-01
WAKISO,BUSIRO NORTH,KIZIBA(MASULIITA),KYENGEZA,SSEGGANGA PRIMARY SCHOOL,459,3,0,2,74,235,314,22,336,0,O-52-155-02-05-02
WAKISO,BUSIRO NORTH,KIZIBA(MASULIITA),LUGUNGUDE,LUGUNGUDDE TRADING CENTRE,573,2,0,13,50,338,403,18,421,0,O-52-155-02-06-01
WAKISO,BUSIRO NORTH,KIZIBA(MASULIITA),LWEMWEDDE,LWEMWEDDE TRADING CENTRE,608,2,1,39,117,244,403,9,412,0,O-52-155-02-07-01
WAKISO,BUSIRO NORTH,KIZIBA(MASULIITA),MASULIITA,MASULITA S/COUNTY HQTRS,685,14,1,14,121,278,428,0,428,0,O-52-155-02-08-01
WAKISO,BUSIRO NORTH,KIZIBA(MASULIITA),MASULIITA,MASUULITA COMMUNITY CENTRE,627,7,5,44,99,288,443,9,452,0,O-52-155-02-08-02
WAKISO,BUSIRO NORTH,KIZIBA(MASULIITA),MASULIITA,MASULITA TOWN,448,3,0,14,70,175,262,6,268,0,O-52-155-02-08-03
WAKISO,BUSIRO NORTH,KIZIBA(MASULIITA),MMANZE,MMANZE PRIMARY SCHOOL,527,4,1,11,64,282,362,9,371,0,O-52-155-02-09-01
WAKISO,BUSIRO NORTH,KIZIBA(MASULIITA),NAKIKUNGUBE,NAKIKUNGUBE PRIMARY SCHOOL,451,0,1,28,71,178,278,5,283,0,O-52-155-02-10-01
WAKISO,BUSIRO NORTH,KIZIBA(MASULIITA),TTUMBALI,TTUMBALI PLAYGROUND,390,1,0,31,66,163,261,8,269,0,O-52-155-02-11-01
WAKISO,BUSIRO NORTH,NAMAYUMBA,BBEMBE,BBEMBE PRI SCHOOL,530,1,0,10,45,247,303,45,348,0,O-52-155-03-01-01
WAKISO,BUSIRO NORTH,NAMAYUMBA,BBEMBE,MPANGA T/CENTRE,361,1,1,12,61,167,242,18,260,0,O-52-155-03-01-02
WAKISO,BUSIRO NORTH,NAMAYUMBA,BBEMBE,KIBUJJO T/CENTRE,472,0,0,5,38,296,339,11,350,0,O-52-155-03-01-03
WAKISO,BUSIRO NORTH,NAMAYUMBA,BUKONDO,KATUUSO P/SCHOOL,421,4,0,2,42,236,284,18,302,0,O-52-155-03-02-01
WAKISO,BUSIRO NORTH,NAMAYUMBA,BUKONDO,BUKONDO P/SCHOOL,528,3,0,5,75,241,324,11,335,0,O-52-155-03-02-02
WAKISO,BUSIRO NORTH,NAMAYUMBA,KANZIRO,BUGIMBA P/SCHOOL,459,0,0,4,21,266,291,59,350,0,O-52-155-03-03-01
WAKISO,BUSIRO NORTH,NAMAYUMBA,KANZIRO,KANZIRO LATE KINAGOMBA,328,1,0,1,36,163,201,15,216,0,O-52-155-03-03-02
WAKISO,BUSIRO NORTH,NAMAYUMBA,KITAYITA,NAKITOKOLO T/CENTRE,628,1,1,4,63,329,398,18,416,0,O-52-155-03-04-01
WAKISO,BUSIRO NORTH,NAMAYUMBA,KITAYITA,BUWEMBO PRIMARY SCHOOL,410,2,3,5,17,211,238,20,258,0,O-52-155-03-04-02
WAKISO,BUSIRO NORTH,NAMAYUMBA,KITAYITA,KITAYITA C/U,204,1,0,0,8,118,127,6,133,0,O-52-155-03-04-03
WAKISO,BUSIRO NORTH,NAMAYUMBA,KYAMPISI,KYAMPISI P/SCHOOL,551,5,2,12,95,246,360,8,368,0,O-52-155-03-05-01
WAKISO,BUSIRO NORTH,NAMAYUMBA,KYAMPISI,KYAMPISI P/SCHOOL MABANGA,307,0,0,2,25,179,206,12,218,0,O-52-155-03-05-02
WAKISO,BUSIRO NORTH,NAMAYUMBA,KYANUNA,KITULA T/CENTRE,546,1,0,13,71,243,328,9,337,0,O-52-155-03-06-01
WAKISO,BUSIRO NORTH,NAMAYUMBA,KYANUNA,NAGGULU P/S,588,1,1,10,91,307,410,20,430,0,O-52-155-03-06-02
WAKISO,BUSIRO NORTH,NAMAYUMBA,KYANUNA,KYANUNA KITAWULUZI,432,1,1,6,87,190,285,9,294,0,O-52-155-03-06-03
WAKISO,BUSIRO NORTH,NAMAYUMBA,KYASA,KYASA T/CENTRE,710,4,1,5,91,314,415,14,429,0,O-52-155-03-07-01
WAKISO,BUSIRO NORTH,NAMAYUMBA,KYASA,GANGAMA T/CENTRE,510,6,0,2,36,254,298,22,320,0,O-52-155-03-07-02
WAKISO,BUSIRO NORTH,NAMAYUMBA,LUGUZI,NAMAYUMBA S/C HQTRS,442,2,0,3,58,205,268,5,273,0,O-52-155-03-08-01
WAKISO,BUSIRO NORTH,NAMAYUMBA,LUGUZI,BANANYWA P/SCHOOL,456,0,0,4,60,208,272,12,284,0,O-52-155-03-08-02
WAKISO,BUSIRO NORTH,NAMAYUMBA,LUGUZI,BUDAALI T/C,727,3,1,17,113,285,419,9,428,0,O-52-155-03-08-03
WAKISO,BUSIRO NORTH,NAMAYUMBA,LUTTISI,LUTISI STORES,345,1,0,4,62,194,261,5,266,0,O-52-155-03-09-01
WAKISO,BUSIRO NORTH,NAMAYUMBA,LUTTISI,LUTISI STORE BASAKU,302,0,0,0,61,148,209,9,218,0,O-52-155-03-09-02
WAKISO,BUSIRO NORTH,NAMAYUMBA,NAKEDDE,NAKEDDE P/SCHOOL,563,0,3,2,31,364,400,11,411,0,O-52-155-03-10-01
WAKISO,ENTEBBE MUNICIPALITY,DIVISION A,CENTRAL,LAKE VICTORIA P/S KAKEEKA,717,5,6,13,187,248,459,4,463,0,O-52-164-01-01-01
WAKISO,ENTEBBE MUNICIPALITY,DIVISION A,CENTRAL,BANGA NAKIWOGO LC I,803,0,0,25,164,234,423,4,427,0,O-52-164-01-01-02
WAKISO,ENTEBBE MUNICIPALITY,DIVISION A,CENTRAL,NSAMIZI SUB WARD/POST OFFICE,824,6,7,8,245,195,461,8,469,0,O-52-164-01-01-03
WAKISO,ENTEBBE MUNICIPALITY,DIVISION A,CENTRAL,POST OFFICE II/CHILDRENS' PAR,951,6,3,13,268,194,484,50,534,0,O-52-164-01-01-04
WAKISO,ENTEBBE MUNICIPALITY,DIVISION A,CENTRAL,VIRUS INSTITUTE,779,8,0,22,220,205,455,77,532,0,O-52-164-01-01-05
WAKISO,ENTEBBE MUNICIPALITY,DIVISION A,CENTRAL,BUGONGA BOYS P/S I,721,1,1,34,229,185,450,8,458,0,O-52-164-01-01-06
WAKISO,ENTEBBE MUNICIPALITY,DIVISION A,CENTRAL,BUGONGA BOYS P/S II,583,1,0,19,188,126,334,26,360,0,O-52-164-01-01-07
WAKISO,ENTEBBE MUNICIPALITY,DIVISION A,CENTRAL,L.VICTORIA P/S NAKASAMBA,715,2,0,3,186,222,413,5,418,0,O-52-164-01-01-08
WAKISO,ENTEBBE MUNICIPALITY,DIVISION A,CENTRAL,KAKEEKA PLAY GROUND NSAMIZI,649,0,2,12,170,191,375,12,387,0,O-52-164-01-01-09
WAKISO,ENTEBBE MUNICIPALITY,DIVISION A,CENTRAL,NAMATE P/S LUNYU,1014,6,2,12,257,230,507,91,598,0,O-52-164-01-01-10
WAKISO,ENTEBBE MUNICIPALITY,DIVISION A,CENTRAL,POLICE PLAY GROUND LUNYU,632,2,2,14,196,177,391,9,400,0,O-52-164-01-01-11
WAKISO,ENTEBBE MUNICIPALITY,DIVISION A,CENTRAL,NAMATE P/S N-Z,728,7,1,13,192,155,368,54,422,0,O-52-164-01-01-12
WAKISO,ENTEBBE MUNICIPALITY,DIVISION A,CENTRAL,BANGA PLAY GROUND,599,2,1,15,99,172,289,68,357,0,O-52-164-01-01-13
WAKISO,ENTEBBE MUNICIPALITY,DIVISION A,CENTRAL,L.VICTORIA P/S NAKASAMBA,417,1,1,10,101,128,241,4,245,0,O-52-164-01-01-14
WAKISO,ENTEBBE MUNICIPALITY,DIVISION A,CENTRAL,POLICE PLAY GROUND LUNYU,345,3,0,7,82,100,192,33,225,0,O-52-164-01-01-15
WAKISO,ENTEBBE MUNICIPALITY,DIVISION A,CENTRAL,KAKEEKA PLAY GROUND (A-BUW),737,1,4,1,54,395,455,10,465,0,O-52-164-01-01-16
WAKISO,ENTEBBE MUNICIPALITY,DIVISION A,CENTRAL,KAKEEKA PLAY GROUND (BUY-KI,760,4,0,2,57,367,430,11,441,0,O-52-164-01-01-17
WAKISO,ENTEBBE MUNICIPALITY,DIVISION A,CENTRAL,KAKEEKA PLAY GROUND (KIT-MU,716,1,0,0,40,336,377,17,394,0,O-52-164-01-01-18
WAKISO,ENTEBBE MUNICIPALITY,DIVISION A,CENTRAL,KAKEEKA PLAY GROUND (MUT-OI,763,3,0,3,54,349,409,1,410,0,O-52-164-01-01-19
WAKISO,ENTEBBE MUNICIPALITY,DIVISION A,CENTRAL,KAKEEKA PLAY GROUND (OJO-Z),792,0,0,3,60,382,445,18,463,0,O-52-164-01-01-20
WAKISO,ENTEBBE MUNICIPALITY,DIVISION A,KATABI,MAYORS GARDENS I (A-M),697,2,2,17,232,175,428,12,440,0,O-52-164-01-02-01
WAKISO,ENTEBBE MUNICIPALITY,DIVISION A,KATABI,ST. JOSEPH P/S I (A-M),467,4,1,6,119,129,259,10,269,0,O-52-164-01-02-02
WAKISO,ENTEBBE MUNICIPALITY,DIVISION A,KATABI,ST. JOSEPH P/S II,1003,2,2,27,306,217,554,14,568,0,O-52-164-01-02-03
WAKISO,ENTEBBE MUNICIPALITY,DIVISION A,KATABI,MAYORS GARDENS II (A-M),458,2,1,7,149,112,271,10,281,0,O-52-164-01-02-04
WAKISO,ENTEBBE MUNICIPALITY,DIVISION A,KATABI,MAYORS GARDENS III (A-M),575,4,3,16,184,140,347,24,371,0,O-52-164-01-02-05
WAKISO,ENTEBBE MUNICIPALITY,DIVISION A,KATABI,ST. JOSEPH. P. S I,731,5,0,13,189,142,349,75,424,0,O-52-164-01-02-06
WAKISO,ENTEBBE MUNICIPALITY,DIVISION A,KATABI,ST. JOSEPH. P. S II,375,0,0,13,104,123,240,5,245,0,O-52-164-01-02-07
WAKISO,ENTEBBE MUNICIPALITY,DIVISION A,KATABI,MAYORS GARDENS I (N-Z),496,0,2,15,128,146,291,9,300,0,O-52-164-01-02-08
WAKISO,ENTEBBE MUNICIPALITY,DIVISION A,KATABI,ST. JOSEPH. P/S I (N-Z),515,1,0,10,113,115,239,38,277,0,O-52-164-01-02-09
WAKISO,ENTEBBE MUNICIPALITY,DIVISION A,KATABI,MAYORS GARDENS II (N-Z),473,2,1,5,129,119,256,10,266,0,O-52-164-01-02-10
WAKISO,ENTEBBE MUNICIPALITY,DIVISION A,KATABI,MAYORS GARDENS III (N-Z),427,5,3,9,162,97,276,1,277,0,O-52-164-01-02-11
WAKISO,ENTEBBE MUNICIPALITY,DIVISION A,KATABI,KATABI BARRACKS,593,3,2,3,80,223,311,3,314,0,O-52-164-01-02-12
WAKISO,ENTEBBE MUNICIPALITY,DIVISION B,KIGUNGU,KIGUNGU P.S (A - M),789,2,0,14,245,205,466,11,477,0,O-52-164-02-01-01
WAKISO,ENTEBBE MUNICIPALITY,DIVISION B,KIGUNGU,VETERINARY TRAINING INSTITUT,311,3,1,1,106,98,209,7,216,0,O-52-164-02-01-02
WAKISO,ENTEBBE MUNICIPALITY,DIVISION B,KIGUNGU,ST. PAUL'S C/U MAYANZI,848,0,0,30,189,244,463,16,479,0,O-52-164-02-01-03
WAKISO,ENTEBBE MUNICIPALITY,DIVISION B,KIGUNGU,KIGUNGU P.S (N),419,0,2,7,60,146,215,38,253,0,O-52-164-02-01-04
WAKISO,ENTEBBE MUNICIPALITY,DIVISION B,KIGUNGU,MAYANJA'S COMPOUND (MUSOLO,870,1,1,8,114,296,420,9,429,0,O-52-164-02-01-05
WAKISO,ENTEBBE MUNICIPALITY,DIVISION B,KIGUNGU,KIGUNGU P.S (O - Z),433,1,2,10,137,99,249,10,259,0,O-52-164-02-01-06
WAKISO,ENTEBBE MUNICIPALITY,DIVISION B,KIWAFU,KITORO COMMUNITY CENTRE (A-,904,2,1,29,304,241,577,1,578,0,O-52-164-02-02-01
WAKISO,ENTEBBE MUNICIPALITY,DIVISION B,KIWAFU,KITORO COMMUNITY CENTRE (N-,810,4,4,27,285,224,544,6,550,0,O-52-164-02-02-02
WAKISO,ENTEBBE MUNICIPALITY,DIVISION B,KIWAFU,KIWAFU MODERN NURSERY SCH,861,2,0,14,211,238,465,84,549,0,O-52-164-02-02-03
WAKISO,ENTEBBE MUNICIPALITY,DIVISION B,KIWAFU,KIWAFU MODERN NURSERY SCH,688,2,1,11,174,196,384,63,447,0,O-52-164-02-02-04
WAKISO,ENTEBBE MUNICIPALITY,DIVISION B,KIWAFU,KIWAFU P/S (A-KAB),572,1,3,2,201,121,328,9,337,0,O-52-164-02-02-05
WAKISO,ENTEBBE MUNICIPALITY,DIVISION B,KIWAFU,KIWAFU P/S (M-NAJ),495,0,5,11,146,133,295,0,295,0,O-52-164-02-02-06
WAKISO,ENTEBBE MUNICIPALITY,DIVISION B,KIWAFU,KIWAFU P/S (KAD-L),551,2,0,16,162,134,314,12,326,0,O-52-164-02-02-07
WAKISO,ENTEBBE MUNICIPALITY,DIVISION B,KIWAFU,KIWAFU P/S (NAK-NYO),613,4,0,8,135,158,305,48,353,0,O-52-164-02-02-08
WAKISO,ENTEBBE MUNICIPALITY,DIVISION B,KIWAFU,ENTEBBE COMPREHENSIVE S.S N,606,2,0,7,159,162,330,46,376,0,O-52-164-02-02-09
WAKISO,ENTEBBE MUNICIPALITY,DIVISION B,KIWAFU,KIWAFU MOSLEM P/S (A-KAS),582,3,0,9,186,144,342,4,346,0,O-52-164-02-02-10
WAKISO,ENTEBBE MUNICIPALITY,DIVISION B,KIWAFU,KIWAFU P/S (O-Z),597,3,0,16,213,112,344,33,377,0,O-52-164-02-02-11
WAKISO,ENTEBBE MUNICIPALITY,DIVISION B,KIWAFU,KIWAFU MOSLEM (N-Z),880,3,5,15,275,252,550,2,552,0,O-52-164-02-02-12
WAKISO,ENTEBBE MUNICIPALITY,DIVISION B,KIWAFU,ENTEBBE COMPREHENSIVE S.S N,680,4,2,21,196,165,388,12,400,0,O-52-164-02-02-13
WAKISO,ENTEBBE MUNICIPALITY,DIVISION B,KIWAFU,ENTEBBE COMPREHENSIVE S.S N,688,2,0,20,140,165,327,84,411,0,O-52-164-02-02-14
WAKISO,ENTEBBE MUNICIPALITY,DIVISION B,KIWAFU,ENTEBBE COMPREHENSIVE S.S N,671,1,0,19,146,223,389,9,398,0,O-52-164-02-02-15
WAKISO,ENTEBBE MUNICIPALITY,DIVISION B,KIWAFU,KIWAFU MOSLEM P/S (KAT-M),502,1,1,16,167,169,354,2,356,0,O-52-164-02-02-16
WAKISO,ENTEBBE MUNICIPALITY,DIVISION B,KIWAFU,ENTEBBE COMPREHENSIVE S.S N,579,4,3,13,200,122,342,22,364,0,O-52-164-02-02-17
WAKISO,KYADONDO COUNTY NORTH,GOMBE,BUJUMBA/TIKALU,KITANDA P/SCHOOL (BUJUMBA),442,0,0,9,96,190,295,11,306,0,O-52-160-01-01-01
WAKISO,KYADONDO COUNTY NORTH,GOMBE,BUJUMBA/TIKALU,KITANDA P/SCHOOL,618,5,0,16,128,300,449,9,458,0,O-52-160-01-01-02
WAKISO,KYADONDO COUNTY NORTH,GOMBE,BUWAMBO,BUWAMBO H/CENTRE,654,4,0,15,153,256,428,8,436,0,O-52-160-01-02-01
WAKISO,KYADONDO COUNTY NORTH,GOMBE,BUWAMBO,KIGOMBOLOLA (KIGOOGWA),684,5,0,13,167,236,421,0,421,0,O-52-160-01-02-02
WAKISO,KYADONDO COUNTY NORTH,GOMBE,BUWAMBO,VOVAK P/SCHOOL - KAKERENGE,530,2,0,22,102,250,376,20,396,0,O-52-160-01-02-03
WAKISO,KYADONDO COUNTY NORTH,GOMBE,BUWAMBO,NAMAKONKOME CATHOLIC CHUR,423,5,2,20,63,204,294,12,306,0,O-52-160-01-02-04
WAKISO,KYADONDO COUNTY NORTH,GOMBE,GOMBE,GOMBE S/C HQTRS,534,9,1,21,146,150,327,10,337,0,O-52-160-01-03-01
WAKISO,KYADONDO COUNTY NORTH,GOMBE,GOMBE,KITUNGWA P/SCHOOL,456,1,1,8,145,160,315,11,326,0,O-52-160-01-03-02
WAKISO,KYADONDO COUNTY NORTH,GOMBE,JAGGALA/KAVULE,JJAGALA PLAY GROUND,622,6,0,19,87,296,408,14,422,0,O-52-160-01-04-01
WAKISO,KYADONDO COUNTY NORTH,GOMBE,JAGGALA/KAVULE,"ST. KIZITO P/SCHOOL, GGALAMBA",405,1,0,14,60,231,306,10,316,0,O-52-160-01-04-02
WAKISO,KYADONDO COUNTY NORTH,GOMBE,KIRYAMULI,KUNGU P/SCHOOL,542,2,0,11,112,225,350,5,355,0,O-52-160-01-05-01
WAKISO,KYADONDO COUNTY NORTH,GOMBE,KIRYAMULI,KIGOGWA MOSLEM P/SCHOOL,550,3,0,9,114,202,328,9,337,0,O-52-160-01-05-02
WAKISO,KYADONDO COUNTY NORTH,GOMBE,MATUGGA,MATTUGA S.D.A CHURCH (A-M),376,6,0,7,107,99,219,2,221,0,O-52-160-01-06-01
WAKISO,KYADONDO COUNTY NORTH,GOMBE,MATUGGA,SUN-RISE P/SCHOOL,856,2,0,11,228,217,458,6,464,0,O-52-160-01-06-02
WAKISO,KYADONDO COUNTY NORTH,GOMBE,MATUGGA,KIRYAGONJA T/CENTRE,658,3,0,16,147,205,371,13,384,0,O-52-160-01-06-03
WAKISO,KYADONDO COUNTY NORTH,GOMBE,MATUGGA,ST. LWANDA P/SCHOOL (KIRWANI,743,5,0,16,173,282,476,12,488,0,O-52-160-01-06-04
WAKISO,KYADONDO COUNTY NORTH,GOMBE,MATUGGA,MATTUGA S.D.A CHURCH (N-Z),571,4,0,9,109,185,307,2,309,0,O-52-160-01-06-05
WAKISO,KYADONDO COUNTY NORTH,GOMBE,MATUGGA,LWADDA A P/S (A-M),740,3,0,14,253,159,429,3,432,0,O-52-160-01-06-06
WAKISO,KYADONDO COUNTY NORTH,GOMBE,MATUGGA,LWADDA A P/S (N-Z),1038,4,0,12,242,251,509,10,519,0,O-52-160-01-06-07
WAKISO,KYADONDO COUNTY NORTH,GOMBE,MIGADDE,NABINAKA P/SCHOOL (KINGIDDE),386,1,0,13,76,166,256,14,270,0,O-52-160-01-07-01
WAKISO,KYADONDO COUNTY NORTH,GOMBE,MIGADDE,MIGADDE ST. ANDREW C/U,498,2,0,13,119,202,336,13,349,0,O-52-160-01-07-02
WAKISO,KYADONDO COUNTY NORTH,GOMBE,MWERERWE,MWERERWE CATHOLIC CHURCH,685,3,0,32,120,266,421,14,435,0,O-52-160-01-08-01
WAKISO,KYADONDO COUNTY NORTH,GOMBE,NASSE,NASSE MOSLEM S CHOOL,494,2,1,19,133,206,361,9,370,0,O-52-160-01-09-01
WAKISO,KYADONDO COUNTY NORTH,GOMBE,SSANGA,BUKIIKA P/SCHOOL (NAKUKUBA),616,3,1,32,128,268,432,11,443,0,O-52-160-01-10-01
WAKISO,KYADONDO COUNTY NORTH,GOMBE,SSANGA,SSANGA P/SCHOOL (A-M),322,1,1,19,110,84,215,8,223,0,O-52-160-01-10-02
WAKISO,KYADONDO COUNTY NORTH,GOMBE,SSANGA,SSANGA P/SCHOOL (N-Z),490,2,0,15,108,171,296,14,310,0,O-52-160-01-10-03
WAKISO,KYADONDO COUNTY NORTH,GOMBE,WAMBALE,KIWEEBWA T/CENTRE,664,2,2,41,138,236,419,18,437,0,O-52-160-01-11-01
WAKISO,KYADONDO COUNTY NORTH,GOMBE,WAMBALE,SSAAYI P/SCHOOL,448,1,2,21,111,184,319,7,326,0,O-52-160-01-11-02
WAKISO,KYADONDO COUNTY NORTH,KYAMBOGO (BUSUKUMA),BUSUKUMA,NAMULONGE P/SCHOOL,831,1,0,9,174,360,544,7,551,0,O-52-160-02-01-01
WAKISO,KYADONDO COUNTY NORTH,KYAMBOGO (BUSUKUMA),BUSUKUMA,BUSUKUMA S/COUNTY HQTRS,385,2,0,4,100,127,233,3,236,0,O-52-160-02-01-02
WAKISO,KYADONDO COUNTY NORTH,KYAMBOGO (BUSUKUMA),GULUDDENE,GULUDDENE (A-M),481,2,0,2,103,166,273,10,283,0,O-52-160-02-02-01
WAKISO,KYADONDO COUNTY NORTH,KYAMBOGO (BUSUKUMA),GULUDDENE,BULESA P/SCHOOL,439,6,1,10,113,133,263,19,282,0,O-52-160-02-02-02
WAKISO,KYADONDO COUNTY NORTH,KYAMBOGO (BUSUKUMA),GULUDDENE,GULUDDENE (N-Z),602,5,4,4,99,209,321,7,328,0,O-52-160-02-02-03
WAKISO,KYADONDO COUNTY NORTH,KYAMBOGO (BUSUKUMA),KABUUMBA,BUSO MOSLEM P/SCHOOL,477,2,0,14,101,204,321,8,329,0,O-52-160-02-03-01
WAKISO,KYADONDO COUNTY NORTH,KYAMBOGO (BUSUKUMA),KABUUMBA,KABUUMBA (KITAWULUZI P/STATI,450,1,0,20,112,180,313,5,318,0,O-52-160-02-03-02
WAKISO,KYADONDO COUNTY NORTH,KYAMBOGO (BUSUKUMA),KIKOKO,NAMULONGE JUNIOR GOLF CLUB,685,3,1,9,126,341,480,6,486,0,O-52-160-02-04-01
WAKISO,KYADONDO COUNTY NORTH,KYAMBOGO (BUSUKUMA),KIKOKO,KIKOKO P/SCHOOL,396,1,0,1,53,205,260,18,278,0,O-52-160-02-04-02
WAKISO,KYADONDO COUNTY NORTH,KYAMBOGO (BUSUKUMA),KIWENDA,KIWENDA FALSK P/SCHOOL,727,5,1,14,270,213,503,12,515,0,O-52-160-02-05-01
WAKISO,KYADONDO COUNTY NORTH,KYAMBOGO (BUSUKUMA),KIWENDA,NAZALESI C/U,639,0,1,50,166,199,416,20,436,0,O-52-160-02-05-02
WAKISO,KYADONDO COUNTY NORTH,KYAMBOGO (BUSUKUMA),KIWENDA,KIWENDA NEW P/SCHOOL BALITT,483,4,1,25,140,170,340,16,356,0,O-52-160-02-05-03
WAKISO,KYADONDO COUNTY NORTH,KYAMBOGO (BUSUKUMA),LUGO,LUGO COMMUNITY CENTRE,539,0,1,18,171,172,362,7,369,0,O-52-160-02-06-01
WAKISO,KYADONDO COUNTY NORTH,KYAMBOGO (BUSUKUMA),LUGO,BANDADU P/SCHOOL,534,1,0,9,104,202,316,4,320,0,O-52-160-02-06-02
WAKISO,KYADONDO COUNTY NORTH,KYAMBOGO (BUSUKUMA),LUGO,KABONGE P/SCHOOL,545,2,2,7,120,218,349,24,373,0,O-52-160-02-06-03
WAKISO,KYADONDO COUNTY NORTH,KYAMBOGO (BUSUKUMA),MAGIGYE,MAGIGYE C/U,521,2,1,4,94,270,371,9,380,0,O-52-160-02-07-01
WAKISO,KYADONDO COUNTY NORTH,KYAMBOGO (BUSUKUMA),MAGIGYE,ST. JUDE P/SCHOOL BUKEMBA,681,1,2,5,157,276,441,8,449,0,O-52-160-02-07-02
WAKISO,KYADONDO COUNTY NORTH,KYAMBOGO (BUSUKUMA),MAGIGYE,KIJJUDDE P/SCHOOL,464,5,0,8,138,164,315,7,322,0,O-52-160-02-07-03
WAKISO,KYADONDO COUNTY NORTH,KYAMBOGO (BUSUKUMA),WAMIRONGO,WAMUWONGO P/SCHOOL,513,4,1,7,83,268,363,16,379,0,O-52-160-02-08-01
WAKISO,KYADONDO COUNTY NORTH,KYAMBOGO (BUSUKUMA),WAMIRONGO,KIBIBI P/SCHOOL,519,2,0,10,104,241,357,5,362,0,O-52-160-02-08-02
WAKISO,KYADONDO COUNTY NORTH,NABWERU,KAWANDA,CENTRAL (KAWANDA C/U),923,2,1,24,262,292,581,12,593,0,O-52-160-03-01-01
WAKISO,KYADONDO COUNTY NORTH,NABWERU,KAWANDA,NKOKONJERU KAWANDA C/U (A-M,517,3,1,11,175,163,353,10,363,0,O-52-160-03-01-02
WAKISO,KYADONDO COUNTY NORTH,NABWERU,KAWANDA,KIRINYABIGO LC1 MEETING PLAC,357,2,0,20,83,128,233,1,234,0,O-52-160-03-01-03
WAKISO,KYADONDO COUNTY NORTH,NABWERU,KAWANDA,NKOKONJERU KAWANDA C/U (N-Z,627,2,0,11,156,228,397,11,408,0,O-52-160-03-01-04
WAKISO,KYADONDO COUNTY NORTH,NABWERU,MAGANJO,KAGOMA A PETRO STATION (A - M,596,4,3,11,213,95,326,3,329,0,O-52-160-03-02-01
WAKISO,KYADONDO COUNTY NORTH,NABWERU,MAGANJO,KAGOMA B PETRO STATIOM (A -,679,2,0,10,224,118,354,4,358,0,O-52-160-03-02-02
WAKISO,KYADONDO COUNTY NORTH,NABWERU,MAGANJO,MAGANJO C/U A (A-M),304,3,0,7,120,43,173,5,178,0,O-52-160-03-02-03
WAKISO,KYADONDO COUNTY NORTH,NABWERU,MAGANJO,MAGANJO C/U B (A-M),373,1,0,20,140,56,217,4,221,0,O-52-160-03-02-04
WAKISO,KYADONDO COUNTY NORTH,NABWERU,MAGANJO,MAGANJO C/U C,778,2,0,11,277,142,432,20,452,0,O-52-160-03-02-05
WAKISO,KYADONDO COUNTY NORTH,NABWERU,MAGANJO,MAGANJO C/U D,712,4,1,6,237,149,397,9,406,0,O-52-160-03-02-06
WAKISO,KYADONDO COUNTY NORTH,NABWERU,MAGANJO,MAGANJO C/U E,926,3,2,11,308,153,477,7,484,0,O-52-160-03-02-07
WAKISO,KYADONDO COUNTY NORTH,NABWERU,MAGANJO,KAWEMPE A STONE QUARRY (A-,360,1,0,8,144,49,202,6,208,0,O-52-160-03-02-08
WAKISO,KYADONDO COUNTY NORTH,NABWERU,MAGANJO,KAWEMPE MAJAANI FACTORY B,623,1,0,20,229,132,382,3,385,0,O-52-160-03-02-09
WAKISO,KYADONDO COUNTY NORTH,NABWERU,MAGANJO,KAWEMPE MAJAANI FACTORY C,1018,5,1,16,314,202,538,2,540,0,O-52-160-03-02-10
WAKISO,KYADONDO COUNTY NORTH,NABWERU,MAGANJO,KAWEMPE MAJAANI FACTORY D,740,3,0,20,237,114,374,5,379,0,O-52-160-03-02-11
WAKISO,KYADONDO COUNTY NORTH,NABWERU,MAGANJO,KAWEMPE STONE QUARRY E,678,5,0,16,232,128,381,10,391,0,O-52-160-03-02-12
WAKISO,KYADONDO COUNTY NORTH,NABWERU,MAGANJO,KAWEMPE MAJAANI FACTORY F,531,1,0,8,188,92,289,14,303,0,O-52-160-03-02-13
WAKISO,KYADONDO COUNTY NORTH,NABWERU,MAGANJO,KAWEMPE MAJAANI FACTORY G,581,3,1,9,226,121,360,2,362,0,O-52-160-03-02-14
WAKISO,KYADONDO COUNTY NORTH,NABWERU,MAGANJO,KAWEMPE STONE QUARRY H,910,4,0,17,299,163,483,2,485,0,O-52-160-03-02-15
WAKISO,KYADONDO COUNTY NORTH,NABWERU,MAGANJO,MAGANJO C/U F,1087,4,0,22,318,174,518,10,528,0,O-52-160-03-02-16
WAKISO,KYADONDO COUNTY NORTH,NABWERU,MAGANJO,TTULA P/S (A-M),646,1,1,12,218,155,387,14,401,0,O-52-160-03-02-17
WAKISO,KYADONDO COUNTY NORTH,NABWERU,MAGANJO,KAGOMA PETRO STATION A (N - Z,755,3,0,12,207,167,389,7,396,0,O-52-160-03-02-18
WAKISO,KYADONDO COUNTY NORTH,NABWERU,MAGANJO,KAGOMA PETRO STATION B (N - Z,832,4,0,16,224,162,406,3,409,0,O-52-160-03-02-19
WAKISO,KYADONDO COUNTY NORTH,NABWERU,MAGANJO,MAGANJO C/U A (N-Z),419,1,1,3,129,86,220,4,224,0,O-52-160-03-02-20
WAKISO,KYADONDO COUNTY NORTH,NABWERU,MAGANJO,MAGANJO C/U B (N-Z),460,0,0,13,141,77,231,31,262,0,O-52-160-03-02-21
WAKISO,KYADONDO COUNTY NORTH,NABWERU,MAGANJO,KAWEMPE A STONE QUARRY (N-Z,398,2,0,7,127,82,218,3,221,0,O-52-160-03-02-22
WAKISO,KYADONDO COUNTY NORTH,NABWERU,MAGANJO,TTULA P/S (N-Z),409,4,1,18,107,112,242,4,246,0,O-52-160-03-02-23
WAKISO,KYADONDO COUNTY NORTH,NABWERU,NAKYESANJA,NAKYESANJA T/CENTRE I (A-M),482,1,1,11,173,134,320,15,335,0,O-52-160-03-03-01
WAKISO,KYADONDO COUNTY NORTH,NABWERU,NAKYESANJA,NAKYESANJA T/CENTRE II,318,0,0,10,96,100,206,7,213,0,O-52-160-03-03-02
WAKISO,KYADONDO COUNTY NORTH,NABWERU,NAKYESANJA,NAKYESANJA T/CENTRE I (N-Z),676,3,0,18,196,206,423,11,434,0,O-52-160-03-03-03
WAKISO,KYADONDO COUNTY NORTH,NABWERU,WAMALA,TTABA PLAY GROUND,439,3,1,7,98,142,251,10,261,0,O-52-160-03-04-01
WAKISO,KYADONDO COUNTY NORTH,NABWERU,WAMALA,KATOOKE LCI OFFICE,489,1,1,13,139,153,307,3,310,0,O-52-160-03-04-02
WAKISO,KYADONDO COUNTY NORTH,NABWERU,WAMALA,KAYE GROUND,733,2,0,14,256,196,468,3,471,0,O-52-160-03-04-03
WAKISO,KYADONDO COUNTY NORTH,NABWERU,WAMALA,KAMADI LULE GROUND,491,2,0,9,135,182,328,8,336,0,O-52-160-03-04-04
WAKISO,KYADONDO COUNTY NORTH,NABWERU,WAMALA,KATOOKE GROWERS,631,2,0,14,208,180,404,7,411,0,O-52-160-03-04-05
WAKISO,KYADONDO COUNTY NORTH,NANSANA TOWN COUNCIL,KAZO,KAZO MIXED P/SCHOOL I (A - L),679,3,0,12,237,132,384,4,388,0,O-52-160-04-01-01
WAKISO,KYADONDO COUNTY NORTH,NANSANA TOWN COUNCIL,KAZO,KAZO MIXED P/SCHOOL II,739,2,0,6,211,163,382,5,387,0,O-52-160-04-01-02
WAKISO,KYADONDO COUNTY NORTH,NANSANA TOWN COUNCIL,KAZO,KAZO MIXED P/SCHOOL III,600,1,0,6,195,104,306,3,309,0,O-52-160-04-01-03
WAKISO,KYADONDO COUNTY NORTH,NANSANA TOWN COUNCIL,KAZO,KAZO C/U P/SCHOOL (A - M),748,2,0,9,273,142,426,46,472,0,O-52-160-04-01-04
WAKISO,KYADONDO COUNTY NORTH,NANSANA TOWN COUNCIL,KAZO,KAZO C/U P/SCHOOL II (A-M),359,4,1,7,139,75,226,4,230,0,O-52-160-04-01-05
WAKISO,KYADONDO COUNTY NORTH,NANSANA TOWN COUNCIL,KAZO,KAZO NORTH I GABUNGA (A-M),547,6,0,17,201,97,321,5,326,0,O-52-160-04-01-06
WAKISO,KYADONDO COUNTY NORTH,NANSANA TOWN COUNCIL,KAZO,KAZO NORTH II GABUNGA (A-M),439,1,0,11,148,89,249,2,251,0,O-52-160-04-01-07
WAKISO,KYADONDO COUNTY NORTH,NANSANA TOWN COUNCIL,KAZO,KAZO MIXED P/SCHOOL I (M - NAM,900,1,1,17,252,184,455,15,470,0,O-52-160-04-01-08
WAKISO,KYADONDO COUNTY NORTH,NANSANA TOWN COUNCIL,KAZO,KAZO C/U P/SCHOOL (N - Z),803,3,0,9,226,189,427,6,433,0,O-52-160-04-01-09
WAKISO,KYADONDO COUNTY NORTH,NANSANA TOWN COUNCIL,KAZO,KAZO MIXED P/SCHOOL I (NAN - Z,632,2,1,7,196,103,309,7,316,0,O-52-160-04-01-10
WAKISO,KYADONDO COUNTY NORTH,NANSANA TOWN COUNCIL,KAZO,KAZO C/U P/SCHOOL II (N-Z),787,1,1,7,233,165,407,9,416,0,O-52-160-04-01-11
WAKISO,KYADONDO COUNTY NORTH,NANSANA TOWN COUNCIL,KAZO,KAZO NORTH I GABUNGA (N-Z),597,0,1,22,165,123,311,8,319,0,O-52-160-04-01-12
WAKISO,KYADONDO COUNTY NORTH,NANSANA TOWN COUNCIL,KAZO,KAZO NORTH II GABUNGA (N-Z),516,0,0,14,154,113,281,5,286,0,O-52-160-04-01-13
WAKISO,KYADONDO COUNTY NORTH,NANSANA TOWN COUNCIL,NABWERU NORTH,NABWERU S/C HQTRS NORTH I (A,580,2,0,18,225,104,349,3,352,0,O-52-160-04-02-01
WAKISO,KYADONDO COUNTY NORTH,NANSANA TOWN COUNCIL,NABWERU NORTH,NABWERU S/C HQTRS NORTH II,985,3,0,19,242,180,444,0,444,0,O-52-160-04-02-02
WAKISO,KYADONDO COUNTY NORTH,NANSANA TOWN COUNCIL,NABWERU NORTH,NABWERU S/C HQTRS NORTH I (N,668,1,1,9,202,134,347,6,353,0,O-52-160-04-02-03
WAKISO,KYADONDO COUNTY NORTH,NANSANA TOWN COUNCIL,NABWERU SOUTH,NABWERU S/C HQTRS SOUTH I (A,675,1,1,11,204,127,344,12,356,0,O-52-160-04-03-01
WAKISO,KYADONDO COUNTY NORTH,NANSANA TOWN COUNCIL,NABWERU SOUTH,NABWERU S/C HQTRS SOUTH II (,608,0,0,11,93,117,221,9,230,0,O-52-160-04-03-02
WAKISO,KYADONDO COUNTY NORTH,NANSANA TOWN COUNCIL,NABWERU SOUTH,NABWERU S/C HQTRS SOUTH III (,610,1,1,15,203,114,334,0,334,0,O-52-160-04-03-03
WAKISO,KYADONDO COUNTY NORTH,NANSANA TOWN COUNCIL,NABWERU SOUTH,NABWERU S/C HQTRS SOUTH I (N,773,1,0,5,187,152,345,4,349,0,O-52-160-04-03-04
WAKISO,KYADONDO COUNTY NORTH,NANSANA TOWN COUNCIL,NABWERU SOUTH,NABWERU S/C HQTRS SOUTH II (,866,2,0,7,249,156,414,10,424,0,O-52-160-04-03-05
WAKISO,KYADONDO COUNTY NORTH,NANSANA TOWN COUNCIL,NABWERU SOUTH,NABWERU S/C HQTRS SOUTH III (,832,1,1,9,249,195,455,12,467,0,O-52-160-04-03-06
WAKISO,KYADONDO COUNTY NORTH,NANSANA TOWN COUNCIL,NANSANA,NANSANA UMEA P/SCHOOL EAST,782,2,0,14,235,165,416,10,426,0,O-52-160-04-04-01
WAKISO,KYADONDO COUNTY NORTH,NANSANA TOWN COUNCIL,NANSANA,NANSANA UMEA P/SCHOOL EAST,512,2,0,11,179,94,286,9,295,0,O-52-160-04-04-02
WAKISO,KYADONDO COUNTY NORTH,NANSANA TOWN COUNCIL,NANSANA,NANSANA ST. JOSEPH P/S II AB (A,862,3,0,23,314,207,547,6,553,0,O-52-160-04-04-03
WAKISO,KYADONDO COUNTY NORTH,NANSANA TOWN COUNCIL,NANSANA,NANSANA ST. JOSEPH P/S II AB (M,793,2,0,10,233,135,380,17,397,0,O-52-160-04-04-04
WAKISO,KYADONDO COUNTY NORTH,NANSANA TOWN COUNCIL,NANSANA,NANSANA UMEA P/SCHOOL EAST,886,4,0,19,241,195,459,13,472,0,O-52-160-04-04-05
WAKISO,KYADONDO COUNTY NORTH,NANSANA TOWN COUNCIL,NANSANA,NANSANA UMEA P/SCHOOL EAST,759,1,0,9,191,173,374,0,374,0,O-52-160-04-04-06
WAKISO,KYADONDO COUNTY NORTH,NANSANA TOWN COUNCIL,NANSANA,NANSANA ST. JOSEPH P/S II AB (N,707,0,1,17,198,164,380,8,388,0,O-52-160-04-04-07
WAKISO,KYADONDO COUNTY NORTH,NANSANA TOWN COUNCIL,NANSANA,NANSANA ST. JOSEPH P/S II AB (O,367,1,1,9,135,69,215,1,216,0,O-52-160-04-04-08
WAKISO,KYADONDO COUNTY NORTH,NANSANA TOWN COUNCIL,NANSANA 7/8 OCHIE,NANSANA GLORY NUR. & PR. SCH,1003,4,2,15,357,211,589,13,602,0,O-52-160-04-05-01
WAKISO,KYADONDO COUNTY NORTH,NANSANA TOWN COUNCIL,NANSANA 7/8 OCHIE,NANSANA OCHIENG SAPH P/S (A-,564,5,0,7,204,157,373,3,376,0,O-52-160-04-05-02
WAKISO,KYADONDO COUNTY NORTH,NANSANA TOWN COUNCIL,NANSANA 7/8 OCHIE,NANSANA CHILDREN'S CENTRE 7/,1079,5,0,12,317,249,583,24,607,0,O-52-160-04-05-03
WAKISO,KYADONDO COUNTY NORTH,NANSANA TOWN COUNCIL,NANSANA 7/8 OCHIE,NANSANA OCHIENG SAPH P/S (N-,696,4,0,11,199,202,416,2,418,0,O-52-160-04-05-04
WAKISO,KYADONDO COUNTY NORTH,NANSANA TOWN COUNCIL,NANSANA WEST,MASENGERE PLAY GROUND WES,663,2,1,34,246,122,405,5,410,0,O-52-160-04-06-01
WAKISO,KYADONDO COUNTY NORTH,NANSANA TOWN COUNCIL,NANSANA WEST,MASENGERE PLAY GROUND WES,1204,4,1,41,366,232,644,25,669,0,O-52-160-04-06-02
WAKISO,KYADONDO COUNTY NORTH,NANSANA TOWN COUNCIL,NANSANA WEST,NANSANA C/U P/SCHOOL WEST II,936,5,1,17,328,188,539,5,544,0,O-52-160-04-06-03
WAKISO,KYADONDO COUNTY NORTH,NANSANA TOWN COUNCIL,NANSANA WEST,NANSANA C/U P/SCHOOL WEST II,819,4,1,18,213,138,374,4,378,0,O-52-160-04-06-04
WAKISO,KYADONDO COUNTY NORTH,NANSANA TOWN COUNCIL,NANSANA WEST,NANSANA C/U P/SCHOOL WEST II,1154,2,0,27,311,217,557,24,581,0,O-52-160-04-06-05
WAKISO,KYADONDO COUNTY NORTH,NANSANA TOWN COUNCIL,NANSANA WEST,MASENGERE PLAY GROUND WES,521,1,0,18,162,116,297,3,300,0,O-52-160-04-06-06
WAKISO,KYADONDO COUNTY SOUTH,MAKINDYE,BUNAMWAYA,LUFUKA PLAY GROUND I (A-M),558,3,2,22,175,91,293,2,295,0,O-52-161-01-01-01
WAKISO,KYADONDO COUNTY SOUTH,MAKINDYE,BUNAMWAYA,LUFUKA PLAY GROUND II,726,3,0,30,250,129,412,2,414,0,O-52-161-01-01-02
WAKISO,KYADONDO COUNTY SOUTH,MAKINDYE,BUNAMWAYA,ANA & TONY P/S KIRIMANYANGA (,770,3,1,27,312,164,507,3,510,0,O-52-161-01-01-03
WAKISO,KYADONDO COUNTY SOUTH,MAKINDYE,BUNAMWAYA,BUNAMWAYA H/CENTRE,623,3,0,29,172,146,350,9,359,0,O-52-161-01-01-04
WAKISO,KYADONDO COUNTY SOUTH,MAKINDYE,BUNAMWAYA,STANDARD JUNIOR SCHOOL (A-M,664,2,0,30,211,170,413,14,427,0,O-52-161-01-01-05
WAKISO,KYADONDO COUNTY SOUTH,MAKINDYE,BUNAMWAYA,MUKASA'S RESIDENCE LUBOWA (,909,4,0,51,285,203,543,17,560,0,O-52-161-01-01-06
WAKISO,KYADONDO COUNTY SOUTH,MAKINDYE,BUNAMWAYA,VIKA P/SCHOOL NANKINGA,690,3,0,12,260,142,417,5,422,0,O-52-161-01-01-07
WAKISO,KYADONDO COUNTY SOUTH,MAKINDYE,BUNAMWAYA,MUMBEJJA BALAMU'S PLACE ZAN,314,1,0,18,115,76,210,3,213,0,O-52-161-01-01-08
WAKISO,KYADONDO COUNTY SOUTH,MAKINDYE,BUNAMWAYA,MUMBEJJA BALAMU'S PLACE ZAN,999,5,0,25,300,232,562,11,573,0,O-52-161-01-01-09
WAKISO,KYADONDO COUNTY SOUTH,MAKINDYE,BUNAMWAYA,LATE MUKASA ZANA II (A-M),785,3,1,25,280,165,474,8,482,0,O-52-161-01-01-10
WAKISO,KYADONDO COUNTY SOUTH,MAKINDYE,BUNAMWAYA,MUKASA'S RESIDENCE LUBOWA (,1103,3,0,42,288,251,584,7,591,0,O-52-161-01-01-11
WAKISO,KYADONDO COUNTY SOUTH,MAKINDYE,BUNAMWAYA,LUFUKA PLAY GROUND I (N-Z),597,3,0,19,145,90,257,5,262,0,O-52-161-01-01-12
WAKISO,KYADONDO COUNTY SOUTH,MAKINDYE,BUNAMWAYA,ANA & TONY P/S KIRIMANYANGA (,889,4,1,27,322,172,526,14,540,0,O-52-161-01-01-13
WAKISO,KYADONDO COUNTY SOUTH,MAKINDYE,BUNAMWAYA,KISINGIRI,459,2,0,30,160,79,271,11,282,0,O-52-161-01-01-14
WAKISO,KYADONDO COUNTY SOUTH,MAKINDYE,BUNAMWAYA,STANDARD JUNIOR SCHOOL (N-Z),692,1,1,25,208,174,409,9,418,0,O-52-161-01-01-15
WAKISO,KYADONDO COUNTY SOUTH,MAKINDYE,BUNAMWAYA,MUMBEJJA BALAMU'S PLACE ZAN,422,2,0,20,112,109,243,3,246,0,O-52-161-01-01-16
WAKISO,KYADONDO COUNTY SOUTH,MAKINDYE,BUNAMWAYA,LATE MUKASA ZANA II (N-Z),777,4,1,21,231,140,397,12,409,0,O-52-161-01-01-17
WAKISO,KYADONDO COUNTY SOUTH,MAKINDYE,BUSABALA,BUSABALA P/SCHOOL,821,1,0,18,172,288,479,9,488,0,O-52-161-01-02-01
WAKISO,KYADONDO COUNTY SOUTH,MAKINDYE,BUSABALA,KIBULOKA ZIRANNUMBU,394,4,0,33,68,131,236,12,248,0,O-52-161-01-02-02
WAKISO,KYADONDO COUNTY SOUTH,MAKINDYE,BUSABALA,DIKA'S PLACE KIBIRI A,836,2,0,51,205,237,495,16,511,0,O-52-161-01-02-03
WAKISO,KYADONDO COUNTY SOUTH,MAKINDYE,BUSABALA,DIKA'S PLACE KIBIRI B,800,5,0,52,230,202,489,12,501,0,O-52-161-01-02-04
WAKISO,KYADONDO COUNTY SOUTH,MAKINDYE,BUSABALA,GANGU C PLAY GROUND,647,4,1,26,188,194,413,4,417,0,O-52-161-01-02-05
WAKISO,KYADONDO COUNTY SOUTH,MAKINDYE,BUSABALA,GANGU B T/CENTRE (A-M),486,0,0,14,209,89,312,7,319,0,O-52-161-01-02-06
WAKISO,KYADONDO COUNTY SOUTH,MAKINDYE,BUSABALA,BUGGU T/C,354,2,0,27,84,132,245,7,252,0,O-52-161-01-02-07
WAKISO,KYADONDO COUNTY SOUTH,MAKINDYE,BUSABALA,KABUUMA,210,1,0,19,54,77,151,0,151,0,O-52-161-01-02-08
WAKISO,KYADONDO COUNTY SOUTH,MAKINDYE,BUSABALA,GANGU B T/CENTRE (N-Z),679,1,1,16,223,143,384,11,395,0,O-52-161-01-02-09
WAKISO,KYADONDO COUNTY SOUTH,MAKINDYE,KIMWANYI (SEGUKU),LUBOWA POLICE POST KYEYAGA,949,8,2,20,252,236,518,23,541,0,O-52-161-01-03-01
WAKISO,KYADONDO COUNTY SOUTH,MAKINDYE,KIMWANYI (SEGUKU),NAZIBA BERTINA P/S (A-M),695,6,0,21,213,192,432,12,444,0,O-52-161-01-03-02
WAKISO,KYADONDO COUNTY SOUTH,MAKINDYE,KIMWANYI (SEGUKU),SEGUKU I WALUSIMBI'S PLACE,569,2,0,26,166,116,310,1,311,0,O-52-161-01-03-03
WAKISO,KYADONDO COUNTY SOUTH,MAKINDYE,KIMWANYI (SEGUKU),SEGUKU II P/SCHOOL,1145,10,0,53,334,220,617,19,636,0,O-52-161-01-03-04
WAKISO,KYADONDO COUNTY SOUTH,MAKINDYE,KIMWANYI (SEGUKU),SEGUKU III KAREBU'S PLACE,737,2,0,47,241,147,437,9,446,0,O-52-161-01-03-05
WAKISO,KYADONDO COUNTY SOUTH,MAKINDYE,KIMWANYI (SEGUKU),ST. NGONDWE SEC SCH. SEGUKU,899,15,0,38,292,187,532,3,535,0,O-52-161-01-03-06
WAKISO,KYADONDO COUNTY SOUTH,MAKINDYE,KIMWANYI (SEGUKU),NAZIBA BERTINA P/S (N-Z),711,2,2,17,216,180,417,10,427,0,O-52-161-01-03-07
WAKISO,KYADONDO COUNTY SOUTH,MAKINDYE,MASAJJA,AGRO-LINKS S.S.S. B (A-M),454,3,1,18,177,65,264,4,268,0,O-52-161-01-04-01
WAKISO,KYADONDO COUNTY SOUTH,MAKINDYE,MASAJJA,AGRO-LINKS SEC SCH. KIKAJJO C,1239,3,1,31,412,201,648,15,663,0,O-52-161-01-04-02
WAKISO,KYADONDO COUNTY SOUTH,MAKINDYE,MASAJJA,AGRO-LINKS SEC SCH. KIKAJJO D,1011,10,2,24,341,151,528,10,538,0,O-52-161-01-04-03
WAKISO,KYADONDO COUNTY SOUTH,MAKINDYE,MASAJJA,ST. ELIZABETH P/SCHOOL CENTR,635,2,0,28,235,108,373,6,379,0,O-52-161-01-04-04
WAKISO,KYADONDO COUNTY SOUTH,MAKINDYE,MASAJJA,ST. ELIZABETH P/SCHOOL CENTR,1236,3,0,38,419,190,650,8,658,0,O-52-161-01-04-05
WAKISO,KYADONDO COUNTY SOUTH,MAKINDYE,MASAJJA,FRED'S PLACE LUFUKA A,482,1,0,18,158,84,261,2,263,0,O-52-161-01-04-06
WAKISO,KYADONDO COUNTY SOUTH,MAKINDYE,MASAJJA,LATE NDUGGA'S PLACE LUFUKA B,676,1,0,10,264,132,407,24,431,0,O-52-161-01-04-07
WAKISO,KYADONDO COUNTY SOUTH,MAKINDYE,MASAJJA,BABA'S PLACE KALINA A (A-M),416,2,0,11,164,79,256,3,259,0,O-52-161-01-04-08
WAKISO,KYADONDO COUNTY SOUTH,MAKINDYE,MASAJJA,NAMASUBA PWD A,679,1,0,19,230,135,385,3,388,0,O-52-161-01-04-09
WAKISO,KYADONDO COUNTY SOUTH,MAKINDYE,MASAJJA,NAMASUBA PWD B,583,2,0,21,189,69,281,5,286,0,O-52-161-01-04-10
WAKISO,KYADONDO COUNTY SOUTH,MAKINDYE,MASAJJA,ESEZA'S PLACE PARA A,1023,4,2,20,342,221,589,10,599,0,O-52-161-01-04-11
WAKISO,KYADONDO COUNTY SOUTH,MAKINDYE,MASAJJA,LATE CANON-MUSOKE'S PLACE P,387,0,1,8,131,73,213,1,214,0,O-52-161-01-04-12
WAKISO,KYADONDO COUNTY SOUTH,MAKINDYE,MASAJJA,BASAJJA B I PLAY GROUND,770,2,0,15,226,150,393,0,393,0,O-52-161-01-04-13
WAKISO,KYADONDO COUNTY SOUTH,MAKINDYE,MASAJJA,ST. PIUS P/SCH. NDIKUTAMADDA,517,1,1,18,203,81,304,7,311,0,O-52-161-01-04-14
WAKISO,KYADONDO COUNTY SOUTH,MAKINDYE,MASAJJA,ST. PIUS P/SCH. NDIKUTAMADDA,958,3,2,21,358,156,540,26,566,0,O-52-161-01-04-15
WAKISO,KYADONDO COUNTY SOUTH,MAKINDYE,MASAJJA,MASAJJA A LIBERTY WORSHIP C,1426,0,1,42,500,186,729,15,744,0,O-52-161-01-04-16
WAKISO,KYADONDO COUNTY SOUTH,MAKINDYE,MASAJJA,MASAJJA B PLAY GROUND (A - L),547,4,0,31,188,94,317,2,319,0,O-52-161-01-04-17
WAKISO,KYADONDO COUNTY SOUTH,MAKINDYE,MASAJJA,MASAJJA P/SCHOOL KIBIRA A (A-,424,0,0,27,185,81,293,0,293,0,O-52-161-01-04-18
WAKISO,KYADONDO COUNTY SOUTH,MAKINDYE,MASAJJA,MASAJJA P/SCHOOL KIBIRA B,991,4,0,37,368,212,621,12,633,0,O-52-161-01-04-19
WAKISO,KYADONDO COUNTY SOUTH,MAKINDYE,MASAJJA,KALINA B REDEEMED CHURCH,647,2,0,20,224,150,396,12,408,0,O-52-161-01-04-20
WAKISO,KYADONDO COUNTY SOUTH,MAKINDYE,MASAJJA,AGRO LINKS SEC SCH. KIKAJJO A,463,5,1,11,155,57,229,7,236,0,O-52-161-01-04-21
WAKISO,KYADONDO COUNTY SOUTH,MAKINDYE,MASAJJA,MASAJJA A GOLDEN AGE P/S (N-,586,2,0,22,181,89,294,8,302,0,O-52-161-01-04-22
WAKISO,KYADONDO COUNTY SOUTH,MAKINDYE,MASAJJA,MASAJJA B PLAY GROUND (M-M),228,1,0,9,74,43,127,0,127,0,O-52-161-01-04-23
WAKISO,KYADONDO COUNTY SOUTH,MAKINDYE,MASAJJA,AGRO-LINKS S.S.S. B (N-Z),515,1,0,13,177,83,274,0,274,0,O-52-161-01-04-24
WAKISO,KYADONDO COUNTY SOUTH,MAKINDYE,MASAJJA,BABA'S PLACE KALINA A (N-Z),395,5,0,9,164,66,244,7,251,0,O-52-161-01-04-25
WAKISO,KYADONDO COUNTY SOUTH,MAKINDYE,MASAJJA,LATE CANON-MUSOKE'S PLACE P,409,0,0,9,127,61,197,3,200,0,O-52-161-01-04-26
WAKISO,KYADONDO COUNTY SOUTH,MAKINDYE,MASAJJA,ST. PIUS P/SCH. NDIKUTAMADDA,566,4,0,26,180,97,307,7,314,0,O-52-161-01-04-27
WAKISO,KYADONDO COUNTY SOUTH,MAKINDYE,MASAJJA,MASAJJA P/SCHOOL KIBIRA A (N-Z,496,5,1,24,141,93,264,4,268,0,O-52-161-01-04-28
WAKISO,KYADONDO COUNTY SOUTH,MAKINDYE,MASAJJA,MASAJJA A GOLDEN AGE P/S (O-,230,1,0,11,104,31,147,4,151,0,O-52-161-01-04-29
WAKISO,KYADONDO COUNTY SOUTH,MAKINDYE,MASAJJA,MASAJJA B PLAY GROUND (O-Z),301,0,0,9,109,63,181,7,188,0,O-52-161-01-04-30
WAKISO,KYADONDO COUNTY SOUTH,MAKINDYE,MASAJJA,MASAJJA B PLAY GROUND (N-N),518,2,0,6,125,102,235,1,236,0,O-52-161-01-04-31
WAKISO,KYADONDO COUNTY SOUTH,MAKINDYE,MUTUNDWE,MIREMBE GREEN VALLEY P/SCH I,426,1,0,11,178,58,248,7,255,0,O-52-161-01-05-01
WAKISO,KYADONDO COUNTY SOUTH,MAKINDYE,MUTUNDWE,MIREMBE GREEN VALLEY P/SCH II,574,1,0,24,214,116,355,6,361,0,O-52-161-01-05-02
WAKISO,KYADONDO COUNTY SOUTH,MAKINDYE,MUTUNDWE,WABIYINJA KASULA'S PLACE I/II,690,1,0,32,256,125,414,3,417,0,O-52-161-01-05-03
WAKISO,KYADONDO COUNTY SOUTH,MAKINDYE,MUTUNDWE,WABIYINJA KASULA'S PLACE II,463,0,1,21,172,84,278,11,289,0,O-52-161-01-05-04
WAKISO,KYADONDO COUNTY SOUTH,MAKINDYE,MUTUNDWE,KANAALA ST. MATIA P/SCH I&II (A,416,0,1,14,135,59,209,2,211,0,O-52-161-01-05-05
WAKISO,KYADONDO COUNTY SOUTH,MAKINDYE,MUTUNDWE,KANAALA ST. MATIA P/SCH II,698,2,1,19,213,134,369,12,381,0,O-52-161-01-05-06
WAKISO,KYADONDO COUNTY SOUTH,MAKINDYE,MUTUNDWE,KISIGULA REFORMED THEOLOGI,689,1,0,17,230,160,408,15,423,0,O-52-161-01-05-07
WAKISO,KYADONDO COUNTY SOUTH,MAKINDYE,MUTUNDWE,BUNAMWAYA YESSE'S PLACE I (A-,525,3,0,19,173,134,329,6,335,0,O-52-161-01-05-08
WAKISO,KYADONDO COUNTY SOUTH,MAKINDYE,MUTUNDWE,BUNAMWAYA YESSE'S PLACE II,499,2,0,21,148,113,284,6,290,0,O-52-161-01-05-09
WAKISO,KYADONDO COUNTY SOUTH,MAKINDYE,MUTUNDWE,AGGREY MEMORIAL S.S.S NYANA,551,1,0,28,187,115,331,8,339,0,O-52-161-01-05-10
WAKISO,KYADONDO COUNTY SOUTH,MAKINDYE,MUTUNDWE,KISIGULA REFORMED THEOLOGI,625,1,1,8,141,179,330,9,339,0,O-52-161-01-05-11
WAKISO,KYADONDO COUNTY SOUTH,MAKINDYE,MUTUNDWE,MIREMBE GREEN VALLEY P/SCH I,654,0,0,17,194,134,345,7,352,0,O-52-161-01-05-12
WAKISO,KYADONDO COUNTY SOUTH,MAKINDYE,MUTUNDWE,KANAALA ST. MATIA P/SCH I&II (N,569,0,0,15,120,93,228,6,234,0,O-52-161-01-05-13
WAKISO,KYADONDO COUNTY SOUTH,MAKINDYE,MUTUNDWE,BUNAMWAYA YESSE'S PLACE I (N,636,0,1,23,146,185,355,20,375,0,O-52-161-01-05-14
WAKISO,KYADONDO COUNTY SOUTH,MAKINDYE,MUTUNDWE,AGGREY MEMORIAL S.S.S NYANA,677,1,2,25,208,150,386,8,394,0,O-52-161-01-05-15
WAKISO,KYADONDO COUNTY SOUTH,MAKINDYE,MUTUNDWE,KISIGULA REFORMED THEOLOGI,265,1,0,9,83,63,156,2,158,0,O-52-161-01-05-16
WAKISO,KYADONDO COUNTY SOUTH,MAKINDYE,MUTUNGO,LWEZA AI PLAY GROUND (A-M),518,4,0,23,165,91,283,0,283,0,O-52-161-01-06-01
WAKISO,KYADONDO COUNTY SOUTH,MAKINDYE,MUTUNGO,LWEZA AII PLAY GROUND,867,2,1,35,267,193,498,24,522,0,O-52-161-01-06-02
WAKISO,KYADONDO COUNTY SOUTH,MAKINDYE,MUTUNGO,LWEZA BI POLIO REHABILITATION,1378,2,6,33,382,308,731,14,745,0,O-52-161-01-06-03
WAKISO,KYADONDO COUNTY SOUTH,MAKINDYE,MUTUNGO,LWEZA BII POLIO REHABILITATIO,698,2,0,25,212,154,393,9,402,0,O-52-161-01-06-04
WAKISO,KYADONDO COUNTY SOUTH,MAKINDYE,MUTUNGO,MUTUNGO I C/U PRI SCHOOL,726,2,0,25,198,254,479,5,484,0,O-52-161-01-06-05
WAKISO,KYADONDO COUNTY SOUTH,MAKINDYE,MUTUNGO,MUTUNGO II C/U P/SCHOOL,662,1,0,16,174,165,356,5,361,0,O-52-161-01-06-06
WAKISO,KYADONDO COUNTY SOUTH,MAKINDYE,MUTUNGO,KIYEMBA MAIN ROAD BIRONGO,482,4,1,11,122,171,309,8,317,0,O-52-161-01-06-07
WAKISO,KYADONDO COUNTY SOUTH,MAKINDYE,MUTUNGO,KIGO PLAY GROUND,815,1,2,11,185,286,485,12,497,0,O-52-161-01-06-08
WAKISO,KYADONDO COUNTY SOUTH,MAKINDYE,MUTUNGO,LWEZA BIII POLIO REH. CENTRE (,399,1,0,14,134,61,210,1,211,0,O-52-161-01-06-09
WAKISO,KYADONDO COUNTY SOUTH,MAKINDYE,MUTUNGO,LWEZA AI PLAY GROUND (N-Z),543,2,0,9,159,135,305,3,308,0,O-52-161-01-06-10
WAKISO,KYADONDO COUNTY SOUTH,MAKINDYE,MUTUNGO,LWEZA BIII POLIO REH. CENTRE (,455,1,1,19,110,98,229,5,234,0,O-52-161-01-06-11
WAKISO,KYADONDO COUNTY SOUTH,MAKINDYE,NDEJJE,ST. ANDREW P/SCHOOL LUGA,933,1,0,38,297,227,563,11,574,0,O-52-161-01-07-01
WAKISO,KYADONDO COUNTY SOUTH,MAKINDYE,NDEJJE,ST. ANDREW P/SCHOOL LUBUGU,691,2,1,34,234,152,423,8,431,0,O-52-161-01-07-02
WAKISO,KYADONDO COUNTY SOUTH,MAKINDYE,NDEJJE,ST. JOHN'S C/U KANYANYA (A-M),514,2,0,9,219,115,345,7,352,0,O-52-161-01-07-03
WAKISO,KYADONDO COUNTY SOUTH,MAKINDYE,NDEJJE,AIDAN COLLEGE NDEJJE (A-M),764,3,0,17,310,131,461,9,470,0,O-52-161-01-07-04
WAKISO,KYADONDO COUNTY SOUTH,MAKINDYE,NDEJJE,LATE HAJJI KATUMBA'S PLACE LU,520,2,0,20,221,83,326,9,335,0,O-52-161-01-07-05
WAKISO,KYADONDO COUNTY SOUTH,MAKINDYE,NDEJJE,AIDAN COLLEGE MIRIMU (A-M),576,2,1,17,224,101,345,12,357,0,O-52-161-01-07-06
WAKISO,KYADONDO COUNTY SOUTH,MAKINDYE,NDEJJE,ST. JOHN'S C/U KANYANYA (N-Z),704,1,0,18,226,170,415,11,426,0,O-52-161-01-07-07
WAKISO,KYADONDO COUNTY SOUTH,MAKINDYE,NDEJJE,AIDAN COLLEGE NDEJJE (N-Z),892,2,0,20,319,150,491,9,500,0,O-52-161-01-07-08
WAKISO,KYADONDO COUNTY SOUTH,MAKINDYE,NDEJJE,LATE HAJJI KATUMBA'S PLACE LU,667,1,0,14,223,151,389,12,401,0,O-52-161-01-07-09
WAKISO,KYADONDO COUNTY SOUTH,MAKINDYE,NDEJJE,AIDAN COLLEGE MIRIMU (N-Z),715,2,0,19,218,167,406,13,419,0,O-52-161-01-07-10
WAKISO,KYADONDO CTY EAST,KIRA,KIREKA,KIREKA REHABILITATION CENTRE,2275,4,6,9,543,283,845,5,850,0,O-52-159-01-01-01
WAKISO,KYADONDO CTY EAST,KIRA,KIREKA,KIREKA REHABILITATION CENTRE,924,8,3,3,314,153,481,2,483,0,O-52-159-01-01-02
WAKISO,KYADONDO CTY EAST,KIRA,KIREKA,ST. STEPHENS P/S KIREKA B (A-KI,945,5,0,9,288,157,459,4,463,0,O-52-159-01-01-03
WAKISO,KYADONDO CTY EAST,KIRA,KIREKA,ST. MATIA P/S KIREKA C (A-L),695,2,0,8,253,139,402,1,403,0,O-52-159-01-01-04
WAKISO,KYADONDO CTY EAST,KIRA,KIREKA,SDA CHURCH KIREKA D,1066,7,1,12,225,265,510,5,515,0,O-52-159-01-01-05
WAKISO,KYADONDO CTY EAST,KIRA,KIREKA,KAMULI C/U P/S,834,5,2,15,211,149,382,0,382,0,O-52-159-01-01-06
WAKISO,KYADONDO CTY EAST,KIRA,KIREKA,KAMULI C/U P/S A,1692,8,4,10,368,271,661,4,665,0,O-52-159-01-01-07
WAKISO,KYADONDO CTY EAST,KIRA,KIREKA,ST.GONZAGA P/S KAMULI B(A-M),736,1,1,14,287,141,444,6,450,0,O-52-159-01-01-08
WAKISO,KYADONDO CTY EAST,KIRA,KIREKA,KIREKA UMEA P/S (A-L),1303,6,1,5,428,226,666,3,669,0,O-52-159-01-01-09
WAKISO,KYADONDO CTY EAST,KIRA,KIREKA,NAALYA HOUSING ESTATE,1806,9,6,18,385,328,746,6,752,0,O-52-159-01-01-10
WAKISO,KYADONDO CTY EAST,KIRA,KIREKA,KASOKOSO T.C,605,1,2,16,188,175,382,17,399,0,O-52-159-01-01-11
WAKISO,KYADONDO CTY EAST,KIRA,KIREKA,KIREKA REHABILITATION CENTRE,873,2,1,15,329,107,454,1,455,0,O-52-159-01-01-12
WAKISO,KYADONDO CTY EAST,KIRA,KIREKA,KIREKA REHABILITATION CENTRE,990,3,1,12,310,163,489,6,495,0,O-52-159-01-01-13
WAKISO,KYADONDO CTY EAST,KIRA,KIREKA,KIREKA REHABILITATION CENTRE,953,4,1,7,230,179,421,1,422,0,O-52-159-01-01-14
WAKISO,KYADONDO CTY EAST,KIRA,KIREKA,ST. STEPHEN P/S KIREKA B (KIV-N,965,5,1,12,283,156,457,10,467,0,O-52-159-01-01-15
WAKISO,KYADONDO CTY EAST,KIRA,KIREKA,ST. STEPHEN P/S KIREKA B (NAK-,864,6,0,9,190,220,425,7,432,0,O-52-159-01-01-16
WAKISO,KYADONDO CTY EAST,KIRA,KIREKA,ST. MATIA P/S KIREKA C (M-NAM),677,2,3,8,163,166,342,3,345,0,O-52-159-01-01-17
WAKISO,KYADONDO CTY EAST,KIRA,KIREKA,ST. GONZAGA C/S KAMULI B (N-Z),797,3,1,16,261,179,460,2,462,0,O-52-159-01-01-18
WAKISO,KYADONDO CTY EAST,KIRA,KIREKA,KIREKA UMEA P/S (M-NAM),1185,5,4,13,334,259,615,9,624,0,O-52-159-01-01-19
WAKISO,KYADONDO CTY EAST,KIRA,KIREKA,KIREKA UMEA P/S (NAN-Z),584,1,0,5,169,102,277,2,279,0,O-52-159-01-01-20
WAKISO,KYADONDO CTY EAST,KIRA,KIREKA,KIREKA REHABILITATION CENTRE,875,5,0,10,300,90,405,2,407,0,O-52-159-01-01-21
WAKISO,KYADONDO CTY EAST,KIRA,KIREKA,ST. STEPHEN P/S KIREKA B (NAR-,992,4,2,8,285,168,467,14,481,0,O-52-159-01-01-22
WAKISO,KYADONDO CTY EAST,KIRA,KIREKA,ST. MATIA P/S KIREKA C (NAN-Z),567,6,1,4,205,107,323,6,329,0,O-52-159-01-01-23
WAKISO,KYADONDO CTY EAST,KIRA,KIREKA,KAMULI C (O-Z),467,0,6,3,198,74,281,4,285,0,O-52-159-01-01-24
WAKISO,KYADONDO CTY EAST,KIRA,KIREKA,ST. PETERS SEC. SCHOOL,660,9,2,9,141,133,294,0,294,0,O-52-159-01-01-25
WAKISO,KYADONDO CTY EAST,KIRA,KIRINYA,KIRA T/C HTQRS (A-M),740,4,4,13,189,200,410,8,418,0,O-52-159-01-02-01
WAKISO,KYADONDO CTY EAST,KIRA,KIRINYA,MULAWA T.C,546,3,2,12,133,222,372,15,387,0,O-52-159-01-02-02
WAKISO,KYADONDO CTY EAST,KIRA,KIRINYA,BULINDO MOTHER CARE P/S,954,3,3,17,277,309,609,8,617,0,O-52-159-01-02-03
WAKISO,KYADONDO CTY EAST,KIRA,KIRINYA,NAJJERA T/C (A-M),853,9,0,19,328,212,568,7,575,0,O-52-159-01-02-04
WAKISO,KYADONDO CTY EAST,KIRA,KIRINYA,BUWATE P/S,562,4,0,12,224,125,365,14,379,0,O-52-159-01-02-05
WAKISO,KYADONDO CTY EAST,KIRA,KIRINYA,KUNGU T.C,457,3,0,13,179,151,346,4,350,0,O-52-159-01-02-06
WAKISO,KYADONDO CTY EAST,KIRA,KIRINYA,KIRA T/C HTQRS (N-Z),558,4,1,10,149,186,350,2,352,0,O-52-159-01-02-07
WAKISO,KYADONDO CTY EAST,KIRA,KIRINYA,NAJJERA T/C (N-Z),916,11,2,29,311,262,615,4,619,0,O-52-159-01-02-08
WAKISO,KYADONDO CTY EAST,KIRA,KYALIWAJJALA,UGANDA MARTYRS SHRINE I,1736,1,0,27,437,253,718,15,733,0,O-52-159-01-03-01
WAKISO,KYADONDO CTY EAST,KIRA,KYALIWAJJALA,UGANDA MARTYRS SHRINE II,1026,3,3,17,294,194,511,4,515,0,O-52-159-01-03-02
WAKISO,KYADONDO CTY EAST,KIRA,KYALIWAJJALA,KYALIWAJJALA UMEA P/S (A-M),488,2,1,12,176,100,291,1,292,0,O-52-159-01-03-03
WAKISO,KYADONDO CTY EAST,KIRA,KYALIWAJJALA,KYALIWAJALA II,936,6,0,19,292,169,486,4,490,0,O-52-159-01-03-04
WAKISO,KYADONDO CTY EAST,KIRA,KYALIWAJJALA,MBALWA C/U,753,2,2,15,259,168,446,0,446,0,O-52-159-01-03-05
WAKISO,KYADONDO CTY EAST,KIRA,KYALIWAJJALA,UGANDA MARTYRS SHRINE III,530,2,1,12,138,80,233,2,235,0,O-52-159-01-03-06
WAKISO,KYADONDO CTY EAST,KIRA,KYALIWAJJALA,KYALIWAJJALA UMEA P/S,1028,4,0,11,283,206,504,7,511,0,O-52-159-01-03-07
WAKISO,KYADONDO CTY EAST,KIRA,KYALIWAJJALA,UGANDA MARTYRS II (N-Z),456,1,0,7,120,98,226,5,231,0,O-52-159-01-03-08
WAKISO,KYADONDO CTY EAST,KIRA,KYALIWAJJALA,KYALIWAJJALA UMEA P/S (N-Z),558,2,1,9,123,107,242,3,245,0,O-52-159-01-03-09
WAKISO,KYADONDO CTY EAST,KIRA,KYALIWAJJALA,UGANDA MARTYRS SHRINE (N-Z),392,0,1,13,87,78,179,3,182,0,O-52-159-01-03-10
WAKISO,KYADONDO CTY EAST,KIRA TOWN COUNCIL,BWEYOGERERE,BBUTO T/C (A-M),690,4,2,2,193,90,291,6,297,0,O-52-159-02-01-01
WAKISO,KYADONDO CTY EAST,KIRA TOWN COUNCIL,BWEYOGERERE,BWEYOGERERE C/S I (A-M),717,3,0,9,299,133,444,2,446,0,O-52-159-02-01-02
WAKISO,KYADONDO CTY EAST,KIRA TOWN COUNCIL,BWEYOGERERE,BWEYOGERERE C/S II,572,2,0,10,216,93,321,1,322,0,O-52-159-02-01-03
WAKISO,KYADONDO CTY EAST,KIRA TOWN COUNCIL,BWEYOGERERE,NAMANVE RAILWAY KIREKU I (A-M,673,2,3,11,215,124,355,6,361,0,O-52-159-02-01-04
WAKISO,KYADONDO CTY EAST,KIRA TOWN COUNCIL,BWEYOGERERE,NAMANVE RAILWAY KIREKU 2 (A-,539,2,0,9,169,104,284,3,287,0,O-52-159-02-01-05
WAKISO,KYADONDO CTY EAST,KIRA TOWN COUNCIL,BWEYOGERERE,HASSAN TOURABI P/S I KAZINGA (,479,3,0,12,201,88,304,9,313,0,O-52-159-02-01-06
WAKISO,KYADONDO CTY EAST,KIRA TOWN COUNCIL,BWEYOGERERE,HASSAN TOURABI P/S II KAZINGA,494,4,2,8,189,75,278,3,281,0,O-52-159-02-01-07
WAKISO,KYADONDO CTY EAST,KIRA TOWN COUNCIL,BWEYOGERERE,HASSAN TOURABI P/S III KAZINGA,824,6,0,16,281,135,438,8,446,0,O-52-159-02-01-08
WAKISO,KYADONDO CTY EAST,KIRA TOWN COUNCIL,BWEYOGERERE,BWEYOGERERE C/U I KAKAJJO,1241,11,1,21,351,229,613,3,616,0,O-52-159-02-01-09
WAKISO,KYADONDO CTY EAST,KIRA TOWN COUNCIL,BWEYOGERERE,BWEYOGERERE C/U II KAKAJJO (,612,4,1,11,199,128,343,2,345,0,O-52-159-02-01-10
WAKISO,KYADONDO CTY EAST,KIRA TOWN COUNCIL,BWEYOGERERE,NAMULONDO THEATRE I KIGAND,697,5,0,10,262,127,404,1,405,0,O-52-159-02-01-11
WAKISO,KYADONDO CTY EAST,KIRA TOWN COUNCIL,BWEYOGERERE,NAMULONDO THEATRE II KIGAND,690,5,1,11,281,126,424,4,428,0,O-52-159-02-01-12
WAKISO,KYADONDO CTY EAST,KIRA TOWN COUNCIL,BWEYOGERERE,NTEBETEBE PLAYGROUND I (A-M,832,3,2,10,310,158,483,9,492,0,O-52-159-02-01-13
WAKISO,KYADONDO CTY EAST,KIRA TOWN COUNCIL,BWEYOGERERE,NTEBETEBE PLAYGROUND II (A-M,963,2,0,13,264,245,524,2,526,0,O-52-159-02-01-14
WAKISO,KYADONDO CTY EAST,KIRA TOWN COUNCIL,BWEYOGERERE,BBUTO T/C (N-Z),611,3,1,6,133,118,261,4,265,0,O-52-159-02-01-15
WAKISO,KYADONDO CTY EAST,KIRA TOWN COUNCIL,BWEYOGERERE,BWEYOGERERE C/S I (N-Z),802,2,0,17,269,142,430,11,441,0,O-52-159-02-01-16
WAKISO,KYADONDO CTY EAST,KIRA TOWN COUNCIL,BWEYOGERERE,NAMANVE RAILWAY KIREKU I (N-Z,670,5,0,8,172,153,338,4,342,0,O-52-159-02-01-17
WAKISO,KYADONDO CTY EAST,KIRA TOWN COUNCIL,BWEYOGERERE,NAMANVE RAILWAY KIREKU 2 (N-,615,2,0,9,162,125,298,1,299,0,O-52-159-02-01-18
WAKISO,KYADONDO CTY EAST,KIRA TOWN COUNCIL,BWEYOGERERE,HASSAN TOURABI P/S I KAZINGA (,876,1,1,14,268,165,449,6,455,0,O-52-159-02-01-19
WAKISO,KYADONDO CTY EAST,KIRA TOWN COUNCIL,BWEYOGERERE,BWEYOGERERE C/U II KAKAJJO (,753,4,0,8,202,158,372,6,378,0,O-52-159-02-01-20
WAKISO,KYADONDO CTY EAST,KIRA TOWN COUNCIL,BWEYOGERERE,NAMULONDO THEATRE I KIGAND,729,1,3,6,219,120,349,1,350,0,O-52-159-02-01-21
WAKISO,KYADONDO CTY EAST,KIRA TOWN COUNCIL,BWEYOGERERE,NAMULONDO THEATRE II KIGAND,794,1,1,14,266,145,427,6,433,0,O-52-159-02-01-22
WAKISO,KYADONDO CTY EAST,KIRA TOWN COUNCIL,BWEYOGERERE,NTEBETEBE PLAYGROUND I (L-Z),208,1,0,2,71,42,116,1,117,0,O-52-159-02-01-23
WAKISO,KYADONDO CTY EAST,KIRA TOWN COUNCIL,BWEYOGERERE,NTEBETEBE PLAYGROUND II (O-Z),363,3,2,8,141,73,227,1,228,0,O-52-159-02-01-24
WAKISO,KYADONDO CTY EAST,KIRA TOWN COUNCIL,KIMWANYI,KIMWANYI UMEA P/S,685,3,2,10,234,194,443,11,454,0,O-52-159-02-02-01
WAKISO,KYADONDO CTY EAST,KIRA TOWN COUNCIL,KIMWANYI,KITUKUTWE P/S,782,3,2,14,191,224,434,19,453,0,O-52-159-02-02-02
WAKISO,KYADONDO CTY EAST,KIRA TOWN COUNCIL,KIMWANYI,MELISA P/S (A-M),440,1,1,5,163,135,305,0,305,0,O-52-159-02-02-03
WAKISO,KYADONDO CTY EAST,KIRA TOWN COUNCIL,KIMWANYI,NAMBOGO P/S KIJJABIJJO,797,5,0,25,261,202,493,9,502,0,O-52-159-02-02-04
WAKISO,KYADONDO CTY EAST,KIRA TOWN COUNCIL,KIMWANYI,MELISA P/S (N-Z),594,6,0,11,151,188,356,9,365,0,O-52-159-02-02-05
WAKISO,KYADONDO CTY EAST,KIRA TOWN COUNCIL,KIRINYA,KIRINYA C/U NAMATABA A (A-K),731,7,1,11,234,169,422,13,435,0,O-52-159-02-03-01
WAKISO,KYADONDO CTY EAST,KIRA TOWN COUNCIL,KIRINYA,KIRINYA C/U NAMATABA B (A-M),687,3,1,9,229,148,390,5,395,0,O-52-159-02-03-02
WAKISO,KYADONDO CTY EAST,KIRA TOWN COUNCIL,KIRINYA,BUKASA T.C,578,2,2,15,154,231,404,5,409,0,O-52-159-02-03-03
WAKISO,KYADONDO CTY EAST,KIRA TOWN COUNCIL,KIRINYA,KIRINYA C/U KITO A-L,1013,5,0,15,347,233,600,15,615,0,O-52-159-02-03-04
WAKISO,KYADONDO CTY EAST,KIRA TOWN COUNCIL,KIRINYA,KIRINYA C/U NAMATABA A (N- Z),629,5,0,6,137,173,321,3,324,0,O-52-159-02-03-05
WAKISO,KYADONDO CTY EAST,KIRA TOWN COUNCIL,KIRINYA,KIRINYA C/U KITO (M - NAM),1025,6,0,13,270,255,544,12,556,0,O-52-159-02-03-06
WAKISO,KYADONDO CTY EAST,KIRA TOWN COUNCIL,KIRINYA,KIRINYA C/U KITO (NAN - Z),774,3,1,10,243,173,430,3,433,0,O-52-159-02-03-07
WAKISO,KYADONDO CTY EAST,KIRA TOWN COUNCIL,KIRINYA,KIRINYA C/U NAMATABA A (L -M),357,6,1,9,117,79,212,6,218,0,O-52-159-02-03-08
WAKISO,KYADONDO CTY EAST,KIRA TOWN COUNCIL,KIRINYA,KIRINYA C/U NAMATABA B (N - Z),1168,8,1,15,344,238,606,9,615,0,O-52-159-02-03-09
WAKISO,KYADONDO CTY EAST,NANGABO,BULAMU,BULAMU DEPUTY (A-M),626,1,2,10,248,172,433,10,443,0,O-52-159-03-01-01
WAKISO,KYADONDO CTY EAST,NANGABO,BULAMU,NAMAVUNDU C/U,524,1,1,19,158,197,376,2,378,0,O-52-159-03-01-02
WAKISO,KYADONDO CTY EAST,NANGABO,BULAMU,KASANGATI MOSLEM P/S,683,4,0,17,217,130,368,9,377,0,O-52-159-03-01-03
WAKISO,KYADONDO CTY EAST,NANGABO,BULAMU,ST. THEREZA GIRLS P/S KYETUM,475,3,1,18,114,155,291,7,298,0,O-52-159-03-01-04
WAKISO,KYADONDO CTY EAST,NANGABO,BULAMU,KAYEBE (KUMBUGA) P/S,369,1,1,17,127,76,222,8,230,0,O-52-159-03-01-05
WAKISO,KYADONDO CTY EAST,NANGABO,BULAMU,BULAMU DEPUTY (N-Z),836,2,0,13,226,277,518,14,532,0,O-52-159-03-01-06
WAKISO,KYADONDO CTY EAST,NANGABO,GAYAZA,GAYAZA C/U P/S I,660,1,0,9,240,180,430,8,438,0,O-52-159-03-02-01
WAKISO,KYADONDO CTY EAST,NANGABO,GAYAZA,GAYAZA C/U P/S II,922,4,2,14,262,223,505,10,515,0,O-52-159-03-02-02
WAKISO,KYADONDO CTY EAST,NANGABO,GAYAZA,GAYAZA P/S KYETUME A,251,0,0,4,74,59,137,1,138,0,O-52-159-03-02-03
WAKISO,KYADONDO CTY EAST,NANGABO,GAYAZA,SSAZA COUNTY HTQRS (A-M),600,6,1,11,228,138,384,4,388,0,O-52-159-03-02-04
WAKISO,KYADONDO CTY EAST,NANGABO,GAYAZA,KABANYOLO UNIVERSITY FARM,593,3,0,18,182,206,409,3,412,0,O-52-159-03-02-05
WAKISO,KYADONDO CTY EAST,NANGABO,GAYAZA,NALYAMAGONJA BWAGGU'S PLA,340,1,3,12,94,116,226,8,234,0,O-52-159-03-02-06
WAKISO,KYADONDO CTY EAST,NANGABO,GAYAZA,GAYAZA C/U P/S I (N-Z),779,4,0,12,221,181,418,10,428,0,O-52-159-03-02-07
WAKISO,KYADONDO CTY EAST,NANGABO,GAYAZA,SSAZA COUNTY HTQRS (N-Z),834,2,0,18,243,189,452,19,471,0,O-52-159-03-02-08
WAKISO,KYADONDO CTY EAST,NANGABO,KABUBBU,MANYANGWA T.C KASASA'S PLAC,796,1,0,22,328,145,496,16,512,0,O-52-159-03-03-01
WAKISO,KYADONDO CTY EAST,NANGABO,KABUBBU,MANYANGWA C/U P/S,533,2,1,11,177,147,338,7,345,0,O-52-159-03-03-02
WAKISO,KYADONDO CTY EAST,NANGABO,KABUBBU,NGALAMYE T/C BWAGU'S PLACE,601,3,0,36,207,129,375,5,380,0,O-52-159-03-03-03
WAKISO,KYADONDO CTY EAST,NANGABO,KABUBBU,NAMAINA,318,2,0,10,43,163,218,7,225,0,O-52-159-03-03-04
WAKISO,KYADONDO CTY EAST,NANGABO,KABUBBU,KABUBBU,572,1,0,15,158,202,376,9,385,0,O-52-159-03-03-05
WAKISO,KYADONDO CTY EAST,NANGABO,KATADDE,MAYIRIKITI P/S,576,2,1,10,192,139,344,3,347,0,O-52-159-03-04-01
WAKISO,KYADONDO CTY EAST,NANGABO,KATADDE,KATADDE P/S,619,7,0,7,135,228,377,15,392,0,O-52-159-03-04-02
WAKISO,KYADONDO CTY EAST,NANGABO,KATADDE,NALUSUGGA CATHOLIC CHURCH,743,0,0,18,196,264,478,20,498,0,O-52-159-03-04-03
WAKISO,KYADONDO CTY EAST,NANGABO,KITEEZI,NAMALERE T.C,424,1,1,14,128,148,292,8,300,0,O-52-159-03-05-01
WAKISO,KYADONDO CTY EAST,NANGABO,KITEEZI,KITEEZI DISABLED P/S,768,3,1,36,262,238,540,22,562,0,O-52-159-03-05-02
WAKISO,KYADONDO CTY EAST,NANGABO,KITEEZI,LUBATU,536,0,2,22,167,192,383,9,392,0,O-52-159-03-05-03
WAKISO,KYADONDO CTY EAST,NANGABO,KITEEZI,LUSANJA GRACE NURSERY & P/S,609,5,0,28,202,168,403,8,411,0,O-52-159-03-05-04
WAKISO,KYADONDO CTY EAST,NANGABO,MASOOLI,MASOOLI P/S,787,4,1,30,313,202,550,27,577,0,O-52-159-03-06-01
WAKISO,KYADONDO CTY EAST,NANGABO,MASOOLI,LUTEETE(KEREZIYA),448,2,0,10,164,141,317,6,323,0,O-52-159-03-06-02
WAKISO,KYADONDO CTY EAST,NANGABO,MASOOLI,KITETIKA(MBAZZI),760,2,3,17,296,196,514,11,525,0,O-52-159-03-06-03
WAKISO,KYADONDO CTY EAST,NANGABO,MASOOLI,YOGEMU P/S KIWALIMU,319,0,0,7,121,87,215,4,219,0,O-52-159-03-06-04
WAKISO,KYADONDO CTY EAST,NANGABO,NANGABO,NANGABO SELF HELP CENTRE,586,4,0,22,217,162,405,10,415,0,O-52-159-03-07-01
WAKISO,KYADONDO CTY EAST,NANGABO,NANGABO,KITEGOMBA P/S,353,3,0,7,136,90,236,0,236,0,O-52-159-03-07-02
WAKISO,KYADONDO CTY EAST,NANGABO,NANGABO,KITAGOBWA P/S,562,5,1,18,178,127,329,8,337,0,O-52-159-03-07-03
WAKISO,KYADONDO CTY EAST,NANGABO,NANGABO,NABUTAKA GITTA T.C,613,2,2,11,172,234,421,15,436,0,O-52-159-03-07-04
WAKISO,KYADONDO CTY EAST,NANGABO,WAMPEWO,WAMPEWO P/S,966,10,2,20,329,271,632,12,644,0,O-52-159-03-08-01
WAKISO,KYADONDO CTY EAST,NANGABO,WAMPEWO,P.W.D. KASANGATI (A-M),529,3,0,16,233,116,368,15,383,0,O-52-159-03-08-02
WAKISO,KYADONDO CTY EAST,NANGABO,WAMPEWO,KASANGATI DISPENSARY (A-M),480,3,0,18,220,123,364,3,367,0,O-52-159-03-08-03
WAKISO,KYADONDO CTY EAST,NANGABO,WAMPEWO,MAGERE,591,1,0,15,250,148,414,15,429,0,O-52-159-03-08-04
WAKISO,KYADONDO CTY EAST,NANGABO,WAMPEWO,LUTEETE TRADING CENTRE,1004,2,2,13,358,273,648,19,667,0,O-52-159-03-08-05
WAKISO,KYADONDO CTY EAST,NANGABO,WAMPEWO,SEETA P/S,485,3,0,19,177,134,333,11,344,0,O-52-159-03-08-06
WAKISO,KYADONDO CTY EAST,NANGABO,WAMPEWO,P.W.D. KASANGATI (N-Z),713,4,0,29,231,187,451,10,461,0,O-52-159-03-08-07
WAKISO,KYADONDO CTY EAST,NANGABO,WAMPEWO,KASANGATI DISPENSARY (N-Z),587,9,0,9,251,135,404,8,412,0,O-52-159-03-08-08
WAKISO,KYADONDO CTY EAST,NANGABO,WATTUBA,KITI PRIVATE P/S,525,1,1,8,140,188,338,10,348,0,O-52-159-03-09-01
WAKISO,KYADONDO CTY EAST,NANGABO,WATTUBA,WATTUBA (A-M),445,1,0,21,160,115,297,4,301,0,O-52-159-03-09-02
WAKISO,KYADONDO CTY EAST,NANGABO,WATTUBA,JJOKOLERA C/U,339,1,0,4,97,118,220,8,228,0,O-52-159-03-09-03
WAKISO,KYADONDO CTY EAST,NANGABO,WATTUBA,WATTUBA (N-Z),556,4,0,11,162,174,351,12,363,0,O-52-159-03-09-04
MITYANA,BUSUJJU COUNTY,BUTAYUNJA,KITEBERE,BULENGE,565,0,1,33,142,213,389,20,409,0,O-68-165-01-01-01
MITYANA,BUSUJJU COUNTY,BUTAYUNJA,KITONGO,KITONGO PRI. SCHOOL,720,1,3,26,182,254,466,8,474,0,O-68-165-01-02-01
MITYANA,BUSUJJU COUNTY,BUTAYUNJA,KITONGO,BULUMA/KIGOGOLO,476,2,0,13,40,300,355,23,378,0,O-68-165-01-02-02
MITYANA,BUSUJJU COUNTY,BUTAYUNJA,KITONGO,KIGGWA PRI. SCHOOL,384,1,2,12,53,164,232,15,247,0,O-68-165-01-02-03
MITYANA,BUSUJJU COUNTY,BUTAYUNJA,KITONGO,KANDE PRI.SCHOOL,456,1,0,33,101,178,313,9,322,0,O-68-165-01-02-04
MITYANA,BUSUJJU COUNTY,BUTAYUNJA,NAKAZIBA(GGORA),NAKAZIBA/KAKUNYU,505,2,0,10,110,262,384,17,401,0,O-68-165-01-03-01
MITYANA,BUSUJJU COUNTY,BUTAYUNJA,NGANDWE,BEKINA/NAWANGIRI,662,3,1,14,122,334,474,9,483,0,O-68-165-01-04-01
MITYANA,BUSUJJU COUNTY,BUTAYUNJA,NGANDWE,BUTAYUNJA/NGANDWE,451,1,1,10,95,190,297,11,308,0,O-68-165-01-04-02
MITYANA,BUSUJJU COUNTY,KAKINDU,KAKINDU TOWN,KAKINDU COMMUNITY CENTRE,842,2,2,36,222,253,515,12,527,0,O-68-165-02-01-01
MITYANA,BUSUJJU COUNTY,KAKINDU,KAKINDU TOWN,GOMBOLOLA HQRS,481,2,2,23,84,224,335,15,350,0,O-68-165-02-01-02
MITYANA,BUSUJJU COUNTY,KAKINDU,KAKINDU TOWN,VVUMBE KAZINGA,371,0,0,13,46,101,160,6,166,0,O-68-165-02-01-03
MITYANA,BUSUJJU COUNTY,KAKINDU,KAKINDU TOWN,GOMBOLOLA HQTRS,171,0,0,4,35,71,110,3,113,0,O-68-165-02-01-04
MITYANA,BUSUJJU COUNTY,KAKINDU,KAKINDU TOWN,VVUMBE,252,0,0,13,46,101,160,6,166,0,O-68-165-02-01-05
MITYANA,BUSUJJU COUNTY,KAKINDU,MWERA,MWERA/KIREKU,519,0,0,26,122,180,328,8,336,0,O-68-165-02-02-01
MITYANA,BUSUJJU COUNTY,KAKINDU,MWERA,KIWANDE/BANNANZE,535,2,4,14,92,234,346,42,388,0,O-68-165-02-02-02
MITYANA,BUSUJJU COUNTY,KAKINDU,MWERA,KABONERWA,339,1,0,2,51,146,200,37,237,0,O-68-165-02-02-03
MITYANA,BUSUJJU COUNTY,KAKINDU,NGUGULO (GOMBE),KIKUTA,265,0,0,5,55,122,182,5,187,0,O-68-165-02-03-01
MITYANA,BUSUJJU COUNTY,KAKINDU,NGUGULO (GOMBE),NGUGULO,506,0,1,25,136,169,331,6,337,0,O-68-165-02-03-02
MITYANA,BUSUJJU COUNTY,KAKINDU,NGUGULO (GOMBE),MAYOBYO,233,1,0,4,60,96,161,8,169,0,O-68-165-02-03-03
MITYANA,BUSUJJU COUNTY,KAKINDU,NSAMBYA,NSAMBYA,561,1,0,14,98,256,369,8,377,0,O-68-165-02-04-01
MITYANA,BUSUJJU COUNTY,KAKINDU,NSAMBYA,KALAMA,384,0,1,1,64,166,232,9,241,0,O-68-165-02-04-02
MITYANA,BUSUJJU COUNTY,KAKINDU,NSAMBYA,BUFUMA,431,0,0,4,88,225,317,2,319,0,O-68-165-02-04-03
MITYANA,BUSUJJU COUNTY,KAKINDU,NSAMBYA,TTUMBU,179,0,0,11,62,53,126,5,131,0,O-68-165-02-04-04
MITYANA,BUSUJJU COUNTY,KAKINDU,VVUMBE,MAWANDA,731,0,0,24,147,356,527,6,533,0,O-68-165-02-05-01
MITYANA,BUSUJJU COUNTY,MAANYI,BANDA,NDIRA BWERU PRI. SCHOOL,235,0,0,7,32,121,160,5,165,0,O-68-165-03-01-01
MITYANA,BUSUJJU COUNTY,MAANYI,BANDA,NABUKONDO/KALUNGUBALA,692,2,1,32,136,252,423,14,437,0,O-68-165-03-01-02
MITYANA,BUSUJJU COUNTY,MAANYI,BANDA,NDIRAWERU,218,0,0,7,32,121,160,5,165,0,O-68-165-03-01-03
MITYANA,BUSUJJU COUNTY,MAANYI,BANDA,BANDA (A-M),263,0,0,6,45,140,191,9,200,0,O-68-165-03-01-04
MITYANA,BUSUJJU COUNTY,MAANYI,BANDA,BANDA (N-Z),388,0,0,6,57,166,229,11,240,0,O-68-165-03-01-05
MITYANA,BUSUJJU COUNTY,MAANYI,KASOTA,KASOTA,507,0,0,17,58,277,352,13,365,0,O-68-165-03-02-01
MITYANA,BUSUJJU COUNTY,MAANYI,KASOTA,GULWE,324,1,0,11,108,114,234,10,244,0,O-68-165-03-02-02
MITYANA,BUSUJJU COUNTY,MAANYI,KASOTA,SERINYA,582,3,1,6,66,325,401,8,409,0,O-68-165-03-02-03
MITYANA,BUSUJJU COUNTY,MAANYI,KASOTA,KIZIIMIZO,388,2,0,8,34,208,252,15,267,0,O-68-165-03-02-04
MITYANA,BUSUJJU COUNTY,MAANYI,KASOTA,LUBAJJA,381,1,1,15,66,147,230,5,235,0,O-68-165-03-02-05
MITYANA,BUSUJJU COUNTY,MAANYI,KIMULI,KIMULI,830,4,1,11,101,377,494,18,512,0,O-68-165-03-03-01
MITYANA,BUSUJJU COUNTY,MAANYI,KIMULI,GULEJJA,306,0,1,4,8,201,214,3,217,0,O-68-165-03-03-02
MITYANA,BUSUJJU COUNTY,MAANYI,KIMULI,KABAYENGA,544,1,3,5,73,275,357,14,371,0,O-68-165-03-03-03
MITYANA,BUSUJJU COUNTY,MAANYI,KIMULI,MAANYI,669,5,1,3,84,319,412,10,422,0,O-68-165-03-03-04
MITYANA,BUSUJJU COUNTY,MAANYI,MAAWA,NABAALE,340,0,0,4,37,191,232,5,237,0,O-68-165-03-04-01
MITYANA,BUSUJJU COUNTY,MAANYI,MAAWA,KAKINDU,658,0,1,4,102,335,442,8,450,0,O-68-165-03-04-02
MITYANA,BUSUJJU COUNTY,MAANYI,MAAWA,KIREKU,273,0,0,1,26,157,184,9,193,0,O-68-165-03-04-03
MITYANA,BUSUJJU COUNTY,MAANYI,MPONGO,MPONGO,495,0,1,6,36,308,351,10,361,0,O-68-165-03-05-01
MITYANA,BUSUJJU COUNTY,MAANYI,MPONGO,MISIMBA,486,0,0,0,46,324,370,1,371,0,O-68-165-03-05-02
MITYANA,BUSUJJU COUNTY,MAANYI,MPONGO,KAYANGA T.C,460,0,1,7,48,217,273,9,282,0,O-68-165-03-05-03
MITYANA,BUSUJJU COUNTY,MAANYI,MPONGO,LUSALIRA PRI. SCHOOL,450,2,1,8,83,163,257,8,265,0,O-68-165-03-05-04
MITYANA,BUSUJJU COUNTY,MAANYI,NAMUTUNKU,MAYIRIKITI,213,0,0,4,49,101,154,3,157,0,O-68-165-03-06-01
MITYANA,BUSUJJU COUNTY,MAANYI,NAMUTUNKU,KIBUTO,748,0,1,17,68,458,544,17,561,0,O-68-165-03-06-02
MITYANA,BUSUJJU COUNTY,MAANYI,NAMUTUNKU,KAJOJI,432,0,0,8,56,237,301,17,318,0,O-68-165-03-06-03
MITYANA,BUSUJJU COUNTY,MAANYI,NFUMBYE,MISIGI,558,1,0,7,109,285,402,9,411,0,O-68-165-03-07-01
MITYANA,BUSUJJU COUNTY,MAANYI,NFUMBYE,NFUMBYE,461,1,2,2,61,234,300,27,327,0,O-68-165-03-07-02
MITYANA,BUSUJJU COUNTY,MAANYI,NFUMBYE,KALYANKOKO,612,2,0,14,94,329,439,10,449,0,O-68-165-03-07-03
MITYANA,BUSUJJU COUNTY,MALANGALA,KANYANYA,KABYUMA,453,0,1,9,53,241,304,25,329,0,O-68-165-04-01-01
MITYANA,BUSUJJU COUNTY,MALANGALA,KANYANYA,KANYANYA,589,0,0,16,62,358,436,0,436,0,O-68-165-04-01-02
MITYANA,BUSUJJU COUNTY,MALANGALA,KANYANYA,KANYANYA PLAY GROUND,107,0,0,9,15,60,84,2,86,0,O-68-165-04-01-03
MITYANA,BUSUJJU COUNTY,MALANGALA,KIWAWU,KIWAWU/KAZINGA,742,1,0,47,167,204,419,13,432,0,O-68-165-04-02-01
MITYANA,BUSUJJU COUNTY,MALANGALA,KIWAWU,MALANGALA/NTONYEZE,292,1,0,2,39,66,108,2,110,0,O-68-165-04-02-02
MITYANA,BUSUJJU COUNTY,MALANGALA,KIWAWU,KYESENGEZE PRI. SCHOOL,292,1,1,11,58,85,156,0,156,0,O-68-165-04-02-03
MITYANA,BUSUJJU COUNTY,MALANGALA,KIWAWU,MALANGALA,191,2,0,21,38,70,131,5,136,0,O-68-165-04-02-04
MITYANA,BUSUJJU COUNTY,MALANGALA,KIWAWU,MAGEZI PRIMARY SCHOOL,180,1,1,5,44,121,172,4,176,0,O-68-165-04-02-05
MITYANA,BUSUJJU COUNTY,MALANGALA,KIWAWU,KAMULI PRI. SCHOOL,366,1,0,18,88,149,256,5,261,0,O-68-165-04-02-06
MITYANA,BUSUJJU COUNTY,MALANGALA,MAGONGA,MAGONGA,526,2,0,11,85,241,339,2,341,0,O-68-165-04-03-01
MITYANA,BUSUJJU COUNTY,MALANGALA,MAGONGA,BAALA,221,0,0,4,50,105,159,10,169,0,O-68-165-04-03-02
MITYANA,BUSUJJU COUNTY,MALANGALA,NABATU,NABATU/KIKONGE,549,0,6,23,156,184,369,5,374,0,O-68-165-04-04-01
MITYANA,BUSUJJU COUNTY,MALANGALA,NABATU,KABAGOLO,529,1,1,17,101,209,329,3,332,0,O-68-165-04-04-02
MITYANA,BUSUJJU COUNTY,MALANGALA,NABATU,KYENGEZA,221,0,0,9,39,106,154,2,156,0,O-68-165-04-04-03
MITYANA,BUSUJJU COUNTY,MALANGALA,ZIGOTI (KYENGEZA),ZIGOTI/NAWANGA A,640,3,0,13,157,223,396,17,413,0,O-68-165-04-05-01
MITYANA,BUSUJJU COUNTY,MALANGALA,ZIGOTI (KYENGEZA),MABUYE PLAY GROUND,188,0,0,2,22,88,112,8,120,0,O-68-165-04-05-02
MITYANA,BUSUJJU COUNTY,MALANGALA,ZIGOTI (KYENGEZA),ZIGOTI,119,1,0,2,46,28,77,1,78,0,O-68-165-04-05-03
MITYANA,BUSUJJU COUNTY,MALANGALA,ZIGOTI (KYENGEZA),KASALAGA PLAY GROUND,647,4,1,41,142,239,427,14,441,0,O-68-165-04-05-04
MITYANA,BUSUJJU COUNTY,MALANGALA,ZIGOTI (KYENGEZA),ZIGOTI/NAWANGA B,716,2,1,23,160,245,431,11,442,0,O-68-165-04-05-05
MITYANA,MITYANA CTY NORTH,BULERA,BULERA,BAKIJULULA,810,4,2,5,73,419,503,19,522,0,O-68-169-01-01-01
MITYANA,MITYANA CTY NORTH,BULERA,BULERA,BULERA,687,2,1,19,150,267,439,6,445,0,O-68-169-01-01-02
MITYANA,MITYANA CTY NORTH,BULERA,BULERA,NABUMBUGU,445,5,0,6,68,260,339,11,350,0,O-68-169-01-01-03
MITYANA,MITYANA CTY NORTH,BULERA,BULERA,BUYAMBI,377,1,0,4,38,253,296,5,301,0,O-68-169-01-01-04
MITYANA,MITYANA CTY NORTH,BULERA,BULERA,KIBIBI/KITEWULUZI,311,3,0,1,33,176,213,10,223,0,O-68-169-01-01-05
MITYANA,MITYANA CTY NORTH,BULERA,BULERA,SSENDA TEA ESTATE,662,3,2,8,55,339,407,9,416,0,O-68-169-01-01-06
MITYANA,MITYANA CTY NORTH,BULERA,BULERA,LWAMBA,214,0,0,12,22,105,139,6,145,0,O-68-169-01-01-07
MITYANA,MITYANA CTY NORTH,BULERA,BULERA/KIBALE,KIBAALE A,490,4,1,15,82,255,357,0,357,0,O-68-169-01-02-01
MITYANA,MITYANA CTY NORTH,BULERA,BULERA/KIBALE,KIBAALE B,419,1,0,17,67,240,325,8,333,0,O-68-169-01-02-02
MITYANA,MITYANA CTY NORTH,BULERA,KALAMA,NALUGI,509,1,1,8,33,271,314,10,324,0,O-68-169-01-03-01
MITYANA,MITYANA CTY NORTH,BULERA,KALAMA,NALYAMAGONJA/KYAMUSISI,539,1,0,5,38,291,335,0,335,0,O-68-169-01-03-02
MITYANA,MITYANA CTY NORTH,BULERA,KALAMA,KIBALU/MUKONGA,390,1,1,3,16,220,241,16,257,0,O-68-169-01-03-03
MITYANA,MITYANA CTY NORTH,BULERA,KALAMA,MAYOBYO,247,1,1,1,15,137,155,4,159,0,O-68-169-01-03-04
MITYANA,MITYANA CTY NORTH,BULERA,KALAMA,KYEWANISE,115,0,0,0,5,66,71,4,75,0,O-68-169-01-03-05
MITYANA,MITYANA CTY NORTH,BULERA,KALANGAALO,KALANGALO,794,4,1,7,88,448,548,12,560,0,O-68-169-01-04-01
MITYANA,MITYANA CTY NORTH,BULERA,KALANGAALO,KIMULI/KYAMUSISI,336,2,0,5,26,203,236,10,246,0,O-68-169-01-04-02
MITYANA,MITYANA CTY NORTH,BULERA,KALANGAALO,BUJAAYU,691,1,3,14,49,404,471,17,488,0,O-68-169-01-04-03
MITYANA,MITYANA CTY NORTH,BULERA,KIRYOOKYA,KIRYOKYA,781,2,8,20,90,407,527,31,558,0,O-68-169-01-05-01
MITYANA,MITYANA CTY NORTH,BULERA,KIRYOOKYA,MUGOYE,449,2,1,7,36,272,318,9,327,0,O-68-169-01-05-02
MITYANA,MITYANA CTY NORTH,BULERA,KIRYOOKYA,KIKUUTA,404,0,0,2,31,255,288,5,293,0,O-68-169-01-05-03
MITYANA,MITYANA CTY NORTH,BULERA,KITEREDDE,NAKAWERE,566,1,1,5,25,390,422,9,431,0,O-68-169-01-06-01
MITYANA,MITYANA CTY NORTH,BULERA,KITEREDDE,KIGO,268,0,1,1,8,179,189,5,194,0,O-68-169-01-06-02
MITYANA,MITYANA CTY NORTH,BULERA,KIYOGANYI,KISIGALA,228,1,0,0,18,161,180,8,188,0,O-68-169-01-07-01
MITYANA,MITYANA CTY NORTH,BULERA,KIYOGANYI,MAGOMA B,514,2,1,3,52,300,358,22,380,0,O-68-169-01-07-02
MITYANA,MITYANA CTY NORTH,BULERA,KIYOGANYI,KIYOGANYI A,484,1,1,6,103,236,347,10,357,0,O-68-169-01-07-03
MITYANA,MITYANA CTY NORTH,BULERA,KIYOGANYI,LUGAZI B,314,0,0,4,78,138,220,7,227,0,O-68-169-01-07-04
MITYANA,MITYANA CTY NORTH,BULERA,KIYOGANYI,BUSEMBI,212,1,1,3,30,116,151,4,155,0,O-68-169-01-07-05
MITYANA,MITYANA CTY NORTH,BULERA,LUSANJA,NAMUTIDDE/NGONZA,542,2,0,10,59,311,382,11,393,0,O-68-169-01-08-01
MITYANA,MITYANA CTY NORTH,BULERA,LUSANJA,MWERERWE,530,4,2,7,52,308,373,10,383,0,O-68-169-01-08-02
MITYANA,MITYANA CTY NORTH,BULERA,LUSANJA,NAMASENENE,300,4,1,3,31,164,203,10,213,0,O-68-169-01-08-03
MITYANA,MITYANA CTY NORTH,BULERA,LUSANJA,LUSANJA,646,7,2,16,66,341,432,31,463,0,O-68-169-01-08-04
MITYANA,MITYANA CTY NORTH,BULERA,LUSANJA,NAMUWUNDA/KATETO,194,2,0,16,37,101,156,6,162,0,O-68-169-01-08-05
MITYANA,MITYANA CTY NORTH,BULERA,MISEEBE,NABUSOLO/NALYANKANJA,769,2,0,9,64,421,496,83,579,0,O-68-169-01-09-01
MITYANA,MITYANA CTY NORTH,BULERA,MISEEBE,BULAMU,916,3,2,11,110,413,539,31,570,0,O-68-169-01-09-02
MITYANA,MITYANA CTY NORTH,BULERA,MISEEBE,GEMA/NAMBUTE,684,3,1,6,78,381,469,12,481,0,O-68-169-01-09-03
MITYANA,MITYANA CTY NORTH,BULERA,MISEEBE,MISEEBE,849,2,4,23,78,410,517,66,583,0,O-68-169-01-09-04
MITYANA,MITYANA CTY NORTH,BULERA,MUTETTEMA,MUTETEMA,704,5,5,27,111,349,497,8,505,0,O-68-169-01-10-01
MITYANA,MITYANA CTY NORTH,BULERA,MUTETTEMA,MIREMBE/KYAMANYOOLI,705,2,0,9,83,427,521,12,533,0,O-68-169-01-10-02
MITYANA,MITYANA CTY NORTH,BULERA,MUTETTEMA,SIROBERA/NDEKU,293,1,0,1,14,179,195,6,201,0,O-68-169-01-10-03
MITYANA,MITYANA CTY NORTH,BULERA,NAMUTAMBA,BUTUMBIZI,475,0,0,2,37,274,313,1,314,0,O-68-169-01-11-01
MITYANA,MITYANA CTY NORTH,BULERA,NAMUTAMBA,SAGALA/NAKYERIIRA,381,1,2,11,68,223,305,4,309,0,O-68-169-01-11-02
MITYANA,MITYANA CTY NORTH,BULERA,NAMUTAMBA,KABUNGO,711,1,1,13,91,433,539,16,555,0,O-68-169-01-11-03
MITYANA,MITYANA CTY NORTH,BULERA,NAMUTAMBA,KITEMU,337,1,1,13,36,198,249,0,249,0,O-68-169-01-11-04
MITYANA,MITYANA CTY NORTH,KIKANDWA,BAMBULA,BAMBULA,590,0,0,10,59,328,397,16,413,0,O-68-169-02-01-01
MITYANA,MITYANA CTY NORTH,KIKANDWA,BAMBULA,GAMBA,332,0,0,2,37,212,251,7,258,0,O-68-169-02-01-02
MITYANA,MITYANA CTY NORTH,KIKANDWA,BAMBULA,KASEJJERE,372,2,0,6,59,203,270,3,273,0,O-68-169-02-01-03
MITYANA,MITYANA CTY NORTH,KIKANDWA,KIKANDWA,KIKANDWA,453,0,0,10,96,216,322,13,335,0,O-68-169-02-02-01
MITYANA,MITYANA CTY NORTH,KIKANDWA,KIKANDWA,NABITETE B,413,1,1,6,51,254,313,17,330,0,O-68-169-02-02-02
MITYANA,MITYANA CTY NORTH,KIKANDWA,KIKANDWA,KABUMBA,609,4,1,6,70,373,454,21,475,0,O-68-169-02-02-03
MITYANA,MITYANA CTY NORTH,KIKANDWA,KIKUNYU,KITOLOLO,578,1,0,6,71,337,415,9,424,0,O-68-169-02-03-01
MITYANA,MITYANA CTY NORTH,KIKANDWA,KIKUNYU,KIKUNYU,819,2,0,15,127,415,559,15,574,0,O-68-169-02-03-02
MITYANA,MITYANA CTY NORTH,KIKANDWA,LUWUNGA,LUWUNGA,610,0,0,9,57,405,471,24,495,0,O-68-169-02-04-01
MITYANA,MITYANA CTY NORTH,KIKANDWA,LUWUNGA,KABULAMULIRO,386,2,0,2,21,249,274,13,287,0,O-68-169-02-04-02
MITYANA,MITYANA CTY NORTH,KIKANDWA,NAKWAYA,NAKWAYA A,861,2,3,28,230,266,529,30,559,0,O-68-169-02-05-01
MITYANA,MITYANA CTY NORTH,KIKANDWA,NAKWAYA,WABINYIRA,280,1,0,4,50,166,221,3,224,0,O-68-169-02-05-02
MITYANA,MITYANA CTY NORTH,KIKANDWA,NAMIGAVU,NAMIGAVU,562,1,2,7,75,326,411,5,416,0,O-68-169-02-06-01
MITYANA,MITYANA CTY NORTH,KIKANDWA,NAMIGAVU,KANYALE,271,0,1,5,29,184,219,4,223,0,O-68-169-02-06-02
MITYANA,MITYANA CTY NORTH,KIKANDWA,NAMWENE,NAKASEETA,313,2,1,3,27,218,251,10,261,0,O-68-169-02-07-01
MITYANA,MITYANA CTY NORTH,KIKANDWA,NAMWENE,WABIYINJA,289,1,2,0,8,224,235,5,240,0,O-68-169-02-07-02
MITYANA,MITYANA CTY NORTH,KIKANDWA,WATTUBA,NAMUZIKIZA,267,0,0,7,35,163,205,8,213,0,O-68-169-02-08-01
MITYANA,MITYANA CTY NORTH,KIKANDWA,WATTUBA,MATE,339,2,2,8,61,163,236,13,249,0,O-68-169-02-08-02
MITYANA,MITYANA CTY NORTH,KIKANDWA,WATTUBA,KASAMBYA,230,1,1,6,28,147,183,4,187,0,O-68-169-02-08-03
MITYANA,MITYANA CTY SOUTH,BUSIMBI,BUSUBIZI,MITIMBOJJE/GINGO,537,2,0,18,176,186,382,11,393,0,O-68-170-01-01-01
MITYANA,MITYANA CTY SOUTH,BUSIMBI,BUSUBIZI,MBAALE/KIGANWA,695,2,1,24,190,165,382,4,386,0,O-68-170-01-01-02
MITYANA,MITYANA CTY SOUTH,BUSIMBI,BUSUBIZI,NTIKIDDE,369,1,2,30,97,113,243,9,252,0,O-68-170-01-01-03
MITYANA,MITYANA CTY SOUTH,BUSIMBI,KABULE,KABULE A,602,4,0,24,119,278,425,10,435,0,O-68-170-01-02-01
MITYANA,MITYANA CTY SOUTH,BUSIMBI,KABULE,NKWALE,327,0,0,7,68,173,248,11,259,0,O-68-170-01-02-02
MITYANA,MITYANA CTY SOUTH,BUSIMBI,KABULE,SAALA B,288,1,1,12,73,148,235,5,240,0,O-68-170-01-02-03
MITYANA,MITYANA CTY SOUTH,BUSIMBI,KABULE,KABULE B,265,2,0,6,53,126,187,18,205,0,O-68-170-01-02-04
MITYANA,MITYANA CTY SOUTH,BUSIMBI,KABUWAMBO,BUGABO/NANDEGEJJA,294,2,5,3,54,179,243,8,251,0,O-68-170-01-03-01
MITYANA,MITYANA CTY SOUTH,BUSIMBI,KABUWAMBO,LUBIRA/KIWAMIREMBE,650,3,3,27,156,304,493,15,508,0,O-68-170-01-03-02
MITYANA,MITYANA CTY SOUTH,BUSIMBI,KABUWAMBO,KABUWAMBO CENTRAL,723,1,1,40,210,299,551,29,580,0,O-68-170-01-03-03
MITYANA,MITYANA CTY SOUTH,BUSIMBI,KATAKALA,MAGONGOLO/NKONYA,412,3,1,10,78,183,275,5,280,0,O-68-170-01-04-01
MITYANA,MITYANA CTY SOUTH,BUSIMBI,KATAKALA,KATAKALA/KANSALEETI,764,4,2,31,174,264,475,23,498,0,O-68-170-01-04-02
MITYANA,MITYANA CTY SOUTH,BUSIMBI,KATAKALA,NAMAMONDE,421,2,1,10,144,165,322,3,325,0,O-68-170-01-04-03
MITYANA,MITYANA CTY SOUTH,BUSIMBI,KIREKU,KIREKU,473,1,0,9,141,195,346,14,360,0,O-68-170-01-05-01
MITYANA,MITYANA CTY SOUTH,BUSIMBI,KIREKU,LUBANJA,737,11,0,7,197,333,548,18,566,0,O-68-170-01-05-02
MITYANA,MITYANA CTY SOUTH,BUSIMBI,KIREKU,KATETE TC,291,2,1,2,57,157,219,11,230,0,O-68-170-01-05-03
MITYANA,MITYANA CTY SOUTH,BUSIMBI,NAAMA,NAAMA,462,3,1,15,118,200,337,4,341,0,O-68-170-01-06-01
MITYANA,MITYANA CTY SOUTH,BUSIMBI,NAAMA,GOMBE//KALAMBA,338,3,0,16,76,154,249,6,255,0,O-68-170-01-06-02
MITYANA,MITYANA CTY SOUTH,BUSIMBI,NAAMA,KATIKO,448,4,1,6,91,212,314,13,327,0,O-68-170-01-06-03
MITYANA,MITYANA CTY SOUTH,BUSIMBI,NAAMA,BUSEENDO/BUTAAMI,556,4,0,22,127,229,382,6,388,0,O-68-170-01-06-04
MITYANA,MITYANA CTY SOUTH,BUSIMBI,NAAMA,BUSINZIGGO/NALUGAZI,567,2,1,12,158,206,379,61,440,0,O-68-170-01-06-05
MITYANA,MITYANA CTY SOUTH,BUSIMBI,NAAMA,NAAMA JUNIOR SCHOOL,324,3,0,19,94,97,213,4,217,0,O-68-170-01-06-06
MITYANA,MITYANA CTY SOUTH,BUSIMBI,NAAMA,NAAMA A,325,4,1,9,87,121,222,1,223,0,O-68-170-01-06-07
MITYANA,MITYANA CTY SOUTH,BUSIMBI,NAKASEETA,KISULE A,641,1,1,10,140,282,434,33,467,0,O-68-170-01-07-01
MITYANA,MITYANA CTY SOUTH,BUSIMBI,NAKASEETA,KISULE B,740,2,3,16,202,330,553,16,569,0,O-68-170-01-07-02
MITYANA,MITYANA CTY SOUTH,BUSIMBI,NAKIBANGA,BUTEBI,497,3,0,16,112,240,371,1,372,0,O-68-170-01-08-01
MITYANA,MITYANA CTY SOUTH,BUSIMBI,NAKIBANGA,NAMBAALE,516,1,2,8,153,162,326,26,352,0,O-68-170-01-08-02
MITYANA,MITYANA CTY SOUTH,BUSIMBI,NAKIBANGA,NAKIBANGA,650,3,3,44,141,280,471,9,480,0,O-68-170-01-08-03
MITYANA,MITYANA CTY SOUTH,BUSIMBI,NAKIBANGA,KIWEEREZA,272,1,0,10,94,86,191,11,202,0,O-68-170-01-08-04
MITYANA,MITYANA CTY SOUTH,BUSIMBI,TTAMU,GGINZI/NDIBULUNGI,581,1,0,9,198,192,400,18,418,0,O-68-170-01-09-01
MITYANA,MITYANA CTY SOUTH,BUSIMBI,TTAMU,KITINKOKOLA,429,1,0,8,112,153,274,16,290,0,O-68-170-01-09-02
MITYANA,MITYANA CTY SOUTH,BUSIMBI,TTAMU,TTAMU,618,2,1,14,193,233,443,7,450,0,O-68-170-01-09-03
MITYANA,MITYANA CTY SOUTH,BUSIMBI,TTAMU,BUSERE/MPANGA,407,4,0,2,77,177,260,44,304,0,O-68-170-01-09-04
MITYANA,MITYANA CTY SOUTH,BUSIMBI,TTAMU,KITO/GGALABI,520,0,0,3,59,309,371,21,392,0,O-68-170-01-09-05
MITYANA,MITYANA CTY SOUTH,BUSIMBI,TTANDA,NAKITOLO/NAKANYENYA,820,4,3,17,181,416,621,10,631,0,O-68-170-01-10-01
MITYANA,MITYANA CTY SOUTH,BUSIMBI,TTANDA,BUKONGO/KIWAMBYA,392,1,0,17,69,234,321,5,326,0,O-68-170-01-10-02
MITYANA,MITYANA CTY SOUTH,MITYANA TOWN COUNCIL,CENTRAL WARD,AGIP KAMPALA RD. A,763,3,2,19,282,188,494,1,495,0,O-68-170-02-01-01
MITYANA,MITYANA CTY SOUTH,MITYANA TOWN COUNCIL,CENTRAL WARD,BUSIMBI C.U. A,1133,6,3,44,397,277,727,12,739,0,O-68-170-02-01-02
MITYANA,MITYANA CTY SOUTH,MITYANA TOWN COUNCIL,CENTRAL WARD,BUSIMBI C.U. B (A-M),422,3,3,13,154,109,282,5,287,0,O-68-170-02-01-03
MITYANA,MITYANA CTY SOUTH,MITYANA TOWN COUNCIL,CENTRAL WARD,AGIP KAMPALA RD. B,746,1,1,26,242,171,441,7,448,0,O-68-170-02-01-04
MITYANA,MITYANA CTY SOUTH,MITYANA TOWN COUNCIL,CENTRAL WARD,BUSIMBI C.U. B (N-Z),443,2,1,21,142,130,296,1,297,0,O-68-170-02-01-05
MITYANA,MITYANA CTY SOUTH,MITYANA TOWN COUNCIL,EAST WARD,BUSIMBI GOMBOLOLA AREA A,920,6,0,27,297,215,545,1,546,0,O-68-170-02-02-01
MITYANA,MITYANA CTY SOUTH,MITYANA TOWN COUNCIL,EAST WARD,BUSIMBI RAILWAY,516,1,2,9,163,140,315,7,322,0,O-68-170-02-02-02
MITYANA,MITYANA CTY SOUTH,MITYANA TOWN COUNCIL,EAST WARD,MUSALABA,777,0,1,24,257,196,478,3,481,0,O-68-170-02-02-03
MITYANA,MITYANA CTY SOUTH,MITYANA TOWN COUNCIL,EAST WARD,KIYINDA A,877,4,1,50,273,234,562,8,570,0,O-68-170-02-02-04
MITYANA,MITYANA CTY SOUTH,MITYANA TOWN COUNCIL,EAST WARD,BUSIMBI GOMBOLOLA AREA B (K-,132,0,0,5,45,18,68,1,69,0,O-68-170-02-02-05
MITYANA,MITYANA CTY SOUTH,MITYANA TOWN COUNCIL,EAST WARD,KIBIBI GARAGE A,280,0,3,17,97,62,179,1,180,0,O-68-170-02-02-06
MITYANA,MITYANA CTY SOUTH,MITYANA TOWN COUNCIL,EAST WARD,KIBIBI GARAGE B,378,2,0,15,134,66,217,17,234,0,O-68-170-02-02-07
MITYANA,MITYANA CTY SOUTH,MITYANA TOWN COUNCIL,EAST WARD,KIYINDA B,508,2,2,19,146,133,302,7,309,0,O-68-170-02-02-08
MITYANA,MITYANA CTY SOUTH,MITYANA TOWN COUNCIL,EAST WARD,BUSIMBI GOMBOLOLA AREA B (O-,273,0,1,11,103,46,161,0,161,0,O-68-170-02-02-09
MITYANA,MITYANA CTY SOUTH,MITYANA TOWN COUNCIL,EAST WARD,BUSIMBI GOMBOLOLA AREA B ( N,722,2,1,11,166,236,416,4,420,0,O-68-170-02-02-10
MITYANA,MITYANA CTY SOUTH,MITYANA TOWN COUNCIL,NORTH WARD,BBUYE/KIKUMBI (A-M),530,2,0,11,194,111,318,8,326,0,O-68-170-02-03-01
MITYANA,MITYANA CTY SOUTH,MITYANA TOWN COUNCIL,NORTH WARD,BUSWA-BULONGO (A-M),483,2,0,12,168,101,283,3,286,0,O-68-170-02-03-02
MITYANA,MITYANA CTY SOUTH,MITYANA TOWN COUNCIL,NORTH WARD,KIKUMBI ROMAN CATHOLIC,205,2,1,11,67,63,144,7,151,0,O-68-170-02-03-03
MITYANA,MITYANA CTY SOUTH,MITYANA TOWN COUNCIL,NORTH WARD,MIZIGO A,827,1,0,17,251,278,547,8,555,0,O-68-170-02-03-04
MITYANA,MITYANA CTY SOUTH,MITYANA TOWN COUNCIL,NORTH WARD,MIZIGO B/KATAKALA A,756,0,2,41,201,251,495,0,495,0,O-68-170-02-03-05
MITYANA,MITYANA CTY SOUTH,MITYANA TOWN COUNCIL,NORTH WARD,BBUYE/KIKUMBI (N-Z),661,1,3,20,184,184,392,13,405,0,O-68-170-02-03-06
MITYANA,MITYANA CTY SOUTH,MITYANA TOWN COUNCIL,NORTH WARD,BUSWA-BULONGO (N-Z),742,1,2,18,197,210,428,11,439,0,O-68-170-02-03-07
MITYANA,MITYANA CTY SOUTH,MITYANA TOWN COUNCIL,SOUTH WARD,KIWESA/KIKUMAMBOGO A,559,2,1,28,223,119,373,7,380,0,O-68-170-02-04-01
MITYANA,MITYANA CTY SOUTH,MITYANA TOWN COUNCIL,SOUTH WARD,MAGALA/NTIKIDDE,536,1,1,18,198,124,342,4,346,0,O-68-170-02-04-02
MITYANA,MITYANA CTY SOUTH,MITYANA TOWN COUNCIL,SOUTH WARD,WABIGALO,936,3,1,46,343,230,623,8,631,0,O-68-170-02-04-03
MITYANA,MITYANA CTY SOUTH,MITYANA TOWN COUNCIL,SOUTH WARD,KIWESA/KIKUMAMBOGO B,794,2,0,35,229,222,488,7,495,0,O-68-170-02-04-04
MITYANA,MITYANA CTY SOUTH,MITYANA TOWN COUNCIL,WEST WARD,KAYUNGA CENTRAL,509,3,0,23,140,130,296,7,303,0,O-68-170-02-05-01
MITYANA,MITYANA CTY SOUTH,MITYANA TOWN COUNCIL,WEST WARD,KAYUNGA KIGOGWA,742,2,0,20,238,242,502,4,506,0,O-68-170-02-05-02
MITYANA,MITYANA CTY SOUTH,MITYANA TOWN COUNCIL,WEST WARD,KAYUNGA KIMEMETE,416,2,2,23,128,122,277,5,282,0,O-68-170-02-05-03
MITYANA,MITYANA CTY SOUTH,MITYANA TOWN COUNCIL,WEST WARD,MITYANA A/KANAMBA,708,0,1,28,204,261,494,5,499,0,O-68-170-02-05-04
MITYANA,MITYANA CTY SOUTH,MITYANA TOWN COUNCIL,WEST WARD,MITYANA CENTRAL/NAMUKOZI CE,477,3,0,14,105,176,298,2,300,0,O-68-170-02-05-05
MITYANA,MITYANA CTY SOUTH,MITYANA TOWN COUNCIL,WEST WARD,MITYANA JUNIOR PRIMARY SCHO,357,3,0,9,83,167,262,3,265,0,O-68-170-02-05-06
MITYANA,MITYANA CTY SOUTH,SSEKANYONYI,BULYANKUYEGE,BULYANKUYEGE,727,1,2,25,101,364,493,7,500,0,O-68-170-03-01-01
MITYANA,MITYANA CTY SOUTH,SSEKANYONYI,BULYANKUYEGE,LUKAAKA,448,0,0,13,91,230,334,6,340,0,O-68-170-03-01-02
MITYANA,MITYANA CTY SOUTH,SSEKANYONYI,BULYANKUYEGE,KABIRI,348,2,2,25,60,169,258,3,261,0,O-68-170-03-01-03
MITYANA,MITYANA CTY SOUTH,SSEKANYONYI,BUSUNJU,KABBEGA,446,0,0,5,54,255,314,6,320,0,O-68-170-03-02-01
MITYANA,MITYANA CTY SOUTH,SSEKANYONYI,BUSUNJU,SSEBOBBO,298,3,0,5,48,161,217,6,223,0,O-68-170-03-02-02
MITYANA,MITYANA CTY SOUTH,SSEKANYONYI,BUSUNJU,NAKASERO,324,0,2,4,23,200,229,13,242,0,O-68-170-03-02-03
MITYANA,MITYANA CTY SOUTH,SSEKANYONYI,BUSUNJU,BUSUNJU CENTRAL A,862,2,1,15,165,281,464,8,472,0,O-68-170-03-02-04
MITYANA,MITYANA CTY SOUTH,SSEKANYONYI,BUSUNJU,KIDUUZI CENTRE(NEW),358,0,1,5,39,198,243,19,262,0,O-68-170-03-02-05
MITYANA,MITYANA CTY SOUTH,SSEKANYONYI,BUSUNJU,BUSUNJU CENTRAL B,861,4,0,9,164,314,491,19,510,0,O-68-170-03-02-06
MITYANA,MITYANA CTY SOUTH,SSEKANYONYI,KAGEREKAMU,BUKOOBA,711,1,0,16,110,376,503,7,510,0,O-68-170-03-03-01
MITYANA,MITYANA CTY SOUTH,SSEKANYONYI,KAGEREKAMU,KYAKKOSI,690,2,0,15,125,370,512,6,518,0,O-68-170-03-03-02
MITYANA,MITYANA CTY SOUTH,SSEKANYONYI,KAGEREKAMU,KANYOGOGA,381,3,0,9,54,220,286,12,298,0,O-68-170-03-03-03
MITYANA,MITYANA CTY SOUTH,SSEKANYONYI,KAGEREKAMU,KATIITI,332,0,0,7,84,145,236,21,257,0,O-68-170-03-03-04
MITYANA,MITYANA CTY SOUTH,SSEKANYONYI,KAGEREKAMU,NAKIRAGALA,278,1,0,6,47,140,194,13,207,0,O-68-170-03-03-05
MITYANA,MITYANA CTY SOUTH,SSEKANYONYI,KISAANA,KITEETE,548,1,2,13,99,276,391,9,400,0,O-68-170-03-04-01
MITYANA,MITYANA CTY SOUTH,SSEKANYONYI,KISAANA,NAKABAZZI,272,0,0,7,68,140,215,5,220,0,O-68-170-03-04-02
MITYANA,MITYANA CTY SOUTH,SSEKANYONYI,KISAANA,KISAANA,717,1,2,18,212,273,506,9,515,0,O-68-170-03-04-03
MITYANA,MITYANA CTY SOUTH,SSEKANYONYI,KISAANA,BUWALULA TC,387,0,0,4,83,200,287,8,295,0,O-68-170-03-04-04
MITYANA,MITYANA CTY SOUTH,SSEKANYONYI,KISAANA,DAVULA TC,194,2,0,5,29,109,145,3,148,0,O-68-170-03-04-05
MITYANA,MITYANA CTY SOUTH,SSEKANYONYI,MAGALA,MAGALA/NKUUBI,595,2,0,5,74,346,427,8,435,0,O-68-170-03-05-01
MITYANA,MITYANA CTY SOUTH,SSEKANYONYI,MAGALA,KASIKOMBE PRI. SCHOOL,505,3,1,8,48,311,371,9,380,0,O-68-170-03-05-02
MITYANA,MITYANA CTY SOUTH,SSEKANYONYI,MAGALA,BUDIMBO PRI. SCHOOL,255,1,0,2,17,173,193,3,196,0,O-68-170-03-05-03
MITYANA,MITYANA CTY SOUTH,SSEKANYONYI,MPIRIGWA,NABUTAKA,697,6,2,11,152,376,547,12,559,0,O-68-170-03-06-01
MITYANA,MITYANA CTY SOUTH,SSEKANYONYI,MPIRIGWA,ZZIRA/NAKWANGU/KITEREDDE/M,578,1,0,14,142,282,439,12,451,0,O-68-170-03-06-02
MITYANA,MITYANA CTY SOUTH,SSEKANYONYI,MPIRIGWA,BUKALAKAMBA,688,4,1,14,90,374,483,3,486,0,O-68-170-03-06-03
MITYANA,MITYANA CTY SOUTH,SSEKANYONYI,NAMUNGO,LUNYOLYA,382,0,0,3,35,260,298,5,303,0,O-68-170-03-07-01
MITYANA,MITYANA CTY SOUTH,SSEKANYONYI,NAMUNGO,NAMUNGO,759,3,1,9,137,421,571,20,591,0,O-68-170-03-07-02
MITYANA,MITYANA CTY SOUTH,SSEKANYONYI,NAMUNGO,KASANGULA,481,2,0,2,49,316,369,15,384,0,O-68-170-03-07-03
MITYANA,MITYANA CTY SOUTH,SSEKANYONYI,SSEKANYONYI,SSEKANYONYI/MAKAJJO (A-M),455,2,1,15,135,174,327,9,336,0,O-68-170-03-08-01
MITYANA,MITYANA CTY SOUTH,SSEKANYONYI,SSEKANYONYI,LUGUZI/BUTALALE,491,1,0,1,92,239,333,7,340,0,O-68-170-03-08-02
MITYANA,MITYANA CTY SOUTH,SSEKANYONYI,SSEKANYONYI,BBIRA/KASWI,524,1,0,4,79,285,369,0,369,0,O-68-170-03-08-03
MITYANA,MITYANA CTY SOUTH,SSEKANYONYI,SSEKANYONYI,LUWONVU STORE(NEW),204,0,0,1,33,119,153,4,157,0,O-68-170-03-08-04
MITYANA,MITYANA CTY SOUTH,SSEKANYONYI,SSEKANYONYI,SSEKANYONYI/MAKAJJO (M-Z),584,0,1,10,131,283,425,11,436,0,O-68-170-03-08-05
NAKASEKE,NAKASEKE COUNTY,KAASANGOMBE,BUKUUKU,UKUUKU Pr. SCH.,467,1,0,7,73,246,327,5,332,0,O-69-109-01-01-01
NAKASEKE,NAKASEKE COUNTY,KAASANGOMBE,BUKUUKU,UKYAMU PR. SCHOOL,410,2,0,12,67,190,271,9,280,0,O-69-109-01-01-02
NAKASEKE,NAKASEKE COUNTY,KAASANGOMBE,BUKUUKU,UKUUKU Pr. SCH.,170,2,0,1,7,120,130,1,131,0,O-69-109-01-01-03
NAKASEKE,NAKASEKE COUNTY,KAASANGOMBE,BULYAKE,UGENYI Pr. SCH. A,659,4,0,14,99,350,467,9,476,0,O-69-109-01-02-01
NAKASEKE,NAKASEKE COUNTY,KAASANGOMBE,BULYAKE,UGENYI Pr. SCH. B,522,2,0,9,65,285,361,9,370,0,O-69-109-01-02-02
NAKASEKE,NAKASEKE COUNTY,KAASANGOMBE,MPWEDDE,AMASUBA,356,0,1,3,50,189,243,11,254,0,O-69-109-01-03-01
NAKASEKE,NAKASEKE COUNTY,KAASANGOMBE,MPWEDDE,AMASUBA B,195,1,0,2,34,94,131,5,136,0,O-69-109-01-03-02
NAKASEKE,NAKASEKE COUNTY,KAASANGOMBE,MPWEDDE,UKALABI,457,2,0,15,73,183,273,9,282,0,O-69-109-01-03-03
NAKASEKE,NAKASEKE COUNTY,KAASANGOMBE,MPWEDDE,AYIRIKITI,507,2,0,4,43,269,318,3,321,0,O-69-109-01-03-04
NAKASEKE,NAKASEKE COUNTY,KAASANGOMBE,MPWEDDE,WERA,284,1,0,3,42,113,159,8,167,0,O-69-109-01-03-05
NAKASEKE,NAKASEKE COUNTY,KAASANGOMBE,NAKASEETA,AKASEETA T/C,459,1,0,9,53,251,314,14,328,0,O-69-109-01-04-01
NAKASEKE,NAKASEKE COUNTY,KAASANGOMBE,NAKASEETA,IBALE,385,0,0,8,76,195,279,8,287,0,O-69-109-01-04-02
NAKASEKE,NAKASEKE COUNTY,KAASANGOMBE,NAKASEETA,IKUMANGO,517,7,2,11,85,282,387,13,400,0,O-69-109-01-04-03
NAKASEKE,NAKASEKE COUNTY,KAASANGOMBE,NAKASEETA,UKABALA NURSERY SCHOOL,395,3,1,3,52,214,273,12,285,0,O-69-109-01-04-04
NAKASEKE,NAKASEKE COUNTY,KAASANGOMBE,SAKABUSOLO,EKABUSOLO PARISH HQTRS.,678,0,0,12,70,429,511,5,516,0,O-69-109-01-05-01
NAKASEKE,NAKASEKE COUNTY,KAPEEKA,KALAGALA,ALAGALA,555,4,3,1,21,357,386,11,397,0,O-69-109-02-01-01
NAKASEKE,NAKASEKE COUNTY,KAPEEKA,KALAGALA,AGOGWE,356,0,0,5,27,183,215,7,222,0,O-69-109-02-01-02
NAKASEKE,NAKASEKE COUNTY,KAPEEKA,KAPEEKA,APEEKA PRIMARY SCHOOL (A -,662,4,0,12,90,316,422,8,430,0,O-69-109-02-02-01
NAKASEKE,NAKASEKE COUNTY,KAPEEKA,KAPEEKA,UKEEKA Pr. SCHOOL,536,0,0,18,108,271,397,20,417,0,O-69-109-02-02-02
NAKASEKE,NAKASEKE COUNTY,KAPEEKA,KAPEEKA,APEEKA PRIMARY SCHOOL (N -,824,2,2,7,72,371,454,8,462,0,O-69-109-02-02-03
NAKASEKE,NAKASEKE COUNTY,KAPEEKA,KISIMULA,ASIGA,383,1,0,5,16,239,261,4,265,0,O-69-109-02-03-01
NAKASEKE,NAKASEKE COUNTY,KAPEEKA,KISIMULA,ISIMULA Pr. SCHOOL,492,2,2,5,15,352,376,10,386,0,O-69-109-02-03-02
NAKASEKE,NAKASEKE COUNTY,KAPEEKA,KISIMULA,AKOORA Pr. SCHOOL A(A-M),222,1,0,0,32,173,206,4,210,0,O-69-109-02-03-03
NAKASEKE,NAKASEKE COUNTY,KAPEEKA,KISIMULA,YEREREZI T/C,287,0,1,1,16,141,159,5,164,0,O-69-109-02-03-04
NAKASEKE,NAKASEKE COUNTY,KAPEEKA,KISIMULA,AKOORA Pr. SCHOOL B(N-Z),165,0,0,1,45,117,163,2,165,0,O-69-109-02-03-05
NAKASEKE,NAKASEKE COUNTY,KAPEEKA,KISIMULA,AKOOLA OUTSIDE GUARD (A-L),531,0,2,4,62,415,483,3,486,0,O-69-109-02-03-06
NAKASEKE,NAKASEKE COUNTY,KAPEEKA,KISIMULA,AKOOLA OUTSIDE GUARD (M-Z),705,0,2,1,108,581,692,13,705,0,O-69-109-02-03-07
NAKASEKE,NAKASEKE COUNTY,KAPEEKA,KITTO,USANJE,273,0,0,2,35,184,221,7,228,0,O-69-109-02-04-01
NAKASEKE,NAKASEKE COUNTY,KAPEEKA,KITTO,ITTO,317,5,0,2,51,180,238,6,244,0,O-69-109-02-04-02
NAKASEKE,NAKASEKE COUNTY,KAPEEKA,KITTO,AKATAAMA RC P/S,189,0,0,1,9,132,142,3,145,0,O-69-109-02-04-03
NAKASEKE,NAKASEKE COUNTY,KAPEEKA,KIVUMU,IVUMU Pr. SCH. A,337,0,0,3,21,216,240,3,243,0,O-69-109-02-05-01
NAKASEKE,NAKASEKE COUNTY,KAPEEKA,KIVUMU,IVUMU PR. SCHOOL B,286,1,1,3,9,175,189,2,191,0,O-69-109-02-05-02
NAKASEKE,NAKASEKE COUNTY,KAPEEKA,KIVUMU,ATALE KAMESE T.C,433,1,1,5,13,271,291,20,311,0,O-69-109-02-05-03
NAKASEKE,NAKASEKE COUNTY,KAPEEKA,NALUVULE,ALATIRA,301,1,0,7,32,155,195,6,201,0,O-69-109-02-06-01
NAKASEKE,NAKASEKE COUNTY,KAPEEKA,NALUVULE,IFAMPA,552,0,0,5,37,302,344,22,366,0,O-69-109-02-06-02
NAKASEKE,NAKASEKE COUNTY,KAPEEKA,NALUVULE,ASAMBYA STORE,281,0,0,2,17,161,180,3,183,0,O-69-109-02-06-03
NAKASEKE,NAKASEKE COUNTY,KAPEEKA,NALUVULE,WENTUGA P/S,292,1,0,3,28,190,222,4,226,0,O-69-109-02-06-04
NAKASEKE,NAKASEKE COUNTY,KAPEEKA,NALUVULE,ASIISO T/C,389,1,1,6,17,226,251,13,264,0,O-69-109-02-06-05
NAKASEKE,NAKASEKE COUNTY,KAPEEKA,NAMUSAALE,AMUSUTA Pr. SCH.,315,1,0,9,27,198,235,6,241,0,O-69-109-02-07-01
NAKASEKE,NAKASEKE COUNTY,KAPEEKA,NAMUSAALE,AMUSAALE Pr. SCH.,614,2,1,3,65,332,403,11,414,0,O-69-109-02-07-02
NAKASEKE,NAKASEKE COUNTY,KAPEEKA,NAMUSAALE,ENDEGERE T/C,372,0,1,8,41,229,279,5,284,0,O-69-109-02-07-03
NAKASEKE,NAKASEKE COUNTY,KIKAMULO,KAMULI (MUSALE),AMULI Pr. SCHOOL,562,2,1,14,80,246,343,7,350,0,O-69-109-03-01-01
NAKASEKE,NAKASEKE COUNTY,KIKAMULO,KAMULI (MUSALE),NAKAZILUGO T/C,174,1,0,3,10,103,117,3,120,0,O-69-109-03-01-02
NAKASEKE,NAKASEKE COUNTY,KIKAMULO,KAMULI (MUSALE),LUMPEWE P/SCH,474,3,0,2,50,243,298,14,312,0,O-69-109-03-01-03
NAKASEKE,NAKASEKE COUNTY,KIKAMULO,KAPEKE,UTIKWA,377,1,1,1,42,198,243,6,249,0,O-69-109-03-02-01
NAKASEKE,NAKASEKE COUNTY,KIKAMULO,KAPEKE,APEKE,577,0,0,7,47,343,397,4,401,0,O-69-109-03-02-02
NAKASEKE,NAKASEKE COUNTY,KIKAMULO,KAPEKE,ABALE TOWN C.,333,1,0,0,15,168,184,18,202,0,O-69-109-03-02-03
NAKASEKE,NAKASEKE COUNTY,KIKAMULO,KASANA,KIWOKO P.S.,554,4,1,14,85,244,348,12,360,0,O-69-109-03-03-01
NAKASEKE,NAKASEKE COUNTY,KIKAMULO,KASANA,WABITUNDA,456,3,1,7,67,226,304,27,331,0,O-69-109-03-03-02
NAKASEKE,NAKASEKE COUNTY,KIKAMULO,KASANA,KIWOKO MOSQUE,759,3,0,12,156,270,441,7,448,0,O-69-109-03-03-03
NAKASEKE,NAKASEKE COUNTY,KIKAMULO,KIBOSSE,KIBOSSE,608,2,0,8,55,320,385,12,397,0,O-69-109-03-04-01
NAKASEKE,NAKASEKE COUNTY,KIKAMULO,KIBOSSE,NSANVU,346,1,0,3,19,244,267,3,270,0,O-69-109-03-04-02
NAKASEKE,NAKASEKE COUNTY,KIKAMULO,KIBOSSE,KYASAMPANGO T.C,335,1,1,5,47,176,230,3,233,0,O-69-109-03-04-03
NAKASEKE,NAKASEKE COUNTY,KIKAMULO,LUTEETE,LUTEETE Pr. SCHOOL,912,2,2,5,47,503,559,8,567,0,O-69-109-03-05-01
NAKASEKE,NAKASEKE COUNTY,KIKAMULO,LUTEETE,BUKOTO T/C,424,0,0,3,31,235,269,6,275,0,O-69-109-03-05-02
NAKASEKE,NAKASEKE COUNTY,KIKAMULO,MAGOMA,MAGOMA PR. SCHOOL,636,1,1,7,79,313,401,16,417,0,O-69-109-03-06-01
NAKASEKE,NAKASEKE COUNTY,KIKAMULO,MAGOMA,CITY OF FAITH PR. SCHOOL,637,1,0,9,93,260,363,15,378,0,O-69-109-03-06-02
NAKASEKE,NAKASEKE COUNTY,KIKAMULO,MAGOMA,KIKAMULO S/C HQTS,273,0,0,7,39,129,175,4,179,0,O-69-109-03-06-03
NAKASEKE,NAKASEKE COUNTY,KIKAMULO,MAGOMA,KIKUBANIMBA,244,1,0,1,32,128,162,10,172,0,O-69-109-03-06-04
NAKASEKE,NAKASEKE COUNTY,KIKAMULO,WAKAYAMBA,KABUBU MARKET,777,6,1,6,65,422,500,20,520,0,O-69-109-03-07-01
NAKASEKE,NAKASEKE COUNTY,KIKAMULO,WAKAYAMBA,WAKAYAMBA,324,0,0,2,26,190,218,2,220,0,O-69-109-03-07-02
NAKASEKE,NAKASEKE COUNTY,KINYOGOGA,BUWANA,BUWANA,379,0,0,1,4,362,367,3,370,0,O-69-109-04-01-01
NAKASEKE,NAKASEKE COUNTY,KINYOGOGA,BUWANA,KAGONGI,164,0,0,0,1,160,161,1,162,0,O-69-109-04-01-02
NAKASEKE,NAKASEKE COUNTY,KINYOGOGA,BUWANA,BUWANA OUTSIDE Q.GUARD A(A-,634,1,1,3,76,548,629,5,634,0,O-69-109-04-01-03
NAKASEKE,NAKASEKE COUNTY,KINYOGOGA,BUWANA,BUWANA OUTSIDE Q.GUARD B (M,926,1,1,1,141,765,909,11,920,0,O-69-109-04-01-04
NAKASEKE,NAKASEKE COUNTY,KINYOGOGA,KINYOGOGA,KINYOGOGA,684,1,0,1,30,430,462,3,465,0,O-69-109-04-02-01
NAKASEKE,NAKASEKE COUNTY,KINYOGOGA,KINYOGOGA,KIBAMBIRE,112,0,0,0,0,94,94,3,97,0,O-69-109-04-02-02
NAKASEKE,NAKASEKE COUNTY,KINYOGOGA,KINYOGOGA,KYAMAWENO,170,0,0,0,4,158,162,4,166,0,O-69-109-04-02-03
NAKASEKE,NAKASEKE COUNTY,KINYOGOGA,RUKONO,KIMOTOZI P/S,197,0,0,0,2,187,189,2,191,0,O-69-109-04-03-01
NAKASEKE,NAKASEKE COUNTY,KINYOGOGA,RUKONO,RUKONO,398,0,0,1,8,388,397,0,397,0,O-69-109-04-03-02
NAKASEKE,NAKASEKE COUNTY,KINYOGOGA,RWOMA,BUTEBERE,190,0,0,0,5,183,188,2,190,0,O-69-109-04-04-01
NAKASEKE,NAKASEKE COUNTY,KINYOGOGA,RWOMA,LWAMAWUNGU,216,0,2,0,0,214,216,0,216,0,O-69-109-04-04-02
NAKASEKE,NAKASEKE COUNTY,KINYOGOGA,RWOMA,RWOMA,269,0,0,0,2,130,132,3,135,0,O-69-109-04-04-03
NAKASEKE,NAKASEKE COUNTY,KINYOGOGA,RWOMA,KITINDO,187,0,0,0,3,178,181,5,186,0,O-69-109-04-04-04
NAKASEKE,NAKASEKE COUNTY,KINYOGOGA,RWOMA,KYARUSESA,160,0,0,0,3,155,158,1,159,0,O-69-109-04-04-05
NAKASEKE,NAKASEKE COUNTY,NAKASEKE,BULWADDA,SEMBWA T.CENTRE,455,0,1,3,29,297,330,5,335,0,O-69-109-05-01-01
NAKASEKE,NAKASEKE COUNTY,NAKASEKE,BULWADDA,BULWADDA PARISH HQT,537,3,0,13,54,306,376,15,391,0,O-69-109-05-01-02
NAKASEKE,NAKASEKE COUNTY,NAKASEKE,KASAGGA,KASAGGA,631,3,0,8,66,323,400,33,433,0,O-69-109-05-02-01
NAKASEKE,NAKASEKE COUNTY,NAKASEKE,KASAGGA,SEKANYONYI,379,1,0,3,28,211,243,17,260,0,O-69-109-05-02-02
NAKASEKE,NAKASEKE COUNTY,NAKASEKE,KASAMBYA,KASAMBYA,387,1,1,8,28,237,275,10,285,0,O-69-109-05-03-01
NAKASEKE,NAKASEKE COUNTY,NAKASEKE,KASAMBYA,BUTEMULA NURSERY SCHOOL,198,0,0,1,26,143,170,4,174,0,O-69-109-05-03-02
NAKASEKE,NAKASEKE COUNTY,NAKASEKE,KIGEGE,KIGEGE,753,6,0,18,149,341,514,11,525,0,O-69-109-05-04-01
NAKASEKE,NAKASEKE COUNTY,NAKASEKE,KIGEGE,MULUNGIOMU P/S,367,0,0,5,45,189,239,16,255,0,O-69-109-05-04-02
NAKASEKE,NAKASEKE COUNTY,NAKASEKE,KYAMUTAKASA,KALAGALA P.S,249,3,0,10,54,136,203,4,207,0,O-69-109-05-05-01
NAKASEKE,NAKASEKE COUNTY,NAKASEKE,KYAMUTAKASA,NABBIIKA P/SCH,332,3,1,5,81,150,240,10,250,0,O-69-109-05-05-02
NAKASEKE,NAKASEKE COUNTY,NAKASEKE,MIFUNYA,MIFUNYA,715,2,1,10,57,370,440,24,464,0,O-69-109-05-06-01
NAKASEKE,NAKASEKE COUNTY,NAKASEKE,MIFUNYA,KIVULE,159,0,0,0,21,88,109,0,109,0,O-69-109-05-06-02
NAKASEKE,NAKASEKE COUNTY,NAKASEKE,MIFUNYA,LUVUNVU,296,4,1,6,28,159,198,10,208,0,O-69-109-05-06-03
NAKASEKE,NAKASEKE COUNTY,NAKASEKE,MIFUNYA,KYAMBOGO T/C,201,4,0,0,17,138,159,5,164,0,O-69-109-05-06-04
NAKASEKE,NAKASEKE COUNTY,NAKASEKE,NAKASEKE,NAKASEKE CTY HQT,950,13,2,17,168,397,597,6,603,0,O-69-109-05-07-01
NAKASEKE,NAKASEKE COUNTY,NAKASEKE,NAKASEKE,KITTANSWA COU,85,0,0,4,30,35,69,0,69,0,O-69-109-05-07-02
NAKASEKE,NAKASEKE COUNTY,NAKASEKE,NAKASEKE,NAKASEKE T.CENTRE,725,8,0,20,158,278,464,9,473,0,O-69-109-05-07-03
NAKASEKE,NAKASEKE COUNTY,NAKASEKE,NAKASEKE,KIZIBA,352,5,1,7,48,163,224,9,233,0,O-69-109-05-07-04
NAKASEKE,NAKASEKE COUNTY,NGOMA,BIDDUKU,KINOONI PRIMARY SCHOOL,296,0,0,0,1,285,286,5,291,0,O-69-109-06-01-01
NAKASEKE,NAKASEKE COUNTY,NGOMA,BIDDUKU,BIDDUKU P/SCH,508,0,0,2,26,466,494,5,499,0,O-69-109-06-01-02
NAKASEKE,NAKASEKE COUNTY,NGOMA,BULYAMUSENYU,KYABIGULU,516,1,1,2,34,446,484,8,492,0,O-69-109-06-02-01
NAKASEKE,NAKASEKE COUNTY,NGOMA,BULYAMUSENYU,NAKALONGO,225,0,0,1,0,219,220,3,223,0,O-69-109-06-02-02
NAKASEKE,NAKASEKE COUNTY,NGOMA,BULYAMUSENYU,BULYAMUSENYU,209,1,0,0,2,205,208,1,209,0,O-69-109-06-02-03
NAKASEKE,NAKASEKE COUNTY,NGOMA,KATUUGO,KILANGAZI TRADING CENTRE,373,0,0,3,3,343,349,14,363,0,O-69-109-06-03-01
NAKASEKE,NAKASEKE COUNTY,NGOMA,KATUUGO,KAGUSYO,208,0,0,0,2,203,205,0,205,0,O-69-109-06-03-02
NAKASEKE,NAKASEKE COUNTY,NGOMA,KIGWERI,KIGWERI,478,0,1,1,11,449,462,8,470,0,O-69-109-06-04-01
NAKASEKE,NAKASEKE COUNTY,NGOMA,KIGWERI,MIGAANE PRIMARY SCHOOL,249,0,0,0,1,96,97,3,100,0,O-69-109-06-04-02
NAKASEKE,NAKASEKE COUNTY,NGOMA,KIGWERI,NATIGA,210,0,0,0,2,197,199,2,201,0,O-69-109-06-04-03
NAKASEKE,NAKASEKE COUNTY,NGOMA,KITEYONGERA,KILANGAZI Pr. SCH.,229,0,0,0,1,214,215,4,219,0,O-69-109-06-05-01
NAKASEKE,NAKASEKE COUNTY,NGOMA,KITEYONGERA,MBIRIZI PRIMARY SCHOOL,215,0,0,0,0,215,215,0,215,0,O-69-109-06-05-02
NAKASEKE,NAKASEKE COUNTY,NGOMA,KYALUSEBEKA,KYALUSEBEKA PARISH HQTRS.,450,0,0,1,5,436,442,3,445,0,O-69-109-06-06-01
NAKASEKE,NAKASEKE COUNTY,NGOMA,KYALUSEBEKA,BULAMBA,271,0,0,0,1,264,265,5,270,0,O-69-109-06-06-02
NAKASEKE,NAKASEKE COUNTY,NGOMA,KYALUSEBEKA,KAYONZA PRIMARY SCHOOL,382,1,0,0,0,378,379,3,382,0,O-69-109-06-06-03
NAKASEKE,NAKASEKE COUNTY,NGOMA,KYALUSEBEKA,GOMERO,289,0,0,0,1,281,282,7,289,0,O-69-109-06-06-04
NAKASEKE,NAKASEKE COUNTY,NGOMA,NGOMA,NGOMA (A - K),766,0,0,2,68,654,724,4,728,0,O-69-109-06-07-01
NAKASEKE,NAKASEKE COUNTY,NGOMA,NGOMA,NGOMA (L - M),375,1,1,2,31,295,330,4,334,0,O-69-109-06-07-02
NAKASEKE,NAKASEKE COUNTY,NGOMA,NGOMA,NGANDO,149,0,0,0,6,139,145,1,146,0,O-69-109-06-07-03
NAKASEKE,NAKASEKE COUNTY,NGOMA,NGOMA,KIJUMBA P/S,384,0,0,1,2,360,363,3,366,0,O-69-109-06-07-04
NAKASEKE,NAKASEKE COUNTY,NGOMA,NGOMA,NGOMA (N - Z),805,1,0,4,65,390,460,10,470,0,O-69-109-06-07-05
NAKASEKE,NAKASEKE COUNTY,NGOMA,NGOMA,KALYABURO P/S,297,0,1,1,13,234,249,6,255,0,O-69-109-06-07-06
NAKASEKE,NAKASEKE COUNTY,SEMUTO,KIKANDWA,KIKANDWA COMM. CENTRE A,325,2,0,8,40,178,228,2,230,0,O-69-109-07-01-01
NAKASEKE,NAKASEKE COUNTY,SEMUTO,KIKANDWA,MABINDI T.CENTRE,180,0,0,3,9,101,113,4,117,0,O-69-109-07-01-02
NAKASEKE,NAKASEKE COUNTY,SEMUTO,KIKANDWA,BBAMBAGA T.C,375,1,0,6,30,232,269,3,272,0,O-69-109-07-01-03
NAKASEKE,NAKASEKE COUNTY,SEMUTO,KIKYUSA,KIKYUSA COMM. CENTRE,400,3,0,8,71,171,253,3,256,0,O-69-109-07-02-01
NAKASEKE,NAKASEKE COUNTY,SEMUTO,KIKYUSA,KASANA PR. SCHOOL,360,0,0,12,47,193,252,15,267,0,O-69-109-07-02-02
NAKASEKE,NAKASEKE COUNTY,SEMUTO,KIKYUSA,KYAJJINJA P.SCH,478,4,1,5,97,221,328,2,330,0,O-69-109-07-02-03
NAKASEKE,NAKASEKE COUNTY,SEMUTO,KIKYUSA,NAKATANDAGIRA STORES,262,0,1,8,40,137,186,6,192,0,O-69-109-07-02-04
NAKASEKE,NAKASEKE COUNTY,SEMUTO,KIREMA,KIREMA HEALTH CENTRE,447,2,1,4,28,195,230,9,239,0,O-69-109-07-03-01
NAKASEKE,NAKASEKE COUNTY,SEMUTO,KIREMA,BAKAKALA COMM. CENTRE,228,1,2,6,9,123,141,10,151,0,O-69-109-07-03-02
NAKASEKE,NAKASEKE COUNTY,SEMUTO,KIREMA,KUFFU PRIMARY SCH.,301,1,0,4,18,160,183,8,191,0,O-69-109-07-03-03
NAKASEKE,NAKASEKE COUNTY,SEMUTO,KIREMA,KIREMA P/S,279,1,0,2,36,128,167,2,169,0,O-69-109-07-03-04
NAKASEKE,NAKASEKE COUNTY,SEMUTO,KISEGA,KIKUBAMPANGA,484,0,1,10,55,250,316,11,327,0,O-69-109-07-04-01
NAKASEKE,NAKASEKE COUNTY,SEMUTO,KISEGA,KAKONDA PR. SCHOOL,203,1,0,7,27,100,135,3,138,0,O-69-109-07-04-02
NAKASEKE,NAKASEKE COUNTY,SEMUTO,KISEGA,KITEKAANYA STORES,161,0,0,3,31,57,91,2,93,0,O-69-109-07-04-03
NAKASEKE,NAKASEKE COUNTY,SEMUTO,MIGINGYE,NAKALAMUDDE Pr. SCH.,263,0,0,1,26,139,166,3,169,0,O-69-109-07-05-01
NAKASEKE,NAKASEKE COUNTY,SEMUTO,MIGINGYE,ST STEPHEN ACADEMY,294,3,1,7,33,164,208,3,211,0,O-69-109-07-05-02
NAKASEKE,NAKASEKE COUNTY,SEMUTO,MIGINGYE,MACHAY APOSTORIC CHURCH,483,1,0,6,53,254,314,17,331,0,O-69-109-07-05-03
NAKASEKE,NAKASEKE COUNTY,SEMUTO,MIGINGYE,KIRINYA PRIMARY SCH.,218,0,0,7,36,120,163,1,164,0,O-69-109-07-05-04
NAKASEKE,NAKASEKE COUNTY,SEMUTO,MIGINGYE,KAWUKU T/C,137,0,0,2,22,69,93,4,97,0,O-69-109-07-05-05
NAKASEKE,NAKASEKE COUNTY,SEMUTO,MIGINGYE,NAKITEMBE T/C,217,0,0,6,11,141,158,3,161,0,O-69-109-07-05-06
NAKASEKE,NAKASEKE COUNTY,SEMUTO,SEGALYA,LUKUMBI,526,0,0,12,66,234,312,14,326,0,O-69-109-07-06-01
NAKASEKE,NAKASEKE COUNTY,SEMUTO,SEGALYA,BUKATIRA CATHOLIC CHURCH,602,2,0,11,87,246,346,13,359,0,O-69-109-07-06-02
NAKASEKE,NAKASEKE COUNTY,SEMUTO,SEGALYA,KALEGE TOWN,542,2,0,5,101,232,340,6,346,0,O-69-109-07-06-03
NAKASEKE,NAKASEKE COUNTY,SEMUTO,SEMUTO,KIJAGUZO P.SCH.,387,4,0,9,45,171,229,12,241,0,O-69-109-07-07-01
NAKASEKE,NAKASEKE COUNTY,SEMUTO,SEMUTO,NKUZONGERE P.S.,346,1,0,18,39,162,220,13,233,0,O-69-109-07-07-02
NAKASEKE,NAKASEKE COUNTY,SEMUTO,SEMUTO,SEMUTO H. CENTRE,471,0,0,7,57,166,230,16,246,0,O-69-109-07-07-03
NAKASEKE,NAKASEKE COUNTY,SEMUTO,SEMUTO,LULE,414,0,1,2,47,260,310,2,312,0,O-69-109-07-07-04
NAKASEKE,NAKASEKE COUNTY,SEMUTO,SEMUTO,SEMUTO COMM. CENTRE,906,3,3,18,121,354,499,9,508,0,O-69-109-07-07-05
NAKASEKE,NAKASEKE COUNTY,SEMUTO,SEMUTO,KIKONDO P.SCH,363,5,0,10,65,166,246,11,257,0,O-69-109-07-07-06
NAKASEKE,NAKASEKE COUNTY,SEMUTO,SEMUTO,SEMUTO PLAYGROUND,301,0,0,5,56,108,169,7,176,0,O-69-109-07-07-07
NAKASEKE,NAKASEKE COUNTY,WAKYATO,KALAGALA,KALAGALA,428,2,1,11,24,206,244,12,256,0,O-69-109-08-01-01
NAKASEKE,NAKASEKE COUNTY,WAKYATO,KALAGALA,KYALUWEESI,310,2,0,3,22,165,192,9,201,0,O-69-109-08-01-02
NAKASEKE,NAKASEKE COUNTY,WAKYATO,KIRINDA,BWAMI,213,0,0,0,0,0,0,0,0,1,O-69-109-08-02-01
NAKASEKE,NAKASEKE COUNTY,WAKYATO,KIRINDA,KIRINDA,530,1,0,2,17,285,305,19,324,0,O-69-109-08-02-02
NAKASEKE,NAKASEKE COUNTY,WAKYATO,KIRINDA,KABAALE,202,1,0,0,5,172,178,3,181,0,O-69-109-08-02-03
NAKASEKE,NAKASEKE COUNTY,WAKYATO,KIRINDA,NABISOJO T/C,239,3,0,2,13,218,236,3,239,0,O-69-109-08-02-04
NAKASEKE,NAKASEKE COUNTY,WAKYATO,KISOGA,KISOGA,301,0,0,2,31,151,184,6,190,0,O-69-109-08-03-01
NAKASEKE,NAKASEKE COUNTY,WAKYATO,KISOGA,KATOOKE,776,2,1,3,81,373,460,15,475,0,O-69-109-08-03-02
NAKASEKE,NAKASEKE COUNTY,WAKYATO,KISOGA,BUJJUBYA T/C,516,1,0,5,53,293,352,5,357,0,O-69-109-08-03-03
NAKASEKE,NAKASEKE COUNTY,WAKYATO,MIJUMWA,BALITTA,550,0,0,5,57,255,317,6,323,0,O-69-109-08-04-01
NAKASEKE,NAKASEKE COUNTY,WAKYATO,MIJUMWA,MITYOMERE P/SCH,182,1,0,0,3,84,88,0,88,0,O-69-109-08-04-02
NAKASEKE,NAKASEKE COUNTY,WAKYATO,MIJUMWA,KAKIRA T/C,184,0,0,2,10,78,90,5,95,0,O-69-109-08-04-03
NAKASEKE,NAKASEKE COUNTY,WAKYATO,NAKONGE,WANSALANGI P/S,636,2,1,5,55,348,411,6,417,0,O-69-109-08-05-01
NAKASEKE,NAKASEKE COUNTY,WAKYATO,NAKONGE,WAKYATO,268,0,0,1,12,115,128,3,131,0,O-69-109-08-05-02
RAKAI,KABULA COUNTY,KALIIRO,KABATEMA,KABATEMA,863,5,0,6,72,555,638,11,649,0,O-80-191-01-01-01
RAKAI,KABULA COUNTY,KALIIRO,KABATEMA,KASAMBYA,364,0,0,1,25,269,295,5,300,0,O-80-191-01-01-02
RAKAI,KABULA COUNTY,KALIIRO,KABATEMA,KINONI,325,0,0,0,25,221,246,2,248,0,O-80-191-01-01-03
RAKAI,KABULA COUNTY,KALIIRO,KALIIRO,KALIIRO S/C QHRS (A-M),425,2,0,2,52,258,314,13,327,0,O-80-191-01-02-01
RAKAI,KABULA COUNTY,KALIIRO,KALIIRO,NKIRO,566,2,0,2,29,463,496,11,507,0,O-80-191-01-02-02
RAKAI,KABULA COUNTY,KALIIRO,KALIIRO,KALIIRO S/C QHRS (N-Z),474,0,0,0,29,274,303,5,308,0,O-80-191-01-02-03
RAKAI,KABULA COUNTY,KALIIRO,KASAMBYA,KITOVU,798,3,0,3,69,431,506,10,516,0,O-80-191-01-03-01
RAKAI,KABULA COUNTY,KALIIRO,KASAMBYA,KATAGENGELA,371,0,0,3,30,265,298,13,311,0,O-80-191-01-03-02
RAKAI,KABULA COUNTY,KALIIRO,KIYINDA,KIYINDA T/C,719,2,1,2,58,445,508,4,512,0,O-80-191-01-04-01
RAKAI,KABULA COUNTY,KALIIRO,KIYINDA,TWAFADA,448,0,2,1,40,288,331,6,337,0,O-80-191-01-04-02
RAKAI,KABULA COUNTY,KALIIRO,KYALUTEREKERA,KATALE,644,1,0,0,73,394,468,8,476,0,O-80-191-01-05-01
RAKAI,KABULA COUNTY,KALIIRO,KYALUTEREKERA,LWENTONDO,295,1,0,2,64,126,193,6,199,0,O-80-191-01-05-02
RAKAI,KABULA COUNTY,KALIIRO,KYALUTEREKERA,MAKUKULU,427,3,0,1,68,224,296,7,303,0,O-80-191-01-05-03
RAKAI,KABULA COUNTY,KALIIRO,KYALUTEREKERA,NAKISAJA,202,0,0,1,11,140,152,3,155,0,O-80-191-01-05-04
RAKAI,KABULA COUNTY,KASAGAMA,BUYANJA,BUYANJA,805,3,0,2,58,576,639,11,650,0,O-80-191-02-01-01
RAKAI,KABULA COUNTY,KASAGAMA,BUYANJA,NAMUTAMBA,409,2,0,5,50,247,304,8,312,0,O-80-191-02-01-02
RAKAI,KABULA COUNTY,KASAGAMA,BUYANJA,MUZAIRE,413,1,0,2,28,266,297,6,303,0,O-80-191-02-01-03
RAKAI,KABULA COUNTY,KASAGAMA,KATEBE,KATEBE,249,1,0,0,16,157,174,2,176,0,O-80-191-02-02-01
RAKAI,KABULA COUNTY,KASAGAMA,KATEBE,KABUTETERA,249,1,0,0,1,182,184,6,190,0,O-80-191-02-02-02
RAKAI,KABULA COUNTY,KASAGAMA,KATEBE,KATAMUCHUBA,149,0,0,0,2,141,143,3,146,0,O-80-191-02-02-03
RAKAI,KABULA COUNTY,KASAGAMA,KISALUUKO,KISALUUKO,512,1,0,1,48,325,375,4,379,0,O-80-191-02-03-01
RAKAI,KABULA COUNTY,KASAGAMA,KISALUUKO,KAGAARA,345,1,0,1,3,203,208,6,214,0,O-80-191-02-03-02
RAKAI,KABULA COUNTY,KASAGAMA,KISALUUKO,KASAGAMA TC,578,1,1,1,68,306,377,11,388,0,O-80-191-02-03-03
RAKAI,KABULA COUNTY,KINUUKA,BWAMULAMIRA,BWAMULAMIRA,625,2,0,1,57,315,375,3,378,0,O-80-191-03-01-01
RAKAI,KABULA COUNTY,KINUUKA,BWAMULAMIRA,KYENSAMA,210,1,0,1,2,198,202,5,207,0,O-80-191-03-01-02
RAKAI,KABULA COUNTY,KINUUKA,BWAMULAMIRA,RANCH I,250,0,0,0,0,202,202,0,202,0,O-80-191-03-01-03
RAKAI,KABULA COUNTY,KINUUKA,NAKASOZI,NAKASOZI,605,2,1,0,5,425,433,9,442,0,O-80-191-03-02-01
RAKAI,KABULA COUNTY,KINUUKA,NAKASOZI,KINUUKA,676,0,1,0,49,384,434,10,444,0,O-80-191-03-02-02
RAKAI,KABULA COUNTY,KINUUKA,WABUSANA,LUGARAMA,751,0,0,0,64,493,557,5,562,0,O-80-191-03-03-01
RAKAI,KABULA COUNTY,KINUUKA,WABUSANA,NKOOTE,469,0,0,3,45,307,355,9,364,0,O-80-191-03-03-02
RAKAI,KABULA COUNTY,LYANTONDE,BIWOLOBO,KABASEGWA C.O.U,413,0,0,2,35,291,328,4,332,0,O-80-191-04-01-01
RAKAI,KABULA COUNTY,LYANTONDE,BIWOLOBO,BIWOLOBO,667,0,0,1,51,391,443,12,455,0,O-80-191-04-01-02
RAKAI,KABULA COUNTY,LYANTONDE,BIWOLOBO,GAYAZA PLAY GROUND,475,0,1,0,49,303,353,5,358,0,O-80-191-04-01-03
RAKAI,KABULA COUNTY,LYANTONDE,KALAGALA,MWEYOGEREZE,482,0,1,1,38,281,321,8,329,0,O-80-191-04-02-01
RAKAI,KABULA COUNTY,LYANTONDE,KALAGALA,KINVUNIKIDDE,479,1,0,1,32,309,343,13,356,0,O-80-191-04-02-02
RAKAI,KABULA COUNTY,LYANTONDE,KALAGALA,KALAGALA,429,0,2,2,44,243,291,6,297,0,O-80-191-04-02-03
RAKAI,KABULA COUNTY,LYANTONDE,KATOVU,KATOVU,806,1,0,3,58,487,549,17,566,0,O-80-191-04-03-01
RAKAI,KABULA COUNTY,LYANTONDE,KATOVU,KITAZIGOLOKA,614,1,1,2,59,404,467,12,479,0,O-80-191-04-03-02
RAKAI,KABULA COUNTY,LYANTONDE,KIROWOOZA,COMMUNITY CENTRE,711,1,0,3,42,407,453,6,459,0,O-80-191-04-04-01
RAKAI,KABULA COUNTY,LYANTONDE,KYEWANULA,KYEWANULA,758,1,1,1,78,441,522,8,530,0,O-80-191-04-05-01
RAKAI,KABULA COUNTY,LYANTONDE,KYEWANULA,LWAMAWUNGU,699,1,4,4,54,459,522,5,527,0,O-80-191-04-05-02
RAKAI,KABULA COUNTY,LYANTONDE T.C.,KALIIRO,KALIIRO A PLAYGROUND (A-M),634,4,2,5,134,223,368,1,369,0,O-80-191-05-01-01
RAKAI,KABULA COUNTY,LYANTONDE T.C.,KALIIRO,KALIIRO B (CURRENT T.C OFFICE,712,4,2,3,195,228,432,2,434,0,O-80-191-05-01-02
RAKAI,KABULA COUNTY,LYANTONDE T.C.,KALIIRO,KALIIRO A PLAYGROUND (N-Z),669,3,2,4,123,244,376,10,386,0,O-80-191-05-01-03
RAKAI,KABULA COUNTY,LYANTONDE T.C.,KOOKI,LYANTODE PARENTS SCHOOL (A-,619,2,1,1,143,190,337,9,346,0,O-80-191-05-02-01
RAKAI,KABULA COUNTY,LYANTONDE T.C.,KOOKI,ST. JOSEPH'S NURSERY SCH (A-L),554,2,0,2,145,166,315,4,319,0,O-80-191-05-02-02
RAKAI,KABULA COUNTY,LYANTONDE T.C.,KOOKI,ST. MARTIN PRIMARY SCHOOL,718,0,3,4,112,268,387,4,391,0,O-80-191-05-02-03
RAKAI,KABULA COUNTY,LYANTONDE T.C.,KOOKI,KAYEMBE PLAY GROUND,770,2,1,2,135,226,366,6,372,0,O-80-191-05-02-04
RAKAI,KABULA COUNTY,LYANTONDE T.C.,KOOKI,LYANTODE PARENTS SCHOOL (N-,658,2,0,3,125,224,354,5,359,0,O-80-191-05-02-05
RAKAI,KABULA COUNTY,LYANTONDE T.C.,KOOKI,ST. JOSEPH'S NURSERY SCH (M-Z,634,2,2,1,151,217,373,0,373,0,O-80-191-05-02-06
RAKAI,KABULA COUNTY,MPUMUDDE,BUYAGA,BUYAGA,527,0,0,1,41,348,390,4,394,0,O-80-191-06-01-01
RAKAI,KABULA COUNTY,MPUMUDDE,BUYAGA,KEMBOGO,520,3,0,1,60,330,394,4,398,0,O-80-191-06-01-02
RAKAI,KABULA COUNTY,MPUMUDDE,BUYAGA,KASANA,740,0,1,1,53,464,519,8,527,0,O-80-191-06-01-03
RAKAI,KABULA COUNTY,MPUMUDDE,KYEMAMBA,KYEMAMBA,568,1,0,2,9,355,367,14,381,0,O-80-191-06-02-01
RAKAI,KABULA COUNTY,MPUMUDDE,KYEMAMBA,KABALE P/SCHOOL,292,0,0,0,2,287,289,1,290,0,O-80-191-06-02-02
RAKAI,KABULA COUNTY,MPUMUDDE,LYAKAJURA,LYAKAJURA,686,1,0,5,37,449,492,18,510,0,O-80-191-06-03-01
RAKAI,KABULA COUNTY,MPUMUDDE,LYAKAJURA,BWIHAGAJU,812,0,0,2,27,533,562,12,574,0,O-80-191-06-03-02
RAKAI,KABULA COUNTY,MPUMUDDE,LYAKAJURA,NAMIRUNDA P/S,535,1,0,3,32,352,388,14,402,0,O-80-191-06-03-03
RAKAI,KABULA COUNTY,MPUMUDDE,MPUMUDDE,MPUMUDDE,859,2,0,7,89,508,606,14,620,0,O-80-191-06-04-01
RAKAI,KABULA COUNTY,MPUMUDDE,MPUMUDDE,KANAALA,468,2,0,1,24,296,323,5,328,0,O-80-191-06-04-02
RAKAI,KABULA COUNTY,MPUMUDDE,MPUMUDDE,KALYAMENVU,858,1,0,3,92,496,592,16,608,0,O-80-191-06-04-03
RAKAI,KABULA COUNTY,MPUMUDDE,MPUMUDDE,NYAKAYAGA T.C,238,1,0,1,17,151,170,2,172,0,O-80-191-06-04-04
RAKAI,KABULA COUNTY,MPUMUDDE,NSIIKA,NSIIKA,736,3,0,0,51,441,495,22,517,0,O-80-191-06-05-01
RAKAI,KABULA COUNTY,MPUMUDDE,NSIIKA,KIREEBE A,612,1,0,0,115,307,423,7,430,0,O-80-191-06-05-02
MUKONO,BUIKWE COUNTY SOUTH,BUIKWE,BUYIKWE,BUIKWE,668,2,1,14,224,173,414,11,425,0,O-82-174-01-01-01
MUKONO,BUIKWE COUNTY SOUTH,BUIKWE,BUYIKWE,LUBANYI,708,5,1,12,188,278,484,9,493,0,O-82-174-01-01-02
MUKONO,BUIKWE COUNTY SOUTH,BUIKWE,BUYIKWE,NALUBABWE,526,2,0,7,150,164,323,8,331,0,O-82-174-01-01-03
MUKONO,BUIKWE COUNTY SOUTH,BUIKWE,BUYIKWE,MISINDYE,551,0,1,7,130,231,369,18,387,0,O-82-174-01-01-04
MUKONO,BUIKWE COUNTY SOUTH,BUIKWE,KITAZI,NAKIKUNYU,139,1,0,4,42,61,108,1,109,0,O-82-174-01-02-01
MUKONO,BUIKWE COUNTY SOUTH,BUIKWE,KITAZI,KASUBI,488,4,0,10,146,180,340,6,346,0,O-82-174-01-02-02
MUKONO,BUIKWE COUNTY SOUTH,BUIKWE,KITAZI,KOBA,566,2,0,9,128,255,394,7,401,0,O-82-174-01-02-03
MUKONO,BUIKWE COUNTY SOUTH,BUIKWE,KITAZI,LUWOMBO,351,0,0,14,47,177,238,12,250,0,O-82-174-01-02-04
MUKONO,BUIKWE COUNTY SOUTH,BUIKWE,KITAZI,KYANJA,247,1,0,3,72,112,188,5,193,0,O-82-174-01-02-05
MUKONO,BUIKWE COUNTY SOUTH,BUIKWE,LWERU,LWERU,651,3,4,8,186,263,464,12,476,0,O-82-174-01-03-01
MUKONO,BUIKWE COUNTY SOUTH,BUIKWE,LWERU,BUGABO,482,4,0,9,125,201,339,14,353,0,O-82-174-01-03-02
MUKONO,BUIKWE COUNTY SOUTH,BUIKWE,LWERU,KAWULU,555,4,3,13,127,240,387,7,394,0,O-82-174-01-03-03
MUKONO,BUIKWE COUNTY SOUTH,BUIKWE,LWERU,NANTWALA,314,0,0,18,106,101,225,14,239,0,O-82-174-01-03-04
MUKONO,BUIKWE COUNTY SOUTH,BUIKWE,LWERU,KIKOOLI,148,1,4,0,41,70,116,7,123,0,O-82-174-01-03-05
MUKONO,BUIKWE COUNTY SOUTH,BUIKWE,MALONGWE,KIYAGI,537,1,0,32,154,208,395,4,399,0,O-82-174-01-04-01
MUKONO,BUIKWE COUNTY SOUTH,BUIKWE,MALONGWE,MAKONGE,442,3,0,6,128,190,327,8,335,0,O-82-174-01-04-02
MUKONO,BUIKWE COUNTY SOUTH,BUIKWE,MALONGWE,NSANVU,371,1,0,16,75,191,283,5,288,0,O-82-174-01-04-03
MUKONO,BUIKWE COUNTY SOUTH,BUIKWE,MALONGWE,MALONGWE,543,1,4,21,204,147,377,7,384,0,O-82-174-01-04-04
MUKONO,BUIKWE COUNTY SOUTH,BUIKWE,SSUGU,KIKOMA,467,1,0,15,58,251,325,6,331,0,O-82-174-01-05-01
MUKONO,BUIKWE COUNTY SOUTH,BUIKWE,SSUGU,MATALE,788,3,1,15,164,324,507,7,514,0,O-82-174-01-05-02
MUKONO,BUIKWE COUNTY SOUTH,BUIKWE,SSUGU,SSUGU,610,6,3,12,138,249,408,22,430,0,O-82-174-01-05-03
MUKONO,BUIKWE COUNTY SOUTH,BUIKWE,SSUGU,NAKATYABA,261,2,0,8,64,93,167,0,167,0,O-82-174-01-05-04
MUKONO,BUIKWE COUNTY SOUTH,NAJJA,BUSAGAZI,GOMBOLOLA LANDING SITE,380,0,0,0,60,185,245,4,249,0,O-82-174-02-01-01
MUKONO,BUIKWE COUNTY SOUTH,NAJJA,BUSAGAZI,BUSAGAZI PRIMARY SCHOOL,712,0,2,3,64,362,431,10,441,0,O-82-174-02-01-02
MUKONO,BUIKWE COUNTY SOUTH,NAJJA,GULAMA,MPOGO,432,2,1,3,60,221,287,15,302,0,O-82-174-02-02-01
MUKONO,BUIKWE COUNTY SOUTH,NAJJA,GULAMA,KIWANGALA,662,6,2,5,199,261,473,19,492,0,O-82-174-02-02-02
MUKONO,BUIKWE COUNTY SOUTH,NAJJA,GULAMA,BUYOMBA,665,7,1,11,121,259,399,11,410,0,O-82-174-02-02-03
MUKONO,BUIKWE COUNTY SOUTH,NAJJA,KISIIMBA,KISIIMBA,551,1,4,5,140,223,373,13,386,0,O-82-174-02-03-01
MUKONO,BUIKWE COUNTY SOUTH,NAJJA,KISIIMBA,NAJJA,903,4,2,18,218,310,552,9,561,0,O-82-174-02-03-02
MUKONO,BUIKWE COUNTY SOUTH,NAJJA,KISIIMBA,KIZAALA,403,1,0,9,79,210,299,11,310,0,O-82-174-02-03-03
MUKONO,BUIKWE COUNTY SOUTH,NAJJA,KIYINDI,KIYINDI,1048,3,2,10,242,242,499,99,598,0,O-82-174-02-04-01
MUKONO,BUIKWE COUNTY SOUTH,NAJJA,KIYINDI,BUZAAMA C/U PRIMARY SCHOOL,345,0,0,4,80,164,248,2,250,0,O-82-174-02-04-02
MUKONO,BUIKWE COUNTY SOUTH,NAJJA,KIYINDI,GIMBO,611,0,1,7,86,261,355,7,362,0,O-82-174-02-04-03
MUKONO,BUIKWE COUNTY SOUTH,NAJJA,KIYINDI,GOLI,560,3,1,7,77,281,369,12,381,0,O-82-174-02-04-04
MUKONO,BUIKWE COUNTY SOUTH,NAJJA,KIYINDI,KOBA-KAKUNYU,720,5,0,5,197,223,430,7,437,0,O-82-174-02-04-05
MUKONO,BUIKWE COUNTY SOUTH,NAJJA,MAWOTTO,BUGIRI,649,4,0,9,129,236,378,15,393,0,O-82-174-02-05-01
MUKONO,BUIKWE COUNTY SOUTH,NAJJA,MAWOTTO,KIGAYA,482,4,1,11,101,201,318,13,331,0,O-82-174-02-05-02
MUKONO,BUIKWE COUNTY SOUTH,NAJJA,MAWOTTO,MAWOTTO,372,2,1,4,56,184,247,4,251,0,O-82-174-02-05-03
MUKONO,BUIKWE COUNTY SOUTH,NAJJA,MAWOTTO,BUTTIKULA,360,1,4,4,42,179,230,19,249,0,O-82-174-02-05-04
MUKONO,BUIKWE COUNTY SOUTH,NAJJA,NAMATOVU,BULEEGA PRIMARY SCHOOL,419,3,0,1,62,239,305,13,318,0,O-82-174-02-06-01
MUKONO,BUIKWE COUNTY SOUTH,NAJJA,NAMATOVU,BULERE,516,2,0,11,116,213,342,8,350,0,O-82-174-02-06-02
MUKONO,BUIKWE COUNTY SOUTH,NAJJA,NAMATOVU,BUWOYA S.D.A P/S,296,2,1,3,81,92,179,10,189,0,O-82-174-02-06-03
MUKONO,BUIKWE COUNTY SOUTH,NAJJA,TUKULU,KOKOLA,483,2,1,6,5,227,241,20,261,0,O-82-174-02-07-01
MUKONO,BUIKWE COUNTY SOUTH,NAJJA,TUKULU,BUFUMBE,693,8,4,6,95,287,400,32,432,0,O-82-174-02-07-02
MUKONO,BUIKWE COUNTY SOUTH,NAJJA,TUKULU,BUSIRI R/C PRIMARY SCHOOL,418,2,2,4,101,160,269,5,274,0,O-82-174-02-07-03
MUKONO,BUIKWE COUNTY SOUTH,NGOGWE,DUNGI,BULUTWE,876,4,3,10,122,419,558,10,568,0,O-82-174-03-01-01
MUKONO,BUIKWE COUNTY SOUTH,NGOGWE,DUNGI,KAWUNA,524,2,0,18,133,140,293,7,300,0,O-82-174-03-01-02
MUKONO,BUIKWE COUNTY SOUTH,NGOGWE,DUNGI,BUGWIISA,294,2,1,5,61,132,201,5,206,0,O-82-174-03-01-03
MUKONO,BUIKWE COUNTY SOUTH,NGOGWE,DUNGI,LUGASA,733,3,1,18,189,250,461,16,477,0,O-82-174-03-01-04
MUKONO,BUIKWE COUNTY SOUTH,NGOGWE,KIKWAYI,KATEETE,654,3,0,31,149,270,453,18,471,0,O-82-174-03-02-01
MUKONO,BUIKWE COUNTY SOUTH,NGOGWE,KIKWAYI,KIKWAYI,467,3,2,34,105,168,312,0,312,0,O-82-174-03-02-02
MUKONO,BUIKWE COUNTY SOUTH,NGOGWE,KIKWAYI,MASEKE,172,0,0,8,37,71,116,7,123,0,O-82-174-03-02-03
MUKONO,BUIKWE COUNTY SOUTH,NGOGWE,KIRINGO,KIWULUGUMA,311,0,0,1,39,158,198,6,204,0,O-82-174-03-03-01
MUKONO,BUIKWE COUNTY SOUTH,NGOGWE,KIRINGO,KAMULI,499,2,1,16,74,240,333,19,352,0,O-82-174-03-03-02
MUKONO,BUIKWE COUNTY SOUTH,NGOGWE,KIRINGO,KUNGU,461,1,0,19,71,221,312,14,326,0,O-82-174-03-03-03
MUKONO,BUIKWE COUNTY SOUTH,NGOGWE,KIRINGO,NKOMBE,466,0,4,10,90,209,313,13,326,0,O-82-174-03-03-04
MUKONO,BUIKWE COUNTY SOUTH,NGOGWE,KIRINGO,BOGO,239,0,0,16,28,108,152,0,152,0,O-82-174-03-03-05
MUKONO,BUIKWE COUNTY SOUTH,NGOGWE,LUBONGO,NGOGWE,450,1,2,17,98,111,229,2,231,0,O-82-174-03-04-01
MUKONO,BUIKWE COUNTY SOUTH,NGOGWE,LUBONGO,NYEMERWA,380,0,0,7,37,222,266,0,266,0,O-82-174-03-04-02
MUKONO,BUIKWE COUNTY SOUTH,NGOGWE,LUBONGO,LUBONGO,550,0,0,18,99,261,378,3,381,0,O-82-174-03-04-03
MUKONO,BUIKWE COUNTY SOUTH,NGOGWE,LUBONGO,NAMPANYI,277,0,0,13,49,118,180,6,186,0,O-82-174-03-04-04
MUKONO,BUIKWE COUNTY SOUTH,NGOGWE,LUBONGO,KIWALE,219,0,0,1,9,163,173,5,178,0,O-82-174-03-04-05
MUKONO,BUIKWE COUNTY SOUTH,NGOGWE,NAMULESA,GERA,427,2,0,21,104,164,291,4,295,0,O-82-174-03-05-01
MUKONO,BUIKWE COUNTY SOUTH,NGOGWE,NAMULESA,NGOGWE,551,4,1,13,171,194,383,11,394,0,O-82-174-03-05-02
MUKONO,BUIKWE COUNTY SOUTH,NGOGWE,NAMULESA,BUWOGOLE,517,8,4,11,74,228,325,17,342,0,O-82-174-03-05-03
MUKONO,BUIKWE COUNTY SOUTH,NGOGWE,NAMULESA,NAMULESA,394,0,0,22,107,124,253,7,260,0,O-82-174-03-05-04
MUKONO,BUIKWE COUNTY SOUTH,NGOGWE,NAMULESA,KAWOMYA,138,2,0,8,26,52,88,1,89,0,O-82-174-03-05-05
MUKONO,BUIKWE COUNTY SOUTH,NGOGWE,NAMULESA,NANGUNGA TRADING CENTRE,526,1,0,34,156,152,343,12,355,0,O-82-174-03-05-06
MUKONO,BUIKWE COUNTY SOUTH,NGOGWE,NDOLWA,MASABA,339,1,0,33,81,142,257,15,272,0,O-82-174-03-06-01
MUKONO,BUIKWE COUNTY SOUTH,NGOGWE,NDOLWA,MAYIRIKITI,353,1,0,35,75,134,245,3,248,0,O-82-174-03-06-02
MUKONO,BUIKWE COUNTY SOUTH,NGOGWE,NDOLWA,BUSITWE,761,3,0,37,182,305,527,11,538,0,O-82-174-03-06-03
MUKONO,BUIKWE COUNTY SOUTH,NKOKONJERU T.C,BUKASA,BUKASA,506,2,0,25,136,174,337,8,345,0,O-82-174-04-01-01
MUKONO,BUIKWE COUNTY SOUTH,NKOKONJERU T.C,BUKASA,NABUWUNDO,196,0,1,5,46,52,104,2,106,0,O-82-174-04-01-02
MUKONO,BUIKWE COUNTY SOUTH,NKOKONJERU T.C,BUKASA,NKOKONJERU,727,1,1,25,185,185,397,0,397,0,O-82-174-04-01-03
MUKONO,BUIKWE COUNTY SOUTH,NKOKONJERU T.C,MULAJJE,MULAJJE C/U P/SCH.,358,0,1,26,90,129,246,10,256,0,O-82-174-04-02-01
MUKONO,BUIKWE COUNTY SOUTH,NKOKONJERU T.C,MULAJJE,NAMALIRI,194,2,0,6,62,65,135,1,136,0,O-82-174-04-02-02
MUKONO,BUIKWE COUNTY SOUTH,NKOKONJERU T.C,MULAJJE,KIGULU,246,1,0,10,67,99,177,2,179,0,O-82-174-04-02-03
MUKONO,BUIKWE COUNTY SOUTH,NKOKONJERU T.C,NKOKONJERU,NKOKONJERU A (A - M),519,2,1,23,113,124,263,8,271,0,O-82-174-04-03-01
MUKONO,BUIKWE COUNTY SOUTH,NKOKONJERU T.C,NKOKONJERU,NKOKONJERU B,674,2,0,22,119,159,302,12,314,0,O-82-174-04-03-02
MUKONO,BUIKWE COUNTY SOUTH,NKOKONJERU T.C,NKOKONJERU,NAZIWANGA,334,0,1,19,73,119,212,8,220,0,O-82-174-04-03-03
MUKONO,BUIKWE COUNTY SOUTH,NKOKONJERU T.C,NKOKONJERU,NKOKONJERU A (N - Z),195,0,0,5,40,71,116,2,118,0,O-82-174-04-03-04
MUKONO,BUIKWE COUNTY SOUTH,SSI,BBINGA,SEIRA,333,3,1,22,28,165,219,6,225,0,O-82-174-05-01-01
MUKONO,BUIKWE COUNTY SOUTH,SSI,BBINGA,MPUKU,146,0,1,4,21,77,103,1,104,0,O-82-174-05-01-02
MUKONO,BUIKWE COUNTY SOUTH,SSI,KIMERA,KOBA,712,3,0,63,142,249,457,10,467,0,O-82-174-05-02-01
MUKONO,BUIKWE COUNTY SOUTH,SSI,KIMERA,SENYI,932,1,0,43,237,266,547,16,563,0,O-82-174-05-02-02
MUKONO,BUIKWE COUNTY SOUTH,SSI,KIMERA,BUTALE,249,3,0,27,38,97,165,6,171,0,O-82-174-05-02-03
MUKONO,BUIKWE COUNTY SOUTH,SSI,KIMERA,KIMERA,319,1,1,64,26,140,232,6,238,0,O-82-174-05-02-04
MUKONO,BUIKWE COUNTY SOUTH,SSI,LUGALA,SSI,910,2,2,52,173,355,584,23,607,0,O-82-174-05-03-01
MUKONO,BUIKWE COUNTY SOUTH,SSI,LUGALA,LUGALA,373,2,0,29,42,138,211,9,220,0,O-82-174-05-03-02
MUKONO,BUIKWE COUNTY SOUTH,SSI,LUGALA,BUKAYA,182,2,0,17,17,88,124,6,130,0,O-82-174-05-03-03
MUKONO,BUIKWE COUNTY SOUTH,SSI,LUGOBA,LUKUBO,925,3,0,20,112,385,520,3,523,0,O-82-174-05-04-01
MUKONO,BUIKWE COUNTY SOUTH,SSI,MUVO,MUVO,715,2,0,17,117,286,422,26,448,0,O-82-174-05-05-01
MUKONO,BUIKWE COUNTY SOUTH,SSI,MUVO,SANGANA,119,0,0,16,17,35,68,6,74,0,O-82-174-05-05-02
MUKONO,BUIKWE COUNTY SOUTH,SSI,NAMUKUMA,GULAMA,196,0,0,5,21,117,143,3,146,0,O-82-174-05-06-01
MUKONO,BUIKWE COUNTY SOUTH,SSI,NAMUKUMA,BUBENDA,824,2,1,31,141,386,561,22,583,0,O-82-174-05-06-02
MUKONO,BUIKWE COUNTY SOUTH,SSI,NAMUKUMA,KIGGUGO,220,0,0,4,12,89,105,3,108,0,O-82-174-05-06-03
MUKONO,BUIKWE COUNTY SOUTH,SSI,NAMUKUMA,KIJJA,131,1,0,7,22,57,87,4,91,0,O-82-174-05-06-04
MUKONO,BUIKWE COUNTY SOUTH,SSI,ZITWE,MAYUGWE,601,7,1,22,73,291,394,18,412,0,O-82-174-05-07-01
MUKONO,BUIKWE COUNTY SOUTH,SSI,ZITWE,BUWANGO,714,2,1,30,136,237,406,19,425,0,O-82-174-05-07-02
MUKONO,BUIKWE COUNTY SOUTH,SSI,ZITWE,LUKUBO,60,0,0,2,5,32,39,0,39,0,O-82-174-05-07-03
MUKONO,BUIKWE CTY NORTH,NJERU T C,NJERU EAST,BUKAYA WEST I,465,1,0,0,160,87,248,6,254,0,O-82-172-01-01-01
MUKONO,BUIKWE CTY NORTH,NJERU T C,NJERU EAST,BUKAYA WEST II,563,0,2,2,195,111,310,8,318,0,O-82-172-01-01-02
MUKONO,BUIKWE CTY NORTH,NJERU T C,NJERU EAST,BUKAYA EAST,576,2,4,0,201,133,340,3,343,0,O-82-172-01-01-03
MUKONO,BUIKWE CTY NORTH,NJERU T C,NJERU EAST,UPPER NAAVA,1098,5,2,2,375,176,560,9,569,0,O-82-172-01-01-04
MUKONO,BUIKWE CTY NORTH,NJERU T C,NJERU EAST,LOWER NAAVA,986,5,2,3,294,158,462,9,471,0,O-82-172-01-01-05
MUKONO,BUIKWE CTY NORTH,NJERU T C,NJERU EAST,UEB,806,3,4,1,253,147,408,11,419,0,O-82-172-01-01-06
MUKONO,BUIKWE CTY NORTH,NJERU T C,NJERU NORTH,BUJOWALI CHURCH,671,6,5,3,159,220,393,0,393,0,O-82-172-01-02-01
MUKONO,BUIKWE CTY NORTH,NJERU T C,NJERU NORTH,NAAVA (A - M),631,6,2,1,186,149,344,6,350,0,O-82-172-01-02-02
MUKONO,BUIKWE CTY NORTH,NJERU T C,NJERU NORTH,NAAVA (N - Z),545,3,4,0,114,148,269,35,304,0,O-82-172-01-02-03
MUKONO,BUIKWE CTY NORTH,NJERU T C,NJERU SOUTH,BUZIIKA I,563,0,1,2,175,175,353,10,363,0,O-82-172-01-03-01
MUKONO,BUIKWE CTY NORTH,NJERU T C,NJERU SOUTH,BUTEMA,734,5,11,6,184,311,517,10,527,0,O-82-172-01-03-02
MUKONO,BUIKWE CTY NORTH,NJERU T C,NJERU SOUTH,BULYANKUYEGE,478,1,1,3,119,180,304,17,321,0,O-82-172-01-03-03
MUKONO,BUIKWE CTY NORTH,NJERU T C,NJERU SOUTH,KIRYOWA I,926,1,1,4,297,249,552,28,580,0,O-82-172-01-03-04
MUKONO,BUIKWE CTY NORTH,NJERU T C,NJERU SOUTH,KIRYOWA UMEA P/S,436,1,0,3,128,164,296,11,307,0,O-82-172-01-03-05
MUKONO,BUIKWE CTY NORTH,NJERU T C,NJERU SOUTH,KIRYOWA III,207,0,0,1,56,65,122,1,123,0,O-82-172-01-03-06
MUKONO,BUIKWE CTY NORTH,NJERU T C,NJERU SOUTH,BUZIIKA B,429,4,2,0,120,119,245,0,245,0,O-82-172-01-03-07
MUKONO,BUIKWE CTY NORTH,NJERU T C,NJERU SOUTH,NSENGE,567,1,3,3,137,274,418,9,427,0,O-82-172-01-03-08
MUKONO,BUIKWE CTY NORTH,NJERU T C,NJERU SOUTH,BUKABALA,355,2,3,1,89,132,227,14,241,0,O-82-172-01-03-09
MUKONO,BUIKWE CTY NORTH,NJERU T C,NJERU SOUTH,BUGUNGU,564,5,4,2,121,184,316,24,340,0,O-82-172-01-03-10
MUKONO,BUIKWE CTY NORTH,NJERU T C,NJERU WEST,KISANJA I (A - M),741,2,1,1,242,200,446,0,446,0,O-82-172-01-04-01
MUKONO,BUIKWE CTY NORTH,NJERU T C,NJERU WEST,KISANJA II,885,4,1,3,267,233,508,4,512,0,O-82-172-01-04-02
MUKONO,BUIKWE CTY NORTH,NJERU T C,NJERU WEST,KISANJA III,735,2,0,0,253,210,465,6,471,0,O-82-172-01-04-03
MUKONO,BUIKWE CTY NORTH,NJERU T C,NJERU WEST,KYABAGGU I,986,6,0,0,334,212,552,7,559,0,O-82-172-01-04-04
MUKONO,BUIKWE CTY NORTH,NJERU T C,NJERU WEST,KYABAGGU II,974,3,1,4,331,193,532,13,545,0,O-82-172-01-04-05
MUKONO,BUIKWE CTY NORTH,NJERU T C,NJERU WEST,NAMWEZI I,989,4,1,5,353,270,633,4,637,0,O-82-172-01-04-06
MUKONO,BUIKWE CTY NORTH,NJERU T C,NJERU WEST,NAMWEZI II,652,4,0,8,195,185,392,14,406,0,O-82-172-01-04-07
MUKONO,BUIKWE CTY NORTH,NJERU T C,NJERU WEST,NAMUWAYA I,1111,3,2,5,365,299,674,15,689,0,O-82-172-01-04-08
MUKONO,BUIKWE CTY NORTH,NJERU T C,NJERU WEST,NAMUWAYA II,711,3,0,5,208,189,405,5,410,0,O-82-172-01-04-09
MUKONO,BUIKWE CTY NORTH,NJERU T C,NJERU WEST,NTINDA,654,0,3,6,173,231,413,12,425,0,O-82-172-01-04-10
MUKONO,BUIKWE CTY NORTH,NJERU T C,NJERU WEST,ST. BERNADECT PRIMARY SCHOO,463,0,2,4,130,147,283,7,290,0,O-82-172-01-04-11
MUKONO,BUIKWE CTY NORTH,NJERU T C,NJERU WEST,LUGAZI II (A),687,2,0,6,173,189,370,58,428,0,O-82-172-01-04-12
MUKONO,BUIKWE CTY NORTH,NJERU T C,NJERU WEST,LUGAZI II (B),562,0,1,8,166,181,356,11,367,0,O-82-172-01-04-13
MUKONO,BUIKWE CTY NORTH,NJERU T C,NJERU WEST,WAMPALA (A - M),628,1,1,7,209,159,377,15,392,0,O-82-172-01-04-14
MUKONO,BUIKWE CTY NORTH,NJERU T C,NJERU WEST,KYABAGGU III,226,0,0,1,66,68,135,7,142,0,O-82-172-01-04-15
MUKONO,BUIKWE CTY NORTH,NJERU T C,NJERU WEST,KISANJA I (N - Z),340,1,0,1,74,101,177,4,181,0,O-82-172-01-04-16
MUKONO,BUIKWE CTY NORTH,NJERU T C,NJERU WEST,WAMPALA (N- Z),481,2,0,3,123,135,263,9,272,0,O-82-172-01-04-17
MUKONO,BUIKWE CTY NORTH,NYENGA,BUZIIKA (B),NAMAZIBA,301,0,0,3,43,158,204,7,211,0,O-82-172-02-01-01
MUKONO,BUIKWE CTY NORTH,NYENGA,BUZIIKA (B),MBUKIRO,532,2,0,2,87,228,319,18,337,0,O-82-172-02-01-02
MUKONO,BUIKWE CTY NORTH,NYENGA,BUZIIKA (B),BUZIIKA 'B',434,1,0,2,73,218,294,26,320,0,O-82-172-02-01-03
MUKONO,BUIKWE CTY NORTH,NYENGA,BUZIIKA (B),KAVULE,90,2,0,0,15,33,50,12,62,0,O-82-172-02-01-04
MUKONO,BUIKWE CTY NORTH,NYENGA,KABIZZI,KITEME,533,4,1,8,60,253,326,16,342,0,O-82-172-02-02-01
MUKONO,BUIKWE CTY NORTH,NYENGA,KABIZZI,BBANGA,374,2,0,8,46,205,261,8,269,0,O-82-172-02-02-02
MUKONO,BUIKWE CTY NORTH,NYENGA,KABIZZI,BUGOBA,542,0,2,1,43,321,367,9,376,0,O-82-172-02-02-03
MUKONO,BUIKWE CTY NORTH,NYENGA,KABIZZI,MBABIRIRE,441,1,2,7,66,243,319,5,324,0,O-82-172-02-02-04
MUKONO,BUIKWE CTY NORTH,NYENGA,KABIZZI,BWEZINDU,258,1,0,4,21,152,178,7,185,0,O-82-172-02-02-05
MUKONO,BUIKWE CTY NORTH,NYENGA,KABIZZI,BUGOBA B,397,2,1,4,19,258,284,7,291,0,O-82-172-02-02-06
MUKONO,BUIKWE CTY NORTH,NYENGA,NAMABU,NAMABU,441,2,1,4,50,251,308,12,320,0,O-82-172-02-03-01
MUKONO,BUIKWE CTY NORTH,NYENGA,NAMABU,GOMATI,296,0,1,2,31,181,215,11,226,0,O-82-172-02-03-02
MUKONO,BUIKWE CTY NORTH,NYENGA,NAMABU,SESSE,609,4,2,5,90,335,436,5,441,0,O-82-172-02-03-03
MUKONO,BUIKWE CTY NORTH,NYENGA,NAMABU,NAWA,703,1,0,1,89,404,495,19,514,0,O-82-172-02-03-04
MUKONO,BUIKWE CTY NORTH,NYENGA,NAMABU,BUWAGAJJO,456,1,2,2,49,232,286,7,293,0,O-82-172-02-03-05
MUKONO,BUIKWE CTY NORTH,NYENGA,NAMABU,BUTEMBE,336,1,0,2,53,194,250,8,258,0,O-82-172-02-03-06
MUKONO,BUIKWE CTY NORTH,NYENGA,NAMABU,BUKUBUZI,401,2,1,2,71,175,251,7,258,0,O-82-172-02-03-07
MUKONO,BUIKWE CTY NORTH,NYENGA,NYENGA,BULAMAGI,880,4,4,12,252,212,484,13,497,0,O-82-172-02-04-01
MUKONO,BUIKWE CTY NORTH,NYENGA,NYENGA,BUJUUTA,721,3,1,7,143,246,400,8,408,0,O-82-172-02-04-02
MUKONO,BUIKWE CTY NORTH,NYENGA,NYENGA,KIGUDU,463,1,1,3,82,215,302,1,303,0,O-82-172-02-04-03
MUKONO,BUIKWE CTY NORTH,NYENGA,NYENGA,NJALEGOBYE,294,2,0,7,80,103,192,9,201,0,O-82-172-02-04-04
MUKONO,BUIKWE CTY NORTH,NYENGA,NYENGA,NYENGA,605,1,0,9,132,235,377,15,392,0,O-82-172-02-04-05
MUKONO,BUIKWE CTY NORTH,NYENGA,NYENGA,BUJUUTA A,242,0,0,2,45,76,123,2,125,0,O-82-172-02-04-06
MUKONO,BUIKWE CTY NORTH,NYENGA,SSUNGA,SSUNGA,542,3,2,3,88,290,386,15,401,0,O-82-172-02-05-01
MUKONO,BUIKWE CTY NORTH,NYENGA,SSUNGA,LUKUMBI,248,2,1,0,40,125,168,13,181,0,O-82-172-02-05-02
MUKONO,BUIKWE CTY NORTH,NYENGA,SSUNGA,KIDUUSU,642,0,2,5,128,268,403,3,406,0,O-82-172-02-05-03
MUKONO,BUIKWE CTY NORTH,NYENGA,SSUNGA,KAMULI,331,1,2,1,45,168,217,6,223,0,O-82-172-02-05-04
MUKONO,BUIKWE CTY NORTH,NYENGA,TONGOLO,BUKAMUNYE I,480,2,2,2,110,167,283,13,296,0,O-82-172-02-06-01
MUKONO,BUIKWE CTY NORTH,NYENGA,TONGOLO,BUKAMUNYE II,293,3,2,2,56,109,172,7,179,0,O-82-172-02-06-02
MUKONO,BUIKWE CTY NORTH,NYENGA,TONGOLO,TONGOLO,733,5,6,4,177,226,418,24,442,0,O-82-172-02-06-03
MUKONO,BUIKWE CTY NORTH,NYENGA,TONGOLO,KIKONDO (A - M),419,2,2,0,99,154,257,9,266,0,O-82-172-02-06-04
MUKONO,BUIKWE CTY NORTH,NYENGA,TONGOLO,BUKWAMBI,183,3,0,2,28,87,120,10,130,0,O-82-172-02-06-05
MUKONO,BUIKWE CTY NORTH,NYENGA,TONGOLO,BUWAMBA,489,2,1,7,49,241,300,15,315,0,O-82-172-02-06-06
MUKONO,BUIKWE CTY NORTH,NYENGA,TONGOLO,NANGULWE,312,0,2,2,38,152,194,9,203,0,O-82-172-02-06-07
MUKONO,BUIKWE CTY NORTH,NYENGA,TONGOLO,NANSO,362,1,3,1,51,167,223,10,233,0,O-82-172-02-06-08
MUKONO,BUIKWE CTY NORTH,NYENGA,TONGOLO,KALEGGA,288,3,1,0,92,94,190,7,197,0,O-82-172-02-06-09
MUKONO,BUIKWE CTY NORTH,NYENGA,TONGOLO,KIKONDO (N - Z),389,3,2,5,80,128,218,16,234,0,O-82-172-02-06-10
MUKONO,BUIKWE CTY NORTH,WAKISI,KALAGALA,KALAGALA,536,2,1,1,182,151,337,12,349,0,O-82-172-03-01-01
MUKONO,BUIKWE CTY NORTH,WAKISI,KALAGALA,KYAMBOGO,363,2,2,7,57,154,222,4,226,0,O-82-172-03-01-02
MUKONO,BUIKWE CTY NORTH,WAKISI,KALAGALA,NALUVULE,419,4,0,2,111,143,260,7,267,0,O-82-172-03-01-03
MUKONO,BUIKWE CTY NORTH,WAKISI,KALAGALA,BYABUKU,414,3,1,7,135,138,284,7,291,0,O-82-172-03-01-04
MUKONO,BUIKWE CTY NORTH,WAKISI,KALAGALA,WABUSANKE,385,2,0,6,60,189,257,4,261,0,O-82-172-03-01-05
MUKONO,BUIKWE CTY NORTH,WAKISI,KKONKO,WABUNYINJA,316,1,2,0,47,179,229,15,244,0,O-82-172-03-02-01
MUKONO,BUIKWE CTY NORTH,WAKISI,KKONKO,KONKO 'A',565,6,2,1,110,238,357,0,357,0,O-82-172-03-02-02
MUKONO,BUIKWE CTY NORTH,WAKISI,KKONKO,LUWALA 'A',425,3,3,5,98,138,247,17,264,0,O-82-172-03-02-03
MUKONO,BUIKWE CTY NORTH,WAKISI,KKONKO,LUWALA 'B',609,5,2,7,158,201,373,9,382,0,O-82-172-03-02-04
MUKONO,BUIKWE CTY NORTH,WAKISI,KKONKO,KIYUNGA,244,0,3,0,32,152,187,3,190,0,O-82-172-03-02-05
MUKONO,BUIKWE CTY NORTH,WAKISI,KKONKO,LUKAAGA,381,0,7,5,72,200,284,2,286,0,O-82-172-03-02-06
MUKONO,BUIKWE CTY NORTH,WAKISI,MALINDI,MALINDI (A - M),527,0,2,1,162,176,341,2,343,0,O-82-172-03-03-01
MUKONO,BUIKWE CTY NORTH,WAKISI,MALINDI,BULOBA 'W',351,0,2,2,54,178,236,12,248,0,O-82-172-03-03-02
MUKONO,BUIKWE CTY NORTH,WAKISI,MALINDI,BULOBA 'C',704,3,2,0,143,335,483,12,495,0,O-82-172-03-03-03
MUKONO,BUIKWE CTY NORTH,WAKISI,MALINDI,NANKWANGA,366,1,3,2,62,186,254,7,261,0,O-82-172-03-03-04
MUKONO,BUIKWE CTY NORTH,WAKISI,MALINDI,KIKUBAMUTWE,566,3,2,1,166,169,341,12,353,0,O-82-172-03-03-05
MUKONO,BUIKWE CTY NORTH,WAKISI,MALINDI,MALINDI (N - Z),386,1,3,0,91,134,229,11,240,0,O-82-172-03-03-06
MUKONO,BUIKWE CTY NORTH,WAKISI,MALINDI,WABIKOKOOMA,246,1,4,0,42,125,172,5,177,0,O-82-172-03-03-07
MUKONO,BUIKWE CTY NORTH,WAKISI,NAKALANGA,KIRUGU,690,5,2,12,181,261,461,1,462,0,O-82-172-03-04-01
MUKONO,BUIKWE CTY NORTH,WAKISI,NAKALANGA,NAMIYAGI,657,4,1,4,117,309,435,15,450,0,O-82-172-03-04-02
MUKONO,BUIKWE CTY NORTH,WAKISI,NAKALANGA,NAKALANGA,358,1,0,2,119,110,232,17,249,0,O-82-172-03-04-03
MUKONO,BUIKWE CTY NORTH,WAKISI,NAKALANGA,MULANGE,198,4,1,2,53,67,127,1,128,0,O-82-172-03-04-04
MUKONO,BUIKWE CTY NORTH,WAKISI,NAKALANGA,KIRUGU W,268,2,2,1,59,113,177,7,184,0,O-82-172-03-04-05
MUKONO,BUIKWE CTY NORTH,WAKISI,NAMINYA,NAMILYANGO,453,5,5,4,75,241,330,12,342,0,O-82-172-03-05-01
MUKONO,BUIKWE CTY NORTH,WAKISI,NAMINYA,NAMINYA,594,1,1,3,144,248,397,10,407,0,O-82-172-03-05-02
MUKONO,BUIKWE CTY NORTH,WAKISI,NAMINYA,BUJOWALI/KIIRA,854,1,3,5,231,373,613,12,625,0,O-82-172-03-05-03
MUKONO,BUIKWE CTY NORTH,WAKISI,NAMINYA,NALUWERERE,218,0,0,1,54,99,154,7,161,0,O-82-172-03-05-04
MUKONO,BUIKWE CTY NORTH,WAKISI,WAKISI,WAKISI I,586,1,0,5,179,197,382,12,394,0,O-82-172-03-06-01
MUKONO,BUIKWE CTY NORTH,WAKISI,WAKISI,WAKISI (A - M),515,3,0,0,147,181,331,11,342,0,O-82-172-03-06-02
MUKONO,BUIKWE CTY NORTH,WAKISI,WAKISI,WAKIKOKOOLA 'A',557,1,7,1,121,252,382,5,387,0,O-82-172-03-06-03
MUKONO,BUIKWE CTY NORTH,WAKISI,WAKISI,WAKISI (N - Z),469,3,3,1,100,163,270,2,272,0,O-82-172-03-06-04
MUKONO,BUIKWE CTY NORTH,WAKISI,WAKISI,WAKIKOKOOLA 'B',177,3,2,0,21,87,113,6,119,0,O-82-172-03-06-05
MUKONO,BUIKWE CTY WEST,KAWOLO,BBIBO,NAKUSUBYAKI,508,3,0,10,93,281,387,13,400,0,O-82-173-01-01-01
MUKONO,BUIKWE CTY WEST,KAWOLO,BBIBO,KASOKOSO,478,2,1,3,121,214,341,12,353,0,O-82-173-01-01-02
MUKONO,BUIKWE CTY WEST,KAWOLO,BBIBO,BBIBO,157,0,0,1,33,73,107,3,110,0,O-82-173-01-01-03
MUKONO,BUIKWE CTY WEST,KAWOLO,BBIBO,KUNGU,433,3,1,6,66,247,323,13,336,0,O-82-173-01-01-04
MUKONO,BUIKWE CTY WEST,KAWOLO,BULYANTETE,BULYANTETE,803,3,2,5,124,354,488,29,517,0,O-82-173-01-02-01
MUKONO,BUIKWE CTY WEST,KAWOLO,BULYANTETE,KISAASI,150,0,0,5,15,80,100,8,108,0,O-82-173-01-02-02
MUKONO,BUIKWE CTY WEST,KAWOLO,BUSAABAGA,NAKIBALE,579,5,0,5,92,285,387,11,398,0,O-82-173-01-03-01
MUKONO,BUIKWE CTY WEST,KAWOLO,BUSAABAGA,VUMBA,540,0,2,8,79,259,348,11,359,0,O-82-173-01-03-02
MUKONO,BUIKWE CTY WEST,KAWOLO,BUTININDI,KASAKU,370,3,1,2,112,102,220,12,232,0,O-82-173-01-04-01
MUKONO,BUIKWE CTY WEST,KAWOLO,BUTININDI,KITEGA,1084,2,4,5,233,389,633,17,650,0,O-82-173-01-04-02
MUKONO,BUIKWE CTY WEST,KAWOLO,BUTININDI,MONEKO,460,2,3,4,59,197,265,22,287,0,O-82-173-01-04-03
MUKONO,BUIKWE CTY WEST,KAWOLO,BUTININDI,KIKAMBWE,329,5,0,6,22,206,239,31,270,0,O-82-173-01-04-04
MUKONO,BUIKWE CTY WEST,KAWOLO,BUTININDI,KOLOLO,112,0,0,0,50,20,70,0,70,0,O-82-173-01-04-05
MUKONO,BUIKWE CTY WEST,KAWOLO,BUTININDI,LUSESA,262,3,6,2,110,27,148,2,150,0,O-82-173-01-04-06
MUKONO,BUIKWE CTY WEST,KAWOLO,KIGENDA,KIGENDA,561,4,1,7,89,285,386,30,416,0,O-82-173-01-05-01
MUKONO,BUIKWE CTY WEST,KAWOLO,KIGENDA,BUGAMBA,230,0,0,3,19,139,161,4,165,0,O-82-173-01-05-02
MUKONO,BUIKWE CTY WEST,KAWOLO,KIGENDA,WANANDA,148,2,0,2,12,87,103,14,117,0,O-82-173-01-05-03
MUKONO,BUIKWE CTY WEST,KAWOLO,KIGENDA,BUSABAGA,376,2,0,3,50,178,233,17,250,0,O-82-173-01-05-04
MUKONO,BUIKWE CTY WEST,KAWOLO,KIGENDA,KAGERE,252,0,0,4,41,123,168,18,186,0,O-82-173-01-05-05
MUKONO,BUIKWE CTY WEST,KAWOLO,KITEZA,KAWUKU,613,4,0,9,154,223,390,34,424,0,O-82-173-01-06-01
MUKONO,BUIKWE CTY WEST,KAWOLO,KITEZA,LUYANZI,1057,3,2,8,257,275,545,40,585,0,O-82-173-01-06-02
MUKONO,BUIKWE CTY WEST,KAWOLO,KITEZA,NTENGA,702,7,4,10,204,200,425,0,425,0,O-82-173-01-06-03
MUKONO,BUIKWE CTY WEST,KAWOLO,KITEZA,KAMENYA,622,2,1,6,131,305,445,13,458,0,O-82-173-01-06-04
MUKONO,BUIKWE CTY WEST,KAWOLO,LUWAYO,NAKANYA,561,2,1,2,50,363,418,12,430,0,O-82-173-01-07-01
MUKONO,BUIKWE CTY WEST,KAWOLO,LUWAYO,LUWAYO,555,4,1,2,84,258,349,19,368,0,O-82-173-01-07-02
MUKONO,BUIKWE CTY WEST,KAWOLO,LUWAYO,KISU,507,2,0,4,46,291,343,0,343,0,O-82-173-01-07-03
MUKONO,BUIKWE CTY WEST,KAWOLO,LUWAYO,BUVUMA,165,1,1,1,29,88,120,4,124,0,O-82-173-01-07-04
MUKONO,BUIKWE CTY WEST,KAWOLO,LUWAYO,KASOKOSO,114,0,0,8,13,59,80,4,84,0,O-82-173-01-07-05
MUKONO,BUIKWE CTY WEST,KAWOLO,SAGAZI,KASININYA/SAGAZI,588,1,3,17,75,320,416,17,433,0,O-82-173-01-08-01
MUKONO,BUIKWE CTY WEST,LUGAZI T C,KABOWA,NEW COLONY,307,3,4,1,96,87,191,3,194,0,O-82-173-02-01-01
MUKONO,BUIKWE CTY WEST,LUGAZI T C,KABOWA,UPPER And LOWER,482,4,1,3,188,97,293,5,298,0,O-82-173-02-01-02
MUKONO,BUIKWE CTY WEST,LUGAZI T C,KABOWA,LUSOZI,572,3,4,1,213,144,365,14,379,0,O-82-173-02-01-03
MUKONO,BUIKWE CTY WEST,LUGAZI T C,KABOWA,LOWER KABOWA,355,0,3,4,145,87,239,6,245,0,O-82-173-02-01-04
MUKONO,BUIKWE CTY WEST,LUGAZI T C,KAWOTTO,KAWOTTO P/S II,646,3,3,2,189,170,367,18,385,0,O-82-173-02-02-01
MUKONO,BUIKWE CTY WEST,LUGAZI T C,KAWOTTO,KAWOTTO PS I,322,2,0,1,98,69,170,12,182,0,O-82-173-02-02-02
MUKONO,BUIKWE CTY WEST,LUGAZI T C,KAWOTTO,GEREGERE I/SAFI PRIMARY SCHO,308,3,1,4,113,66,187,23,210,0,O-82-173-02-02-03
MUKONO,BUIKWE CTY WEST,LUGAZI T C,KIKAWULA,KIKAWULA I,482,4,0,10,156,133,303,2,305,0,O-82-173-02-03-01
MUKONO,BUIKWE CTY WEST,LUGAZI T C,KIKAWULA,KIKAWULA II/LANE,859,12,2,10,250,268,542,8,550,0,O-82-173-02-03-02
MUKONO,BUIKWE CTY WEST,LUGAZI T C,KIKAWULA,NKOKO (A - M),549,3,3,7,175,183,371,11,382,0,O-82-173-02-03-03
MUKONO,BUIKWE CTY WEST,LUGAZI T C,KIKAWULA,LUGAZI I (A - M),725,7,3,15,212,173,410,6,416,0,O-82-173-02-03-04
MUKONO,BUIKWE CTY WEST,LUGAZI T C,KIKAWULA,LUGAZI II,676,2,1,7,219,163,392,6,398,0,O-82-173-02-03-05
MUKONO,BUIKWE CTY WEST,LUGAZI T C,KIKAWULA,NKOKO (N - Z),533,3,0,9,115,183,310,29,339,0,O-82-173-02-03-06
MUKONO,BUIKWE CTY WEST,LUGAZI T C,KIKAWULA,LUGAZI I (N - Z),489,3,0,9,140,125,277,5,282,0,O-82-173-02-03-07
MUKONO,BUIKWE CTY WEST,LUGAZI T C,NAKAZADDE,GEREGERE I,1054,5,2,4,242,309,562,18,580,0,O-82-173-02-04-01
MUKONO,BUIKWE CTY WEST,LUGAZI T C,NAKAZADDE,GERERERE II,1040,3,1,6,306,301,617,20,637,0,O-82-173-02-04-02
MUKONO,BUIKWE CTY WEST,LUGAZI T C,NAKAZADDE,NAKAZADDE I,464,1,1,9,126,155,292,4,296,0,O-82-173-02-04-03
MUKONO,BUIKWE CTY WEST,LUGAZI T C,NAKAZADDE,NAKAZADDE II(A - M),313,0,0,5,105,69,179,3,182,0,O-82-173-02-04-04
MUKONO,BUIKWE CTY WEST,LUGAZI T C,NAKAZADDE,KINYORO I,599,1,0,6,163,208,378,6,384,0,O-82-173-02-04-05
MUKONO,BUIKWE CTY WEST,LUGAZI T C,NAKAZADDE,KINYORO II,476,4,0,6,138,143,291,21,312,0,O-82-173-02-04-06
MUKONO,BUIKWE CTY WEST,LUGAZI T C,NAKAZADDE,NAKAZADDE II(N - Z),399,0,1,6,94,97,198,2,200,0,O-82-173-02-04-07
MUKONO,BUIKWE CTY WEST,LUGAZI T C,NAMENGO,KITEREDDE 1,800,3,2,3,210,247,465,1,466,0,O-82-173-02-05-01
MUKONO,BUIKWE CTY WEST,LUGAZI T C,NAMENGO,KITEREDDE II (A - M),488,3,1,2,124,130,260,12,272,0,O-82-173-02-05-02
MUKONO,BUIKWE CTY WEST,LUGAZI T C,NAMENGO,KASENKE,712,3,0,9,178,224,414,11,425,0,O-82-173-02-05-03
MUKONO,BUIKWE CTY WEST,LUGAZI T C,NAMENGO,KATAMPEWO,686,1,1,2,212,180,396,22,418,0,O-82-173-02-05-04
MUKONO,BUIKWE CTY WEST,LUGAZI T C,NAMENGO,KITEREDDE II (N - Z),509,0,1,1,128,162,292,12,304,0,O-82-173-02-05-05
MUKONO,BUIKWE CTY WEST,NAJJEMBE,BUVUNYA,BUVUNYA,750,6,1,8,175,335,525,25,550,0,O-82-173-03-01-01
MUKONO,BUIKWE CTY WEST,NAJJEMBE,BUVUNYA,BUWUNDO,709,5,1,5,115,301,427,13,440,0,O-82-173-03-01-02
MUKONO,BUIKWE CTY WEST,NAJJEMBE,BUVUNYA,KOKO,303,1,1,10,113,82,207,7,214,0,O-82-173-03-01-03
MUKONO,BUIKWE CTY WEST,NAJJEMBE,BUWOOLA,BUWOOLA,470,2,2,10,94,211,319,10,329,0,O-82-173-03-02-01
MUKONO,BUIKWE CTY WEST,NAJJEMBE,BUWOOLA,SSANGA,187,4,2,3,20,89,118,12,130,0,O-82-173-03-02-02
MUKONO,BUIKWE CTY WEST,NAJJEMBE,KABANGA,BUGOOYA,197,1,0,1,37,92,131,10,141,0,O-82-173-03-03-01
MUKONO,BUIKWE CTY WEST,NAJJEMBE,KABANGA,TEGGA,452,3,0,4,78,215,300,0,300,0,O-82-173-03-03-02
MUKONO,BUIKWE CTY WEST,NAJJEMBE,KABANGA,BUTAVUJJA,544,1,0,9,81,257,348,20,368,0,O-82-173-03-03-03
MUKONO,BUIKWE CTY WEST,NAJJEMBE,KABANGA,KABULA,377,1,2,3,164,59,229,7,236,0,O-82-173-03-03-04
MUKONO,BUIKWE CTY WEST,NAJJEMBE,KABANGA,TEGGA B,261,2,0,6,55,103,166,7,173,0,O-82-173-03-03-05
MUKONO,BUIKWE CTY WEST,NAJJEMBE,KINONI,KINONI,547,4,1,6,88,237,336,7,343,0,O-82-173-03-04-01
MUKONO,BUIKWE CTY WEST,NAJJEMBE,KINONI,BULYASI/KINONI,560,3,0,5,72,275,355,6,361,0,O-82-173-03-04-02
MUKONO,BUIKWE CTY WEST,NAJJEMBE,KINONI,BUNANGAYA,266,3,2,2,49,119,175,5,180,0,O-82-173-03-04-03
MUKONO,BUIKWE CTY WEST,NAJJEMBE,KITIGOMA,LUGALAMBO,254,2,1,2,71,69,145,3,148,0,O-82-173-03-05-01
MUKONO,BUIKWE CTY WEST,NAJJEMBE,KITIGOMA,NAMATOGONYA,873,4,0,12,229,311,556,13,569,0,O-82-173-03-05-02
MUKONO,BUIKWE CTY WEST,NAJJEMBE,KITIGOMA,NAMANYONYI,799,2,3,11,225,263,504,17,521,0,O-82-173-03-05-03
MUKONO,BUIKWE CTY WEST,NAJJEMBE,KIZIGO,KIKUBE,566,2,1,7,151,242,403,34,437,0,O-82-173-03-06-01
MUKONO,BUIKWE CTY WEST,NAJJEMBE,KIZIGO,KIZIGO,329,1,0,5,80,147,233,14,247,0,O-82-173-03-06-02
MUKONO,BUIKWE CTY WEST,NAJJEMBE,KIZIGO,KIDUSU,545,5,0,4,170,93,272,11,283,0,O-82-173-03-06-03
MUKONO,BUIKWE CTY WEST,NAJJEMBE,KIZIGO,BUKOLONGO,506,2,1,5,176,136,320,6,326,0,O-82-173-03-06-04
MUKONO,BUIKWE CTY WEST,NAJJEMBE,NSAKYA,KASOKOSO,478,3,0,7,92,225,327,14,341,0,O-82-173-03-07-01
MUKONO,BUIKWE CTY WEST,NAJJEMBE,NSAKYA,NSAKYA,839,2,1,6,230,300,539,7,546,0,O-82-173-03-07-02
MUKONO,BUIKWE CTY WEST,NAJJEMBE,NSAKYA,KITOOLA,648,4,0,7,166,308,485,31,516,0,O-82-173-03-07-03
MUKONO,BUIKWE CTY WEST,NAJJEMBE,NSAKYA,DANGALA,563,3,1,2,128,196,330,14,344,0,O-82-173-03-07-04
MUKONO,BUVUMA CTY (ISLANDS),BUGAYA,BUWAGGA,BUWAGGA,520,2,0,12,79,104,197,34,231,0,O-90-175-01-01-01
MUKONO,BUVUMA CTY (ISLANDS),BUGAYA,BUWAGGA,MUWAMA,405,1,0,2,53,47,103,30,133,0,O-90-175-01-01-02
MUKONO,BUVUMA CTY (ISLANDS),BUGAYA,BUWAGGA,LYABAANA,444,0,1,5,138,48,192,6,198,0,O-90-175-01-01-03
MUKONO,BUVUMA CTY (ISLANDS),BUGAYA,BUWAGGA,LUWERO,360,1,2,9,70,34,116,3,119,0,O-90-175-01-01-04
MUKONO,BUVUMA CTY (ISLANDS),BUGAYA,BUWAGGA,ZIIRU,489,2,2,5,95,74,178,9,187,0,O-90-175-01-01-05
MUKONO,BUVUMA CTY (ISLANDS),BUGAYA,BUWAGGA,LIIBU,209,1,0,1,72,38,112,7,119,0,O-90-175-01-01-06
MUKONO,BUVUMA CTY (ISLANDS),BUGAYA,BUWAGGA,KIJJAKA,68,0,0,0,14,12,26,1,27,0,O-90-175-01-01-07
MUKONO,BUVUMA CTY (ISLANDS),BUGAYA,BUWAGGA,NKATA ISLAND,108,0,0,0,33,29,62,7,69,0,O-90-175-01-01-08
MUKONO,BUVUMA CTY (ISLANDS),BUGAYA,BUWAGGA,BUKUZI,40,0,0,0,8,7,15,0,15,0,O-90-175-01-01-09
MUKONO,BUVUMA CTY (ISLANDS),BUGAYA,BUWAGGA,SSAMBA,61,0,0,0,15,7,22,2,24,0,O-90-175-01-01-10
MUKONO,BUVUMA CTY (ISLANDS),BUGAYA,BUWAGGA,DAMBA,76,0,0,0,26,22,48,2,50,0,O-90-175-01-01-11
MUKONO,BUVUMA CTY (ISLANDS),BUGAYA,BUYE,BUYE,815,4,0,3,151,140,298,11,309,0,O-90-175-01-02-01
MUKONO,BUVUMA CTY (ISLANDS),BUGAYA,BUYE,ZINGA ISLAND,395,0,1,1,114,66,182,4,186,0,O-90-175-01-02-02
MUKONO,BUVUMA CTY (ISLANDS),BUGAYA,BUYE,NDWASI,293,1,0,0,51,56,108,25,133,0,O-90-175-01-02-03
MUKONO,BUVUMA CTY (ISLANDS),BUSAMUZI,BUSAMUZI,BUSAMUZI,426,2,0,4,60,145,211,13,224,0,O-90-175-02-01-01
MUKONO,BUVUMA CTY (ISLANDS),BUSAMUZI,BUSAMUZI,KIRONGO,467,0,0,0,66,212,278,18,296,0,O-90-175-02-01-02
MUKONO,BUVUMA CTY (ISLANDS),BUSAMUZI,BUSAMUZI,NAMUGIRI,23,0,0,0,7,5,12,0,12,0,O-90-175-02-01-03
MUKONO,BUVUMA CTY (ISLANDS),BUSAMUZI,BUSAMUZI,GALIGATYA,139,1,2,0,17,75,95,2,97,0,O-90-175-02-01-04
MUKONO,BUVUMA CTY (ISLANDS),BUSAMUZI,BUWOOYA,BUWOOYA / SSESE,695,2,0,1,84,280,367,5,372,0,O-90-175-02-02-01
MUKONO,BUVUMA CTY (ISLANDS),BUSAMUZI,BUWOOYA,BUWANZI B,451,12,2,0,67,141,222,3,225,0,O-90-175-02-02-02
MUKONO,BUVUMA CTY (ISLANDS),BUSAMUZI,BUWOOYA,BUKINALWA / NAMATOOKE,675,3,3,2,101,199,308,10,318,0,O-90-175-02-02-03
MUKONO,BUVUMA CTY (ISLANDS),BUSAMUZI,LINGIRA,LINGIRA,512,3,5,4,148,172,332,10,342,0,O-90-175-02-03-01
MUKONO,BUVUMA CTY (ISLANDS),BUSAMUZI,LINGIRA,ZINGA,252,1,1,1,39,94,136,1,137,0,O-90-175-02-03-02
MUKONO,BUVUMA CTY (ISLANDS),BUSAMUZI,LINGIRA,LUKOMA,284,2,1,5,75,86,169,8,177,0,O-90-175-02-03-03
MUKONO,BUVUMA CTY (ISLANDS),BUSAMUZI,LINGIRA,BUWANZI,396,7,0,0,69,114,190,6,196,0,O-90-175-02-03-04
MUKONO,BUVUMA CTY (ISLANDS),BUSAMUZI,LINGIRA,MAWANGA,328,1,0,2,60,105,168,2,170,0,O-90-175-02-03-05
MUKONO,BUVUMA CTY (ISLANDS),BUSAMUZI,LINGIRA,KATONGA,241,4,2,0,36,73,115,0,115,0,O-90-175-02-03-06
MUKONO,BUVUMA CTY (ISLANDS),BUSAMUZI,LINGIRA,BANGA,59,1,0,0,22,13,36,2,38,0,O-90-175-02-03-07
MUKONO,BUVUMA CTY (ISLANDS),BUSAMUZI,LINGIRA,BUGAABO,209,1,2,0,89,75,167,9,176,0,O-90-175-02-03-08
MUKONO,BUVUMA CTY (ISLANDS),BUSAMUZI,LUNYANJA,WALWANDA,590,1,1,15,104,135,256,9,265,0,O-90-175-02-04-01
MUKONO,BUVUMA CTY (ISLANDS),BUSAMUZI,LUNYANJA,KYANAMU,265,0,0,1,43,88,132,2,134,0,O-90-175-02-04-02
MUKONO,BUVUMA CTY (ISLANDS),BWEMA,BWEEMA,KYANJA,383,0,1,4,86,109,200,9,209,0,O-90-175-03-01-01
MUKONO,BUVUMA CTY (ISLANDS),BWEMA,BWEEMA,SERINYA,264,0,1,7,52,22,82,3,85,0,O-90-175-03-01-02
MUKONO,BUVUMA CTY (ISLANDS),BWEMA,BWEEMA,NALUBAALE,181,0,0,5,32,23,60,1,61,0,O-90-175-03-01-03
MUKONO,BUVUMA CTY (ISLANDS),BWEMA,BWEEMA,MALIJJA BWANIKA,195,1,0,2,61,58,122,1,123,0,O-90-175-03-01-04
MUKONO,BUVUMA CTY (ISLANDS),BWEMA,BWEEMA,BUKWAYA ISLAND,223,2,1,1,33,99,136,6,142,0,O-90-175-03-01-05
MUKONO,BUVUMA CTY (ISLANDS),BWEMA,BWEEMA,NAMATALE,656,3,3,3,102,208,319,22,341,0,O-90-175-03-01-06
MUKONO,BUVUMA CTY (ISLANDS),BWEMA,BWEEMA,ZIIRU,331,2,0,3,80,31,116,7,123,0,O-90-175-03-01-07
MUKONO,BUVUMA CTY (ISLANDS),BWEMA,BWEEMA,BWEEMA S/C HQTRS,109,0,0,3,17,56,76,2,78,0,O-90-175-03-01-08
MUKONO,BUVUMA CTY (ISLANDS),BWEMA,BWEEMA,GUNDA,78,0,0,0,14,18,32,2,34,0,O-90-175-03-01-09
MUKONO,BUVUMA CTY (ISLANDS),BWEMA,BWEEMA,NYENDA,125,1,0,2,11,47,61,3,64,0,O-90-175-03-01-10
MUKONO,BUVUMA CTY (ISLANDS),BWEMA,LWAJJE,LWAJJE,353,2,0,1,56,129,188,26,214,0,O-90-175-03-02-01
MUKONO,BUVUMA CTY (ISLANDS),BWEMA,LWAJJE,LYABALUME,161,0,0,0,43,18,61,3,64,0,O-90-175-03-02-02
MUKONO,BUVUMA CTY (ISLANDS),BWEMA,LWAJJE,KIWOLOLO,389,2,1,2,42,121,168,10,178,0,O-90-175-03-02-03
MUKONO,BUVUMA CTY (ISLANDS),BWEMA,LWAJJE,KASERERE,72,0,0,0,19,51,70,2,72,0,O-90-175-03-02-04
MUKONO,BUVUMA CTY (ISLANDS),NAIRAMBI,BUWANGA,BUWANGA,738,3,1,20,141,183,348,13,361,0,O-90-175-04-01-01
MUKONO,BUVUMA CTY (ISLANDS),NAIRAMBI,BUWANGA,MUBAALE,506,2,0,3,163,64,232,3,235,0,O-90-175-04-01-02
MUKONO,BUVUMA CTY (ISLANDS),NAIRAMBI,BUWANGA,KASAALI,480,1,0,3,118,38,160,1,161,0,O-90-175-04-01-03
MUKONO,BUVUMA CTY (ISLANDS),NAIRAMBI,BUWANGA,TOJJWE,442,3,2,1,78,109,193,7,200,0,O-90-175-04-01-04
MUKONO,BUVUMA CTY (ISLANDS),NAIRAMBI,BUWANGA,NVUZA,163,0,0,1,14,32,47,8,55,0,O-90-175-04-01-05
MUKONO,BUVUMA CTY (ISLANDS),NAIRAMBI,LUUFU,LUKALE,499,2,0,2,108,129,241,20,261,0,O-90-175-04-02-01
MUKONO,BUVUMA CTY (ISLANDS),NAIRAMBI,LUUFU,LUUFU,186,0,0,0,44,58,102,4,106,0,O-90-175-04-02-02
MUKONO,BUVUMA CTY (ISLANDS),NAIRAMBI,LUUFU,YUBWE,182,0,2,1,37,52,92,2,94,0,O-90-175-04-02-03
MUKONO,BUVUMA CTY (ISLANDS),NAIRAMBI,LUUFU,BUKINAALWA,406,0,0,0,95,82,177,4,181,0,O-90-175-04-02-04
MUKONO,BUVUMA CTY (ISLANDS),NAIRAMBI,LUUFU,BULUGULU,479,4,0,1,69,144,218,17,235,0,O-90-175-04-02-05
MUKONO,BUVUMA CTY (ISLANDS),NAIRAMBI,MAGYO,KATININDI,260,6,1,2,37,92,138,3,141,0,O-90-175-04-03-01
MUKONO,BUVUMA CTY (ISLANDS),NAIRAMBI,MAGYO,MANYAMA,594,3,0,17,109,198,327,8,335,0,O-90-175-04-03-02
MUKONO,BUVUMA CTY (ISLANDS),NAIRAMBI,MAGYO,KEMBO,412,0,1,1,75,75,152,6,158,0,O-90-175-04-03-03
MUKONO,BUVUMA CTY (ISLANDS),NAIRAMBI,MAGYO,KAKEJE,165,0,0,19,39,36,94,0,94,0,O-90-175-04-03-04
MUKONO,BUVUMA CTY (ISLANDS),NAIRAMBI,MAGYO,NDOOTWE,173,2,0,1,38,34,75,2,77,0,O-90-175-04-03-05
MUKONO,BUVUMA CTY (ISLANDS),NAIRAMBI,NAMITTI,KIREWE,575,8,0,0,138,56,202,10,212,0,O-90-175-04-04-01
MUKONO,BUVUMA CTY (ISLANDS),NAIRAMBI,NAMITTI,MAKALAGA,51,0,0,0,11,9,20,1,21,0,O-90-175-04-04-02
MUKONO,BUVUMA CTY (ISLANDS),NAIRAMBI,NAMITTI,NAMITI,441,3,0,0,107,76,186,3,189,0,O-90-175-04-04-03
MUKONO,BUVUMA CTY (ISLANDS),NAIRAMBI,NAMITTI,LABOLO,107,0,0,0,23,9,32,2,34,0,O-90-175-04-04-04
MUKONO,BUVUMA CTY (ISLANDS),NAIRAMBI,NAMITTI,LUBYA (A - M),438,3,0,2,110,47,162,13,175,0,O-90-175-04-04-05
MUKONO,BUVUMA CTY (ISLANDS),NAIRAMBI,NAMITTI,LUBYA (N - Z),507,3,2,3,86,67,161,19,180,0,O-90-175-04-04-06
MPIGI,GOMBA COUNTY,KABULASOKE,BUKANDULA,BUKANDULA,711,1,3,12,214,217,447,17,464,0,O-91-158-01-01-01
MPIGI,GOMBA COUNTY,KABULASOKE,BUKANDULA,KIGO,570,2,1,3,86,294,386,9,395,0,O-91-158-01-01-02
MPIGI,GOMBA COUNTY,KABULASOKE,BUKANDULA,KATEETE,384,0,0,10,78,157,245,4,249,0,O-91-158-01-01-03
MPIGI,GOMBA COUNTY,KABULASOKE,BUKANDULA,KANDEGEYA,531,0,0,4,50,317,371,3,374,0,O-91-158-01-01-04
MPIGI,GOMBA COUNTY,KABULASOKE,BULWADDA,BULWADDA C/S,631,0,0,6,63,342,411,10,421,0,O-91-158-01-02-01
MPIGI,GOMBA COUNTY,KABULASOKE,BULWADDA,MATAKA,667,4,0,3,25,401,433,17,450,0,O-91-158-01-02-02
MPIGI,GOMBA COUNTY,KABULASOKE,BULWADDA,LUZIRA,547,0,1,12,29,295,337,17,354,0,O-91-158-01-02-03
MPIGI,GOMBA COUNTY,KABULASOKE,BULWADDA,NSIMBIZIWOOME,188,0,0,1,11,116,128,4,132,0,O-91-158-01-02-04
MPIGI,GOMBA COUNTY,KABULASOKE,BUTITI,KAKIPUYA,545,0,0,7,64,275,346,20,366,0,O-91-158-01-03-01
MPIGI,GOMBA COUNTY,KABULASOKE,BUTITI,LUBAALE,562,1,1,6,53,355,416,10,426,0,O-91-158-01-03-02
MPIGI,GOMBA COUNTY,KABULASOKE,BUTITI,KABULASOKE S/C HTQRS,958,1,1,22,162,468,654,19,673,0,O-91-158-01-03-03
MPIGI,GOMBA COUNTY,KABULASOKE,KALWANGA,KAKUBANSIRI UMEA,971,1,4,1,71,559,636,11,647,0,O-91-158-01-04-01
MPIGI,GOMBA COUNTY,KABULASOKE,KALWANGA,KAKUBANSIRI C/S,342,2,0,1,26,193,222,11,233,0,O-91-158-01-04-02
MPIGI,GOMBA COUNTY,KABULASOKE,KALWANGA,MIRAMBI,761,1,1,0,34,457,493,8,501,0,O-91-158-01-04-03
MPIGI,GOMBA COUNTY,KABULASOKE,KALWANGA,KALWANGA,674,4,0,7,54,369,434,10,444,0,O-91-158-01-04-04
MPIGI,GOMBA COUNTY,KABULASOKE,KIFAMPA,KIFAMPA C/U,624,3,0,4,58,337,402,0,402,0,O-91-158-01-05-01
MPIGI,GOMBA COUNTY,KABULASOKE,KIFAMPA,KITAYITWAKO,446,2,1,6,62,256,327,7,334,0,O-91-158-01-05-02
MPIGI,GOMBA COUNTY,KABULASOKE,KIFAMPA,KAGONGERO,580,2,1,10,26,398,437,11,448,0,O-91-158-01-05-03
MPIGI,GOMBA COUNTY,KABULASOKE,KIFAMPA,KIFAMPA UMEA,346,0,2,10,26,223,261,8,269,0,O-91-158-01-05-04
MPIGI,GOMBA COUNTY,KABULASOKE,KISOZI,KISOZI,654,1,0,4,20,449,474,21,495,0,O-91-158-01-06-01
MPIGI,GOMBA COUNTY,KABULASOKE,KISOZI,KAWUULA,711,0,0,3,35,394,432,15,447,0,O-91-158-01-06-02
MPIGI,GOMBA COUNTY,KABULASOKE,KISOZI,KAMUSENENE,490,0,0,1,36,262,299,12,311,0,O-91-158-01-06-03
MPIGI,GOMBA COUNTY,KABULASOKE,LUGAGA,KISAMULA C/S,258,0,0,7,65,114,186,7,193,0,O-91-158-01-07-01
MPIGI,GOMBA COUNTY,KABULASOKE,LUGAGA,LUGAAGA C/U P/S,363,2,2,6,37,160,207,11,218,0,O-91-158-01-07-02
MPIGI,GOMBA COUNTY,KABULASOKE,LUGAGA,LUGAAGA UMEA,834,2,1,7,106,410,526,27,553,0,O-91-158-01-07-03
MPIGI,GOMBA COUNTY,KABULASOKE,MATONGO,MATONGO C/U,563,0,1,11,30,359,401,22,423,0,O-91-158-01-08-01
MPIGI,GOMBA COUNTY,KABULASOKE,MATONGO,BUSAALE R/C,514,1,3,12,42,290,348,7,355,0,O-91-158-01-08-02
MPIGI,GOMBA COUNTY,KABULASOKE,MAWUKI,NAKULAMUDDE,422,1,0,12,86,206,305,10,315,0,O-91-158-01-09-01
MPIGI,GOMBA COUNTY,KABULASOKE,MAWUKI,MAWUKI,710,2,1,14,115,311,443,10,453,0,O-91-158-01-09-02
MPIGI,GOMBA COUNTY,KYEGONZA,BUKUNDUGULU,BUYANJA,544,10,0,6,85,268,369,0,369,0,O-91-158-02-01-01
MPIGI,GOMBA COUNTY,KYEGONZA,BUKUNDUGULU,KITAKA STORE,235,0,0,1,33,113,147,5,152,0,O-91-158-02-01-02
MPIGI,GOMBA COUNTY,KYEGONZA,KANONI,KANONI COUNTY HQTRS (A-M),326,1,1,8,60,130,200,6,206,0,O-91-158-02-02-01
MPIGI,GOMBA COUNTY,KYEGONZA,KANONI,KITWE C/U,302,3,1,10,22,204,240,5,245,0,O-91-158-02-02-02
MPIGI,GOMBA COUNTY,KYEGONZA,KANONI,KANONI C/S,817,1,1,10,97,465,574,1,575,0,O-91-158-02-02-03
MPIGI,GOMBA COUNTY,KYEGONZA,KANONI,KANONI COUNTY HQTRS (N-Z),462,2,0,7,63,205,277,7,284,0,O-91-158-02-02-04
MPIGI,GOMBA COUNTY,KYEGONZA,KISOGA,SEKULO,590,0,0,5,67,312,384,5,389,0,O-91-158-02-03-01
MPIGI,GOMBA COUNTY,KYEGONZA,KISOGA,KISOGA,765,0,0,17,90,451,558,7,565,0,O-91-158-02-03-02
MPIGI,GOMBA COUNTY,KYEGONZA,MALELE,MALELE,485,1,0,4,89,268,362,7,369,0,O-91-158-02-04-01
MPIGI,GOMBA COUNTY,KYEGONZA,MALELE,LUMULI-KABULASOKE,358,2,0,4,47,197,250,9,259,0,O-91-158-02-04-02
MPIGI,GOMBA COUNTY,KYEGONZA,MAMBA,MAMBA T. C (A-M),340,3,0,3,32,207,245,5,250,0,O-91-158-02-05-01
MPIGI,GOMBA COUNTY,KYEGONZA,MAMBA,NABUYINDO P/S,698,2,3,2,43,396,446,9,455,0,O-91-158-02-05-02
MPIGI,GOMBA COUNTY,KYEGONZA,MAMBA,KIZIBA,427,3,0,3,25,244,275,16,291,0,O-91-158-02-05-03
MPIGI,GOMBA COUNTY,KYEGONZA,MAMBA,MAMBA T. C (N-Z),547,1,1,4,31,309,346,16,362,0,O-91-158-02-05-04
MPIGI,GOMBA COUNTY,KYEGONZA,MPUNGE,MPUNGE,813,4,1,11,118,420,554,7,561,0,O-91-158-02-06-01
MPIGI,GOMBA COUNTY,KYEGONZA,MPUNGE,LWANGANZI P/S,520,0,0,2,32,383,417,12,429,0,O-91-158-02-06-02
MPIGI,GOMBA COUNTY,KYEGONZA,NAKIJJU,KASASA,707,2,2,15,143,313,475,3,478,0,O-91-158-02-07-01
MPIGI,GOMBA COUNTY,KYEGONZA,NAKIJJU,NAKIJU,628,1,0,12,165,232,410,15,425,0,O-91-158-02-07-02
MPIGI,GOMBA COUNTY,KYEGONZA,NAMABEYA,NAMABEYA,740,2,0,11,99,450,562,6,568,0,O-91-158-02-08-01
MPIGI,GOMBA COUNTY,KYEGONZA,NAMABEYA,BUZIMBA,507,1,0,13,131,204,349,7,356,0,O-91-158-02-08-02
MPIGI,GOMBA COUNTY,KYEGONZA,NSAMBWE,NSAMBWE T.C,510,3,0,12,104,193,312,4,316,0,O-91-158-02-09-01
MPIGI,GOMBA COUNTY,KYEGONZA,NSAMBWE,KIMBO KIZIGO B,454,1,1,7,124,233,366,9,375,0,O-91-158-02-09-02
MPIGI,GOMBA COUNTY,KYEGONZA,NSAMBWE,KIZIGO SDA P/S,338,0,0,2,58,168,228,10,238,0,O-91-158-02-09-03
MPIGI,GOMBA COUNTY,KYEGONZA,SAALI,BUKALAGI,420,2,0,29,107,141,279,9,288,0,O-91-158-02-10-01
MPIGI,GOMBA COUNTY,KYEGONZA,SAALI,SSAALI,403,0,1,5,22,266,294,8,302,0,O-91-158-02-10-02
MPIGI,GOMBA COUNTY,KYEGONZA,SABAGABO(KOOME),KOOME,582,3,0,11,99,312,425,10,435,0,O-91-158-02-11-01
MPIGI,GOMBA COUNTY,KYEGONZA,SABAGABO(KOOME),KASAKA,559,0,0,14,90,281,385,9,394,0,O-91-158-02-11-02
MPIGI,GOMBA COUNTY,KYEGONZA,WANJEYO,WANJEYO,507,2,0,8,68,323,401,4,405,0,O-91-158-02-12-01
MPIGI,GOMBA COUNTY,KYEGONZA,WANJEYO,NAKAYE,338,0,0,1,47,174,222,14,236,0,O-91-158-02-12-02
MPIGI,GOMBA COUNTY,MADDU,DDEGEYA,LUMANYO,361,2,1,2,45,181,231,26,257,0,O-91-158-03-01-01
MPIGI,GOMBA COUNTY,MADDU,DDEGEYA,DDEGEYA UMEA PRIMARY SCHO,384,1,1,1,41,234,278,7,285,0,O-91-158-03-01-02
MPIGI,GOMBA COUNTY,MADDU,DDEGEYA,BUYANJA T.C,504,0,0,0,34,333,367,42,409,0,O-91-158-03-01-03
MPIGI,GOMBA COUNTY,MADDU,DDEGEYA,NAKITEMBE C.O.U,335,0,0,1,4,277,282,2,284,0,O-91-158-03-01-04
MPIGI,GOMBA COUNTY,MADDU,DDEGEYA,KIRASI T/C,668,0,0,0,20,435,455,15,470,0,O-91-158-03-01-05
MPIGI,GOMBA COUNTY,MADDU,KIGEZI,KYABALEMBYA T. C (N-Z),666,3,2,7,50,379,441,14,455,0,O-91-158-03-02-01
MPIGI,GOMBA COUNTY,MADDU,KIGEZI,KYABALEMBYA T. C (A-M),651,1,0,7,56,364,428,11,439,0,O-91-158-03-02-02
MPIGI,GOMBA COUNTY,MADDU,KIGEZI,KYAMBOOBO,588,1,0,1,30,399,431,3,434,0,O-91-158-03-02-03
MPIGI,GOMBA COUNTY,MADDU,KIGEZI,LUKONDA TRADING CENTRE,550,1,1,4,46,374,426,6,432,0,O-91-158-03-02-04
MPIGI,GOMBA COUNTY,MADDU,KIGEZI,BUJUNJUUZI C/U,640,2,0,3,38,399,442,5,447,0,O-91-158-03-02-05
MPIGI,GOMBA COUNTY,MADDU,KYABAGAMBA,KIGAYAZA INFANT SCHOOL,451,2,1,0,24,255,282,61,343,0,O-91-158-03-03-01
MPIGI,GOMBA COUNTY,MADDU,KYABAGAMBA,KYABAGAMBA CATHOLIC PRIMAR,405,0,2,3,35,243,283,25,308,0,O-91-158-03-03-02
MPIGI,GOMBA COUNTY,MADDU,KYAYI,KYAAYI PRIMARY SCHOOL (A-M),594,1,0,6,30,349,386,11,397,0,O-91-158-03-04-01
MPIGI,GOMBA COUNTY,MADDU,KYAYI,BUGULA PRIMARY SCHOOL,300,0,0,1,7,248,256,3,259,0,O-91-158-03-04-02
MPIGI,GOMBA COUNTY,MADDU,KYAYI,KYAMUKAMA T.C,473,3,0,1,47,260,311,8,319,0,O-91-158-03-04-03
MPIGI,GOMBA COUNTY,MADDU,KYAYI,KYAAYI PRIMARY SCHOOL (N-Z),489,1,0,3,29,290,323,13,336,0,O-91-158-03-04-04
MPIGI,GOMBA COUNTY,MADDU,MADDU,MADDU C/U PRIMARY SCHOOL,591,1,2,3,43,369,418,24,442,0,O-91-158-03-05-01
MPIGI,GOMBA COUNTY,MADDU,MADDU,MADDU A (A-M),566,0,0,3,81,225,309,55,364,0,O-91-158-03-05-02
MPIGI,GOMBA COUNTY,MADDU,MADDU,KAYUNGA C/U PRIMARY SCHOOL,686,1,0,3,43,437,484,9,493,0,O-91-158-03-05-03
MPIGI,GOMBA COUNTY,MADDU,MADDU,LWANSASI PRIMARY SCHOOL,352,1,0,4,26,224,255,9,264,0,O-91-158-03-05-04
MPIGI,GOMBA COUNTY,MADDU,MADDU,MADDU A (N-Z),713,2,0,4,78,282,366,79,445,0,O-91-158-03-05-05
MPIGI,GOMBA COUNTY,MADDU,NTALAGI,GWANIKA,508,2,0,4,40,329,375,7,382,0,O-91-158-03-06-01
MPIGI,GOMBA COUNTY,MADDU,NTALAGI,LUSAANA,349,0,1,13,30,206,250,9,259,0,O-91-158-03-06-02
MPIGI,GOMBA COUNTY,MPENJA,BBINZI/TTABA,BUYINJABUTOOLE,549,1,1,20,117,213,352,12,364,0,O-91-158-04-01-01
MPIGI,GOMBA COUNTY,MPENJA,BBINZI/TTABA,NGALAGALA,372,1,0,3,75,183,262,9,271,0,O-91-158-04-01-02
MPIGI,GOMBA COUNTY,MPENJA,BBINZI/TTABA,TTABA,447,3,1,9,49,206,268,0,268,0,O-91-158-04-01-03
MPIGI,GOMBA COUNTY,MPENJA,GOLOLA,GOLOLA A,490,2,0,0,114,199,315,6,321,0,O-91-158-04-02-01
MPIGI,GOMBA COUNTY,MPENJA,GOLOLA,KYETUME-KITOJO,375,3,1,28,81,182,295,4,299,0,O-91-158-04-02-02
MPIGI,GOMBA COUNTY,MPENJA,GOLOLA,LUWANGALA-JJUMBI,316,0,0,4,90,126,220,4,224,0,O-91-158-04-02-03
MPIGI,GOMBA COUNTY,MPENJA,GOLOLA,GOLOLA B,223,0,0,3,34,109,146,10,156,0,O-91-158-04-02-04
MPIGI,GOMBA COUNTY,MPENJA,KAKOMO,MPENJA S/C HTQRS,492,1,1,6,108,180,296,4,300,0,O-91-158-04-03-01
MPIGI,GOMBA COUNTY,MPENJA,KAKOMO,KAKOMO,263,0,0,6,66,93,165,5,170,0,O-91-158-04-03-02
MPIGI,GOMBA COUNTY,MPENJA,KANZIIRA,KANZIIRA,475,1,1,5,46,282,335,10,345,0,O-91-158-04-04-01
MPIGI,GOMBA COUNTY,MPENJA,KANZIIRA,BUJEGE,452,2,2,16,106,169,295,6,301,0,O-91-158-04-04-02
MPIGI,GOMBA COUNTY,MPENJA,KIRIRI,KIRIRI,633,1,0,18,214,162,395,6,401,0,O-91-158-04-05-01
MPIGI,GOMBA COUNTY,MPENJA,KIRIRI,NSWANJERE,473,3,1,7,105,175,291,9,300,0,O-91-158-04-05-02
MPIGI,GOMBA COUNTY,MPENJA,MASERUKA,MASERUKA,354,1,0,2,25,205,233,8,241,0,O-91-158-04-06-01
MPIGI,GOMBA COUNTY,MPENJA,MASERUKA,SUGEEZI T/C,304,0,0,4,15,212,231,3,234,0,O-91-158-04-06-02
MPIGI,GOMBA COUNTY,MPENJA,MPOGO,MPOGO,524,1,1,1,45,244,292,66,358,0,O-91-158-04-07-01
MPIGI,GOMBA COUNTY,MPENJA,MPOGO,KIKOKO,754,2,0,4,84,426,516,8,524,0,O-91-158-04-07-02
MPIGI,GOMBA COUNTY,MPENJA,NGERIBALYA,NGELIBALYA,447,0,0,4,129,195,328,4,332,0,O-91-158-04-08-01
MPIGI,GOMBA COUNTY,MPENJA,NGERIBALYA,MPONGO,500,2,0,3,107,253,365,18,383,0,O-91-158-04-08-02
MPIGI,GOMBA COUNTY,MPENJA,NGOMANENE,NGOMANENE C/S,569,2,2,10,74,293,381,18,399,0,O-91-158-04-09-01
MPIGI,GOMBA COUNTY,MPENJA,NGOMANENE,NGOMANENE P/S,546,2,0,8,116,239,365,10,375,0,O-91-158-04-09-02
MPIGI,GOMBA COUNTY,MPENJA,NGOMANENE,KALYABAYOGA UMEA,321,1,1,1,44,167,214,0,214,0,O-91-158-04-09-03
MPIGI,GOMBA COUNTY,MPENJA,NKOMA,NGEYE,615,0,3,17,144,261,425,13,438,0,O-91-158-04-10-01
MPIGI,GOMBA COUNTY,MPENJA,NKOMA,NDIMULABA,278,0,0,4,27,161,192,10,202,0,O-91-158-04-10-02
KIBOGA,KIBOGA COUNTY WEST,BUTEMBA,BUKWIRI,LWENGIRI,202,0,0,0,1,120,121,4,125,0,O-93-85-01-01-01
KIBOGA,KIBOGA COUNTY WEST,BUTEMBA,BUKWIRI,BUKWIRI P/S A,417,0,0,2,40,103,145,3,148,0,O-93-85-01-01-02
KIBOGA,KIBOGA COUNTY WEST,BUTEMBA,BUKWIRI,BUKWIRI P/S B,666,0,1,5,60,220,286,6,292,0,O-93-85-01-01-03
KIBOGA,KIBOGA COUNTY WEST,BUTEMBA,BUKWIRI,KASEETA,575,1,0,1,29,201,232,5,237,0,O-93-85-01-01-04
KIBOGA,KIBOGA COUNTY WEST,BUTEMBA,BUKWIRI,BUKWIRI T.C,399,2,0,1,26,133,162,8,170,0,O-93-85-01-01-05
KIBOGA,KIBOGA COUNTY WEST,BUTEMBA,BULAMULA,KABAGAYA,875,4,2,3,83,350,442,25,467,0,O-93-85-01-02-01
KIBOGA,KIBOGA COUNTY WEST,BUTEMBA,BULAMULA,KYAMUKWANGA,264,0,0,1,13,154,168,5,173,0,O-93-85-01-02-02
KIBOGA,KIBOGA COUNTY WEST,BUTEMBA,BYERIIMA,BYERIIMA (A-M),652,3,0,6,66,280,355,9,364,0,O-93-85-01-03-01
KIBOGA,KIBOGA COUNTY WEST,BUTEMBA,BYERIIMA,BUGONDI PRIMARY SCHOOL,856,7,1,7,84,318,417,10,427,0,O-93-85-01-03-02
KIBOGA,KIBOGA COUNTY WEST,BUTEMBA,BYERIIMA,KIRYAMUSUNKU T.C,715,3,0,4,77,279,363,25,388,0,O-93-85-01-03-03
KIBOGA,KIBOGA COUNTY WEST,BUTEMBA,BYERIIMA,BYERIIMA (N-Z),605,1,1,6,46,280,334,26,360,0,O-93-85-01-03-04
KIBOGA,KIBOGA COUNTY WEST,BUTEMBA,KATOVU,BUGULUMA,812,4,0,7,39,426,476,22,498,0,O-93-85-01-04-01
KIBOGA,KIBOGA COUNTY WEST,BUTEMBA,KATOVU,BUKIRIMBO,209,1,0,0,10,139,150,2,152,0,O-93-85-01-04-02
KIBOGA,KIBOGA COUNTY WEST,BUTEMBA,KIKOMA,KIKOMA B,538,2,1,4,52,266,325,14,339,0,O-93-85-01-05-01
KIBOGA,KIBOGA COUNTY WEST,BUTEMBA,KIKOMA,LWAMAGAALI,639,3,0,12,51,301,367,13,380,0,O-93-85-01-05-02
KIBOGA,KIBOGA COUNTY WEST,BUTEMBA,LWEBISIRIZA,LWEBISIRIZA T/C,575,1,0,2,66,246,315,18,333,0,O-93-85-01-06-01
KIBOGA,KIBOGA COUNTY WEST,BUTEMBA,LWEBISIRIZA,LWENKONGE,809,0,1,5,109,281,396,16,412,0,O-93-85-01-06-02
KIBOGA,KIBOGA COUNTY WEST,BUTEMBA,MISAGO,KAYUNGA PRIMARY SCHOOL,690,8,0,6,48,380,442,31,473,0,O-93-85-01-07-01
KIBOGA,KIBOGA COUNTY WEST,BUTEMBA,MISAGO,KAYUNGA P/S B,363,3,0,1,29,205,238,13,251,0,O-93-85-01-07-02
KIBOGA,KIBOGA COUNTY WEST,BUTEMBA,NABITAKULI,BISIIKA,850,2,0,4,61,339,406,29,435,0,O-93-85-01-08-01
KIBOGA,KIBOGA COUNTY WEST,BUTEMBA,NABITAKULI,LWABALANGA,444,4,0,7,108,201,320,2,322,0,O-93-85-01-08-02
KIBOGA,KIBOGA COUNTY WEST,BUTEMBA,NABITAKULI,NAMIRIRO,345,3,0,2,25,170,200,12,212,0,O-93-85-01-08-03
KIBOGA,KIBOGA COUNTY WEST,GAYAZA,GAYAZA,GAYAZA,657,1,0,4,39,391,435,8,443,0,O-93-85-02-01-01
KIBOGA,KIBOGA COUNTY WEST,GAYAZA,GAYAZA,NKONDO P/S,429,1,2,2,19,251,275,8,283,0,O-93-85-02-01-02
KIBOGA,KIBOGA COUNTY WEST,GAYAZA,KIRYAJOBYO,BUTAMBUKA,407,1,0,3,38,233,275,10,285,0,O-93-85-02-02-01
KIBOGA,KIBOGA COUNTY WEST,GAYAZA,KIRYAJOBYO,KASANJE,597,3,1,2,36,324,366,11,377,0,O-93-85-02-02-02
KIBOGA,KIBOGA COUNTY WEST,GAYAZA,KIYUNI,KIYUNI TRADING CENTRE,593,2,0,1,67,364,434,8,442,0,O-93-85-02-03-01
KIBOGA,KIBOGA COUNTY WEST,GAYAZA,KIYUNI,NANKANDULA,333,1,0,0,17,209,227,8,235,0,O-93-85-02-03-02
KIBOGA,KIBOGA COUNTY WEST,GAYAZA,KIYUNI,KIKUUBYA T.C,235,0,0,1,6,164,171,10,181,0,O-93-85-02-03-03
KIBOGA,KIBOGA COUNTY WEST,GAYAZA,LUWUUNA,LUWUUNA,661,3,1,10,21,334,369,39,408,0,O-93-85-02-04-01
KIBOGA,KIBOGA COUNTY WEST,GAYAZA,LUWUUNA,KISALA PRIMARY,724,5,0,14,12,435,466,61,527,0,O-93-85-02-04-02
KIBOGA,KIBOGA COUNTY WEST,KYANKWANZI,BANDA,BANDA,615,0,0,0,7,465,472,5,477,0,O-93-85-03-01-01
KIBOGA,KIBOGA COUNTY WEST,KYANKWANZI,GALA,GALA,345,1,0,1,3,298,303,3,306,0,O-93-85-03-02-01
KIBOGA,KIBOGA COUNTY WEST,KYANKWANZI,GALA,RWENGAJU,383,0,0,0,3,357,360,3,363,0,O-93-85-03-02-02
KIBOGA,KIBOGA COUNTY WEST,KYANKWANZI,KYANKWANZI,SUNGA,251,0,0,0,0,247,247,4,251,0,O-93-85-03-03-01
KIBOGA,KIBOGA COUNTY WEST,KYANKWANZI,KYANKWANZI,NALUKONGE,834,0,0,1,27,407,435,8,443,0,O-93-85-03-03-02
KIBOGA,KIBOGA COUNTY WEST,KYANKWANZI,KYANKWANZI,NTAVERA,341,0,0,1,14,251,266,1,267,0,O-93-85-03-03-03
KIBOGA,KIBOGA COUNTY WEST,KYANKWANZI,KYANKWANZI,KAYANJA OUTSIDE Q.GUARD,515,3,0,4,37,253,297,3,300,0,O-93-85-03-03-04
KIBOGA,KIBOGA COUNTY WEST,KYANKWANZI,LUBIRI,KYALAJONI,269,0,0,1,21,200,222,3,225,0,O-93-85-03-04-01
KIBOGA,KIBOGA COUNTY WEST,KYANKWANZI,LUBIRI,BIROBOKA T.C,421,0,0,1,4,415,420,1,421,0,O-93-85-03-04-02
KIBOGA,KIBOGA COUNTY WEST,KYANKWANZI,LUBIRI,KATUUGO,551,1,0,0,3,535,539,2,541,0,O-93-85-03-04-03
KIBOGA,KIBOGA COUNTY WEST,KYANKWANZI,LUBIRI,LUBIRI,658,0,0,2,16,628,646,8,654,0,O-93-85-03-04-04
KIBOGA,KIBOGA COUNTY WEST,KYANKWANZI,LWEBISANJA,KITEGWA P/S,386,0,0,1,3,344,348,1,349,0,O-93-85-03-05-01
KIBOGA,KIBOGA COUNTY WEST,KYANKWANZI,LWEMIGANDA,KASEJERE T\C,490,0,0,0,1,482,483,4,487,0,O-93-85-03-06-01
KIBOGA,KIBOGA COUNTY WEST,KYANKWANZI,LWEMIGANDA,BUWANGA,316,0,0,0,1,312,313,0,313,0,O-93-85-03-06-02
KIBOGA,KIBOGA COUNTY WEST,MULAGI,KALAGI,KALAGI,343,0,0,3,63,160,226,9,235,0,O-93-85-04-01-01
KIBOGA,KIBOGA COUNTY WEST,MULAGI,KALAGI,KIYUNI,268,0,0,1,31,166,198,8,206,0,O-93-85-04-01-02
KIBOGA,KIBOGA COUNTY WEST,MULAGI,KIGANDO (MASODDE),KIGANDO,508,2,0,2,37,181,222,13,235,0,O-93-85-04-02-01
KIBOGA,KIBOGA COUNTY WEST,MULAGI,KIGANDO (MASODDE),BUMBIRI,487,0,0,2,24,348,374,6,380,0,O-93-85-04-02-02
KIBOGA,KIBOGA COUNTY WEST,MULAGI,KIGANDO (MASODDE),MUGEREKA FULL GOSPEL CHURC,589,1,0,4,61,272,338,5,343,0,O-93-85-04-02-03
KIBOGA,KIBOGA COUNTY WEST,MULAGI,KIGANDO (MASODDE),NAKIMPULI SDA CHURCH,213,2,1,3,11,119,136,30,166,0,O-93-85-04-02-04
KIBOGA,KIBOGA COUNTY WEST,MULAGI,KIWAGUZI,KITEREDDE,558,1,1,1,109,252,364,19,383,0,O-93-85-04-03-01
KIBOGA,KIBOGA COUNTY WEST,MULAGI,KIWAGUZI,KIWAGUZI,447,1,0,2,45,269,317,4,321,0,O-93-85-04-03-02
KIBOGA,KIBOGA COUNTY WEST,MULAGI,KIWAGUZI,KIBOGA PARENTS P/S,447,2,1,1,41,242,287,8,295,0,O-93-85-04-03-03
KIBOGA,KIBOGA COUNTY WEST,MULAGI,LUWAWU,VVUMBA PRIMARY SCHOOL,448,0,0,10,68,241,319,2,321,0,O-93-85-04-04-01
KIBOGA,KIBOGA COUNTY WEST,MULAGI,LUWAWU,KAFAGAGALA,384,1,0,3,47,219,270,5,275,0,O-93-85-04-04-02
KIBOGA,KIBOGA COUNTY WEST,NSAMBYA,BANANYWA,KIRYANONGO,651,2,1,2,68,342,415,20,435,0,O-93-85-05-01-01
KIBOGA,KIBOGA COUNTY WEST,NSAMBYA,BANANYWA,NAKASERO,611,0,0,5,108,278,391,16,407,0,O-93-85-05-01-02
KIBOGA,KIBOGA COUNTY WEST,NSAMBYA,BANANYWA,LWENGO,431,0,2,4,46,245,297,7,304,0,O-93-85-05-01-03
KIBOGA,KIBOGA COUNTY WEST,NSAMBYA,KATUUGO,KIJOGOLO,753,1,0,3,32,436,472,17,489,0,O-93-85-05-02-01
KIBOGA,KIBOGA COUNTY WEST,NSAMBYA,KATUUGO,MBAALI,422,0,0,2,19,307,328,2,330,0,O-93-85-05-02-02
KIBOGA,KIBOGA COUNTY WEST,NSAMBYA,KIGANDO,KIGANDO T/C (A-M),854,3,0,2,94,306,405,36,441,0,O-93-85-05-03-01
KIBOGA,KIBOGA COUNTY WEST,NSAMBYA,KIGANDO,BUKHALI ISLAMIC SCHOOL,916,0,1,8,73,351,433,20,453,0,O-93-85-05-03-02
KIBOGA,KIBOGA COUNTY WEST,NSAMBYA,KIGANDO,LWEBITOMI T.C,459,0,0,4,36,219,259,9,268,0,O-93-85-05-03-03
KIBOGA,KIBOGA COUNTY WEST,NSAMBYA,KIGANDO,KIGABWA P/S,640,2,0,4,31,247,284,10,294,0,O-93-85-05-03-04
KIBOGA,KIBOGA COUNTY WEST,NSAMBYA,KIGANDO,KIGANDO T/C (N-Z),745,4,0,6,93,267,370,23,393,0,O-93-85-05-03-05
KIBOGA,KIBOGA COUNTY WEST,NSAMBYA,KIKONDA,KIKONDA,1214,1,2,7,141,565,716,16,732,0,O-93-85-05-04-01
KIBOGA,KIBOGA COUNTY WEST,NSAMBYA,KIRYANONGO,KIRYANONGO,910,2,0,4,65,611,682,21,703,0,O-93-85-05-05-01
KIBOGA,KIBOGA COUNTY WEST,NSAMBYA,KYAKABUGA,KYAKABUGA,724,4,0,2,34,363,403,22,425,0,O-93-85-05-06-01
KIBOGA,KIBOGA COUNTY WEST,NSAMBYA,KYAKABUGA,KALAGI,400,0,0,4,22,183,209,3,212,0,O-93-85-05-06-02
KIBOGA,KIBOGA COUNTY WEST,NSAMBYA,MUJUNZA,MUJUNZA,1067,7,0,3,136,301,447,29,476,0,O-93-85-05-07-01
KIBOGA,KIBOGA COUNTY WEST,NSAMBYA,NTUNDA,BUKOMERO,968,3,2,2,58,367,432,10,442,0,O-93-85-05-08-01
KIBOGA,KIBOGA COUNTY WEST,NSAMBYA,NTUNDA,NTUNDA,1084,0,0,2,89,320,411,18,429,0,O-93-85-05-08-02
KIBOGA,KIBOGA COUNTY WEST,NSAMBYA,NTUNDA,NTUNDA CENTRAL,640,2,1,1,76,258,338,7,345,0,O-93-85-05-08-03
KIBOGA,KIBOGA COUNTY WEST,NTWETWE,BUGOMOLWA,BUGOMOLWA,700,4,1,0,51,434,490,15,505,0,O-93-85-06-01-01
KIBOGA,KIBOGA COUNTY WEST,NTWETWE,BUGOMOLWA,MALUNGU LC I,216,2,0,0,12,148,162,4,166,0,O-93-85-06-01-02
KIBOGA,KIBOGA COUNTY WEST,NTWETWE,BUGOMOLWA,KASOOLO SDA P/S,312,0,0,1,24,195,220,12,232,0,O-93-85-06-01-03
KIBOGA,KIBOGA COUNTY WEST,NTWETWE,BULAGWE,SERUNYONYI MOSQUE,432,0,0,3,17,302,322,2,324,0,O-93-85-06-02-01
KIBOGA,KIBOGA COUNTY WEST,NTWETWE,BULAGWE,KABUKA P/S,268,0,0,0,18,160,178,4,182,0,O-93-85-06-02-02
KIBOGA,KIBOGA COUNTY WEST,NTWETWE,KISOJO,NTWETWE G/HQTRS,654,3,1,4,118,324,450,7,457,0,O-93-85-06-03-01
KIBOGA,KIBOGA COUNTY WEST,NTWETWE,KISOJO,KISOJO P/S,270,1,0,3,28,151,183,5,188,0,O-93-85-06-03-02
KIBOGA,KIBOGA COUNTY WEST,NTWETWE,KITABONA,GAYAZA,198,0,0,0,12,109,121,2,123,0,O-93-85-06-04-01
KIBOGA,KIBOGA COUNTY WEST,NTWETWE,KITABONA,ST. BALIKUDEMBE P/S,394,0,0,1,11,248,260,12,272,0,O-93-85-06-04-02
KIBOGA,KIBOGA COUNTY WEST,NTWETWE,KITABONA,NSAMBYA P/S,603,1,4,2,65,348,420,5,425,0,O-93-85-06-04-03
KIBOGA,KIBOGA COUNTY WEST,NTWETWE,KITWALA,MUWANGI TRADING CENTRE,360,0,0,2,4,222,228,27,255,0,O-93-85-06-05-01
KIBOGA,KIBOGA COUNTY WEST,NTWETWE,KITWALA,DDEGEYA,749,2,0,3,29,393,427,19,446,0,O-93-85-06-05-02
KIBOGA,KIBOGA COUNTY WEST,NTWETWE,KITWALA,BAMBALA T.C,311,0,0,0,2,229,231,13,244,0,O-93-85-06-05-03
KIBOGA,KIBOGA COUNTY WEST,NTWETWE,KITWALA,NZO P/S,131,0,0,1,2,89,92,2,94,0,O-93-85-06-05-04
KIBOGA,KIBOGA COUNTY WEST,NTWETWE,NATYOLE,NATYOLE,557,2,0,3,57,318,380,17,397,0,O-93-85-06-06-01
KIBOGA,KIBOGA COUNTY WEST,NTWETWE,NATYOLE,NDIBATA PRIMARY SCHOOL,375,2,0,0,45,235,282,7,289,0,O-93-85-06-06-02
KIBOGA,KIBOGA COUNTY WEST,NTWETWE,NATYOLE,KANYOGOGA T.C,297,0,1,3,34,176,214,4,218,0,O-93-85-06-06-03
KIBOGA,KIBOGA COUNTY WEST,NTWETWE,NKANDWA,BUYONDO T/C,726,3,0,3,67,431,504,14,518,0,O-93-85-06-07-01
KIBOGA,KIBOGA COUNTY WEST,NTWETWE,NKANDWA,NKANDWA MOSLEM P/S,197,0,0,1,26,94,121,0,121,0,O-93-85-06-07-02
KIBOGA,KIBOGA COUNTY WEST,NTWETWE,NTIBA,NTIBA,787,1,0,3,79,463,546,6,552,0,O-93-85-06-08-01
KIBOGA,KIBOGA COUNTY WEST,NTWETWE,NTIBA,KYABASIITA,669,0,1,4,32,449,486,11,497,0,O-93-85-06-08-02
KIBOGA,KIBOGA COUNTY WEST,NTWETWE,SIRIMULA,KAYINDIYINDI,532,1,1,2,8,332,344,12,356,0,O-93-85-06-09-01
KIBOGA,KIBOGA COUNTY WEST,NTWETWE,SIRIMULA,SIRIMULA SDA,855,0,1,4,23,571,599,32,631,0,O-93-85-06-09-02
KIBOGA,KIBOGA COUNTY WEST,NTWETWE,SIRIMULA,KAMBUZI P/S A,396,1,0,6,10,254,271,2,273,0,O-93-85-06-09-03
KIBOGA,KIBOGA COUNTY WEST,NTWETWE,SIRIMULA,KAMBUZI P/S B,385,2,0,2,28,241,273,13,286,0,O-93-85-06-09-04
KIBOGA,KIBOGA COUNTY WEST,WATTUBA,KIDUUMI,KISOZI P/SCHOOL,379,1,0,3,10,222,236,3,239,0,O-93-85-07-01-01
KIBOGA,KIBOGA COUNTY WEST,WATTUBA,KIDUUMI,KALAMBI,416,3,3,3,46,208,263,9,272,0,O-93-85-07-01-02
KIBOGA,KIBOGA COUNTY WEST,WATTUBA,KISOROZA,KASAMBYA TRADING CENTRE,416,0,0,5,35,235,275,10,285,0,O-93-85-07-02-01
KIBOGA,KIBOGA COUNTY WEST,WATTUBA,KISOROZA,KASAMBYA P/S,408,3,0,1,22,266,292,3,295,0,O-93-85-07-02-02
KIBOGA,KIBOGA COUNTY WEST,WATTUBA,LWANSAMA,LWANSAMA,278,2,0,2,47,148,199,7,206,0,O-93-85-07-03-01
KIBOGA,KIBOGA COUNTY WEST,WATTUBA,LWANSAMA,GAYAZA,543,0,0,3,64,293,360,8,368,0,O-93-85-07-03-02
KIBOGA,KIBOGA COUNTY WEST,WATTUBA,LWANSAMA,KABANGA PRIMARY SCHOOL,389,3,1,0,27,239,270,5,275,0,O-93-85-07-03-03
KIBOGA,KIBOGA COUNTY WEST,WATTUBA,MASODDE,KIGOMA CHURCH YARD,391,2,0,2,70,206,280,8,288,0,O-93-85-07-04-01
KIBOGA,KIBOGA COUNTY WEST,WATTUBA,MASODDE,MASODDE P/SCHOOL,697,3,3,14,197,249,466,7,473,0,O-93-85-07-04-02
KIBOGA,KIBOGA COUNTY WEST,WATTUBA,NABULEMBEKO,NABIDONDOLO NURSERY SCHOO,550,2,0,9,52,320,383,14,397,0,O-93-85-07-05-01
KIBOGA,KIBOGA COUNTY WEST,WATTUBA,NABULEMBEKO,KIKAJJO P/SCHOOL,481,3,0,3,32,298,336,14,350,0,O-93-85-07-05-02
KIBOGA,KIBOGA COUNTY WEST,WATTUBA,NAKITEMBE,KIREMEERA PRIMARY SCHOOL,550,1,0,0,58,372,431,2,433,0,O-93-85-07-06-01
KIBOGA,KIBOGA COUNTY WEST,WATTUBA,WATTUBA,KIYOMBYA,561,5,1,6,51,262,325,8,333,0,O-93-85-07-07-01
KIBOGA,KIBOGA COUNTY WEST,WATTUBA,WATTUBA,WATTUBA,583,2,0,6,62,270,340,9,349,0,O-93-85-07-07-02
KIBOGA,KIBOGA COUNTY WEST,WATTUBA,WATTUBA,KITABOWA P/S,378,3,0,3,21,192,219,5,224,0,O-93-85-07-07-03
MASAKA,BUKOMANSIMBI CTY,BIGASA,BUKANGO,KIBAALE,563,1,0,1,73,312,387,5,392,0,O-98-111-01-01-01
MASAKA,BUKOMANSIMBI CTY,BIGASA,BUKANGO,MAKOOMI,474,0,0,8,83,232,323,1,324,0,O-98-111-01-01-02
MASAKA,BUKOMANSIMBI CTY,BIGASA,BUKANGO,KAWOKO,452,0,0,2,52,267,321,7,328,0,O-98-111-01-01-03
MASAKA,BUKOMANSIMBI CTY,BIGASA,BUKANGO,LWANKUBA,336,2,0,8,91,130,231,4,235,0,O-98-111-01-01-04
MASAKA,BUKOMANSIMBI CTY,BIGASA,BUKANGO,KALUNGU,583,2,0,5,84,305,396,1,397,0,O-98-111-01-01-05
MASAKA,BUKOMANSIMBI CTY,BIGASA,BUKANGO,BUKANGO,364,1,0,5,80,161,247,10,257,0,O-98-111-01-01-06
MASAKA,BUKOMANSIMBI CTY,BIGASA,BUKANGO,KITEMI,690,1,1,12,129,353,496,8,504,0,O-98-111-01-01-07
MASAKA,BUKOMANSIMBI CTY,BIGASA,BUKANGO,MIKISA,446,1,0,10,70,238,319,11,330,0,O-98-111-01-01-08
MASAKA,BUKOMANSIMBI CTY,BIGASA,BUTALAGA,BUTALAGA,438,1,0,7,103,180,291,9,300,0,O-98-111-01-02-01
MASAKA,BUKOMANSIMBI CTY,BIGASA,BUTALAGA,BUYINJAYINJA,301,0,0,8,43,158,209,8,217,0,O-98-111-01-02-02
MASAKA,BUKOMANSIMBI CTY,BIGASA,BUTALAGA,GONGWE,538,2,0,4,111,236,353,11,364,0,O-98-111-01-02-03
MASAKA,BUKOMANSIMBI CTY,BIGASA,BUTALAGA,KYAKALINZI,252,0,0,1,58,129,188,4,192,0,O-98-111-01-02-04
MASAKA,BUKOMANSIMBI CTY,BIGASA,BUTALAGA,MUKOZA,365,0,0,4,83,192,279,8,287,0,O-98-111-01-02-05
MASAKA,BUKOMANSIMBI CTY,BIGASA,BUTALAGA,GANDA,438,1,0,5,42,255,303,12,315,0,O-98-111-01-02-06
MASAKA,BUKOMANSIMBI CTY,BIGASA,BUTALAGA,SSEKKINGA,414,2,0,11,57,212,282,19,301,0,O-98-111-01-02-07
MASAKA,BUKOMANSIMBI CTY,BIGASA,BUTALAGA,BWANGA,440,1,0,4,153,143,301,10,311,0,O-98-111-01-02-08
MASAKA,BUKOMANSIMBI CTY,BIGASA,BUTALAGA,KAKINDU,430,1,3,8,81,221,314,8,322,0,O-98-111-01-02-09
MASAKA,BUKOMANSIMBI CTY,BIGASA,BUTALAGA,KABOSA,180,1,0,2,37,91,131,0,131,0,O-98-111-01-02-10
MASAKA,BUKOMANSIMBI CTY,BIGASA,KINGANGAZZI,KIGANGAZZI,758,1,0,14,181,310,506,8,514,0,O-98-111-01-03-01
MASAKA,BUKOMANSIMBI CTY,BIGASA,KINGANGAZZI,MBIRIZI,726,1,0,7,122,318,448,5,453,0,O-98-111-01-03-02
MASAKA,BUKOMANSIMBI CTY,BIGASA,KINGANGAZZI,KISABA,400,3,0,7,75,191,276,0,276,0,O-98-111-01-03-03
MASAKA,BUKOMANSIMBI CTY,BIGASA,KINGANGAZZI,KAYUNGA PRIMARY SCHOOL,540,0,0,2,107,252,361,8,369,0,O-98-111-01-03-04
MASAKA,BUKOMANSIMBI CTY,BIGASA,KINGANGAZZI,BUSAGULA,357,0,0,3,79,148,230,9,239,0,O-98-111-01-03-05
MASAKA,BUKOMANSIMBI CTY,BIGASA,KINGANGAZZI,KASENYI,416,0,0,3,147,117,267,10,277,0,O-98-111-01-03-06
MASAKA,BUKOMANSIMBI CTY,BIGASA,KINGANGAZZI,LUTUGUNDA,206,0,0,2,11,132,145,3,148,0,O-98-111-01-03-07
MASAKA,BUKOMANSIMBI CTY,BIGASA,KINGANGAZZI,MIJUNWA,368,1,2,2,25,253,283,8,291,0,O-98-111-01-03-08
MASAKA,BUKOMANSIMBI CTY,BIGASA,MBIRIZI,BIGASA,607,0,0,7,104,277,388,5,393,0,O-98-111-01-04-01
MASAKA,BUKOMANSIMBI CTY,BIGASA,MBIRIZI,GAWEWE,327,0,0,2,49,155,206,2,208,0,O-98-111-01-04-02
MASAKA,BUKOMANSIMBI CTY,BIGASA,MBIRIZI,BULENGE,658,2,0,3,180,244,429,10,439,0,O-98-111-01-04-03
MASAKA,BUKOMANSIMBI CTY,BIGASA,MBIRIZI,KISALA,345,0,1,6,76,165,248,3,251,0,O-98-111-01-04-04
MASAKA,BUKOMANSIMBI CTY,BIGASA,MBIRIZI,BUSWEGE,324,0,2,2,64,163,231,3,234,0,O-98-111-01-04-05
MASAKA,BUKOMANSIMBI CTY,BIGASA,MBIRIZI,KYALUTANGA,340,1,0,8,83,152,244,13,257,0,O-98-111-01-04-06
MASAKA,BUKOMANSIMBI CTY,BIGASA,MBIRIZI,KITEERA,568,1,0,8,189,210,408,4,412,0,O-98-111-01-04-07
MASAKA,BUKOMANSIMBI CTY,BIGASA,MBIRIZI,NAMAKULA,279,0,0,6,81,105,192,7,199,0,O-98-111-01-04-08
MASAKA,BUKOMANSIMBI CTY,BUTENGA,KABIGI,KYAKAMUNYA T/C,380,0,0,5,53,217,275,6,281,0,O-98-111-02-01-01
MASAKA,BUKOMANSIMBI CTY,BUTENGA,KABIGI,MBALE,473,2,0,10,76,249,337,16,353,0,O-98-111-02-01-02
MASAKA,BUKOMANSIMBI CTY,BUTENGA,KABIGI,MEERU A,698,1,0,8,122,349,480,15,495,0,O-98-111-02-01-03
MASAKA,BUKOMANSIMBI CTY,BUTENGA,KABIGI,KITOMA,551,2,0,8,124,244,378,23,401,0,O-98-111-02-01-04
MASAKA,BUKOMANSIMBI CTY,BUTENGA,KABIGI,MBALE KINONI,665,1,1,10,103,347,462,35,497,0,O-98-111-02-01-05
MASAKA,BUKOMANSIMBI CTY,BUTENGA,KABIGI,KABIGI,557,4,1,13,147,216,381,12,393,0,O-98-111-02-01-06
MASAKA,BUKOMANSIMBI CTY,BUTENGA,KASEBWERA,KIKONDEERE P/SCH,584,1,0,13,141,266,421,6,427,0,O-98-111-02-02-01
MASAKA,BUKOMANSIMBI CTY,BUTENGA,KASEBWERA,KASSEMBWERA,463,0,0,15,122,204,341,12,353,0,O-98-111-02-02-02
MASAKA,BUKOMANSIMBI CTY,BUTENGA,KASEBWERA,KAKUKUULU P/SCH,596,2,0,18,201,201,422,14,436,0,O-98-111-02-02-03
MASAKA,BUKOMANSIMBI CTY,BUTENGA,KASEBWERA,KIRYAMENVU PLAYGROUND,700,2,0,49,173,289,513,13,526,0,O-98-111-02-02-04
MASAKA,BUKOMANSIMBI CTY,BUTENGA,KAWOKO,MULINDWA PLAY GROUND,558,0,1,15,173,245,434,15,449,0,O-98-111-02-03-01
MASAKA,BUKOMANSIMBI CTY,BUTENGA,KAWOKO,SSERINYA PLAY GROUND,499,3,0,30,135,221,389,11,400,0,O-98-111-02-03-02
MASAKA,BUKOMANSIMBI CTY,BUTENGA,KAWOKO,BUKIRI PLAY GROUND,465,0,0,5,140,177,322,8,330,0,O-98-111-02-03-03
MASAKA,BUKOMANSIMBI CTY,BUTENGA,KAWOKO,KAWOOKO P/S II,573,0,0,33,175,187,395,12,407,0,O-98-111-02-03-04
MASAKA,BUKOMANSIMBI CTY,BUTENGA,KAWOKO,BUTENGA P/S,472,0,0,11,159,129,299,7,306,0,O-98-111-02-03-05
MASAKA,BUKOMANSIMBI CTY,BUTENGA,KAWOKO,BUTENGA SUB COUNTY HQRS,813,3,0,17,213,299,532,1,533,0,O-98-111-02-03-06
MASAKA,BUKOMANSIMBI CTY,BUTENGA,KAWOKO,BUKIRI,371,1,0,15,151,134,301,9,310,0,O-98-111-02-03-07
MASAKA,BUKOMANSIMBI CTY,BUTENGA,KISAGAZI,KIGUNGUMIKA/KAG,526,2,0,5,163,166,336,13,349,0,O-98-111-02-04-01
MASAKA,BUKOMANSIMBI CTY,BUTENGA,KISAGAZI,KYANGO,518,1,0,9,178,153,341,9,350,0,O-98-111-02-04-02
MASAKA,BUKOMANSIMBI CTY,BUTENGA,KISAGAZI,BUKOMANSIMBI B,360,1,0,5,96,144,246,13,259,0,O-98-111-02-04-03
MASAKA,BUKOMANSIMBI CTY,BUTENGA,KISAGAZI,KISAGAZI,612,1,1,13,210,165,390,22,412,0,O-98-111-02-04-04
MASAKA,BUKOMANSIMBI CTY,BUTENGA,KISAGAZI,BUKOMANSIMBI A (A - M),392,0,2,20,143,95,260,0,260,0,O-98-111-02-04-05
MASAKA,BUKOMANSIMBI CTY,BUTENGA,KISAGAZI,BUKOMANSIMBI A (N - Z),610,1,2,5,224,165,397,8,405,0,O-98-111-02-04-06
MASAKA,BUKOMANSIMBI CTY,BUTENGA,KISAGAZI,BUKOMANSIMBI C,280,2,0,9,66,115,192,8,200,0,O-98-111-02-04-07
MASAKA,BUKOMANSIMBI CTY,BUTENGA,KISIITA,KYAKATEBE,595,5,0,20,141,231,397,7,404,0,O-98-111-02-05-01
MASAKA,BUKOMANSIMBI CTY,BUTENGA,KISIITA,KISAABWA,523,2,0,12,232,146,392,11,403,0,O-98-111-02-05-02
MASAKA,BUKOMANSIMBI CTY,BUTENGA,KISIITA,KAWOKO,558,1,1,17,192,227,438,8,446,0,O-98-111-02-05-03
MASAKA,BUKOMANSIMBI CTY,BUTENGA,KISIITA,BUWENDA,617,0,0,29,222,151,402,20,422,0,O-98-111-02-05-04
MASAKA,BUKOMANSIMBI CTY,BUTENGA,KYANKOLE,KAVULE,406,2,0,15,111,168,296,10,306,0,O-98-111-02-06-01
MASAKA,BUKOMANSIMBI CTY,BUTENGA,KYANKOLE,KYANSI,493,2,0,14,149,171,336,6,342,0,O-98-111-02-06-02
MASAKA,BUKOMANSIMBI CTY,BUTENGA,KYANKOLE,KYANKOOLE,593,2,0,9,193,202,406,3,409,0,O-98-111-02-06-03
MASAKA,BUKOMANSIMBI CTY,BUTENGA,KYANKOLE,KASWA,587,3,0,22,128,258,411,18,429,0,O-98-111-02-06-04
MASAKA,BUKOMANSIMBI CTY,KIBINGE,BUTAYUNJA,KATOMA,350,1,1,4,95,169,270,12,282,0,O-98-111-03-01-01
MASAKA,BUKOMANSIMBI CTY,KIBINGE,BUTAYUNJA,BUTAYUNJA,501,1,0,16,182,124,323,35,358,0,O-98-111-03-01-02
MASAKA,BUKOMANSIMBI CTY,KIBINGE,BUTAYUNJA,TTALA,200,1,0,3,79,78,161,2,163,0,O-98-111-03-01-03
MASAKA,BUKOMANSIMBI CTY,KIBINGE,BUTAYUNJA,BUYINJA,490,2,0,7,115,231,355,35,390,0,O-98-111-03-01-04
MASAKA,BUKOMANSIMBI CTY,KIBINGE,BUTAYUNJA,MITUUGO T. C.,252,0,1,2,51,139,193,4,197,0,O-98-111-03-01-05
MASAKA,BUKOMANSIMBI CTY,KIBINGE,BUTAYUNJA,KAMANDA T. C.,194,1,1,4,65,74,145,6,151,0,O-98-111-03-01-06
MASAKA,BUKOMANSIMBI CTY,KIBINGE,KIRYASAKA,MINSANVU T/C,764,3,0,9,328,153,493,19,512,0,O-98-111-03-02-01
MASAKA,BUKOMANSIMBI CTY,KIBINGE,KIRYASAKA,SSERINYA RC I,671,4,1,6,165,147,323,78,401,0,O-98-111-03-02-02
MASAKA,BUKOMANSIMBI CTY,KIBINGE,KIRYASAKA,MAGANDO RC I,259,1,0,5,70,107,183,3,186,0,O-98-111-03-02-03
MASAKA,BUKOMANSIMBI CTY,KIBINGE,KIRYASAKA,KIRYASAAKA R/C,363,0,1,2,128,78,209,50,259,0,O-98-111-03-02-04
MASAKA,BUKOMANSIMBI CTY,KIBINGE,KIRYASAKA,KIYOOKA,157,1,0,9,80,24,114,4,118,0,O-98-111-03-02-05
MASAKA,BUKOMANSIMBI CTY,KIBINGE,KISOJJO,BUDDA,400,0,0,10,137,152,299,0,299,0,O-98-111-03-03-01
MASAKA,BUKOMANSIMBI CTY,KIBINGE,KISOJJO,KYAMABAALE,480,3,0,10,209,153,375,7,382,0,O-98-111-03-03-02
MASAKA,BUKOMANSIMBI CTY,KIBINGE,KISOJJO,KISOJJO,510,1,0,15,199,137,352,16,368,0,O-98-111-03-03-03
MASAKA,BUKOMANSIMBI CTY,KIBINGE,KISOJJO,MPALAMPA,397,0,0,8,168,132,308,0,308,0,O-98-111-03-03-04
MASAKA,BUKOMANSIMBI CTY,KIBINGE,KISOJJO,KASEBWAVU,113,0,0,0,41,32,73,19,92,0,O-98-111-03-03-05
MASAKA,BUKOMANSIMBI CTY,KIBINGE,MALEKU,BUYOGA (A - M),343,0,0,3,130,106,239,4,243,0,O-98-111-03-04-01
MASAKA,BUKOMANSIMBI CTY,KIBINGE,MALEKU,LUKENKE,536,0,0,7,135,170,312,83,395,0,O-98-111-03-04-02
MASAKA,BUKOMANSIMBI CTY,KIBINGE,MALEKU,KAGOGGO,431,0,0,3,61,149,213,87,300,0,O-98-111-03-04-03
MASAKA,BUKOMANSIMBI CTY,KIBINGE,MALEKU,MALEKU,710,1,0,22,221,189,433,8,441,0,O-98-111-03-04-04
MASAKA,BUKOMANSIMBI CTY,KIBINGE,MALEKU,KABAALE,289,3,0,12,59,141,215,4,219,0,O-98-111-03-04-05
MASAKA,BUKOMANSIMBI CTY,KIBINGE,MALEKU,KYABIRI,499,2,0,18,167,123,310,27,337,0,O-98-111-03-04-06
MASAKA,BUKOMANSIMBI CTY,KIBINGE,MALEKU,KASAMBYA T.C.,312,1,0,1,78,88,168,60,228,0,O-98-111-03-04-07
MASAKA,BUKOMANSIMBI CTY,KIBINGE,MALEKU,BUYOGA (N - Z),566,5,1,11,135,220,372,9,381,0,O-98-111-03-04-08
MASAKA,BUKOMANSIMBI CTY,KIBINGE,MIRAMBI,KYAMBOGO,751,5,0,19,208,227,459,138,597,0,O-98-111-03-05-01
MASAKA,BUKOMANSIMBI CTY,KIBINGE,MIRAMBI,MAKUKUULU,544,1,2,7,158,166,334,72,406,0,O-98-111-03-05-02
MASAKA,BUKOMANSIMBI CTY,KIBINGE,MIRAMBI,KALUBANDA,601,2,0,6,142,202,352,81,433,0,O-98-111-03-05-03
MASAKA,BUKOMANSIMBI CTY,KITANDA,GAYAZA,MIZINDAALO,647,0,0,8,161,273,442,4,446,0,O-98-111-04-01-01
MASAKA,BUKOMANSIMBI CTY,KITANDA,GAYAZA,MIREMBE,618,3,1,5,183,192,384,13,397,0,O-98-111-04-01-02
MASAKA,BUKOMANSIMBI CTY,KITANDA,GAYAZA,LUKAAWA PRIMARY SCHOOL,506,0,0,0,78,271,349,10,359,0,O-98-111-04-01-03
MASAKA,BUKOMANSIMBI CTY,KITANDA,GAYAZA,GAYAZA MOSQUE,524,0,0,6,100,261,367,7,374,0,O-98-111-04-01-04
MASAKA,BUKOMANSIMBI CTY,KITANDA,LUWOKO,MBULIRE PRIMARY SCHOOL,475,3,0,5,136,144,288,8,296,0,O-98-111-04-02-01
MASAKA,BUKOMANSIMBI CTY,KITANDA,LUWOKO,NTUUMA,477,3,2,6,179,102,292,6,298,0,O-98-111-04-02-02
MASAKA,BUKOMANSIMBI CTY,KITANDA,LUWOKO,NDALAGE MOSQUE,402,3,1,5,137,124,270,5,275,0,O-98-111-04-02-03
MASAKA,BUKOMANSIMBI CTY,KITANDA,LUWOKO,LUWOKO,249,0,0,1,79,79,159,5,164,0,O-98-111-04-02-04
MASAKA,BUKOMANSIMBI CTY,KITANDA,MAKUKULU,MAKUKUULU,634,2,0,3,131,288,424,13,437,0,O-98-111-04-03-01
MASAKA,BUKOMANSIMBI CTY,KITANDA,MAKUKULU,KALAGA,733,3,0,4,128,327,462,8,470,0,O-98-111-04-03-02
MASAKA,BUKOMANSIMBI CTY,KITANDA,MAKUKULU,NAKUUSI,618,2,0,3,141,280,426,6,432,0,O-98-111-04-03-03
MASAKA,BUKOMANSIMBI CTY,KITANDA,MAKUKULU,MISENYI,247,1,0,7,85,99,192,3,195,0,O-98-111-04-03-04
MASAKA,BUKOMANSIMBI CTY,KITANDA,MAKUKULU,MUGAAJU,405,1,0,13,130,171,315,5,320,0,O-98-111-04-03-05
MASAKA,BUKOMANSIMBI CTY,KITANDA,MAKUKULU,KYAKAJWIGA,474,1,0,4,34,296,335,3,338,0,O-98-111-04-03-06
MASAKA,BUKOMANSIMBI CTY,KITANDA,MITIGYERA,KAGOLOGOLO (A - M),305,0,0,1,111,79,191,4,195,0,O-98-111-04-04-01
MASAKA,BUKOMANSIMBI CTY,KITANDA,MITIGYERA,BITETEERO,279,2,0,8,69,57,136,59,195,0,O-98-111-04-04-02
MASAKA,BUKOMANSIMBI CTY,KITANDA,MITIGYERA,SEETA,864,2,3,22,243,289,559,19,578,0,O-98-111-04-04-03
MASAKA,BUKOMANSIMBI CTY,KITANDA,MITIGYERA,KYANIKA,312,2,0,4,85,118,209,5,214,0,O-98-111-04-04-04
MASAKA,BUKOMANSIMBI CTY,KITANDA,MITIGYERA,KAGOLOGOLO (N - Z),527,1,0,3,142,150,296,11,307,0,O-98-111-04-04-05
MASAKA,BUKOMANSIMBI CTY,KITANDA,NDEEBA,KISAKA,566,1,0,2,119,272,394,17,411,0,O-98-111-04-05-01
MASAKA,BUKOMANSIMBI CTY,KITANDA,NDEEBA,NSOLOLO,336,0,0,9,121,105,235,2,237,0,O-98-111-04-05-02
MASAKA,BUKOMANSIMBI CTY,KITANDA,NDEEBA,MBAALE PRIMARY SCHOOL,442,2,0,9,138,88,237,78,315,0,O-98-111-04-05-03
MPIGI,BUTAMBALA COUNTY,BUDDE,BUDDE,KYABADAAZA A,753,3,1,3,209,266,482,17,499,0,O-99-157-01-01-01
MPIGI,BUTAMBALA COUNTY,BUDDE,BUDDE,BUDDE S/C HQTRS,458,2,0,14,97,195,308,12,320,0,O-99-157-01-01-02
MPIGI,BUTAMBALA COUNTY,BUDDE,BUDDE,KYABADAAZA B,297,2,0,10,93,99,204,11,215,0,O-99-157-01-01-03
MPIGI,BUTAMBALA COUNTY,BUDDE,GWATIRO,GWATIRO,472,2,2,7,112,218,341,12,353,0,O-99-157-01-02-01
MPIGI,BUTAMBALA COUNTY,BUDDE,GWATIRO,MUKULUNGO,400,1,2,8,95,142,248,17,265,0,O-99-157-01-02-02
MPIGI,BUTAMBALA COUNTY,BUDDE,KIBUGGA,KIBUGGA A,673,4,4,7,127,380,522,9,531,0,O-99-157-01-03-01
MPIGI,BUTAMBALA COUNTY,BUDDE,KIBUGGA,KIBUGGA B,626,7,0,10,149,312,478,6,484,0,O-99-157-01-03-02
MPIGI,BUTAMBALA COUNTY,BUDDE,LUGALA,LUGALA,445,1,1,14,84,219,319,11,330,0,O-99-157-01-04-01
MPIGI,BUTAMBALA COUNTY,BUDDE,LUGALA,NAMILYANGO,390,2,2,5,77,184,270,14,284,0,O-99-157-01-04-02
MPIGI,BUTAMBALA COUNTY,BULO,BULE,BULE,409,1,1,1,85,208,296,5,301,0,O-99-157-02-01-01
MPIGI,BUTAMBALA COUNTY,BULO,BULE,KIFAMPA,603,3,0,5,94,315,417,21,438,0,O-99-157-02-01-02
MPIGI,BUTAMBALA COUNTY,BULO,BULO,BULO,1234,2,1,5,399,305,712,21,733,0,O-99-157-02-02-01
MPIGI,BUTAMBALA COUNTY,BULO,BULO,WADUDUMA,801,0,0,10,241,248,499,40,539,0,O-99-157-02-02-02
MPIGI,BUTAMBALA COUNTY,BULO,BULO,KAALO,247,0,0,4,84,94,182,0,182,0,O-99-157-02-02-03
MPIGI,BUTAMBALA COUNTY,BULO,BUTAWUKA,BUTAWUKA,610,3,0,8,209,172,392,29,421,0,O-99-157-02-03-01
MPIGI,BUTAMBALA COUNTY,BULO,BUTAWUKA,NAWANGO P/S,338,2,0,5,65,163,235,13,248,0,O-99-157-02-03-02
MPIGI,BUTAMBALA COUNTY,BULO,BUTAWUKA,NDEESE,271,2,0,3,104,71,180,14,194,0,O-99-157-02-03-03
MPIGI,BUTAMBALA COUNTY,BULO,BUTAWUKA,KANKEESA,266,0,1,4,110,78,193,3,196,0,O-99-157-02-03-04
MPIGI,BUTAMBALA COUNTY,BULO,KYERIMA,KYERIMA,629,0,1,21,217,212,451,11,462,0,O-99-157-02-04-01
MPIGI,BUTAMBALA COUNTY,BULO,KYERIMA,MAYUNGWE,586,2,2,14,135,250,403,11,414,0,O-99-157-02-04-02
MPIGI,BUTAMBALA COUNTY,BULO,NAKATOOKE,BBYA,174,0,1,3,54,54,112,8,120,0,O-99-157-02-05-01
MPIGI,BUTAMBALA COUNTY,BULO,NAKATOOKE,NAKATOOKE,237,0,0,4,68,100,172,5,177,0,O-99-157-02-05-02
MPIGI,BUTAMBALA COUNTY,BULO,NAKATOOKE,SEETA,293,1,0,1,106,109,217,6,223,0,O-99-157-02-05-03
MPIGI,BUTAMBALA COUNTY,KALAMBA,BWEYA(SSETA),SEETA,669,1,6,10,225,227,469,20,489,0,O-99-157-03-01-01
MPIGI,BUTAMBALA COUNTY,KALAMBA,BWEYA(SSETA),LUKALU,516,2,2,12,131,193,340,15,355,0,O-99-157-03-01-02
MPIGI,BUTAMBALA COUNTY,KALAMBA,BWEYA(SSETA),KAMUGOMBWA,441,1,1,11,117,189,319,10,329,0,O-99-157-03-01-03
MPIGI,BUTAMBALA COUNTY,KALAMBA,KABASANDA,KABASANDA,750,0,0,19,219,214,452,7,459,0,O-99-157-03-02-01
MPIGI,BUTAMBALA COUNTY,KALAMBA,KABASANDA,KALAMBA,550,4,0,11,137,211,363,7,370,0,O-99-157-03-02-02
MPIGI,BUTAMBALA COUNTY,KALAMBA,KABASANDA,BULUGU,498,2,4,9,134,178,327,4,331,0,O-99-157-03-02-03
MPIGI,BUTAMBALA COUNTY,KALAMBA,KILOKOLA,KAWAMI,756,4,2,13,132,331,482,12,494,0,O-99-157-03-03-01
MPIGI,BUTAMBALA COUNTY,KALAMBA,KILOKOLA,MIREMBE/,582,3,4,8,202,167,384,17,401,0,O-99-157-03-03-02
MPIGI,BUTAMBALA COUNTY,KALAMBA,KILOKOLA,KIROKOLA,454,0,2,11,145,176,334,11,345,0,O-99-157-03-03-03
MPIGI,BUTAMBALA COUNTY,KALAMBA,KITIMBA,KITIMBA,731,2,0,14,164,294,474,25,499,0,O-99-157-03-04-01
MPIGI,BUTAMBALA COUNTY,KALAMBA,KITIMBA,NGOOGWE,498,1,0,6,137,186,330,16,346,0,O-99-157-03-04-02
MPIGI,BUTAMBALA COUNTY,KALAMBA,KITIMBA,MPANGA,502,4,1,4,115,216,340,13,353,0,O-99-157-03-04-03
MPIGI,BUTAMBALA COUNTY,KALAMBA,NSOZIBIRI,KIKUNYU A,287,2,0,11,77,100,190,5,195,0,O-99-157-03-05-01
MPIGI,BUTAMBALA COUNTY,KALAMBA,NSOZIBIRI,NSOZIBIRI,435,1,1,13,114,172,301,14,315,0,O-99-157-03-05-02
MPIGI,BUTAMBALA COUNTY,KALAMBA,NSOZIBIRI,BUYENGA,201,1,0,0,70,82,153,0,153,0,O-99-157-03-05-03
MPIGI,BUTAMBALA COUNTY,KALAMBA,NSOZIBIRI,KIKUNYU B,192,0,0,23,23,94,140,11,151,0,O-99-157-03-05-04
MPIGI,BUTAMBALA COUNTY,KIBIBI,GOMBE,GOMBE (A-M),403,0,0,5,169,98,272,4,276,0,O-99-157-04-01-01
MPIGI,BUTAMBALA COUNTY,KIBIBI,GOMBE,SENYOMO,611,2,0,4,249,141,396,5,401,0,O-99-157-04-01-02
MPIGI,BUTAMBALA COUNTY,KIBIBI,GOMBE,BUGOYE,594,3,1,2,176,272,454,15,469,0,O-99-157-04-01-03
MPIGI,BUTAMBALA COUNTY,KIBIBI,GOMBE,SENENE,337,0,0,2,96,157,255,5,260,0,O-99-157-04-01-04
MPIGI,BUTAMBALA COUNTY,KIBIBI,GOMBE,GOMBE (N-Z),705,4,1,7,230,198,440,11,451,0,O-99-157-04-01-05
MPIGI,BUTAMBALA COUNTY,KIBIBI,KATABIRA,KATABIRA,551,5,2,6,164,224,401,13,414,0,O-99-157-04-02-01
MPIGI,BUTAMBALA COUNTY,KIBIBI,KATABIRA,BUJUMBA,581,3,2,10,88,298,401,15,416,0,O-99-157-04-02-02
MPIGI,BUTAMBALA COUNTY,KIBIBI,KAYENJE,KAYENJE,795,6,1,28,220,285,540,16,556,0,O-99-157-04-03-01
MPIGI,BUTAMBALA COUNTY,KIBIBI,KAYENJE,NYAANAMA,708,4,0,10,153,340,507,20,527,0,O-99-157-04-03-02
MPIGI,BUTAMBALA COUNTY,KIBIBI,KIBIBI,BAMULANZE,754,2,2,8,250,217,479,14,493,0,O-99-157-04-04-01
MPIGI,BUTAMBALA COUNTY,KIBIBI,KIBIBI,KATENDE (A-M),377,2,2,3,138,90,235,5,240,0,O-99-157-04-04-02
MPIGI,BUTAMBALA COUNTY,KIBIBI,KIBIBI,LUBUGO-LUGOYE,479,2,2,2,163,154,323,7,330,0,O-99-157-04-04-03
MPIGI,BUTAMBALA COUNTY,KIBIBI,KIBIBI,KIKUMBO,225,2,2,1,90,76,171,5,176,0,O-99-157-04-04-04
MPIGI,BUTAMBALA COUNTY,KIBIBI,KIBIBI,SIMBA A,209,0,2,8,58,91,159,6,165,0,O-99-157-04-04-05
MPIGI,BUTAMBALA COUNTY,KIBIBI,KIBIBI,KATENDE (N-Z),640,7,1,4,189,244,445,8,453,0,O-99-157-04-04-06
MPIGI,BUTAMBALA COUNTY,KIBIBI,MABANDA,MABANDA,375,3,2,3,124,113,245,7,252,0,O-99-157-04-05-01
MPIGI,BUTAMBALA COUNTY,KIBIBI,MABANDA,KIZIIKO,440,0,0,2,125,182,309,16,325,0,O-99-157-04-05-02
MPIGI,BUTAMBALA COUNTY,KIBIBI,MITWETWE,SIMBA B,267,2,1,1,89,111,204,5,209,0,O-99-157-04-06-01
MPIGI,BUTAMBALA COUNTY,KIBIBI,MITWETWE,BATAAKA,623,6,3,9,213,215,446,12,458,0,O-99-157-04-06-02
MPIGI,BUTAMBALA COUNTY,KIBIBI,NTOLOMWE,KYANAJJANJA,501,1,0,3,113,253,370,10,380,0,O-99-157-04-07-01
MPIGI,BUTAMBALA COUNTY,KIBIBI,NTOLOMWE,NTOLOMWE,655,3,1,7,132,330,473,18,491,0,O-99-157-04-07-02
MPIGI,BUTAMBALA COUNTY,NGANDO,BUKESA,LWAMASAKA P/S,287,1,1,4,73,96,175,13,188,0,O-99-157-05-01-01
MPIGI,BUTAMBALA COUNTY,NGANDO,BUKESA,WAMALA,462,1,2,5,111,212,331,8,339,0,O-99-157-05-01-02
MPIGI,BUTAMBALA COUNTY,NGANDO,BUKESA,BUGOBANGO,433,0,1,3,174,149,327,10,337,0,O-99-157-05-01-03
MPIGI,BUTAMBALA COUNTY,NGANDO,BUKESA,BUKESA,574,3,0,9,197,149,358,14,372,0,O-99-157-05-01-04
MPIGI,BUTAMBALA COUNTY,NGANDO,BUTENDE,BUTENDE,639,2,1,0,153,339,495,8,503,0,O-99-157-05-02-01
MPIGI,BUTAMBALA COUNTY,NGANDO,BUTENDE,LWANGIRI T.C,576,2,0,7,139,254,402,10,412,0,O-99-157-05-02-02
MPIGI,BUTAMBALA COUNTY,NGANDO,KASOZI,NGANDO S/C HTQRS,464,1,0,7,97,204,309,10,319,0,O-99-157-05-03-01
MPIGI,BUTAMBALA COUNTY,NGANDO,KASOZI,KITAGOBWA,768,2,3,6,261,242,514,28,542,0,O-99-157-05-03-02
MPIGI,BUTAMBALA COUNTY,NGANDO,KASOZI,BWETYABA,482,1,4,4,89,259,357,7,364,0,O-99-157-05-03-03
MPIGI,BUTAMBALA COUNTY,NGANDO,LUGALI,LUGALI CHURCH,563,2,0,9,96,269,376,9,385,0,O-99-157-05-04-01
MPIGI,BUTAMBALA COUNTY,NGANDO,LUGALI,KIWAALA P.S,410,4,0,9,39,234,286,9,295,0,O-99-157-05-04-02
MPIGI,BUTAMBALA COUNTY,NGANDO,LUGALI,NDIBULUNGI,454,0,0,6,39,291,336,0,336,0,O-99-157-05-04-03
MASAKA,KALUNGU EAST,BUKULULA,BUGONZI,KABAALE TOWN,679,5,1,18,228,274,526,11,537,0,O-100-117-01-01-01
MASAKA,KALUNGU EAST,BUKULULA,BUGONZI,KAMUTUUZA,441,3,0,7,106,215,331,7,338,0,O-100-117-01-01-02
MASAKA,KALUNGU EAST,BUKULULA,BUGONZI,BUGONZI A,514,2,2,16,151,218,389,8,397,0,O-100-117-01-01-03
MASAKA,KALUNGU EAST,BUKULULA,BUGONZI,BUGONZI B,498,8,0,9,133,224,374,19,393,0,O-100-117-01-01-04
MASAKA,KALUNGU EAST,BWESA,BUGOMOLA,NABWATO,678,5,0,16,97,339,457,18,475,0,O-100-117-02-01-01
MASAKA,KALUNGU EAST,BWESA,BUGOMOLA,BWESA,681,3,0,8,121,372,504,12,516,0,O-100-117-02-01-02
MASAKA,KALUNGU EAST,BWESA,BUGOMOLA,LUKENKE,491,2,0,3,66,289,360,21,381,0,O-100-117-02-01-03
MASAKA,KALUNGU EAST,BWESA,BUGOMOLA,KYATO,412,3,0,4,65,228,300,16,316,0,O-100-117-02-01-04
MASAKA,KALUNGU EAST,BWESA,BUGOMOLA,KINONI,601,3,0,2,67,356,428,53,481,0,O-100-117-02-01-05
MASAKA,KALUNGU EAST,KIBISI,BUGOMOLA,TTOWA,496,0,1,19,108,233,361,3,364,0,O-100-117-03-01-06
MASAKA,KALUNGU EAST,KIBISI,BUGOMOLA,KABAALE,587,2,0,8,58,323,391,41,432,0,O-100-117-03-01-07
MASAKA,KALUNGU EAST,KIBISI,BUGOMOLA,KIBISI,586,1,0,15,95,268,379,48,427,0,O-100-117-03-01-08
MASAKA,KALUNGU EAST,KIBISI,BUGOMOLA,SSALA,451,1,0,4,71,210,286,50,336,0,O-100-117-03-01-09
MASAKA,KALUNGU EAST,KIBISI,KIRAGGA,KIRIMANYAGA (A - M),316,2,1,1,41,145,190,19,209,0,O-100-117-03-02-01
MASAKA,KALUNGU EAST,KIBISI,KIRAGGA,KISITULA,628,1,0,1,57,326,385,85,470,0,O-100-117-03-02-02
MASAKA,KALUNGU EAST,KIBISI,KIRAGGA,KABUYE,326,0,0,3,43,175,221,49,270,0,O-100-117-03-02-03
MASAKA,KALUNGU EAST,KIBISI,KIRAGGA,KITEREDDE,509,1,0,2,57,231,291,62,353,0,O-100-117-03-02-04
MASAKA,KALUNGU EAST,KIBISI,KIRAGGA,KIRAGGA,568,1,0,1,87,281,370,61,431,0,O-100-117-03-02-05
MASAKA,KALUNGU EAST,KIBISI,KIRAGGA,KIRIMANYAGA (N - Z),502,1,0,2,45,260,308,34,342,0,O-100-117-03-02-06
MASAKA,KALUNGU EAST,KITI,BUGONZI,KITI,499,4,1,5,130,169,309,56,365,0,O-100-117-04-01-01
MASAKA,KALUNGU EAST,KITI,BUGONZI,KASUNGA,486,4,0,6,90,200,300,74,374,0,O-100-117-04-01-02
MASAKA,KALUNGU EAST,KITI,BUGONZI,NAMUSUJJA,568,3,1,7,137,286,434,9,443,0,O-100-117-04-01-03
MASAKA,KALUNGU EAST,KITI,BUGONZI,LUGALAMA,372,2,0,2,35,174,213,86,299,0,O-100-117-04-01-04
MASAKA,KALUNGU EAST,KITI,BUGONZI,LUTENTE/KAKWANZI,579,4,0,0,74,275,353,86,439,0,O-100-117-04-01-05
MASAKA,KALUNGU EAST,KITI,BUGONZI,KAYUNGA P.SCHOOL,237,1,0,6,53,127,187,6,193,0,O-100-117-04-01-06
MASAKA,KALUNGU EAST,KITI,KALUNGI/LUSASA,MUGE,299,2,2,4,89,123,220,8,228,0,O-100-117-04-02-01
MASAKA,KALUNGU EAST,KITI,KALUNGI/LUSASA,BUBEMBA,357,2,1,5,151,114,273,7,280,0,O-100-117-04-02-02
MASAKA,KALUNGU EAST,KITI,KALUNGI/LUSASA,BUYIKUUZI,361,1,0,3,77,141,222,43,265,0,O-100-117-04-02-03
MASAKA,KALUNGU EAST,KITI,KASAALI,KASAALI (A - M),392,4,0,24,154,130,312,11,323,0,O-100-117-04-03-01
MASAKA,KALUNGU EAST,KITI,KASAALI,KAGO,244,2,0,14,79,96,191,14,205,0,O-100-117-04-03-02
MASAKA,KALUNGU EAST,KITI,KASAALI,KASAALI (N - Z),703,2,0,20,185,306,513,9,522,0,O-100-117-04-03-03
MASAKA,KALUNGU EAST,KITI,KYAMBALA,KYAMBALA P7 SCH,483,3,0,7,185,215,410,6,416,0,O-100-117-04-04-01
MASAKA,KALUNGU EAST,KITI,KYAMBALA,NSAALU,517,3,1,13,141,249,407,17,424,0,O-100-117-04-04-02
MASAKA,KALUNGU EAST,KITI,KYAMBALA,BUBAALE,118,1,0,5,23,63,92,2,94,0,O-100-117-04-04-03
MASAKA,KALUNGU EAST,KITI,KYAMBALA,BUGWERI,117,0,0,2,16,75,93,7,100,0,O-100-117-04-04-04
MASAKA,KALUNGU EAST,KITI,LUSANGO,LUVULE,639,1,0,12,208,195,416,8,424,0,O-100-117-04-05-01
MASAKA,KALUNGU EAST,KITI,LUSANGO,LUTENGO SEC SCHOOL,572,2,1,8,150,219,380,13,393,0,O-100-117-04-05-02
MASAKA,KALUNGU EAST,KITI,LUSANGO,LUSANGO (A-M),290,0,0,15,133,76,224,2,226,0,O-100-117-04-05-03
MASAKA,KALUNGU EAST,KITI,LUSANGO,LUSANGO (N-Z),619,2,0,10,183,208,403,26,429,0,O-100-117-04-05-04
MASAKA,KALUNGU EAST,KITI,MABUYE,KYAGGUNDA,476,2,0,3,73,254,332,21,353,0,O-100-117-04-06-01
MASAKA,KALUNGU EAST,KITI,MABUYE,MABUYE,400,7,0,15,99,192,313,2,315,0,O-100-117-04-06-02
MASAKA,KALUNGU EAST,KITI,MABUYE,KASEBUTI P. SCHOOL,370,1,0,18,73,167,259,14,273,0,O-100-117-04-06-03
MASAKA,KALUNGU EAST,KITI,MUKOKO,MUKOKO A,475,2,0,9,153,195,359,11,370,0,O-100-117-04-07-01
MASAKA,KALUNGU EAST,KITI,MUKOKO,MUKOKO B,302,1,0,9,59,155,224,8,232,0,O-100-117-04-07-02
MASAKA,KALUNGU EAST,KITI,MUKOKO,KISANJE,506,4,1,31,124,231,391,12,403,0,O-100-117-04-07-03
MASAKA,KALUNGU EAST,KITI,MUKOKO,KASASA EAST,311,1,0,14,66,180,261,9,270,0,O-100-117-04-07-04
MASAKA,KALUNGU EAST,KITI,MUKOKO,BULINGO,358,1,0,4,73,188,266,8,274,0,O-100-117-04-07-05
MASAKA,KALUNGU EAST,KITI,MUKOKO,KALANGALA,256,0,1,5,18,167,191,7,198,0,O-100-117-04-07-06
MASAKA,KALUNGU EAST,KITI,MUKOKO,KASASA WEST (A - M),398,2,0,9,113,125,249,1,250,0,O-100-117-04-07-07
MASAKA,KALUNGU EAST,KITI,MUKOKO,KASASA WEST (N - Z),635,6,0,17,116,264,403,9,412,0,O-100-117-04-07-08
MASAKA,KALUNGU EAST,LUKAYA T.C,BAJJA WARD,BAJJA,485,2,0,20,148,202,372,7,379,0,O-100-117-05-01-01
MASAKA,KALUNGU EAST,LUKAYA T.C,BAJJA WARD,KAYUNGA,281,1,0,12,71,127,211,4,215,0,O-100-117-05-01-02
MASAKA,KALUNGU EAST,LUKAYA T.C,CENTRAL,AGIP CELL,515,1,0,2,148,146,297,24,321,0,O-100-117-05-02-01
MASAKA,KALUNGU EAST,LUKAYA T.C,CENTRAL,CENTRAL CELL,381,1,1,6,142,93,243,17,260,0,O-100-117-05-02-02
MASAKA,KALUNGU EAST,LUKAYA T.C,CENTRAL,JUMA CELL (A - M),446,0,0,4,176,102,282,4,286,0,O-100-117-05-02-03
MASAKA,KALUNGU EAST,LUKAYA T.C,CENTRAL,KALUNGI CELL,723,5,0,12,131,263,411,65,476,0,O-100-117-05-02-04
MASAKA,KALUNGU EAST,LUKAYA T.C,CENTRAL,JUMA CELL (N - Z),691,0,0,3,215,209,427,8,435,0,O-100-117-05-02-05
MASAKA,KALUNGU EAST,LUKAYA T.C,KALIRO,KAKOOZA CELL,772,5,0,4,204,280,493,13,506,0,O-100-117-05-03-01
MASAKA,KALUNGU EAST,LUKAYA T.C,KALIRO,KALIRO CELL,580,0,0,4,214,146,364,5,369,0,O-100-117-05-03-02
MASAKA,KALUNGU EAST,LUKAYA T.C,KALIRO,KAPERE CELL,424,3,0,2,84,170,259,0,259,0,O-100-117-05-03-03
MASAKA,KALUNGU EAST,LUKAYA T.C,MAGEZI,MAGEZI CELL,717,3,0,6,200,211,420,5,425,0,O-100-117-05-04-01
MASAKA,KALUNGU EAST,LUKAYA T.C,MAGEZI,MASTER CELL,659,3,0,2,202,212,419,7,426,0,O-100-117-05-04-02
MASAKA,KALUNGU EAST,LUKAYA T.C,MAGEZI,KULUBYA CELL,267,2,0,7,70,100,179,7,186,0,O-100-117-05-04-03
MASAKA,KALUNGU EAST,LUKAYA T.C,MAGEZI,KAMUWUNGA,609,0,1,4,81,183,269,42,311,0,O-100-117-05-04-04
MASAKA,KALUNGU EAST,LWABENGE,BUGOMOLA,BUGOMOLA A,398,4,0,3,59,209,275,15,290,0,O-100-117-06-01-01
MASAKA,KALUNGU EAST,LWABENGE,BUGOMOLA,BUGOMOLA B,347,1,1,1,53,206,262,13,275,0,O-100-117-06-01-02
MASAKA,KALUNGU EAST,LWABENGE,BUGOMOLA,LWAMANYONYI,762,3,1,3,38,366,411,142,553,0,O-100-117-06-01-03
MASAKA,KALUNGU EAST,LWABENGE,BUGOMOLA,KALUMAGA,398,0,0,6,45,180,231,92,323,0,O-100-117-06-01-04
MASAKA,KALUNGU EAST,LWABENGE,BUGOMOLA,KISAMBA,475,1,0,5,57,206,269,72,341,0,O-100-117-06-01-05
MASAKA,KALUNGU EAST,LWABENGE,BUGOMOLA,KAGONGERO,332,1,0,4,23,229,257,2,259,0,O-100-117-06-01-06
MASAKA,KALUNGU WEST,KALUNGU,BULAWULA,LWANSWERA,402,2,0,16,107,138,263,44,307,0,O-100-118-01-01-01
MASAKA,KALUNGU WEST,KALUNGU,BULAWULA,BULAWULA,345,1,0,46,103,100,250,13,263,0,O-100-118-01-01-02
MASAKA,KALUNGU WEST,KALUNGU,BULAWULA,LUKERERE,371,1,0,21,101,158,281,7,288,0,O-100-118-01-01-03
MASAKA,KALUNGU WEST,KALUNGU,BULAWULA,KYABAKUUMA,326,0,0,26,94,151,271,5,276,0,O-100-118-01-01-04
MASAKA,KALUNGU WEST,KALUNGU,BULAWULA,NATTITA/KIKONDA,406,0,0,13,84,208,305,28,333,0,O-100-118-01-01-05
MASAKA,KALUNGU WEST,KALUNGU,BWASANDEKU,BWASANDEKU,387,1,0,12,104,149,266,5,271,0,O-100-118-01-02-01
MASAKA,KALUNGU WEST,KALUNGU,BWASANDEKU,KITABYAMA,448,2,1,25,180,104,312,16,328,0,O-100-118-01-02-02
MASAKA,KALUNGU WEST,KALUNGU,BWASANDEKU,KYATO,468,2,0,21,142,169,334,11,345,0,O-100-118-01-02-03
MASAKA,KALUNGU WEST,KALUNGU,BWASANDEKU,SSEETA,726,1,2,66,237,211,517,29,546,0,O-100-118-01-02-04
MASAKA,KALUNGU WEST,KALUNGU,KALIRO,KALIIRO,798,1,1,23,175,204,404,112,516,0,O-100-118-01-03-01
MASAKA,KALUNGU WEST,KALUNGU,KALIRO,BYANA (A - M),372,1,0,18,63,124,206,64,270,0,O-100-118-01-03-02
MASAKA,KALUNGU WEST,KALUNGU,KALIRO,KYAMUSOKE GROWERS SOCIET,638,2,0,36,91,275,404,27,431,0,O-100-118-01-03-03
MASAKA,KALUNGU WEST,KALUNGU,KALUNGU,KALUNGU TOWN,667,5,0,16,214,198,433,21,454,0,O-100-118-01-04-01
MASAKA,KALUNGU WEST,KALUNGU,KALUNGU,KALUNGU VILLAGE,228,1,0,14,75,49,139,12,151,0,O-100-118-01-04-02
MASAKA,KALUNGU WEST,KALUNGU,KALUNGU,LUSAANA,553,1,0,44,122,190,357,68,425,0,O-100-118-01-04-03
MASAKA,KALUNGU WEST,KALUNGU,KALUNGU,KISAAWA,481,3,0,27,123,196,349,7,356,0,O-100-118-01-04-04
MASAKA,KALUNGU WEST,KALUNGU,KALUNGU,KASABBAALE,635,0,1,67,153,238,459,17,476,0,O-100-118-01-04-05
MASAKA,KALUNGU WEST,KALUNGU,KASANJE,KIROWOOZA,821,1,1,48,274,244,568,41,609,0,O-100-118-01-05-01
MASAKA,KALUNGU WEST,KALUNGU,KASANJE,BUTAWAATA,440,1,0,20,159,146,326,14,340,0,O-100-118-01-05-02
MASAKA,KALUNGU WEST,KALUNGU,KASANJE,KIRETERWA,553,0,0,36,182,166,384,19,403,0,O-100-118-01-05-03
MASAKA,KALUNGU WEST,KALUNGU,KIBISI,NAMAGOMA,328,1,0,16,144,113,274,2,276,0,O-100-118-01-06-01
MASAKA,KALUNGU WEST,KALUNGU,KIBISI,KIBISI,329,3,0,30,101,123,257,6,263,0,O-100-118-01-06-02
MASAKA,KALUNGU WEST,KALUNGU,KIBISI,KATEERA,460,2,1,27,111,222,363,5,368,0,O-100-118-01-06-03
MASAKA,KALUNGU WEST,KALUNGU,KITAMBA,KITAMBA,855,4,0,38,261,321,624,25,649,0,O-100-118-01-07-01
MASAKA,KALUNGU WEST,KALUNGU,KITAMBA,KAGASA,154,0,0,14,54,55,123,3,126,0,O-100-118-01-07-02
MASAKA,KALUNGU WEST,KALUNGU,KITAMBA,KIKUKUMBI,341,0,0,11,67,163,241,28,269,0,O-100-118-01-07-03
MASAKA,KALUNGU WEST,KALUNGU,NABUTONGWA,NABUTONGWA,336,0,0,13,92,130,235,2,237,0,O-100-118-01-08-01
MASAKA,KALUNGU WEST,KALUNGU,NABUTONGWA,KIKAABYA/NABUTONGWA C.U CO,530,1,0,29,134,216,380,20,400,0,O-100-118-01-08-02
MASAKA,KALUNGU WEST,KALUNGU,NABUTONGWA,KAANIKA P. SCHOOL,271,1,0,1,41,105,148,7,155,0,O-100-118-01-08-03
MASAKA,KALUNGU WEST,KALUNGU,NABUTONGWA,KALOKERO,252,1,0,7,91,83,182,4,186,0,O-100-118-01-08-04
MASAKA,KALUNGU WEST,KALUNGU,NTALE,KABUNGO PRIM SCHOOL,579,3,0,23,163,198,387,68,455,0,O-100-118-01-09-01
MASAKA,KALUNGU WEST,KALUNGU,NTALE,KITEMBO,607,5,0,15,237,245,502,24,526,0,O-100-118-01-09-02
MASAKA,KALUNGU WEST,KALUNGU,VILLA-MARIA,VILLA-MARIA (A - M),365,0,0,33,80,93,206,13,219,0,O-100-118-01-10-01
MASAKA,KALUNGU WEST,KALUNGU,VILLA-MARIA,KATIGONDO,344,3,1,13,122,74,213,15,228,0,O-100-118-01-10-02
MASAKA,KALUNGU WEST,KALUNGU,VILLA-MARIA,BUKALASA,358,2,0,17,73,136,228,22,250,0,O-100-118-01-10-03
MASAKA,KALUNGU WEST,KALUNGU,VILLA-MARIA,KAMUKONGO,403,1,0,37,112,82,232,86,318,0,O-100-118-01-10-04
MASAKA,KALUNGU WEST,KALUNGU,VILLA-MARIA,KAKUNYU,235,1,0,30,69,66,166,8,174,0,O-100-118-01-10-05
MASAKA,KALUNGU WEST,KALUNGU,VILLA-MARIA,VILLA-MARIA (N - Z),662,2,0,79,121,132,334,1,335,0,O-100-118-01-10-06
MASAKA,KALUNGU WEST,KYAMULIBWA,BAKIJJULULA,BAKIJJULULA,382,0,0,13,112,134,259,46,305,0,O-100-118-02-01-01
MASAKA,KALUNGU WEST,KYAMULIBWA,BAKIJJULULA,BUJUBI,286,1,0,11,87,114,213,4,217,0,O-100-118-02-01-02
MASAKA,KALUNGU WEST,KYAMULIBWA,BAKIJJULULA,KIWAAWO,612,1,0,7,145,294,447,10,457,0,O-100-118-02-01-03
MASAKA,KALUNGU WEST,KYAMULIBWA,BUSOGA,NALUNYA,478,0,0,12,87,252,351,17,368,0,O-100-118-02-02-01
MASAKA,KALUNGU WEST,KYAMULIBWA,BUSOGA,KATAALI (N - Z),564,5,1,13,140,252,411,5,416,0,O-100-118-02-02-02
MASAKA,KALUNGU WEST,KYAMULIBWA,BUSOGA,BUSOGA,366,2,0,17,68,187,274,13,287,0,O-100-118-02-02-03
MASAKA,KALUNGU WEST,KYAMULIBWA,BUSOGA,KATAALI (A - M),305,1,0,15,98,114,228,5,233,0,O-100-118-02-02-04
MASAKA,KALUNGU WEST,KYAMULIBWA,KABALE,KABAALE,546,0,0,6,107,249,362,47,409,0,O-100-118-02-03-01
MASAKA,KALUNGU WEST,KYAMULIBWA,KABALE,NAMASAVU,503,3,1,1,81,269,355,10,365,0,O-100-118-02-03-02
MASAKA,KALUNGU WEST,KYAMULIBWA,KABALE,MAGULUKA T. CENTRE,273,0,0,2,38,134,174,27,201,0,O-100-118-02-03-03
MASAKA,KALUNGU WEST,KYAMULIBWA,KIGASA,KIGASA,633,2,0,23,117,349,491,6,497,0,O-100-118-02-04-01
MASAKA,KALUNGU WEST,KYAMULIBWA,KIGASA,KITULIKIZI,593,2,0,13,101,327,443,10,453,0,O-100-118-02-04-02
MASAKA,KALUNGU WEST,KYAMULIBWA,KIGASA,LWANNUME,687,0,0,16,106,372,494,18,512,0,O-100-118-02-04-03
MASAKA,KALUNGU WEST,KYAMULIBWA,KIGASA,KYANAMULI,274,0,0,9,47,159,215,17,232,0,O-100-118-02-04-04
MASAKA,KALUNGU WEST,KYAMULIBWA,KITOSI,BUTAWATA,290,1,0,1,103,105,210,3,213,0,O-100-118-02-05-01
MASAKA,KALUNGU WEST,KYAMULIBWA,KITOSI,KAMPUKI,612,2,0,30,164,268,464,27,491,0,O-100-118-02-05-02
MASAKA,KALUNGU WEST,KYAMULIBWA,KITOSI,KITOSI,518,2,0,20,128,230,380,12,392,0,O-100-118-02-05-03
MASAKA,KALUNGU WEST,KYAMULIBWA,KYAMULIBWA,KYAMULIBWA,844,4,1,28,256,304,593,33,626,0,O-100-118-02-06-01
MASAKA,KALUNGU WEST,KYAMULIBWA,KYAMULIBWA,KALAMA,540,1,1,7,74,233,316,89,405,0,O-100-118-02-06-02
MASAKA,KALUNGU WEST,KYAMULIBWA,KYAMULIBWA,LUSOZI,478,2,0,6,71,201,280,90,370,0,O-100-118-02-06-03
MASAKA,KALUNGU WEST,KYAMULIBWA,KYAMULIBWA,KASUULA,365,0,0,26,124,128,278,6,284,0,O-100-118-02-06-04
MASAKA,KALUNGU WEST,KYAMULIBWA,KYAMULIBWA,KIWUNGA,743,2,0,66,168,293,529,1,530,0,O-100-118-02-06-05
MASAKA,KALUNGU WEST,KYAMULIBWA,KYAMULIBWA,BUNOGA,263,1,0,5,51,148,205,4,209,0,O-100-118-02-06-06
MASAKA,BUKOTO MID-WEST,LWENGO,KALISIZO,KALISIZO,463,3,1,8,59,270,341,13,354,0,O-105-112-01-01-01
MASAKA,BUKOTO MID-WEST,LWENGO,KALISIZO,KYENGERA,434,1,0,3,66,238,308,9,317,0,O-105-112-01-01-02
MASAKA,BUKOTO MID-WEST,LWENGO,KALISIZO,KINVUNUKIDDE,467,3,0,14,83,252,352,24,376,0,O-105-112-01-01-03
MASAKA,BUKOTO MID-WEST,LWENGO,KALISIZO,KIGANDO,702,1,2,10,55,349,417,29,446,0,O-105-112-01-01-04
MASAKA,BUKOTO MID-WEST,LWENGO,KALISIZO,BUGONZI,582,2,0,1,33,365,401,21,422,0,O-105-112-01-01-05
MASAKA,BUKOTO MID-WEST,LWENGO,KALISIZO,KYETUME,202,0,0,4,44,95,143,4,147,0,O-105-112-01-01-06
MASAKA,BUKOTO MID-WEST,LWENGO,KITO,KYASSENYA (A - M),467,2,0,2,44,246,294,16,310,0,O-105-112-01-02-01
MASAKA,BUKOTO MID-WEST,LWENGO,KITO,BULASANA,680,5,0,8,153,336,502,11,513,0,O-105-112-01-02-02
MASAKA,BUKOTO MID-WEST,LWENGO,KITO,LUTI,827,5,0,4,93,512,614,25,639,0,O-105-112-01-02-03
MASAKA,BUKOTO MID-WEST,LWENGO,KITO,KATOSI,554,5,0,6,68,355,434,6,440,0,O-105-112-01-02-04
MASAKA,BUKOTO MID-WEST,LWENGO,KITO,MISENYI,331,1,2,8,59,177,247,13,260,0,O-105-112-01-02-05
MASAKA,BUKOTO MID-WEST,LWENGO,KITO,KIBONA/NYENDO T/C,580,2,1,12,82,356,453,16,469,0,O-105-112-01-02-06
MASAKA,BUKOTO MID-WEST,LWENGO,KITO,KYASSENYA (N - Z),531,3,0,11,46,271,331,28,359,0,O-105-112-01-02-07
MASAKA,BUKOTO MID-WEST,LWENGO,KYAWAGONYA,KAMUSOGA,553,4,0,5,47,320,376,20,396,0,O-105-112-01-03-01
MASAKA,BUKOTO MID-WEST,LWENGO,KYAWAGONYA,KABONERO,525,4,0,3,54,293,354,17,371,0,O-105-112-01-03-02
MASAKA,BUKOTO MID-WEST,LWENGO,KYAWAGONYA,KYETUME,1254,4,1,21,124,467,617,207,824,0,O-105-112-01-03-03
MASAKA,BUKOTO MID-WEST,LWENGO,KYAWAGONYA,LONDON,700,0,0,2,64,302,368,104,472,0,O-105-112-01-03-04
MASAKA,BUKOTO MID-WEST,LWENGO,LWENGO,KIRYANKUYERE,378,1,0,7,69,195,272,26,298,0,O-105-112-01-04-01
MASAKA,BUKOTO MID-WEST,LWENGO,LWENGO,NYENJE,403,0,0,22,164,130,316,17,333,0,O-105-112-01-04-02
MASAKA,BUKOTO MID-WEST,LWENGO,LWENGO,KYENGEZA/LWENGO,300,2,0,4,63,150,219,8,227,0,O-105-112-01-04-03
MASAKA,BUKOTO MID-WEST,LWENGO,LWENGO,BWAMI,794,8,2,30,123,289,452,167,619,0,O-105-112-01-04-04
MASAKA,BUKOTO MID-WEST,LWENGO,MBIRIZI,KITAKOMAGA T.C,700,2,1,15,158,302,478,25,503,0,O-105-112-01-05-01
MASAKA,BUKOTO MID-WEST,LWENGO,MBIRIZI,MBIRIZI VILLAGE,684,3,0,23,153,326,505,12,517,0,O-105-112-01-05-02
MASAKA,BUKOTO MID-WEST,LWENGO,MBIRIZI,MBIRIZI T.C I,595,6,0,14,201,176,397,8,405,0,O-105-112-01-05-03
MASAKA,BUKOTO MID-WEST,LWENGO,MBIRIZI,MBIRIZI T.C 2,806,8,2,6,171,283,470,18,488,0,O-105-112-01-05-04
MASAKA,BUKOTO MID-WEST,LWENGO,MBIRIZI,MBIRIZI T.C 3 (A - M),457,3,0,8,130,131,272,8,280,0,O-105-112-01-05-05
MASAKA,BUKOTO MID-WEST,LWENGO,MBIRIZI,MBIRIZI T.C 3 (N - Z),566,2,1,11,129,198,341,7,348,0,O-105-112-01-05-06
MASAKA,BUKOTO MID-WEST,LWENGO,MUSUBIRO,MUSUBIRO T. C.,464,4,0,5,49,271,329,24,353,0,O-105-112-01-06-01
MASAKA,BUKOTO MID-WEST,LWENGO,MUSUBIRO,NKOMA/LUTOMA,214,1,0,4,5,149,159,1,160,0,O-105-112-01-06-02
MASAKA,BUKOTO MID-WEST,LWENGO,MUSUBIRO,NKOMA T. C.,1016,5,1,18,114,512,650,30,680,0,O-105-112-01-06-03
MASAKA,BUKOTO MID-WEST,LWENGO,MUSUBIRO,MUSUBIRO,320,0,0,1,10,225,236,15,251,0,O-105-112-01-06-04
MASAKA,BUKOTO MID-WEST,LWENGO,MUSUBIRO,MUWANGI,290,2,1,4,53,170,230,6,236,0,O-105-112-01-06-05
MASAKA,BUKOTO MID-WEST,LWENGO,NAKYENYI,LWENSINGA,559,2,0,4,98,317,421,19,440,0,O-105-112-01-07-01
MASAKA,BUKOTO MID-WEST,LWENGO,NAKYENYI,KITAWULUZI,672,8,1,7,146,377,539,17,556,0,O-105-112-01-07-02
MASAKA,BUKOTO MID-WEST,LWENGO,NAKYENYI,MINYEGENYO,660,8,1,8,85,367,469,44,513,0,O-105-112-01-07-03
MASAKA,BUKOTO MID-WEST,LWENGO,NAKYENYI,KAWOKO,494,3,0,13,76,290,382,16,398,0,O-105-112-01-07-04
MASAKA,BUKOTO MID-WEST,LWENGO,NKUNYU,MAIRA,836,6,0,18,196,328,548,19,567,0,O-105-112-01-08-01
MASAKA,BUKOTO MID-WEST,LWENGO,NKUNYU,NKUNYU,567,2,0,6,124,253,385,17,402,0,O-105-112-01-08-02
MASAKA,BUKOTO MID-WEST,LWENGO,NKUNYU,BUZINGA,673,5,0,5,83,422,515,9,524,0,O-105-112-01-08-03
MASAKA,BUKOTO MID-WEST,LWENGO,NKUNYU,KATOMA,561,4,0,3,98,344,449,12,461,0,O-105-112-01-08-04
MASAKA,BUKOTO MID-WEST,LWENGO,NKUNYU,KIGUSA,537,5,0,33,168,188,394,20,414,0,O-105-112-01-08-05
MASAKA,BUKOTO MID-WEST,NDAGWE,MAKONDO,KYAMUKAMA,497,3,0,10,170,183,366,22,388,0,O-105-112-02-01-01
MASAKA,BUKOTO MID-WEST,NDAGWE,MAKONDO,LUYIIYI,683,0,0,9,202,316,527,7,534,0,O-105-112-02-01-02
MASAKA,BUKOTO MID-WEST,NDAGWE,MAKONDO,KANYOGOGA PRIMARY SCHOOL,672,4,1,11,168,321,505,33,538,0,O-105-112-02-01-03
MASAKA,BUKOTO MID-WEST,NDAGWE,MAKONDO,MAKONDO,495,3,0,132,136,207,478,8,486,0,O-105-112-02-01-04
MASAKA,BUKOTO MID-WEST,NDAGWE,MAKONDO,KIBUYE PRIMARY SCHOOL,758,7,1,10,131,389,538,31,569,0,O-105-112-02-01-05
MASAKA,BUKOTO MID-WEST,NDAGWE,MPUMUDDE,NDAGWE S.S,767,3,1,1,107,463,575,5,580,0,O-105-112-02-02-01
MASAKA,BUKOTO MID-WEST,NDAGWE,MPUMUDDE,JAGA P.S,615,2,0,19,76,327,424,39,463,0,O-105-112-02-02-02
MASAKA,BUKOTO MID-WEST,NDAGWE,MPUMUDDE,ANZALANE T/C (A - M),510,1,0,13,37,332,383,13,396,0,O-105-112-02-02-03
MASAKA,BUKOTO MID-WEST,NDAGWE,MPUMUDDE,KYAMATAFALI T/C (A - M),489,1,0,6,40,307,354,9,363,0,O-105-112-02-02-04
MASAKA,BUKOTO MID-WEST,NDAGWE,MPUMUDDE,ANZALANE T/C (N - Z),573,3,0,13,51,331,398,18,416,0,O-105-112-02-02-05
MASAKA,BUKOTO MID-WEST,NDAGWE,MPUMUDDE,KYAMATAFALI T/C N - Z,431,1,0,3,26,264,294,8,302,0,O-105-112-02-02-06
MASAKA,BUKOTO MID-WEST,NDAGWE,NANYWA,NANYWA P/S,763,2,1,13,155,405,576,13,589,0,O-105-112-02-03-01
MASAKA,BUKOTO MID-WEST,NDAGWE,NANYWA,KAYIRIRA P.SCH,797,6,0,4,119,480,609,18,627,0,O-105-112-02-03-02
MASAKA,BUKOTO MID-WEST,NDAGWE,NANYWA,NAKATEETE SCH.(A - M),431,5,0,4,78,229,316,22,338,0,O-105-112-02-03-03
MASAKA,BUKOTO MID-WEST,NDAGWE,NANYWA,NAKATEETE SCH.(N - Z),593,4,0,10,67,341,422,9,431,0,O-105-112-02-03-04
MASAKA,BUKOTO MID-WEST,NDAGWE,NDAGWE,KYANTALE PLAY GROUND,563,3,0,4,143,237,387,11,398,0,O-105-112-02-04-01
MASAKA,BUKOTO MID-WEST,NDAGWE,NDAGWE,MIJUMA T/C,637,4,1,5,89,371,470,27,497,0,O-105-112-02-04-02
MASAKA,BUKOTO MID-WEST,NDAGWE,NDAGWE,KAKINDU PLAY GROUND (A - M),324,6,0,10,67,158,241,9,250,0,O-105-112-02-04-03
MASAKA,BUKOTO MID-WEST,NDAGWE,NDAGWE,KAGOGWA PRIMARY SCHOOL,740,1,1,8,105,452,567,21,588,0,O-105-112-02-04-04
MASAKA,BUKOTO MID-WEST,NDAGWE,NDAGWE,BUKULULA PLAY GROUND,516,8,0,3,129,242,382,13,395,0,O-105-112-02-04-05
MASAKA,BUKOTO MID-WEST,NDAGWE,NDAGWE,BUNJAKO PRIMARY SCHOOL,784,6,2,8,51,513,580,39,619,0,O-105-112-02-04-06
MASAKA,BUKOTO MID-WEST,NDAGWE,NDAGWE,KAKINDU PLAY GROUND (N - Z),538,2,0,10,81,281,374,24,398,0,O-105-112-02-04-07
MASAKA,BUKOTO WEST,KYAZANGA,BIJAABA,KASAMBYA,551,0,1,1,94,267,363,14,377,0,O-105-113-01-01-01
MASAKA,BUKOTO WEST,KYAZANGA,BIJAABA,BIJJAABA,371,0,0,1,133,131,265,7,272,0,O-105-113-01-01-02
MASAKA,BUKOTO WEST,KYAZANGA,BIJAABA,KAMITI,627,2,0,5,195,224,426,5,431,0,O-105-113-01-01-03
MASAKA,BUKOTO WEST,KYAZANGA,BIJAABA,KISAANA,728,0,0,4,79,404,487,15,502,0,O-105-113-01-01-04
MASAKA,BUKOTO WEST,KYAZANGA,BIJAABA,KIKANIKA,566,1,1,2,18,456,478,9,487,0,O-105-113-01-01-05
MASAKA,BUKOTO WEST,KYAZANGA,BIJAABA,BUSUMBI,352,1,0,3,17,248,269,9,278,0,O-105-113-01-01-06
MASAKA,BUKOTO WEST,KYAZANGA,BIJAABA,BUWUMMULIRO,395,3,0,1,17,241,262,18,280,0,O-105-113-01-01-07
MASAKA,BUKOTO WEST,KYAZANGA,KAKOMA,KUBUYINJA,621,1,0,3,112,316,432,11,443,0,O-105-113-01-02-01
MASAKA,BUKOTO WEST,KYAZANGA,KAKOMA,BIJAAABA/NKOKONJERU,547,4,0,1,56,244,305,9,314,0,O-105-113-01-02-02
MASAKA,BUKOTO WEST,KYAZANGA,KAKOMA,KANONIO P. SCHOOL,505,0,0,0,13,346,359,7,366,0,O-105-113-01-02-03
MASAKA,BUKOTO WEST,KYAZANGA,KAKOMA,KIBIMBA,514,3,0,4,32,346,385,7,392,0,O-105-113-01-02-04
MASAKA,BUKOTO WEST,KYAZANGA,KAKOMA,LYANGOMA,287,0,0,1,26,174,201,36,237,0,O-105-113-01-02-05
MASAKA,BUKOTO WEST,KYAZANGA,KAKOMA,BIJJAABA A/B,340,0,0,0,25,202,227,7,234,0,O-105-113-01-02-06
MASAKA,BUKOTO WEST,KYAZANGA,KAKOMA,NKUNDWA,319,1,0,1,46,169,217,13,230,0,O-105-113-01-02-07
MASAKA,BUKOTO WEST,KYAZANGA,KAKOMA,KIKASUKA T/C,552,0,0,0,40,301,341,78,419,0,O-105-113-01-02-08
MASAKA,BUKOTO WEST,KYAZANGA,KATUULO,KALYAMENVU,435,1,0,5,76,235,317,13,330,0,O-105-113-01-03-01
MASAKA,BUKOTO WEST,KYAZANGA,KATUULO,LWEMPAZI,313,1,1,1,27,186,216,3,219,0,O-105-113-01-03-02
MASAKA,BUKOTO WEST,KYAZANGA,KATUULO,KATURO,352,1,0,1,52,260,314,5,319,0,O-105-113-01-03-03
MASAKA,BUKOTO WEST,KYAZANGA,KATUULO,BUSIBO,545,1,0,2,42,332,377,10,387,0,O-105-113-01-03-04
MASAKA,BUKOTO WEST,KYAZANGA,KATUULO,SINGIRO,347,0,0,2,27,229,258,7,265,0,O-105-113-01-03-05
MASAKA,BUKOTO WEST,KYAZANGA,KATUULO,RUBAALE,523,2,1,2,86,278,369,11,380,0,O-105-113-01-03-06
MASAKA,BUKOTO WEST,KYAZANGA,KATUULO,LWENSAMBYA,353,0,0,1,44,226,271,0,271,0,O-105-113-01-03-07
MASAKA,BUKOTO WEST,KYAZANGA,KITOORO,KITOORO F,525,0,0,1,148,157,306,4,310,0,O-105-113-01-04-01
MASAKA,BUKOTO WEST,KYAZANGA,KITOORO,ACADEMY (A - M),487,0,0,1,153,127,281,10,291,0,O-105-113-01-04-02
MASAKA,BUKOTO WEST,KYAZANGA,KITOORO,KELEZIA (A - M),415,0,0,0,110,150,260,6,266,0,O-105-113-01-04-03
MASAKA,BUKOTO WEST,KYAZANGA,KITOORO,TAKWA P/S (A - M),427,1,0,2,144,104,251,6,257,0,O-105-113-01-04-04
MASAKA,BUKOTO WEST,KYAZANGA,KITOORO,S/CTY HQRS,798,2,2,2,267,250,523,7,530,0,O-105-113-01-04-05
MASAKA,BUKOTO WEST,KYAZANGA,KITOORO,TAKWA P/S (N - Z),533,0,0,0,132,166,298,8,306,0,O-105-113-01-04-06
MASAKA,BUKOTO WEST,KYAZANGA,KITOORO,ACADEMY (N - Z,564,2,0,0,163,168,333,8,341,0,O-105-113-01-04-07
MASAKA,BUKOTO WEST,KYAZANGA,KITOORO,KELEZIA (N - Z),513,1,0,0,139,193,333,0,333,0,O-105-113-01-04-08
MASAKA,BUKOTO WEST,KYAZANGA,LYAKIBIRIZI,MPUMUDDE/KIRUMBA A (A - M),487,1,0,3,79,258,341,4,345,0,O-105-113-01-05-01
MASAKA,BUKOTO WEST,KYAZANGA,LYAKIBIRIZI,MPUMUDDE/KIRUMBA A (N - Z),491,0,0,3,58,265,326,11,337,0,O-105-113-01-05-02
MASAKA,BUKOTO WEST,KYAZANGA,LYAKIBIRIZI,NAKATEETE,628,0,0,0,73,311,384,9,393,0,O-105-113-01-05-03
MASAKA,BUKOTO WEST,KYAZANGA,LYAKIBIRIZI,NAKALAGO,507,1,0,0,61,273,335,9,344,0,O-105-113-01-05-04
MASAKA,BUKOTO WEST,KYAZANGA,LYAKIBIRIZI,NAGANGABO OPEN GROUND,463,1,1,3,94,198,297,13,310,0,O-105-113-01-05-05
MASAKA,BUKOTO WEST,KYAZANGA,LYAKIBIRIZI,KENGWE,558,2,0,2,92,275,371,8,379,0,O-105-113-01-05-06
MASAKA,BUKOTO WEST,KYAZANGA,LYAKIBIRIZI,BAMUNANIKA,312,0,0,0,33,168,201,3,204,0,O-105-113-01-05-07
MASAKA,BUKOTO WEST,MALONGO,KALAGALA,KYAMPALAGATA,524,0,1,2,48,346,397,18,415,0,O-105-113-02-01-01
MASAKA,BUKOTO WEST,MALONGO,KALAGALA,KASANA,403,0,0,0,31,185,216,70,286,0,O-105-113-02-01-02
MASAKA,BUKOTO WEST,MALONGO,KALAGALA,KALAGALA,741,1,1,1,74,438,515,43,558,0,O-105-113-02-01-03
MASAKA,BUKOTO WEST,MALONGO,KALAGALA,LWAMANYA (A - L),647,0,0,0,35,405,440,68,508,0,O-105-113-02-01-04
MASAKA,BUKOTO WEST,MALONGO,KALAGALA,RWEKISHUGI,552,0,0,1,33,346,380,35,415,0,O-105-113-02-01-05
MASAKA,BUKOTO WEST,MALONGO,KALAGALA,LUGOLOGOLO,695,4,1,3,64,423,495,7,502,0,O-105-113-02-01-06
MASAKA,BUKOTO WEST,MALONGO,KALAGALA,LWAMANYA (M - Z),711,0,0,4,38,426,468,30,498,0,O-105-113-02-01-07
MASAKA,BUKOTO WEST,MALONGO,KATOVU,KIGAAGA,483,1,2,2,40,243,288,17,305,0,O-105-113-02-02-01
MASAKA,BUKOTO WEST,MALONGO,KATOVU,RWENDEZI,612,2,0,0,54,309,365,12,377,0,O-105-113-02-02-02
MASAKA,BUKOTO WEST,MALONGO,KATOVU,LWEMIYAGA B,825,0,0,1,54,534,589,3,592,0,O-105-113-02-02-03
MASAKA,BUKOTO WEST,MALONGO,KATOVU,KYAMATAFALI,599,0,1,0,43,361,405,16,421,0,O-105-113-02-02-04
MASAKA,BUKOTO WEST,MALONGO,KATOVU,KASAMBYA/KALEGERO (A - M),577,0,0,2,56,276,334,7,341,0,O-105-113-02-02-05
MASAKA,BUKOTO WEST,MALONGO,KATOVU,NTUULA A&B,642,2,0,2,41,406,451,9,460,0,O-105-113-02-02-06
MASAKA,BUKOTO WEST,MALONGO,KATOVU,KASAMBYA/KALEGERO (N - Z),609,0,0,1,31,312,344,15,359,0,O-105-113-02-02-07
MASAKA,BUKOTO WEST,MALONGO,KIGEYE,KIGEYE COPE SCHOOL (A - M),446,1,0,5,45,225,276,62,338,0,O-105-113-02-03-01
MASAKA,BUKOTO WEST,MALONGO,KIGEYE,KIGEYE,579,0,0,0,38,342,380,66,446,0,O-105-113-02-03-02
MASAKA,BUKOTO WEST,MALONGO,KIGEYE,NYANTUNGU,348,0,0,0,34,166,200,40,240,0,O-105-113-02-03-03
MASAKA,BUKOTO WEST,MALONGO,KIGEYE,LWEBIDAALI A/B,731,1,0,3,67,397,468,112,580,0,O-105-113-02-03-04
MASAKA,BUKOTO WEST,MALONGO,KIGEYE,KIGEYE COPE SCHOOL (N - Z),482,3,0,0,49,249,301,53,354,0,O-105-113-02-03-05
MASAKA,BUKOTO WEST,MALONGO,MALONGO,MALONGO,745,0,0,8,170,339,517,19,536,0,O-105-113-02-04-01
MASAKA,BUKOTO WEST,MALONGO,MALONGO,GYENDA,416,3,0,1,84,174,262,3,265,0,O-105-113-02-04-02
MASAKA,BUKOTO WEST,MALONGO,MALONGO,LWENTALE,689,0,2,4,142,322,470,6,476,0,O-105-113-02-04-03
MASAKA,BUKOTO WEST,MALONGO,MALONGO,KABUSIRABO (A - M),823,2,0,4,106,493,605,20,625,0,O-105-113-02-04-04
MASAKA,BUKOTO WEST,MALONGO,MALONGO,KABUSIRABO (N - Z),687,2,1,3,74,400,480,20,500,0,O-105-113-02-04-05
RAKAI,KYOTERA COUNTY,KABIRA,BISANJE,KABAWANGA,555,3,1,9,251,152,416,16,432,0,O-121-194-01-01-01
RAKAI,KYOTERA COUNTY,KABIRA,BISANJE,MISOTO,477,2,0,12,181,167,362,14,376,0,O-121-194-01-01-02
RAKAI,KYOTERA COUNTY,KABIRA,BISANJE,KYANKERE,423,1,0,9,106,238,354,10,364,0,O-121-194-01-01-03
RAKAI,KYOTERA COUNTY,KABIRA,BWAMIJJA,KIGERA,556,0,1,2,83,313,399,61,460,0,O-121-194-01-02-01
RAKAI,KYOTERA COUNTY,KABIRA,BWAMIJJA,BBAKA,409,0,0,1,92,209,302,1,303,0,O-121-194-01-02-02
RAKAI,KYOTERA COUNTY,KABIRA,BWAMIJJA,NKALWE,503,1,0,3,120,196,320,68,388,0,O-121-194-01-02-03
RAKAI,KYOTERA COUNTY,KABIRA,BWAMIJJA,MIJJUNJU PLAY GROUND,447,1,0,6,100,181,288,79,367,0,O-121-194-01-02-04
RAKAI,KYOTERA COUNTY,KABIRA,KYANIKA,KYANIKA A,401,2,0,7,90,190,289,8,297,0,O-121-194-01-03-01
RAKAI,KYOTERA COUNTY,KABIRA,KYANIKA,KYANIKA B,454,3,0,6,99,206,314,8,322,0,O-121-194-01-03-02
RAKAI,KYOTERA COUNTY,KABIRA,KYANIKA,MWENYANJULE,675,1,0,4,188,212,405,106,511,0,O-121-194-01-03-03
RAKAI,KYOTERA COUNTY,KABIRA,KYANIKA,KIFUNFU,590,3,0,9,194,242,448,32,480,0,O-121-194-01-03-04
RAKAI,KYOTERA COUNTY,KABIRA,NDOLO,NDOLO-BUKALA,649,2,1,7,24,457,491,13,504,0,O-121-194-01-04-01
RAKAI,KYOTERA COUNTY,KABIRA,NDOLO,KACHANGA,652,3,3,6,139,344,495,23,518,0,O-121-194-01-04-02
RAKAI,KYOTERA COUNTY,KABIRA,NDOLO,NDOLO,530,0,1,4,57,331,393,15,408,0,O-121-194-01-04-03
RAKAI,KYOTERA COUNTY,KABIRA,NDOLO,KASAKA,388,0,0,2,93,196,291,32,323,0,O-121-194-01-04-04
RAKAI,KYOTERA COUNTY,KABIRA,NJALA,KIFUUTA,577,0,0,12,198,143,353,86,439,0,O-121-194-01-05-01
RAKAI,KYOTERA COUNTY,KABIRA,NJALA,NJALA P/S,513,2,0,9,166,199,376,12,388,0,O-121-194-01-05-02
RAKAI,KYOTERA COUNTY,KABIRA,NJALA,NGANDA P/S,713,4,1,18,262,274,559,6,565,0,O-121-194-01-05-03
RAKAI,KYOTERA COUNTY,KALISIZO,KAKOMA,NALUKOOLA P/S,621,2,0,13,203,225,443,0,443,0,O-121-194-02-01-01
RAKAI,KYOTERA COUNTY,KALISIZO,KAKOMA,NSAMBYA TRADING CENTRE,552,2,0,32,184,172,390,12,402,0,O-121-194-02-01-02
RAKAI,KYOTERA COUNTY,KALISIZO,KIKUNGWE,KALONGO,732,1,0,15,197,334,547,15,562,0,O-121-194-02-02-01
RAKAI,KYOTERA COUNTY,KALISIZO,KIKUNGWE,KIKUNGWE,705,5,0,13,238,265,521,23,544,0,O-121-194-02-02-02
RAKAI,KYOTERA COUNTY,KALISIZO,KIKUNGWE,NSUMBA,470,1,1,5,114,253,374,7,381,0,O-121-194-02-02-03
RAKAI,KYOTERA COUNTY,KALISIZO,KYANGO,KYANGO/MITONDA,552,1,0,12,246,153,412,12,424,0,O-121-194-02-03-01
RAKAI,KYOTERA COUNTY,KALISIZO,KYANGO,KYANGO/JONGOZA,308,2,0,7,137,105,251,4,255,0,O-121-194-02-03-02
RAKAI,KYOTERA COUNTY,KALISIZO,KYANGO,KIKONDA-KAKUZA,417,0,1,25,164,118,308,7,315,0,O-121-194-02-03-03
RAKAI,KYOTERA COUNTY,KALISIZO,MATALE,MATALE C.O.U,577,1,2,14,185,200,402,5,407,0,O-121-194-02-04-01
RAKAI,KYOTERA COUNTY,KALISIZO,MATALE,KALWANGA T/C,338,1,0,8,141,102,252,10,262,0,O-121-194-02-04-02
RAKAI,KYOTERA COUNTY,KALISIZO,MITI,KYAKANYOMOZI,653,0,5,14,146,315,480,16,496,0,O-121-194-02-05-01
RAKAI,KYOTERA COUNTY,KALISIZO,MITI,MITI,710,2,1,19,186,328,536,22,558,0,O-121-194-02-05-02
RAKAI,KYOTERA COUNTY,KALISIZO T.C.,BULINDA,BULINDA ST. RAPHAEL,633,4,0,28,219,182,433,12,445,0,O-121-194-03-01-01
RAKAI,KYOTERA COUNTY,KALISIZO T.C.,BULINDA,MATALE HILL (A-M),300,2,0,21,149,55,227,3,230,0,O-121-194-03-01-02
RAKAI,KYOTERA COUNTY,KALISIZO T.C.,BULINDA,MATALE HILL (N-Z),549,0,0,16,192,165,373,20,393,0,O-121-194-03-01-03
RAKAI,KYOTERA COUNTY,KALISIZO T.C.,KALISIZO,UNION FACTORY (A-M),534,2,0,7,252,79,340,19,359,0,O-121-194-03-02-01
RAKAI,KYOTERA COUNTY,KALISIZO T.C.,KALISIZO,KALISIZO SOUTH A,1115,4,0,17,375,232,628,8,636,0,O-121-194-03-02-02
RAKAI,KYOTERA COUNTY,KALISIZO T.C.,KALISIZO,KALISIZO SOUTH B,759,1,2,14,244,153,414,5,419,0,O-121-194-03-02-03
RAKAI,KYOTERA COUNTY,KALISIZO T.C.,KALISIZO,UNION FACTORY (N-Z),803,2,0,16,293,168,479,1,480,0,O-121-194-03-02-04
RAKAI,KYOTERA COUNTY,KALISIZO T.C.,NINZI,NINZI,588,1,0,45,196,155,397,13,410,0,O-121-194-03-03-01
RAKAI,KYOTERA COUNTY,KASAALI,BUZIRANDUULU,BUZIRANDUULU (KIYIMBA),570,1,0,14,197,166,378,17,395,0,O-121-194-04-01-01
RAKAI,KYOTERA COUNTY,KASAALI,BUZIRANDUULU,KAYUNGA,517,0,0,5,166,231,402,0,402,0,O-121-194-04-01-02
RAKAI,KYOTERA COUNTY,KASAALI,GAYAZA,GAYAZA,670,2,0,11,213,280,506,16,522,0,O-121-194-04-02-01
RAKAI,KYOTERA COUNTY,KASAALI,GAYAZA,KYAKUDUSSE,533,4,0,6,130,215,355,49,404,0,O-121-194-04-02-02
RAKAI,KYOTERA COUNTY,KASAALI,GAYAZA,KALAGALA,645,0,0,9,217,251,477,12,489,0,O-121-194-04-02-03
RAKAI,KYOTERA COUNTY,KASAALI,KIGENYA,KIGENYA,726,4,0,8,219,279,510,16,526,0,O-121-194-04-03-01
RAKAI,KYOTERA COUNTY,KASAALI,KIGENYA,KASAALI,943,5,2,31,359,181,578,20,598,0,O-121-194-04-03-02
RAKAI,KYOTERA COUNTY,KASAALI,KIGENYA,BIIKIRA,822,0,2,39,219,219,479,92,571,0,O-121-194-04-03-03
RAKAI,KYOTERA COUNTY,KASAALI,KYAKONDA,KYAKONDA,553,3,0,6,219,169,397,11,408,0,O-121-194-04-04-01
RAKAI,KYOTERA COUNTY,KASAALI,KYAKONDA,KYOTERA,747,3,3,14,251,192,463,15,478,0,O-121-194-04-04-02
RAKAI,KYOTERA COUNTY,KASAALI,KYAKONDA,SSAGALA,396,0,3,6,182,75,266,22,288,0,O-121-194-04-04-03
RAKAI,KYOTERA COUNTY,KASAALI,NKENGE,NKENGE-BWERERE,485,1,1,9,134,212,357,4,361,0,O-121-194-04-05-01
RAKAI,KYOTERA COUNTY,KASAALI,NKENGE,BUYINGI-KABASEKE,629,3,1,7,176,247,434,9,443,0,O-121-194-04-05-02
RAKAI,KYOTERA COUNTY,KASAALI,NKENGE,KYANGO-BIGAVU-NTOVU,648,2,2,12,175,266,457,29,486,0,O-121-194-04-05-03
RAKAI,KYOTERA COUNTY,KIRUMBA,BUYIISA,KABOWOKO ST JONES,682,2,2,41,255,164,464,8,472,0,O-121-194-05-01-01
RAKAI,KYOTERA COUNTY,KIRUMBA,BUYIISA,BUYIISA P/S,799,4,3,21,277,314,619,14,633,0,O-121-194-05-01-02
RAKAI,KYOTERA COUNTY,KIRUMBA,BUYIISA,LUTUUNGA P/S,278,2,0,5,101,105,213,11,224,0,O-121-194-05-01-03
RAKAI,KYOTERA COUNTY,KIRUMBA,BYERIMA,KAMPUNGU P.7. P/S,691,1,0,10,169,315,495,18,513,0,O-121-194-05-02-01
RAKAI,KYOTERA COUNTY,KIRUMBA,BYERIMA,BYERIMA TRADING CENTRE,586,1,0,3,162,284,450,13,463,0,O-121-194-05-02-02
RAKAI,KYOTERA COUNTY,KIRUMBA,KABUWOKO,BUKIRA-KABUWOKO C/U,703,0,1,44,236,269,550,6,556,0,O-121-194-05-03-01
RAKAI,KYOTERA COUNTY,KIRUMBA,KABUWOKO,KINDULWE,354,3,1,19,81,193,297,8,305,0,O-121-194-05-03-02
RAKAI,KYOTERA COUNTY,KIRUMBA,KIZIBIRA,BUUBWE T/C,649,1,0,8,170,328,507,14,521,0,O-121-194-05-04-01
RAKAI,KYOTERA COUNTY,KIRUMBA,KIZIBIRA,LUNYINYA T/C,328,1,0,4,128,143,276,6,282,0,O-121-194-05-04-02
RAKAI,KYOTERA COUNTY,KIRUMBA,KIZIBIRA,KYANASANJA,251,1,1,5,49,141,197,4,201,0,O-121-194-05-04-03
RAKAI,KYOTERA COUNTY,KIRUMBA,KYENGEZA,KIRUMBA S/C HQRS,436,1,2,12,119,235,369,7,376,0,O-121-194-05-05-01
RAKAI,KYOTERA COUNTY,KIRUMBA,KYENGEZA,KACHANGA,353,1,1,14,90,177,283,11,294,0,O-121-194-05-05-02
RAKAI,KYOTERA COUNTY,KIRUMBA,KYENGEZA,NKOKKA,754,1,0,18,260,251,530,20,550,0,O-121-194-05-05-03
RAKAI,KYOTERA COUNTY,KIRUMBA,KYENGEZA,BUTEMBE,589,1,0,10,157,294,462,18,480,0,O-121-194-05-05-04
RAKAI,KYOTERA COUNTY,KIRUMBA,LWAMBA,KIJUMBULA T/C,525,0,0,38,219,162,419,4,423,0,O-121-194-05-06-01
RAKAI,KYOTERA COUNTY,KIRUMBA,LWAMBA,LWAMBA T/C,475,2,0,17,161,173,353,5,358,0,O-121-194-05-06-02
RAKAI,KYOTERA COUNTY,KYOTERA T.C.,CENTRAL WARD,CENTRAL S.S.,774,1,0,5,278,131,415,58,473,0,O-121-194-06-01-01
RAKAI,KYOTERA COUNTY,KYOTERA T.C.,CENTRAL WARD,OLD TAXI PARK,177,0,1,2,63,36,102,15,117,0,O-121-194-06-01-02
RAKAI,KYOTERA COUNTY,KYOTERA T.C.,INDUSTRIAL AREA W,TEEFE C.O.U,812,1,0,6,267,159,433,14,447,0,O-121-194-06-02-01
RAKAI,KYOTERA COUNTY,KYOTERA T.C.,INDUSTRIAL AREA W,KELEZIA,668,1,0,4,226,123,354,52,406,0,O-121-194-06-02-02
RAKAI,KYOTERA COUNTY,KYOTERA T.C.,INDUSTRIAL AREA W,LAS VEGAS,747,5,0,5,224,163,397,7,404,0,O-121-194-06-02-03
RAKAI,KYOTERA COUNTY,KYOTERA T.C.,MITUKULA WARD,KAMWANYI,473,1,0,2,124,116,243,46,289,0,O-121-194-06-03-01
RAKAI,KYOTERA COUNTY,KYOTERA T.C.,MITUKULA WARD,NEW PARK,879,1,0,2,186,198,387,59,446,0,O-121-194-06-03-02
RAKAI,KYOTERA COUNTY,KYOTERA T.C.,MITUKULA WARD,KYOTERA T/COUNCIL OFFICES,788,0,0,7,189,130,326,38,364,0,O-121-194-06-03-03
RAKAI,KYOTERA COUNTY,KYOTERA T.C.,MITUKULA WARD,KASAMBYA,826,4,0,8,263,180,455,5,460,0,O-121-194-06-03-04
RAKAI,KYOTERA COUNTY,LWANKONI,KAYANJA,KAYANJA,372,3,0,19,151,102,275,0,275,0,O-121-194-07-01-01
RAKAI,KYOTERA COUNTY,LWANKONI,KAYANJA,KYAMBOGO,114,0,0,2,45,40,87,2,89,0,O-121-194-07-01-02
RAKAI,KYOTERA COUNTY,LWANKONI,KIBUTAMO,LUSAKA,717,0,1,23,212,265,501,11,512,0,O-121-194-07-02-01
RAKAI,KYOTERA COUNTY,LWANKONI,KIBUTAMO,KIBUTAMO,721,6,0,8,274,243,531,15,546,0,O-121-194-07-02-02
RAKAI,KYOTERA COUNTY,LWANKONI,KISUNKU,KISUNKU,404,2,0,20,169,102,293,3,296,0,O-121-194-07-03-01
RAKAI,KYOTERA COUNTY,LWANKONI,KISUNKU,KAMAGGWA,301,2,0,11,155,68,236,4,240,0,O-121-194-07-03-02
RAKAI,KYOTERA COUNTY,LWANKONI,LWANKONI,LWANKONI A,455,0,1,17,149,151,318,29,347,0,O-121-194-07-04-01
RAKAI,KYOTERA COUNTY,LWANKONI,LWANKONI,LWANKONI B,456,1,1,10,130,165,307,13,320,0,O-121-194-07-04-02
RAKAI,KYOTERA COUNTY,LWANKONI,LWANKONI,MANYAMA P/S,263,0,0,20,89,110,219,5,224,0,O-121-194-07-04-03
RAKAI,KYOTERA COUNTY,LWANKONI,NABYAJJWE,NABYAJJWE,275,4,1,7,126,87,225,5,230,0,O-121-194-07-05-01
RAKAI,KYOTERA COUNTY,LWANKONI,NABYAJJWE,BBALE,719,2,1,11,299,208,521,19,540,0,O-121-194-07-05-02
RAKAI,KYOTERA COUNTY,LWANKONI,NABYAJJWE,MANYAMA,491,1,0,19,182,164,366,16,382,0,O-121-194-07-05-03
RAKAI,KYOTERA COUNTY,NABIGASA,BETHELEHEM,KIBONZI P/S,312,1,0,6,54,163,224,8,232,0,O-121-194-08-01-01
RAKAI,KYOTERA COUNTY,NABIGASA,BETHELEHEM,BETHELEHEM KISAAWE,689,1,0,8,169,199,377,76,453,0,O-121-194-08-01-02
RAKAI,KYOTERA COUNTY,NABIGASA,BETHELEHEM,LUSESE P/S,592,4,0,12,95,295,406,12,418,0,O-121-194-08-01-03
RAKAI,KYOTERA COUNTY,NABIGASA,KIJEJJA,KIJJEJA,670,4,2,9,253,217,485,13,498,0,O-121-194-08-02-01
RAKAI,KYOTERA COUNTY,NABIGASA,KYANSIMBI,KATTENJU,598,2,1,5,189,267,464,19,483,0,O-121-194-08-03-01
RAKAI,KYOTERA COUNTY,NABIGASA,KYANSIMBI,BULYANA,600,2,0,2,94,341,439,18,457,0,O-121-194-08-03-02
RAKAI,KYOTERA COUNTY,NABIGASA,NABIGASA,NABIGASA-KITAWULIZA,470,0,0,2,84,259,345,5,350,0,O-121-194-08-04-01
RAKAI,KYOTERA COUNTY,NABIGASA,NABIGASA,NABIGASA CHURCH,444,2,0,5,113,205,325,5,330,0,O-121-194-08-04-02
RAKAI,KYOTERA COUNTY,NABIGASA,NABIGASA,NALUBILA,562,3,0,2,168,255,428,15,443,0,O-121-194-08-04-03
RAKAI,KYOTERA COUNTY,NABIGASA,NABIGASA,KASAMBYA,609,1,0,10,175,219,405,17,422,0,O-121-194-08-04-04
RAKAI,KYOTERA COUNTY,NABIGASA,NAKATOOGO,NAKASOGA,425,2,0,1,126,179,308,6,314,0,O-121-194-08-05-01
RAKAI,KYOTERA COUNTY,NABIGASA,NAKATOOGO,NJERU,568,0,0,13,117,299,429,12,441,0,O-121-194-08-05-02
RAKAI,KYOTERA COUNTY,NABIGASA,NAKATOOGO,NAKATOOGO,541,3,1,5,197,161,367,11,378,0,O-121-194-08-05-03
MUBENDE,KASSANDA CTY NORTH,BUKUYA,BBIRA,BBIRA/KAWASA,661,0,1,6,37,469,513,7,520,0,O-125-167-01-01-01
MUBENDE,KASSANDA CTY NORTH,BUKUYA,BUKUYA,BUKUYA S/C HQTRS (M-Z),591,0,2,4,103,215,324,9,333,0,O-125-167-01-02-01
MUBENDE,KASSANDA CTY NORTH,BUKUYA,BUKUYA,BIWALWE/NTONYEZE,300,0,0,4,29,134,167,0,167,0,O-125-167-01-02-02
MUBENDE,KASSANDA CTY NORTH,BUKUYA,BUKUYA,KATUNGURU/BWERENGA,481,1,0,6,87,223,317,13,330,0,O-125-167-01-02-03
MUBENDE,KASSANDA CTY NORTH,BUKUYA,BUKUYA,BUKUYA S/C HQTRS ( N ),400,0,2,1,30,158,191,5,196,0,O-125-167-01-02-04
MUBENDE,KASSANDA CTY NORTH,BUKUYA,BUKUYA,BUKUYA S/C HQTRS (A-L),371,2,0,2,84,130,218,14,232,0,O-125-167-01-02-05
MUBENDE,KASSANDA CTY NORTH,BUKUYA,BULINIMULA,LUGAZI,644,0,0,3,11,288,302,37,339,0,O-125-167-01-03-01
MUBENDE,KASSANDA CTY NORTH,BUKUYA,BULINIMULA,BULINIMULA,321,0,0,1,18,243,262,3,265,0,O-125-167-01-03-02
MUBENDE,KASSANDA CTY NORTH,BUKUYA,BULYAMBIDDE,MABUUBI,279,0,0,1,41,108,150,2,152,0,O-125-167-01-04-01
MUBENDE,KASSANDA CTY NORTH,BUKUYA,BULYAMBIDDE,NAMAKONKOME,345,0,3,3,80,188,274,9,283,0,O-125-167-01-04-02
MUBENDE,KASSANDA CTY NORTH,BUKUYA,BULYAMBIDDE,NAKABISO,328,0,1,2,19,176,198,3,201,0,O-125-167-01-04-03
MUBENDE,KASSANDA CTY NORTH,BUKUYA,BUSEREGENYU,BUSEREGENYU,729,0,0,2,17,464,483,3,486,0,O-125-167-01-05-01
MUBENDE,KASSANDA CTY NORTH,BUKUYA,BUSEREGENYU,KISIITA,577,5,0,10,7,325,347,21,368,0,O-125-167-01-05-02
MUBENDE,KASSANDA CTY NORTH,BUKUYA,BUSEREGENYU,KICUCULA P/S,499,0,0,1,18,297,316,14,330,0,O-125-167-01-05-03
MUBENDE,KASSANDA CTY NORTH,BUKUYA,KABOSI,KASAMBA/KISINZA,392,1,0,4,61,196,262,13,275,0,O-125-167-01-06-01
MUBENDE,KASSANDA CTY NORTH,BUKUYA,KABOSI,KIDUKULU,301,0,3,8,20,188,219,3,222,0,O-125-167-01-06-02
MUBENDE,KASSANDA CTY NORTH,BUKUYA,KABOSI,KABOSI,396,1,0,7,77,161,246,9,255,0,O-125-167-01-06-03
MUBENDE,KASSANDA CTY NORTH,BUKUYA,KABOSI,KYAMUGUGU,421,1,0,11,74,184,270,16,286,0,O-125-167-01-06-04
MUBENDE,KASSANDA CTY NORTH,BUKUYA,KABOSI,KIJJWA/KABUGA,244,2,3,2,45,116,168,6,174,0,O-125-167-01-06-05
MUBENDE,KASSANDA CTY NORTH,BUKUYA,KALAGALA,KALAGALA,486,2,1,3,28,330,364,15,379,0,O-125-167-01-07-01
MUBENDE,KASSANDA CTY NORTH,BUKUYA,KALAGALA,KYAMULINGA TC,706,3,1,10,36,441,491,23,514,0,O-125-167-01-07-02
MUBENDE,KASSANDA CTY NORTH,BUKUYA,KALAGALA,KANDEGEYA CHURCH,585,2,0,7,16,434,459,11,470,0,O-125-167-01-07-03
MUBENDE,KASSANDA CTY NORTH,BUKUYA,KALATA,KALATA/KITEREDDE,809,1,23,11,54,342,431,20,451,0,O-125-167-01-08-01
MUBENDE,KASSANDA CTY NORTH,BUKUYA,KALATA,KIGUNDA/KAGAGABA,772,1,0,3,59,415,478,8,486,0,O-125-167-01-08-02
MUBENDE,KASSANDA CTY NORTH,BUKUYA,KALATA,SEETA,480,1,1,5,45,250,302,13,315,0,O-125-167-01-08-03
MUBENDE,KASSANDA CTY NORTH,BUKUYA,KIJJUNA,LUGINGI,672,10,2,13,29,380,434,39,473,0,O-125-167-01-09-01
MUBENDE,KASSANDA CTY NORTH,BUKUYA,KIJJUNA,DDINGO,608,2,0,5,31,393,431,42,473,0,O-125-167-01-09-02
MUBENDE,KASSANDA CTY NORTH,BUKUYA,KIJJUNA,KYAGUGU,612,4,2,11,19,404,440,22,462,0,O-125-167-01-09-03
MUBENDE,KASSANDA CTY NORTH,BUKUYA,KIJJUNA,NYONGA,355,1,0,3,22,192,218,18,236,0,O-125-167-01-09-04
MUBENDE,KASSANDA CTY NORTH,BUKUYA,KIRYAJOOBYO,KIRYAJOOBYO,268,2,2,1,9,210,224,9,233,0,O-125-167-01-10-01
MUBENDE,KASSANDA CTY NORTH,BUKUYA,KIRYAJOOBYO,KAMWALO,657,4,1,4,50,456,515,17,532,0,O-125-167-01-10-02
MUBENDE,KASSANDA CTY NORTH,BUKUYA,KITUMBI,KITUMBI,889,4,0,2,26,434,466,14,480,0,O-125-167-01-11-01
MUBENDE,KASSANDA CTY NORTH,BUKUYA,KITUMBI,KAMUSENENE,690,2,1,10,26,451,490,16,506,0,O-125-167-01-11-02
MUBENDE,KASSANDA CTY NORTH,BUKUYA,KIZIBAWO,KIZIBAWO/KASENENE,393,0,0,5,38,257,300,8,308,0,O-125-167-01-12-01
MUBENDE,KASSANDA CTY NORTH,BUKUYA,KIZIBAWO,LWAWONA/KIRYANONGO,682,5,4,4,34,451,498,16,514,0,O-125-167-01-12-02
MUBENDE,KASSANDA CTY NORTH,BUKUYA,KIZIBAWO,KALONGO/NABITTI,475,1,0,4,57,262,324,9,333,0,O-125-167-01-12-03
MUBENDE,KASSANDA CTY NORTH,BUKUYA,KYATO,BUKOBA,459,2,0,2,13,276,293,17,310,0,O-125-167-01-13-01
MUBENDE,KASSANDA CTY NORTH,BUKUYA,KYATO,BUWEJJE,402,1,1,2,15,283,302,4,306,0,O-125-167-01-13-02
MUBENDE,KASSANDA CTY NORTH,BUKUYA,MAKOKOTO,KAWOLONGOJJO/BWANJA,182,1,0,2,5,85,93,5,98,0,O-125-167-01-14-01
MUBENDE,KASSANDA CTY NORTH,BUKUYA,MAKOKOTO,MAKOKOTO/NCWAMIGGO,397,3,1,4,55,203,266,5,271,0,O-125-167-01-14-02
MUBENDE,KASSANDA CTY NORTH,BUKUYA,MAKOKOTO,KUZIMU,287,2,0,3,63,119,187,8,195,0,O-125-167-01-14-03
MUBENDE,KASSANDA CTY NORTH,BUKUYA,MBIRIZI,KIGUDDE A,658,1,0,6,20,371,398,23,421,0,O-125-167-01-15-01
MUBENDE,KASSANDA CTY NORTH,BUKUYA,MBIRIZI,KIGUDDE B,658,2,0,0,12,416,430,3,433,0,O-125-167-01-15-02
MUBENDE,KASSANDA CTY NORTH,BUKUYA,MBIRIZI,MBIRIZZI,398,4,1,7,8,237,257,14,271,0,O-125-167-01-15-03
MUBENDE,KASSANDA CTY NORTH,BUKUYA,MBIRIZI,KYALWOLERA,499,3,1,6,10,380,400,14,414,0,O-125-167-01-15-04
MUBENDE,KASSANDA CTY NORTH,BUKUYA,MBIRIZI,KISALIZI,730,0,1,6,21,496,524,19,543,0,O-125-167-01-15-05
MUBENDE,KASSANDA CTY NORTH,BUKUYA,MUNDADDE,NFUKA,610,0,0,3,29,347,379,2,381,0,O-125-167-01-16-01
MUBENDE,KASSANDA CTY NORTH,BUKUYA,MUNDADDE,KATUNGO,964,2,0,6,16,496,520,47,567,0,O-125-167-01-16-02
MUBENDE,KASSANDA CTY NORTH,BUKUYA,NAMIRYANGO,NAMIRYANGO/KASEBWEMBE,555,0,1,6,41,319,367,10,377,0,O-125-167-01-17-01
MUBENDE,KASSANDA CTY NORTH,BUKUYA,NAMIRYANGO,BUJONJO,358,4,0,5,21,201,231,28,259,0,O-125-167-01-17-02
MUBENDE,KASSANDA CTY NORTH,BUKUYA,NAMIRYANGO,KIJWANGANYA,546,3,0,1,14,280,298,46,344,0,O-125-167-01-17-03
MUBENDE,KASSANDA CTY NORTH,BUKUYA,NCWAMAZI,NCWAMAZZI,226,2,0,1,20,128,151,4,155,0,O-125-167-01-18-01
MUBENDE,KASSANDA CTY NORTH,BUKUYA,NCWAMAZI,KIMBEJJA,225,0,1,2,19,148,170,5,175,0,O-125-167-01-18-02
MUBENDE,KASSANDA CTY NORTH,BUKUYA,NCWAMAZI,KABUYIMBA,488,1,1,9,22,285,318,12,330,0,O-125-167-01-18-03
MUBENDE,KASSANDA CTY NORTH,BUKUYA,NCWAMAZI,KAMONDO,317,0,0,2,21,162,185,4,189,0,O-125-167-01-18-04
MUBENDE,KASSANDA CTY NORTH,KASSANDA,BWEYONGEDDE,BWEYONGEDDE,564,2,2,11,30,334,379,8,387,0,O-125-167-02-01-01
MUBENDE,KASSANDA CTY NORTH,KASSANDA,BWEYONGEDDE,MAYIRIKITI,821,7,5,9,50,415,486,48,534,0,O-125-167-02-01-02
MUBENDE,KASSANDA CTY NORTH,KASSANDA,BWEYONGEDDE,KIKUBE,651,1,1,7,25,410,444,17,461,0,O-125-167-02-01-03
MUBENDE,KASSANDA CTY NORTH,KASSANDA,BWEYONGEDDE,BULAGANO,268,2,3,7,6,167,185,7,192,0,O-125-167-02-01-04
MUBENDE,KASSANDA CTY NORTH,KASSANDA,BWEYONGEDDE,KABULAMULIRO,205,0,0,1,14,129,144,15,159,0,O-125-167-02-01-05
MUBENDE,KASSANDA CTY NORTH,KASSANDA,BWEYONGEDDE,KALAGALA,312,1,0,5,20,198,224,5,229,0,O-125-167-02-01-06
MUBENDE,KASSANDA CTY NORTH,KASSANDA,KAMULI,KYOGA,534,2,2,6,44,363,417,10,427,0,O-125-167-02-02-01
MUBENDE,KASSANDA CTY NORTH,KASSANDA,KAMULI,MANYOGASEKA,541,3,0,3,43,329,378,11,389,0,O-125-167-02-02-02
MUBENDE,KASSANDA CTY NORTH,KASSANDA,KAMULI,KAMULI,510,1,0,4,31,320,356,16,372,0,O-125-167-02-02-03
MUBENDE,KASSANDA CTY NORTH,KASSANDA,KAMULI,LUSOLO,351,0,0,3,25,217,245,2,247,0,O-125-167-02-02-04
MUBENDE,KASSANDA CTY NORTH,KASSANDA,KAMULI,MALABIGAMBO,244,0,0,0,6,157,163,5,168,0,O-125-167-02-02-05
MUBENDE,KASSANDA CTY NORTH,KASSANDA,KAMULI,NSOLOLO,177,1,0,0,16,126,143,1,144,0,O-125-167-02-02-06
MUBENDE,KASSANDA CTY NORTH,KASSANDA,KASAAZI,KABULUBUTU,542,2,1,4,48,375,430,4,434,0,O-125-167-02-03-01
MUBENDE,KASSANDA CTY NORTH,KASSANDA,KASAAZI,LWANGIRI,534,1,2,5,35,372,415,5,420,0,O-125-167-02-03-02
MUBENDE,KASSANDA CTY NORTH,KASSANDA,KASAAZI,KALWANA,509,0,0,4,60,311,375,17,392,0,O-125-167-02-03-03
MUBENDE,KASSANDA CTY NORTH,KASSANDA,KASAAZI,NAKATEETE,515,1,1,2,38,320,362,7,369,0,O-125-167-02-03-04
MUBENDE,KASSANDA CTY NORTH,KASSANDA,KASAAZI,KIRUSU,381,1,0,1,55,228,285,11,296,0,O-125-167-02-03-05
MUBENDE,KASSANDA CTY NORTH,KASSANDA,KASAAZI,KYANAMUNUNGU,394,0,1,1,44,276,322,0,322,0,O-125-167-02-03-06
MUBENDE,KASSANDA CTY NORTH,KASSANDA,KASAMBYA,LUSABA,340,3,0,6,34,221,264,4,268,0,O-125-167-02-04-01
MUBENDE,KASSANDA CTY NORTH,KASSANDA,KASAMBYA,NAMATUBA,142,1,0,2,3,93,99,5,104,0,O-125-167-02-04-02
MUBENDE,KASSANDA CTY NORTH,KASSANDA,KASAMBYA,KASAMBYA,475,2,0,11,46,319,378,5,383,0,O-125-167-02-04-03
MUBENDE,KASSANDA CTY NORTH,KASSANDA,KIKANDWA,KIKANDWA VILLAGE,342,2,0,4,33,210,249,9,258,0,O-125-167-02-05-01
MUBENDE,KASSANDA CTY NORTH,KASSANDA,KIKANDWA,KASENSERO,112,0,0,1,6,88,95,0,95,0,O-125-167-02-05-02
MUBENDE,KASSANDA CTY NORTH,KASSANDA,KIKANDWA,KIKANDWA TOWN,510,1,3,3,62,301,370,11,381,0,O-125-167-02-05-03
MUBENDE,KASSANDA CTY NORTH,KASSANDA,KIKANDWA,KITEREDDE,263,0,2,4,21,177,204,6,210,0,O-125-167-02-05-04
MUBENDE,KASSANDA CTY NORTH,KASSANDA,KIKANDWA,KITONGO,507,0,0,2,53,350,405,6,411,0,O-125-167-02-05-05
MUBENDE,KASSANDA CTY NORTH,KASSANDA,KIKANDWA,DDALAMBA,694,3,5,11,60,417,496,35,531,0,O-125-167-02-05-06
MUBENDE,KASSANDA CTY NORTH,KASSANDA,KITONGO,SSERUNYONYI,255,0,1,4,15,155,175,3,178,0,O-125-167-02-06-01
MUBENDE,KASSANDA CTY NORTH,KASSANDA,KITONGO,MIREMBE,716,4,6,73,46,411,540,9,549,0,O-125-167-02-06-02
MUBENDE,KASSANDA CTY NORTH,KASSANDA,KITONGO,KASANDA S/C HQTRS (A-M),301,0,2,4,55,221,282,5,287,0,O-125-167-02-06-03
MUBENDE,KASSANDA CTY NORTH,KASSANDA,KITONGO,DWALIRO (A-M),447,1,2,6,69,214,292,0,292,0,O-125-167-02-06-04
MUBENDE,KASSANDA CTY NORTH,KASSANDA,KITONGO,MAKONZI,225,1,0,10,19,124,154,12,166,0,O-125-167-02-06-05
MUBENDE,KASSANDA CTY NORTH,KASSANDA,KITONGO,KAWAAWA,119,0,1,1,6,86,94,1,95,0,O-125-167-02-06-06
MUBENDE,KASSANDA CTY NORTH,KASSANDA,KITONGO,KASANDA S/C HQTRS (N-Z),434,0,1,3,17,274,295,6,301,0,O-125-167-02-06-07
MUBENDE,KASSANDA CTY NORTH,KASSANDA,KITONGO,DWALIRO ( N ),565,1,1,11,29,337,379,5,384,0,O-125-167-02-06-08
MUBENDE,KASSANDA CTY NORTH,KASSANDA,KITONGO,DWALIRO (O-Z),406,1,0,10,66,185,262,12,274,0,O-125-167-02-06-09
MUBENDE,KASSANDA CTY NORTH,KASSANDA,KYABALANZI,KYABALANZI,579,1,0,3,31,380,415,14,429,0,O-125-167-02-07-01
MUBENDE,KASSANDA CTY NORTH,KASSANDA,KYABALANZI,LWABAZA,625,3,1,8,49,339,400,17,417,0,O-125-167-02-07-02
MUBENDE,KASSANDA CTY NORTH,KASSANDA,KYABALANZI,KYABAKULUNGO,309,1,0,3,4,210,218,17,235,0,O-125-167-02-07-03
MUBENDE,KASSANDA CTY NORTH,KASSANDA,KYABALANZI,KABUGA,247,0,0,2,12,166,180,8,188,0,O-125-167-02-07-04
MUBENDE,KASSANDA CTY NORTH,KASSANDA,KYABALANZI,KACWI TOWN,213,0,0,8,6,148,162,17,179,0,O-125-167-02-07-05
MUBENDE,KASSANDA CTY NORTH,KASSANDA,KYANIKA,KYANIKA P/S,274,0,0,1,20,186,207,6,213,0,O-125-167-02-08-01
MUBENDE,KASSANDA CTY NORTH,KASSANDA,KYANIKA,NAMASWANTA,492,7,1,8,60,275,351,13,364,0,O-125-167-02-08-02
MUBENDE,KASSANDA CTY NORTH,KASSANDA,KYANIKA,KALAMA,304,0,1,0,20,213,234,0,234,0,O-125-167-02-08-03
MUBENDE,KASSANDA CTY NORTH,KASSANDA,MAGWA,BUSWA,713,0,0,16,76,443,535,17,552,0,O-125-167-02-09-01
MUBENDE,KASSANDA CTY NORTH,KASSANDA,MAGWA,JUMA,216,2,1,0,9,153,165,1,166,0,O-125-167-02-09-02
MUBENDE,KASSANDA CTY NORTH,KASSANDA,NABUGONDO,BINIKIRA CENTRAL,738,2,1,3,49,513,568,6,574,0,O-125-167-02-10-01
MUBENDE,KASSANDA CTY NORTH,KASSANDA,NABUGONDO,LUSAANA-KIRAMBULA,295,0,0,4,12,221,237,3,240,0,O-125-167-02-10-02
MUBENDE,KASSANDA CTY NORTH,KASSANDA,NABUGONDO,KYERIMA,639,2,0,9,41,446,498,5,503,0,O-125-167-02-10-03
MUBENDE,KASSANDA CTY NORTH,KASSANDA,NAMABAALE,NAMABAALE,912,4,3,10,98,496,611,8,619,0,O-125-167-02-11-01
MUBENDE,KASSANDA CTY NORTH,KASSANDA,NAMABAALE,LUKOKO,470,2,1,4,24,319,350,13,363,0,O-125-167-02-11-02
MUBENDE,KASSANDA CTY NORTH,KASSANDA,NAMABAALE,KAMULI,751,1,1,12,49,469,532,22,554,0,O-125-167-02-11-03
MUBENDE,KASSANDA CTY NORTH,KASSANDA,NAMIRINGA (LWANTA,JEMBA,828,1,0,5,58,526,590,15,605,0,O-125-167-02-12-01
MUBENDE,KASSANDA CTY NORTH,KASSANDA,NAMIRINGA (LWANTA,LWANTALE,748,0,2,8,47,536,593,7,600,0,O-125-167-02-12-02
MUBENDE,KASSANDA CTY NORTH,KASSANDA,NAMIRINGA (LWANTA,MIJUNWA,265,0,0,1,19,180,200,7,207,0,O-125-167-02-12-03
MUBENDE,KASSANDA CTY NORTH,KASSANDA,NAMIRINGA (LWANTA,KITULEGE,153,0,0,1,11,124,136,4,140,0,O-125-167-02-12-04
MUBENDE,KASSANDA CTY NORTH,KASSANDA,NAMIRINGA (LWANTA,NAMULA,738,3,1,6,42,454,506,3,509,0,O-125-167-02-12-05
MUBENDE,KASSANDA CTY SOUTH,KIGANDA,KAMUSENENE,KAMUSENENE,566,2,0,5,72,311,390,18,408,0,O-125-168-01-01-01
MUBENDE,KASSANDA CTY SOUTH,KIGANDA,KAMUSENENE,KATAYIZA/KILEWE,507,1,0,0,44,222,267,82,349,0,O-125-168-01-01-02
MUBENDE,KASSANDA CTY SOUTH,KIGANDA,KAMUSENENE,KYASAMPAWO,275,0,0,2,12,172,186,5,191,0,O-125-168-01-01-03
MUBENDE,KASSANDA CTY SOUTH,KIGANDA,KAMUSENENE,KALUNGI/NABIJWENGE,510,0,0,3,28,339,370,3,373,0,O-125-168-01-01-04
MUBENDE,KASSANDA CTY SOUTH,KIGANDA,KAMUSENENE,BULYANKUYEGE,475,4,0,2,47,289,342,4,346,0,O-125-168-01-01-05
MUBENDE,KASSANDA CTY SOUTH,KIGANDA,KAWUNGERA,KAWUNGERA,811,5,2,2,117,318,444,62,506,0,O-125-168-01-02-01
MUBENDE,KASSANDA CTY SOUTH,KIGANDA,KAWUNGERA,KYAMUSOTA,629,0,1,13,71,308,393,44,437,0,O-125-168-01-02-02
MUBENDE,KASSANDA CTY SOUTH,KIGANDA,KAWUNGERA,NAKABIMBA,279,1,0,2,48,163,214,12,226,0,O-125-168-01-02-03
MUBENDE,KASSANDA CTY SOUTH,KIGANDA,KAYUNGA,KAYUNGA,521,3,1,4,63,223,294,58,352,0,O-125-168-01-03-01
MUBENDE,KASSANDA CTY SOUTH,KIGANDA,KAYUNGA,KIRYANNONGO,551,1,0,0,62,261,324,66,390,0,O-125-168-01-03-02
MUBENDE,KASSANDA CTY SOUTH,KIGANDA,KAYUNGA,KALAMBA,612,0,0,4,82,261,347,5,352,0,O-125-168-01-03-03
MUBENDE,KASSANDA CTY SOUTH,KIGANDA,KAYUNGA,KITAAMA,139,0,0,0,9,83,92,8,100,0,O-125-168-01-03-04
MUBENDE,KASSANDA CTY SOUTH,KIGANDA,KAYUNGA,KINYERERA,228,0,0,2,29,130,161,4,165,0,O-125-168-01-03-05
MUBENDE,KASSANDA CTY SOUTH,KIGANDA,KIGALAMA,KIGALAMA/GAYAZA,441,0,0,3,73,232,308,7,315,0,O-125-168-01-04-01
MUBENDE,KASSANDA CTY SOUTH,KIGANDA,KIGALAMA,KISIGULA/LWAMAGEMBE,434,0,0,6,55,214,275,15,290,0,O-125-168-01-04-02
MUBENDE,KASSANDA CTY SOUTH,KIGANDA,KIGALAMA,KIMBEJJA,96,0,0,0,16,51,67,5,72,0,O-125-168-01-04-03
MUBENDE,KASSANDA CTY SOUTH,KIGANDA,KIGALAMA,KALAGI,468,0,1,0,42,257,300,54,354,0,O-125-168-01-04-04
MUBENDE,KASSANDA CTY SOUTH,KIGANDA,KINONI,KINONI/KIBUULU,571,0,1,1,81,305,388,7,395,0,O-125-168-01-05-01
MUBENDE,KASSANDA CTY SOUTH,KIGANDA,KINONI,KASAWO/NANSIMBI,679,2,1,2,122,301,428,9,437,0,O-125-168-01-05-02
MUBENDE,KASSANDA CTY SOUTH,KIGANDA,KINONI,KASAMBYA/KISOLOZA,523,0,0,2,69,195,266,96,362,0,O-125-168-01-05-03
MUBENDE,KASSANDA CTY SOUTH,KIGANDA,KYOJJOMANYI,KYOJOMANYI,444,1,0,1,31,269,302,17,319,0,O-125-168-01-06-01
MUBENDE,KASSANDA CTY SOUTH,KIGANDA,KYOJJOMANYI,KABUNYONYI,658,6,0,3,42,347,398,39,437,0,O-125-168-01-06-02
MUBENDE,KASSANDA CTY SOUTH,KIGANDA,KYOJJOMANYI,KASEBWEMBE,336,0,0,1,53,180,234,5,239,0,O-125-168-01-06-03
MUBENDE,KASSANDA CTY SOUTH,KIGANDA,KYOJJOMANYI,NAKIDUDUMA,250,0,0,3,51,120,174,3,177,0,O-125-168-01-06-04
MUBENDE,KASSANDA CTY SOUTH,KIGANDA,LUTUNKU,LUTUNKU,249,1,1,1,23,136,162,9,171,0,O-125-168-01-07-01
MUBENDE,KASSANDA CTY SOUTH,KIGANDA,LUTUNKU,KYABAYIMA,868,1,1,3,51,525,581,10,591,0,O-125-168-01-07-02
MUBENDE,KASSANDA CTY SOUTH,KIGANDA,LUTUNKU,KYASANSUWA/KAWAWA,388,0,0,0,34,253,287,17,304,0,O-125-168-01-07-03
MUBENDE,KASSANDA CTY SOUTH,KIGANDA,LUTUNKU,KYAYI,206,0,0,3,4,139,146,4,150,0,O-125-168-01-07-04
MUBENDE,KASSANDA CTY SOUTH,KIGANDA,LUTUNKU,BUNAKABWA,328,0,0,2,30,182,214,8,222,0,O-125-168-01-07-05
MUBENDE,KASSANDA CTY SOUTH,KIGANDA,MANYOGASEKA,BUZAWULA,604,3,1,6,39,328,377,8,385,0,O-125-168-01-08-01
MUBENDE,KASSANDA CTY SOUTH,KIGANDA,MANYOGASEKA,MANYOGASEKA,459,1,0,2,49,230,282,54,336,0,O-125-168-01-08-02
MUBENDE,KASSANDA CTY SOUTH,KIGANDA,MANYOGASEKA,NYALIRO/KAFUNDA,580,1,0,2,29,368,400,8,408,0,O-125-168-01-08-03
MUBENDE,KASSANDA CTY SOUTH,KIGANDA,NSOZINGA,NSOZINGA/KYAMWERO,756,1,0,3,118,372,494,29,523,0,O-125-168-01-09-01
MUBENDE,KASSANDA CTY SOUTH,KIGANDA,NSOZINGA,KITOVU/LWABUSAANA,502,2,0,7,33,345,387,14,401,0,O-125-168-01-09-02
MUBENDE,KASSANDA CTY SOUTH,KIGANDA,NSOZINGA,KYAKAYANJA,330,1,1,4,59,167,232,11,243,0,O-125-168-01-09-03
MUBENDE,KASSANDA CTY SOUTH,MYANZI,GAMBWA,KITALEGERWA,509,1,1,5,67,281,355,4,359,0,O-125-168-02-01-01
MUBENDE,KASSANDA CTY SOUTH,MYANZI,GAMBWA,KITONYA,647,1,1,0,84,299,385,11,396,0,O-125-168-02-01-02
MUBENDE,KASSANDA CTY SOUTH,MYANZI,GAMBWA,BUJERE,444,1,0,4,24,255,284,10,294,0,O-125-168-02-01-03
MUBENDE,KASSANDA CTY SOUTH,MYANZI,GAMBWA,NAMASENGERE,300,0,0,1,27,139,167,9,176,0,O-125-168-02-01-04
MUBENDE,KASSANDA CTY SOUTH,MYANZI,GAMBWA,GAMBWA,584,1,0,5,44,312,362,3,365,0,O-125-168-02-01-05
MUBENDE,KASSANDA CTY SOUTH,MYANZI,KAMPIRI,KAMBOJJA/NSUMBA,728,4,0,6,73,430,513,33,546,0,O-125-168-02-02-01
MUBENDE,KASSANDA CTY SOUTH,MYANZI,KAMPIRI,BULYAMAGUNJU,372,2,0,4,29,221,256,9,265,0,O-125-168-02-02-02
MUBENDE,KASSANDA CTY SOUTH,MYANZI,KAMPIRI,KAMPIRI PRIMARY SCHOOL,694,3,1,2,70,409,485,22,507,0,O-125-168-02-02-03
MUBENDE,KASSANDA CTY SOUTH,MYANZI,KASAANA,BINAKOTA,207,2,1,3,14,124,144,2,146,0,O-125-168-02-03-01
MUBENDE,KASSANDA CTY SOUTH,MYANZI,KASAANA,LUKOMA,540,2,2,2,41,303,350,13,363,0,O-125-168-02-03-02
MUBENDE,KASSANDA CTY SOUTH,MYANZI,KASAANA,MUSABA I,541,2,2,5,48,266,323,6,329,0,O-125-168-02-03-03
MUBENDE,KASSANDA CTY SOUTH,MYANZI,KASAANA,MUSABA II,369,2,0,5,30,165,202,10,212,0,O-125-168-02-03-04
MUBENDE,KASSANDA CTY SOUTH,MYANZI,KIGALAMA,KIGALAMA,622,4,3,14,114,259,394,17,411,0,O-125-168-02-04-01
MUBENDE,KASSANDA CTY SOUTH,MYANZI,KIGALAMA,KYENGEZA,494,4,2,10,82,198,296,12,308,0,O-125-168-02-04-02
MUBENDE,KASSANDA CTY SOUTH,MYANZI,KIGALAMA,KIDUUKULU,482,0,2,12,95,234,343,13,356,0,O-125-168-02-04-03
MUBENDE,KASSANDA CTY SOUTH,MYANZI,KYAKATEBE,KYAKATEBE/KANYOGOGA,558,1,0,7,50,289,347,18,365,0,O-125-168-02-05-01
MUBENDE,KASSANDA CTY SOUTH,MYANZI,KYAKATEBE,NAMUGANGA,633,1,0,6,64,286,357,11,368,0,O-125-168-02-05-02
MUBENDE,KASSANDA CTY SOUTH,MYANZI,KYAKATEBE,MIREMBE/NKOKOMA,350,0,0,5,30,191,226,8,234,0,O-125-168-02-05-03
MUBENDE,KASSANDA CTY SOUTH,MYANZI,KYAKATEBE,KYETINDA,518,2,0,0,19,309,330,5,335,0,O-125-168-02-05-04
MUBENDE,KASSANDA CTY SOUTH,MYANZI,KYAKATEBE,KISOZI,318,1,0,2,22,168,193,7,200,0,O-125-168-02-05-05
MUBENDE,KASSANDA CTY SOUTH,MYANZI,KYANAMUGERA,KATUUGO A-  KIBONWA,315,0,0,2,51,155,208,11,219,0,O-125-168-02-06-01
MUBENDE,KASSANDA CTY SOUTH,MYANZI,KYANAMUGERA,KAKUNGURE,560,2,0,6,109,218,335,51,386,0,O-125-168-02-06-02
MUBENDE,KASSANDA CTY SOUTH,MYANZI,KYANAMUGERA,KISAANA,196,0,0,1,25,75,101,14,115,0,O-125-168-02-06-03
MUBENDE,KASSANDA CTY SOUTH,MYANZI,KYANAMUGERA,KYANAMUGERA,834,2,0,6,111,396,515,28,543,0,O-125-168-02-06-04
MUBENDE,KASSANDA CTY SOUTH,MYANZI,KYANAMUGERA,KIBONWA,269,0,0,0,11,158,169,16,185,0,O-125-168-02-06-05
MUBENDE,KASSANDA CTY SOUTH,MYANZI,MYANZI,LUBUMBA PR. SCHOOL,578,3,1,6,65,309,384,9,393,0,O-125-168-02-07-01
MUBENDE,KASSANDA CTY SOUTH,MYANZI,MYANZI,LUSWA,315,2,1,10,67,132,212,6,218,0,O-125-168-02-07-02
MUBENDE,KASSANDA CTY SOUTH,MYANZI,MYANZI,MYANZI,628,1,0,8,89,260,358,12,370,0,O-125-168-02-07-03
MUBENDE,KASSANDA CTY SOUTH,MYANZI,MYANZI,BAGWE ISLAND,83,0,0,0,5,46,51,1,52,0,O-125-168-02-07-04
MUBENDE,KASSANDA CTY SOUTH,MYANZI,MYANZI,BUGOLO,139,0,0,0,7,65,72,2,74,0,O-125-168-02-07-05
MUBENDE,KASSANDA CTY SOUTH,MYANZI,MYANZI,KISWERE,325,0,1,2,51,152,206,6,212,0,O-125-168-02-07-06
MUBENDE,KASSANDA CTY SOUTH,MYANZI,NALUTUNTU,KYAKAYONGO,828,5,4,6,120,413,548,7,555,0,O-125-168-02-08-01
MUBENDE,KASSANDA CTY SOUTH,MYANZI,NALUTUNTU,KYAKATEBE A,518,3,0,6,103,202,314,6,320,0,O-125-168-02-08-02
MUBENDE,KASSANDA CTY SOUTH,MYANZI,NALUTUNTU,KIWUMULO B,891,5,4,18,82,426,535,21,556,0,O-125-168-02-08-03
MUBENDE,KASSANDA CTY SOUTH,MYANZI,NALUTUNTU,WAMALA RAILWAY STATION,653,0,2,12,112,220,346,14,360,0,O-125-168-02-08-04
MUBENDE,KASSANDA CTY SOUTH,MYANZI,NALUTUNTU,KYAKASENGULA/KAKINDU,416,0,0,2,47,196,245,15,260,0,O-125-168-02-08-05
BUNDIBUGYO,BUGHENDERA COUNTY,HARUGALI,BUHUNDU,BIMARA,555,3,5,9,171,151,339,9,348,0,O-3-215-01-01-01
BUNDIBUGYO,BUGHENDERA COUNTY,HARUGALI,BUHUNDU,BUHUNDU PR. SCHOOL,634,6,2,4,136,223,371,33,404,0,O-3-215-01-01-02
BUNDIBUGYO,BUGHENDERA COUNTY,HARUGALI,BUHUNDU,KARURUMA MARKET P,200,2,1,1,42,59,105,1,106,0,O-3-215-01-01-03
BUNDIBUGYO,BUGHENDERA COUNTY,HARUGALI,BUHUNDU,IGHOMERA PRI.SCH.,334,4,1,9,134,87,235,10,245,0,O-3-215-01-01-04
BUNDIBUGYO,BUGHENDERA COUNTY,HARUGALI,BUKANGAMA,BUKANGAMA CATH. CHURCH,754,4,0,7,158,222,391,6,397,0,O-3-215-01-02-01
BUNDIBUGYO,BUGHENDERA COUNTY,HARUGALI,BUKANGAMA,KYAMUKUBE,480,2,1,7,47,184,241,15,256,0,O-3-215-01-02-02
BUNDIBUGYO,BUGHENDERA COUNTY,HARUGALI,BUKANGAMA,IRAMBURA PRI.SCH.,308,1,1,1,161,49,213,5,218,0,O-3-215-01-02-03
BUNDIBUGYO,BUGHENDERA COUNTY,HARUGALI,BUPOMBOLI,HARUGALI S/C HQRS,837,14,7,13,242,262,538,8,546,0,O-3-215-01-03-01
BUNDIBUGYO,BUGHENDERA COUNTY,HARUGALI,BUPOMBOLI,KARANGITSIO II,207,1,0,3,57,75,136,9,145,0,O-3-215-01-03-02
BUNDIBUGYO,BUGHENDERA COUNTY,HARUGALI,BUSAMBA,BUGUHA S. D. A. - CHURCH,634,9,3,7,204,200,423,8,431,0,O-3-215-01-04-01
BUNDIBUGYO,BUGHENDERA COUNTY,HARUGALI,BUSAMBA,BUKANGAMA PR. SCHOOL,562,11,2,5,185,117,320,5,325,0,O-3-215-01-04-02
BUNDIBUGYO,BUGHENDERA COUNTY,HARUGALI,KASULENGE,KIRINDI MARKET,884,13,8,14,324,202,561,25,586,0,O-3-215-01-05-01
BUNDIBUGYO,BUGHENDERA COUNTY,HARUGALI,KASULENGE,KASULENGE PARISH HQRS,322,2,1,3,111,68,185,9,194,0,O-3-215-01-05-02
BUNDIBUGYO,BUGHENDERA COUNTY,HARUGALI,NGITE,BUKWALE,277,6,0,2,82,112,202,4,206,0,O-3-215-01-06-01
BUNDIBUGYO,BUGHENDERA COUNTY,HARUGALI,NGITE,NGITE CLINIC,552,12,8,8,176,167,371,17,388,0,O-3-215-01-06-02
BUNDIBUGYO,BUGHENDERA COUNTY,KASITU,BUGANDO,KIRIMYA TRADING CENTRE,631,8,3,9,62,422,504,17,521,0,O-3-215-02-01-01
BUNDIBUGYO,BUGHENDERA COUNTY,KASITU,BUGANDO,KABUGA,676,5,7,15,20,426,473,51,524,0,O-3-215-02-01-02
BUNDIBUGYO,BUGHENDERA COUNTY,KASITU,BURONDO,KABANGO PR. SCHOOL,674,8,3,9,235,185,440,13,453,0,O-3-215-02-02-01
BUNDIBUGYO,BUGHENDERA COUNTY,KASITU,BURONDO,NTANDI MARKET P.S,594,6,2,3,70,199,280,22,302,0,O-3-215-02-02-02
BUNDIBUGYO,BUGHENDERA COUNTY,KASITU,BURONDO,NTANDI TRADING CENTRE,827,10,3,6,152,254,425,19,444,0,O-3-215-02-02-03
BUNDIBUGYO,BUGHENDERA COUNTY,KASITU,BURONDO,BURONDO PR. SCHOOL 'A',464,4,2,7,48,285,346,9,355,0,O-3-215-02-02-04
BUNDIBUGYO,BUGHENDERA COUNTY,KASITU,BURONDO,BURONDO PR. SCHOOL 'B',248,1,3,2,52,122,180,4,184,0,O-3-215-02-02-05
BUNDIBUGYO,BUGHENDERA COUNTY,KASITU,KASITU,NTANDI PR. SCHOOL 'A',853,11,0,16,289,202,518,15,533,0,O-3-215-02-03-01
BUNDIBUGYO,BUGHENDERA COUNTY,KASITU,KASITU,NTANDI SDA CHURCH,553,10,1,7,241,33,292,17,309,0,O-3-215-02-03-02
BUNDIBUGYO,BUGHENDERA COUNTY,KASITU,KIKYO,KIKYO TRADING CENTRE,828,9,1,13,235,262,520,8,528,0,O-3-215-02-04-01
BUNDIBUGYO,BUGHENDERA COUNTY,KASITU,KIKYO,KIKYO PRIMARY SCHOOL,729,7,3,17,230,132,389,17,406,0,O-3-215-02-04-02
BUNDIBUGYO,BUGHENDERA COUNTY,KASITU,KIKYO,KALEMEREME P.SCHOOL,343,2,0,7,94,64,167,10,177,0,O-3-215-02-04-03
BUNDIBUGYO,BUGHENDERA COUNTY,KASITU,MALOMBA,KABANGO PR. SCHOOL B,141,1,2,3,68,33,107,8,115,0,O-3-215-02-05-01
BUNDIBUGYO,BUGHENDERA COUNTY,KASITU,MALOMBA,KABANGO PR. SCHOOL A,335,5,2,7,124,98,236,16,252,0,O-3-215-02-05-02
BUNDIBUGYO,BUGHENDERA COUNTY,KASITU,MUBARE,MABERE,37,2,0,0,25,1,28,1,29,0,O-3-215-02-06-01
BUNDIBUGYO,BUGHENDERA COUNTY,KASITU,MUBARE,NTANDI SDA CHURCH,268,4,0,3,122,34,163,5,168,0,O-3-215-02-06-02
BUNDIBUGYO,BUGHENDERA COUNTY,KASITU,MUBARE,NYABUGESERA,716,13,1,12,273,70,369,21,390,0,O-3-215-02-06-03
BUNDIBUGYO,BUGHENDERA COUNTY,KASITU,NGAMBA,KIRUMYA II,615,17,3,27,40,323,410,32,442,0,O-3-215-02-07-01
BUNDIBUGYO,BUGHENDERA COUNTY,KASITU,NGAMBA,BUYAYA MOSQUE,626,9,4,12,99,352,476,33,509,0,O-3-215-02-07-02
BUNDIBUGYO,BUGHENDERA COUNTY,KASITU,NTOTORO,MANTOROBA PR. SCHOOL,917,13,8,8,54,535,618,28,646,0,O-3-215-02-08-01
BUNDIBUGYO,BUGHENDERA COUNTY,KASITU,NTOTORO,MANTOROBA C.O.U,448,14,2,11,16,270,313,18,331,0,O-3-215-02-08-02
BUNDIBUGYO,BUGHENDERA COUNTY,KASITU,NTOTORO,BUNDIMWALI II,192,0,0,2,16,109,127,6,133,0,O-3-215-02-08-03
BUNDIBUGYO,BUGHENDERA COUNTY,NDUGUTO,BUNYAMWERA,MUTITI P/S,503,9,0,9,164,231,413,11,424,0,O-3-215-03-01-01
BUNDIBUGYO,BUGHENDERA COUNTY,NDUGUTO,BUNYANGULE,BUNYANGULE P. SCHOOL,780,9,6,8,67,415,505,38,543,0,O-3-215-03-02-01
BUNDIBUGYO,BUGHENDERA COUNTY,NDUGUTO,BUNYANGULE,BUNYANGULE TRADING CENTRE,693,7,3,6,56,368,440,24,464,0,O-3-215-03-02-02
BUNDIBUGYO,BUGHENDERA COUNTY,NDUGUTO,BUNYANGULE,NYANKONDA PRI. SCH.,246,3,1,1,10,161,176,6,182,0,O-3-215-03-02-03
BUNDIBUGYO,BUGHENDERA COUNTY,NDUGUTO,BUTAMA,NDUGUTO S/C HQRS,765,23,5,23,250,211,512,34,546,0,O-3-215-03-03-01
BUNDIBUGYO,BUGHENDERA COUNTY,NDUGUTO,BUTAMA,BUTAMA TRADING CENTRE,327,3,0,3,84,55,145,15,160,0,O-3-215-03-03-02
BUNDIBUGYO,BUGHENDERA COUNTY,NDUGUTO,BUTAMA,BUTAMA OUTSIDE Q.GUARD(A-L),443,0,2,1,44,347,394,9,403,0,O-3-215-03-03-03
BUNDIBUGYO,BUGHENDERA COUNTY,NDUGUTO,BUTAMA,BUTAMA OUTSIDE Q.GUARD(M-z),453,1,3,1,47,363,415,15,430,0,O-3-215-03-03-04
BUNDIBUGYO,BUGHENDERA COUNTY,NDUGUTO,KAKUKA,KAKUKA TRADING CENTRE,613,12,3,8,95,242,360,31,391,0,O-3-215-03-04-01
BUNDIBUGYO,BUGHENDERA COUNTY,NDUGUTO,KAKUKA,MUTITI PR. SCHOOL,475,6,0,8,74,215,303,10,313,0,O-3-215-03-04-02
BUNDIBUGYO,BUGHENDERA COUNTY,NDUGUTO,KAKUKA,BUSANZA PR. SCHOOL,268,15,0,4,31,157,207,3,210,0,O-3-215-03-04-03
BUNDIBUGYO,BUGHENDERA COUNTY,NDUGUTO,KAKUKA,KAKUKA OUTSIDE Q.GUARD,528,1,0,1,31,491,524,3,527,0,O-3-215-03-04-04
BUNDIBUGYO,BUGHENDERA COUNTY,NDUGUTO,KASANZI,GALILAYA C. O. U.,312,10,3,13,172,81,279,10,289,0,O-3-215-03-05-01
BUNDIBUGYO,BUGHENDERA COUNTY,NDUGUTO,KASANZI,KISONKO PR. SCHOOL,641,4,4,7,166,292,473,3,476,0,O-3-215-03-05-02
BUNDIBUGYO,BUGHENDERA COUNTY,NDUGUTO,MUTUNDA,MUTUNDA I,657,13,3,6,44,372,438,22,460,0,O-3-215-03-06-01
BUNDIBUGYO,BUGHENDERA COUNTY,NDUGUTO,MUTUNDA,MUTUNDA II,697,22,5,12,57,372,468,38,506,0,O-3-215-03-06-02
BUNDIBUGYO,BUGHENDERA COUNTY,NDUGUTO,MUTUNDA,MUTUNDA PARISH HQRS.,200,3,0,2,4,122,131,9,140,0,O-3-215-03-06-03
BUNDIBUGYO,BWAMBA COUNTY,BUBANDI,BUNDIKAHUNGU,BUNDIKAHUNGU P. S. 'A',634,7,4,8,25,370,414,39,453,0,O-3-14-01-01-01
BUNDIBUGYO,BWAMBA COUNTY,BUBANDI,BUNDIKAHUNGU,BUSU,519,13,3,11,11,312,350,28,378,0,O-3-14-01-01-02
BUNDIBUGYO,BWAMBA COUNTY,BUBANDI,BUNDIKAHUNGU,BUNDIKAHUNGU P. S. 'B',534,3,1,6,26,354,390,11,401,0,O-3-14-01-01-03
BUNDIBUGYO,BWAMBA COUNTY,BUBANDI,BUNDIKUYALI,BHAMBA,625,8,4,8,10,481,511,22,533,0,O-3-14-01-02-01
BUNDIBUGYO,BWAMBA COUNTY,BUBANDI,BUNDIKUYALI,BUNDIKUYALI I,671,10,1,6,8,504,529,7,536,0,O-3-14-01-02-02
BUNDIBUGYO,BWAMBA COUNTY,BUBANDI,BUNDINGOMA,BUNDINGOMA PARISH HQS,395,6,2,5,6,270,289,12,301,0,O-3-14-01-03-01
BUNDIBUGYO,BWAMBA COUNTY,BUBANDI,BUNDINGOMA,BUNDINGOMA P. SCHOOL,813,10,5,15,15,523,568,26,594,0,O-3-14-01-03-02
BUNDIBUGYO,BWAMBA COUNTY,BUBANDI,BUNDINGOMA,BUSU PR. SCHOOL,364,10,2,7,5,268,292,13,305,0,O-3-14-01-03-03
BUNDIBUGYO,BWAMBA COUNTY,BUBANDI,BUSUNGA,BUSUNGA PR. SCHOOL,921,17,3,13,48,588,669,49,718,0,O-3-14-01-04-01
BUNDIBUGYO,BWAMBA COUNTY,BUBANDI,BUSUNGA,BUBANDI PR. SCHOOL,402,4,2,1,12,227,246,23,269,0,O-3-14-01-04-02
BUNDIBUGYO,BWAMBA COUNTY,BUBANDI,BUSUNGA,BUBANDI CATH. CHURCH,545,9,4,7,38,328,386,19,405,0,O-3-14-01-04-03
BUNDIBUGYO,BWAMBA COUNTY,BUBANDI,LAMIA,LAMIA PR. SCHOOL,383,8,2,4,6,280,300,10,310,0,O-3-14-01-05-01
BUNDIBUGYO,BWAMBA COUNTY,BUBANDI,LAMIA,BUNDINGOMA C. O. U.,429,9,4,5,5,290,313,15,328,0,O-3-14-01-05-02
BUNDIBUGYO,BWAMBA COUNTY,BUBANDI,MULUNGITANWA,BUBANDI PR. SCHOOL,238,6,0,8,7,164,185,12,197,0,O-3-14-01-06-01
BUNDIBUGYO,BWAMBA COUNTY,BUBANDI,MULUNGITANWA,BUSUNGU MARKET,408,9,1,7,26,258,301,11,312,0,O-3-14-01-06-02
BUNDIBUGYO,BWAMBA COUNTY,BUBANDI,NJUULE,KABUTABULE S/C HQRS,592,11,2,2,17,395,427,22,449,0,O-3-14-01-07-01
BUNDIBUGYO,BWAMBA COUNTY,BUBANDI,NJUULE,NJULE PR. SCHOOL,748,15,6,22,17,425,485,48,533,0,O-3-14-01-07-02
BUNDIBUGYO,BWAMBA COUNTY,BUBANDI,NJUULE,NUTRITION OFFICE,303,5,0,4,12,192,213,17,230,0,O-3-14-01-07-03
BUNDIBUGYO,BWAMBA COUNTY,BUBANDI,NYAMBARO,NYAMBARO PR.SCHOOL,389,7,1,9,8,245,270,24,294,0,O-3-14-01-08-01
BUNDIBUGYO,BWAMBA COUNTY,BUBUKWANGA,BUBUKWANGA,BUBUKWANGA S\C HQRS,932,11,12,24,37,468,552,33,585,0,O-3-14-02-01-01
BUNDIBUGYO,BWAMBA COUNTY,BUBUKWANGA,BUBUKWANGA,BUBUKWANGA P/S OLD SITE,474,4,2,12,9,300,327,33,360,0,O-3-14-02-01-02
BUNDIBUGYO,BWAMBA COUNTY,BUBUKWANGA,BUBUKWANGA,BUBUKWANGA PRISONS,243,3,2,5,6,135,151,14,165,0,O-3-14-02-01-03
BUNDIBUGYO,BWAMBA COUNTY,BUBUKWANGA,BUBUKWANGA,BUBUKWANGA PARISH HQRS(A-K),373,4,2,16,15,219,256,12,268,0,O-3-14-02-01-04
BUNDIBUGYO,BWAMBA COUNTY,BUBUKWANGA,BUBUKWANGA,BUBUKWANGA PARISH HQRS(L-Z),312,3,2,3,11,199,218,21,239,0,O-3-14-02-01-05
BUNDIBUGYO,BWAMBA COUNTY,BUBUKWANGA,BUNDIKEKI,KATUMBA,647,3,6,8,51,335,403,28,431,0,O-3-14-02-02-01
BUNDIBUGYO,BWAMBA COUNTY,BUBUKWANGA,BUNDIKEKI,BUNDIKEKI,450,13,4,7,36,279,339,23,362,0,O-3-14-02-02-02
BUNDIBUGYO,BWAMBA COUNTY,BUBUKWANGA,BUNDIKEKI,HAMUTOMA,796,10,5,31,46,459,551,32,583,0,O-3-14-02-02-03
BUNDIBUGYO,BWAMBA COUNTY,BUBUKWANGA,BUNDIMURANGYA,BULAMA,682,15,5,6,134,329,489,21,510,0,O-3-14-02-03-01
BUNDIBUGYO,BWAMBA COUNTY,BUBUKWANGA,BUNDINYAMA,BUNDIWERUME,616,7,1,6,13,405,432,26,458,0,O-3-14-02-04-01
BUNDIBUGYO,BWAMBA COUNTY,BUBUKWANGA,BUNDINYAMA,BUHANDA PR. SCHOOL,576,14,4,13,11,414,456,19,475,0,O-3-14-02-04-02
BUNDIBUGYO,BWAMBA COUNTY,BUBUKWANGA,BUNDINYAMA,BUNDINYAMA PR. SCH.,255,6,0,2,12,179,199,11,210,0,O-3-14-02-04-03
BUNDIBUGYO,BWAMBA COUNTY,BUBUKWANGA,HUMYA,BUBUKWANGA -NEW SITE,937,19,4,18,50,550,641,37,678,0,O-3-14-02-05-01
BUNDIBUGYO,BWAMBA COUNTY,BUBUKWANGA,HUMYA,HUMYA TRADING CENTRE,500,8,3,11,13,287,322,11,333,0,O-3-14-02-05-02
BUNDIBUGYO,BWAMBA COUNTY,BUBUKWANGA,MATAISA,HAKITENGYA PR. SCHOOL,627,10,4,12,24,380,430,26,456,0,O-3-14-02-06-01
BUNDIBUGYO,BWAMBA COUNTY,BUBUKWANGA,MATAISA,KANYAMWIRIMA,860,11,5,15,16,469,516,38,554,0,O-3-14-02-06-02
BUNDIBUGYO,BWAMBA COUNTY,BUBUKWANGA,MATAISA,BUNYARUTA C. O. U.,406,9,2,8,11,264,294,12,306,0,O-3-14-02-06-03
BUNDIBUGYO,BWAMBA COUNTY,BUBUKWANGA,MATAISA,KANYAMWIRIMA Q. GUARD,489,1,1,0,26,376,404,17,421,0,O-3-14-02-06-04
BUNDIBUGYO,BWAMBA COUNTY,BUNDIBUGYO T.C.,BIMARA,BUNDIKOHADA PARISH HQRS P.S,677,9,1,8,52,394,464,27,491,0,O-3-14-03-01-01
BUNDIBUGYO,BWAMBA COUNTY,BUNDIBUGYO T.C.,BUMADU,BUMADU PR. SCHOOL,708,5,3,7,52,425,492,28,520,0,O-3-14-03-02-01
BUNDIBUGYO,BWAMBA COUNTY,BUNDIBUGYO T.C.,BUMATE,BUMATE,657,12,2,7,63,402,486,29,515,0,O-3-14-03-03-01
BUNDIBUGYO,BWAMBA COUNTY,BUNDIBUGYO T.C.,BUNDIBUGYO CENTR,TOWN SQUARE PAVILLION A,913,8,0,4,144,356,512,17,529,0,O-3-14-03-04-01
BUNDIBUGYO,BWAMBA COUNTY,BUNDIBUGYO T.C.,BUNDIBUGYO CENTR,TOWN SQUARE PAVILLION B,448,3,2,2,47,182,236,16,252,0,O-3-14-03-04-02
BUNDIBUGYO,BWAMBA COUNTY,BUNDIBUGYO T.C.,BUNDIBUGYO CENTR,TOWN SQUARE PAVILLION C,365,2,1,0,36,168,207,5,212,0,O-3-14-03-04-03
BUNDIBUGYO,BWAMBA COUNTY,BUNDIBUGYO T.C.,HAMUTITI,HOSPITAL,632,6,1,7,76,346,436,21,457,0,O-3-14-03-05-01
BUNDIBUGYO,BWAMBA COUNTY,BUNDIBUGYO T.C.,HAMUTITI,LATE MANUHE'S COMPOUND,394,1,2,3,35,202,243,21,264,0,O-3-14-03-05-02
BUNDIBUGYO,BWAMBA COUNTY,BUNDIBUGYO T.C.,KANYANSIMBI,MUTUKURA,660,8,2,6,35,353,404,33,437,0,O-3-14-03-06-01
BUNDIBUGYO,BWAMBA COUNTY,BUNDIBUGYO T.C.,KANYANSIMBI,BUNDIBUGYO PRI.SCH.,515,4,1,8,37,282,332,13,345,0,O-3-14-03-06-02
BUNDIBUGYO,BWAMBA COUNTY,BUSARU,BUGANIKIRE,SIMBYA PRIMARY SCHOOL,720,7,4,9,47,396,463,23,486,0,O-3-14-04-01-01
BUNDIBUGYO,BWAMBA COUNTY,BUSARU,BUGANIKIRE,BUNDIMULINGA,442,8,3,4,23,322,360,15,375,0,O-3-14-04-01-02
BUNDIBUGYO,BWAMBA COUNTY,BUSARU,BUGANIKIRE,BUGANIKIRE CATHOLIC CHURCH,814,20,4,13,95,425,557,54,611,0,O-3-14-04-01-03
BUNDIBUGYO,BWAMBA COUNTY,BUSARU,BUGOMBWA,BUGOMBWA CATHOLIC CHURCH ',530,8,10,14,36,298,366,47,413,0,O-3-14-04-02-01
BUNDIBUGYO,BWAMBA COUNTY,BUSARU,BUGOMBWA,BUGOMBWA PR. SCHOOL,583,5,2,5,29,357,398,32,430,0,O-3-14-04-02-02
BUNDIBUGYO,BWAMBA COUNTY,BUSARU,BUGOMBWA,BUGOMBWA CATHOLIC CHURCH ',311,3,0,2,15,180,200,38,238,0,O-3-14-04-02-03
BUNDIBUGYO,BWAMBA COUNTY,BUSARU,BUSARU,BUSARU C. O. U.,706,15,9,19,30,402,475,26,501,0,O-3-14-04-03-01
BUNDIBUGYO,BWAMBA COUNTY,BUSARU,BUSARU,BUSARU PRIMARY SCHOOL 'A',670,12,5,11,36,380,444,28,472,0,O-3-14-04-03-02
BUNDIBUGYO,BWAMBA COUNTY,BUSARU,BUSARU,BUSARU S/CTY HQRS,441,7,2,10,37,272,328,11,339,0,O-3-14-04-03-03
BUNDIBUGYO,BWAMBA COUNTY,BUSARU,BUSARU,BUSARU PRIMARY SCHOOL 'B',241,4,2,3,7,159,175,10,185,0,O-3-14-04-03-04
BUNDIBUGYO,BWAMBA COUNTY,BUSARU,BUSORU,BUSORU PARISH HQRS,630,5,4,8,10,410,437,20,457,0,O-3-14-04-04-01
BUNDIBUGYO,BWAMBA COUNTY,BUSARU,BUSORU,BUTOGO PR. SCHOOL,733,11,3,7,12,433,466,68,534,0,O-3-14-04-04-02
BUNDIBUGYO,BWAMBA COUNTY,BUSARU,BUSORU,OUTSIDE Q. GUARD,335,0,0,1,0,331,332,3,335,0,O-3-14-04-04-03
BUNDIBUGYO,BWAMBA COUNTY,BUSARU,HAKITARA,BUBOMBOLI I,466,8,5,8,13,259,293,27,320,0,O-3-14-04-05-01
BUNDIBUGYO,BWAMBA COUNTY,BUSARU,HAKITARA,HAKITARA II,767,2,3,10,3,577,595,12,607,0,O-3-14-04-05-02
BUNDIBUGYO,BWAMBA COUNTY,BUSARU,HAKITARA,KANDENKA CAMP P.S,344,2,0,8,4,236,250,11,261,0,O-3-14-04-05-03
BUNDIBUGYO,BWAMBA COUNTY,BUSARU,KAGHEMA,BUNDIKUYALI PR.SCHOOL,469,6,2,13,16,325,362,23,385,0,O-3-14-04-06-01
BUNDIBUGYO,BWAMBA COUNTY,BUSARU,KAGHEMA,BULIREYA COCOA FARM,666,17,6,19,14,395,451,24,475,0,O-3-14-04-06-02
BUNDIBUGYO,BWAMBA COUNTY,BUSARU,KIRINDI,KIRINDI MARKET,711,7,2,18,82,385,494,20,514,0,O-3-14-04-07-01
BUNDIBUGYO,BWAMBA COUNTY,BUSARU,KIRINDI,NAMUGONGO CATH. CHURCH,637,12,5,6,39,398,460,28,488,0,O-3-14-04-07-02
BUNDIBUGYO,BWAMBA COUNTY,BUSARU,KUKA,BINDIKAHUNGU COU,314,4,0,4,15,208,231,16,247,0,O-3-14-04-08-01
BUNDIBUGYO,BWAMBA COUNTY,BUSARU,KUKA,SIMBYA NKURU,407,3,1,6,8,265,283,27,310,0,O-3-14-04-08-02
BUNDIBUGYO,BWAMBA COUNTY,BUSARU,MIRAMBI,MIRAMBI PR. SCHOOL,727,15,5,13,46,419,498,18,516,0,O-3-14-04-09-01
BUNDIBUGYO,BWAMBA COUNTY,BUSARU,MIRAMBI,BUTAMA MARKET,689,11,2,15,77,373,478,31,509,0,O-3-14-04-09-02
BUNDIBUGYO,BWAMBA COUNTY,BUSARU,MIRAMBI,MIRAMBI HEALTH UNIT,280,1,2,3,12,179,197,17,214,0,O-3-14-04-09-03
BUNDIBUGYO,BWAMBA COUNTY,BUSARU,MIRAMBI,BINDIKAHUNGU COU,555,6,2,8,15,364,395,18,413,0,O-3-14-04-09-04
BUSHENYI,IGARA COUNTY WEST,ISHAKA TOWN COUNCIL,WARD III,KANYAMABONA,509,2,0,2,97,248,349,12,361,0,O-4-19-01-01-01
BUSHENYI,IGARA COUNTY WEST,ISHAKA TOWN COUNCIL,WARD III,KATUNGU P/S,550,1,1,1,132,239,374,4,378,0,O-4-19-01-01-02
BUSHENYI,IGARA COUNTY WEST,ISHAKA TOWN COUNCIL,WARD III,BASAJABALABA P/S I,558,1,0,1,120,178,300,7,307,0,O-4-19-01-01-03
BUSHENYI,IGARA COUNTY WEST,ISHAKA TOWN COUNCIL,WARD III,TAXI PARK I,481,0,0,0,137,138,275,24,299,0,O-4-19-01-01-04
BUSHENYI,IGARA COUNTY WEST,ISHAKA TOWN COUNCIL,WARD III,BASAJABALABA P/S II,608,2,0,0,156,159,317,7,324,0,O-4-19-01-01-05
BUSHENYI,IGARA COUNTY WEST,ISHAKA TOWN COUNCIL,WARD III,TAXI PARK II,550,1,0,0,148,145,294,9,303,0,O-4-19-01-01-06
BUSHENYI,IGARA COUNTY WEST,ISHAKA TOWN COUNCIL,WARD IV,NYAKATOOMA,705,0,0,1,132,272,405,15,420,0,O-4-19-01-02-01
BUSHENYI,IGARA COUNTY WEST,ISHAKA TOWN COUNCIL,WARD IV,ISHAKA ADVENTIST COLLEGE,614,2,1,1,167,252,423,7,430,0,O-4-19-01-02-02
BUSHENYI,IGARA COUNTY WEST,ISHAKA TOWN COUNCIL,WARD IV,ISHAKA HOSPITAL P/S,261,0,0,0,67,133,200,8,208,0,O-4-19-01-02-03
BUSHENYI,IGARA COUNTY WEST,KAKANJU,KABARE,KIJUMO NURSERY SCHOOL,534,0,0,2,83,315,400,4,404,0,O-4-19-02-01-01
BUSHENYI,IGARA COUNTY WEST,KAKANJU,KABARE,KABARE P. SCHOOL,763,3,1,3,131,428,566,11,577,0,O-4-19-02-01-02
BUSHENYI,IGARA COUNTY WEST,KAKANJU,KABARE,NYARURAMBI P. SCHOOL,524,3,0,4,116,261,384,8,392,0,O-4-19-02-01-03
BUSHENYI,IGARA COUNTY WEST,KAKANJU,KAKANJU,KAKANJU SUB - CTY HQRS,709,0,1,6,143,382,532,5,537,0,O-4-19-02-02-01
BUSHENYI,IGARA COUNTY WEST,KAKANJU,KAKANJU,KATONGA P/S,621,3,1,3,147,335,489,9,498,0,O-4-19-02-02-02
BUSHENYI,IGARA COUNTY WEST,KAKANJU,KAKANJU,KYENTOBO P/S,501,7,1,4,171,198,381,17,398,0,O-4-19-02-02-03
BUSHENYI,IGARA COUNTY WEST,KAKANJU,KATUNGA,KATUNGA PARISH HQRS,673,2,2,2,150,304,460,86,546,0,O-4-19-02-03-01
BUSHENYI,IGARA COUNTY WEST,KAKANJU,KATUNGA,KASHANDA T. CENTRE,657,5,0,3,151,330,489,13,502,0,O-4-19-02-03-02
BUSHENYI,IGARA COUNTY WEST,KAKANJU,KATUNGA,KIGONDO P. SCHOOL,478,4,0,4,141,219,368,6,374,0,O-4-19-02-03-03
BUSHENYI,IGARA COUNTY WEST,KAKANJU,KITOJO,KITOJO PARISH HQRS,395,4,0,2,47,244,297,13,310,0,O-4-19-02-04-01
BUSHENYI,IGARA COUNTY WEST,KAKANJU,KITOJO,RYAKAJUJU SHOPS T.C,440,2,0,3,52,309,366,9,375,0,O-4-19-02-04-02
BUSHENYI,IGARA COUNTY WEST,KAKANJU,MAZINGA,AHAKIKOONA,588,5,3,4,138,265,415,7,422,0,O-4-19-02-05-01
BUSHENYI,IGARA COUNTY WEST,KAKANJU,MAZINGA,KEIRERE CHURCH,457,1,0,1,130,229,361,9,370,0,O-4-19-02-05-02
BUSHENYI,IGARA COUNTY WEST,KAKANJU,MAZINGA,RWATUKWIRE P. SCHOOL,669,0,1,1,113,378,493,14,507,0,O-4-19-02-05-03
BUSHENYI,IGARA COUNTY WEST,KAKANJU,RUSHINYA,KABARE PARISH HQRS,382,1,1,0,100,222,324,0,324,0,O-4-19-02-06-01
BUSHENYI,IGARA COUNTY WEST,KAKANJU,RUSHINYA,NYAKABINGO HILL,675,3,0,6,133,383,525,9,534,0,O-4-19-02-06-02
BUSHENYI,IGARA COUNTY WEST,KAKANJU,RUSHINYA,BUNANURA P. SCHOOL,396,3,1,2,91,215,312,6,318,0,O-4-19-02-06-03
BUSHENYI,IGARA COUNTY WEST,KIGOMA,KASHENYI,KAKOMA P. SCHOOL,582,0,2,3,91,315,411,24,435,0,O-4-19-03-01-01
BUSHENYI,IGARA COUNTY WEST,KIGOMA,KASHENYI,BURAMBA P. SCHOOL,733,3,0,1,152,400,556,18,574,0,O-4-19-03-01-02
BUSHENYI,IGARA COUNTY WEST,KIGOMA,KASHENYI,KIGOMA PARISH HQRS I,405,0,0,1,62,239,302,6,308,0,O-4-19-03-01-03
BUSHENYI,IGARA COUNTY WEST,KIGOMA,KASHENYI,KIGOMA PARISH HQRS II,555,1,3,1,74,324,403,6,409,0,O-4-19-03-01-04
BUSHENYI,IGARA COUNTY WEST,KIGOMA,KASHENYI,ST. ANDREW'S P. SCHOOL,338,1,0,0,62,184,247,3,250,0,O-4-19-03-01-05
BUSHENYI,IGARA COUNTY WEST,KIZINDA,KASHENYI,ST.KALEMA CHURCH COMP,577,1,0,2,76,352,431,10,441,0,O-4-19-04-01-06
BUSHENYI,IGARA COUNTY WEST,KIZINDA,KASHENYI,KIZINDA MARKET,576,0,0,0,131,219,350,4,354,0,O-4-19-04-01-07
BUSHENYI,IGARA COUNTY WEST,KIZINDA,KASHENYI,KIZINDA P. SCHOOL,453,1,0,2,111,244,358,5,363,0,O-4-19-04-01-08
BUSHENYI,IGARA COUNTY WEST,KIZINDA,KASHENYI,KIZINDA PARISH HQRS,258,0,0,0,25,178,203,3,206,0,O-4-19-04-01-09
BUSHENYI,IGARA COUNTY WEST,KYAMUHUNGA,BITOOMA,BITOOMA T. CENTRE,442,1,2,0,65,279,347,13,360,0,O-4-19-05-01-01
BUSHENYI,IGARA COUNTY WEST,KYAMUHUNGA,BITOOMA,KAYENGO P. SCHOOL,738,1,0,4,89,467,561,18,579,0,O-4-19-05-01-02
BUSHENYI,IGARA COUNTY WEST,KYAMUHUNGA,BITOOMA,KIMURI T. CENTRE,464,2,0,1,38,363,404,6,410,0,O-4-19-05-01-03
BUSHENYI,IGARA COUNTY WEST,KYAMUHUNGA,BITOOMA,KABUMBURI,457,0,1,7,40,328,376,15,391,0,O-4-19-05-01-04
BUSHENYI,IGARA COUNTY WEST,KYAMUHUNGA,BITOOMA,RUSHOBE P. SCHOOL,252,0,0,3,8,216,227,0,227,0,O-4-19-05-01-05
BUSHENYI,IGARA COUNTY WEST,KYAMUHUNGA,KABINGO,KABINGO P. SCHOOL I,545,0,0,2,79,319,400,13,413,0,O-4-19-05-02-01
BUSHENYI,IGARA COUNTY WEST,KYAMUHUNGA,KABINGO,NYAKAHANGA T. C,747,1,0,1,126,481,609,9,618,0,O-4-19-05-02-02
BUSHENYI,IGARA COUNTY WEST,KYAMUHUNGA,KABINGO,RWANSHETSYA P. SCHOOL,342,3,0,0,85,180,268,11,279,0,O-4-19-05-02-03
BUSHENYI,IGARA COUNTY WEST,KYAMUHUNGA,KABINGO,KYEIKAMBA P. SCHOOL I,708,2,1,1,171,328,503,5,508,0,O-4-19-05-02-04
BUSHENYI,IGARA COUNTY WEST,KYAMUHUNGA,KABINGO,BUTINDE P. SCHOOL,683,2,2,2,86,461,553,10,563,0,O-4-19-05-02-05
BUSHENYI,IGARA COUNTY WEST,KYAMUHUNGA,KYAMUHANGA,KYAMUHUNGA MIXED SCHOOL,838,1,1,3,153,500,658,5,663,0,O-4-19-05-03-01
BUSHENYI,IGARA COUNTY WEST,KYAMUHUNGA,KYAMUHANGA,RYAMAREMBO P. SCHOOL,629,2,1,4,92,376,475,31,506,0,O-4-19-05-03-02
BUSHENYI,IGARA COUNTY WEST,KYAMUHUNGA,KYAMUHANGA,KYAMUHUNGA S/CTY HQRS,536,0,0,0,75,333,408,6,414,0,O-4-19-05-03-03
BUSHENYI,IGARA COUNTY WEST,KYAMUHUNGA,MASHONGA,MASHONGA TEA ESTATE PLAY G,588,1,2,0,97,254,354,13,367,0,O-4-19-05-04-01
BUSHENYI,IGARA COUNTY WEST,KYAMUHUNGA,MASHONGA,KAYEMBE T. CENTRE,717,5,0,0,70,431,506,26,532,0,O-4-19-05-04-02
BUSHENYI,IGARA COUNTY WEST,KYAMUHUNGA,MASHONGA,RYANTENDE T. CENTRE,528,2,0,5,64,321,392,11,403,0,O-4-19-05-04-03
BUSHENYI,IGARA COUNTY WEST,KYAMUHUNGA,MASHONGA,KYAMABARE P. SCHOOL,609,1,0,2,44,466,513,6,519,0,O-4-19-05-04-04
BUSHENYI,IGARA COUNTY WEST,KYAMUHUNGA,MASHONGA,KIBAZI P. SCHOOL I,408,4,0,1,54,246,305,11,316,0,O-4-19-05-04-05
BUSHENYI,IGARA COUNTY WEST,KYAMUHUNGA,MASHONGA,NYAKAZINGA T. CENTRE,621,5,2,7,46,434,494,0,494,0,O-4-19-05-04-06
BUSHENYI,IGARA COUNTY WEST,NKANGA,KASHENYI,KANYEGYERO P. SCHOOL,738,3,0,4,132,416,555,33,588,0,O-4-19-06-01-01
BUSHENYI,IGARA COUNTY WEST,NKANGA,KASHENYI,NKANGA PARISH HQRS I,694,2,1,4,164,295,466,22,488,0,O-4-19-06-01-02
BUSHENYI,IGARA COUNTY WEST,NKANGA,KASHENYI,NKANGA PARISH HQRS II,632,3,1,2,143,325,474,13,487,0,O-4-19-06-01-03
BUSHENYI,IGARA COUNTY WEST,NKANGA,NYABUBARE,NYABUBARE S.S.S,733,4,0,3,155,395,557,18,575,0,O-4-19-06-02-01
BUSHENYI,IGARA COUNTY WEST,NKANGA,NYABUBARE,RUGAGA P. SCHOOL,623,5,0,4,155,337,501,19,520,0,O-4-19-06-02-02
BUSHENYI,IGARA COUNTY WEST,NKANGA,NYABUBARE,NYABUBARE S/C HQRS,654,3,1,0,118,328,450,19,469,0,O-4-19-06-02-03
BUSHENYI,IGARA COUNTY WEST,NKANGA,NYABUBARE,RWAKAZURA'S PLAY GROUND,508,3,1,1,64,346,415,6,421,0,O-4-19-06-02-04
BUSHENYI,IGARA COUNTY WEST,NKANGA,NYABUBARE,KASHOZI BOARDING P/S,500,3,0,3,75,326,407,9,416,0,O-4-19-06-02-05
BUSHENYI,IGARA COUNTY WEST,NKANGA,NYARUGOTE,NYARUGOTE PARISH HQRS,629,4,1,1,78,427,511,5,516,0,O-4-19-06-03-01
BUSHENYI,IGARA COUNTY WEST,NKANGA,NYARUGOTE,MATIGI SUB - PARISH HQRS,510,2,0,2,53,372,429,14,443,0,O-4-19-06-03-02
BUSHENYI,IGARA COUNTY WEST,NKANGA,NYARUGOTE,KAKOMBE TEA GRO. COOP,287,0,0,1,30,196,227,9,236,0,O-4-19-06-03-03
BUSHENYI,IGARA COUNTY WEST,NSHUMI,MASHONGA,NSHUMI PARISH HQRS,538,2,0,1,73,353,429,9,438,0,O-4-19-07-01-01
BUSHENYI,IGARA COUNTY WEST,NSHUMI,MASHONGA,RYAMIHUGA P. SCHOOL,478,2,0,1,52,349,404,8,412,0,O-4-19-07-01-02
BUSHENYI,IGARA COUNTY WEST,NSHUMI,MASHONGA,NSHUMI P. SCHOOL,485,0,0,0,44,343,387,19,406,0,O-4-19-07-01-03
BUSHENYI,IGARA COUNTY WEST,NYABUBARE,KAHUNGYE,NYABUBARE SUB DISPENSARY,483,0,1,3,63,330,397,4,401,0,O-4-19-08-01-01
BUSHENYI,IGARA COUNTY WEST,NYABUBARE,KAHUNGYE,NYAKATUNTU P. SCHOOL,710,1,4,3,72,476,556,10,566,0,O-4-19-08-01-02
BUSHENYI,IGARA COUNTY WEST,NYABUBARE,KAHUNGYE,KAHUNGYE P. SCHOOL I,765,3,0,4,91,451,549,17,566,0,O-4-19-08-01-03
BUSHENYI,IGARA COUNTY WEST,NYABUBARE,KAHUNGYE,KAHUNGYE P. SCHOOL II,406,3,0,1,89,238,331,2,333,0,O-4-19-08-01-04
BUSHENYI,IGARA COUNTY WEST,NYABUBARE,KASHENYI,KASHENYI MODEL P. SCHOOL,399,1,0,2,98,228,329,5,334,0,O-4-19-08-02-01
BUSHENYI,IGARA COUNTY WEST,NYABUBARE,KASHENYI,KASHENYI PARISH HQRS,344,0,2,3,107,170,282,5,287,0,O-4-19-08-02-02
BUSHENYI,IGARA COUNTY WEST,NYANGA,MASHONGA,NYANGA PARISH HQRS,569,4,1,5,80,377,467,19,486,0,O-4-19-09-01-01
BUSHENYI,IGARA COUNTY WEST,NYANGA,MASHONGA,KAKONI P. SCHOOL,496,1,0,1,70,256,328,78,406,0,O-4-19-09-01-02
BUSHENYI,IGARA COUNTY WEST,NYANGA,MASHONGA,NYAMISONDO P. SCHOOL,519,4,0,4,113,258,379,38,417,0,O-4-19-09-01-03
BUSHENYI,IGARA COUNTY WEST,NYANGA,MASHONGA,KAKIIRA P. SCHOOL,477,3,0,3,86,313,405,6,411,0,O-4-19-09-01-04
BUSHENYI,IGARA COUNTY WEST,SWAZI,MASHONGA,KATIMA FULL GOSPEL CHURCH C,721,1,0,1,105,421,528,53,581,0,O-4-19-10-01-05
BUSHENYI,IGARA COUNTY WEST,SWAZI,MASHONGA,SWAZI P. SCHOOL,719,2,0,4,59,531,596,9,605,0,O-4-19-10-01-06
BUSHENYI,IGARA CTY EAST,BUMBAIRE,BUMBAIRE,BUMBAIRE S/C HQRS,650,0,2,1,111,291,405,7,412,0,O-4-18-01-01-01
BUSHENYI,IGARA CTY EAST,BUMBAIRE,BUMBAIRE,KABUSHAHO P. SCHOOL,458,0,1,1,65,242,309,6,315,0,O-4-18-01-01-02
BUSHENYI,IGARA CTY EAST,BUMBAIRE,BUMBAIRE,KAAGATI T. CENTRE,614,1,3,3,125,323,455,0,455,0,O-4-18-01-01-03
BUSHENYI,IGARA CTY EAST,BUMBAIRE,BUMBAIRE,RWECENGE CHURCH,294,3,0,1,33,177,214,8,222,0,O-4-18-01-01-04
BUSHENYI,IGARA CTY EAST,BUMBAIRE,KAINAMO,KAINAMO P. SCHOOL,541,1,0,1,105,302,409,25,434,0,O-4-18-01-02-01
BUSHENYI,IGARA CTY EAST,BUMBAIRE,KAINAMO,KAINAMO PARISH HQRS,423,1,0,1,60,242,304,12,316,0,O-4-18-01-02-02
BUSHENYI,IGARA CTY EAST,BUMBAIRE,KAINAMO,KATAAGU COFFEE BUYING CENT,575,0,0,3,65,373,441,15,456,0,O-4-18-01-02-03
BUSHENYI,IGARA CTY EAST,BUMBAIRE,KAINAMO,KABANSHWERE (ISHUNGA),730,2,1,8,111,444,566,24,590,0,O-4-18-01-02-04
BUSHENYI,IGARA CTY EAST,BUMBAIRE,KIBARE,KIBARE PARISH HQRS,580,1,1,1,164,269,436,9,445,0,O-4-18-01-03-01
BUSHENYI,IGARA CTY EAST,BUMBAIRE,KIBARE,KACUNCU P. SCHOOL I,537,0,4,1,96,302,403,17,420,0,O-4-18-01-03-02
BUSHENYI,IGARA CTY EAST,BUMBAIRE,KIBARE,KACUNCU P. SCHOOL II,426,4,1,2,89,210,306,8,314,0,O-4-18-01-03-03
BUSHENYI,IGARA CTY EAST,BUMBAIRE,KIYAGA,KIYAGA P. SCHOOL,632,2,0,2,130,336,470,8,478,0,O-4-18-01-04-01
BUSHENYI,IGARA CTY EAST,BUMBAIRE,KIYAGA,KIYAGA PARISH HQRS,622,1,1,3,123,347,475,2,477,0,O-4-18-01-04-02
BUSHENYI,IGARA CTY EAST,BUMBAIRE,KIYAGA,KANTUNDA CHURCH,573,1,0,3,106,322,432,6,438,0,O-4-18-01-04-03
BUSHENYI,IGARA CTY EAST,BUMBAIRE,NUMBA,KATONYA P. SCHOOL I,644,0,0,1,105,289,395,81,476,0,O-4-18-01-05-01
BUSHENYI,IGARA CTY EAST,BUMBAIRE,NUMBA,KATONYA P. SCHOOL II,759,2,0,4,176,371,553,13,566,0,O-4-18-01-05-02
BUSHENYI,IGARA CTY EAST,BUMBAIRE,RUHARO,RUHARO PARISH HQRS,606,0,0,1,58,429,488,4,492,0,O-4-18-01-06-01
BUSHENYI,IGARA CTY EAST,BUMBAIRE,RUHARO,KIKUBA HILL TOP CHURCH,476,2,0,2,37,358,399,4,403,0,O-4-18-01-06-02
BUSHENYI,IGARA CTY EAST,BUMBAIRE,RUHARO,OMURUHITA T. CENTRE,519,1,0,0,38,381,420,0,420,0,O-4-18-01-06-03
BUSHENYI,IGARA CTY EAST,BUMBAIRE,RUHARO,BUNYARIGI - NEAR THE CHURCH,599,3,0,4,93,369,469,8,477,0,O-4-18-01-06-04
BUSHENYI,IGARA CTY EAST,BUMBAIRE,RYEISHE,IBAARE P. SCHOOL,567,1,0,3,87,359,450,1,451,0,O-4-18-01-07-01
BUSHENYI,IGARA CTY EAST,BUMBAIRE,RYEISHE,KITABI DEMO SCHOOL,424,0,0,1,73,282,356,3,359,0,O-4-18-01-07-02
BUSHENYI,IGARA CTY EAST,BUMBAIRE,RYEISHE,RYEISHE PARISH HQRS,535,1,0,3,81,339,424,5,429,0,O-4-18-01-07-03
BUSHENYI,IGARA CTY EAST,BUMBAIRE,RYEISHE,BWOMA P. SCHOOL,656,3,1,5,146,355,510,8,518,0,O-4-18-01-07-04
BUSHENYI,IGARA CTY EAST,KYABUGIMBI,BIJENGYE,KYARIHIGIKA,210,2,0,0,55,105,162,3,165,0,O-4-18-02-01-01
BUSHENYI,IGARA CTY EAST,KYABUGIMBI,BIJENGYE,BIJENGYE PARISH HQRS,397,1,0,0,119,188,308,7,315,0,O-4-18-02-01-02
BUSHENYI,IGARA CTY EAST,KYABUGIMBI,BIJENGYE,NYAKABANGA PLAY GROUND,562,1,0,0,143,286,430,15,445,0,O-4-18-02-01-03
BUSHENYI,IGARA CTY EAST,KYABUGIMBI,BUGAARA,BUGAARA P. SCHOOL I,543,2,1,2,82,328,415,13,428,0,O-4-18-02-02-01
BUSHENYI,IGARA CTY EAST,KYABUGIMBI,BUGAARA,BUGAARA PARISH HQRS,546,1,0,3,63,327,394,8,402,0,O-4-18-02-02-02
BUSHENYI,IGARA CTY EAST,KYABUGIMBI,BUGAARA,KACWAMBA P/S,506,4,0,1,38,373,416,5,421,0,O-4-18-02-02-03
BUSHENYI,IGARA CTY EAST,KYABUGIMBI,KAJUNJU,KITWE P. SCHOOL I,502,1,0,2,89,308,400,7,407,0,O-4-18-02-03-01
BUSHENYI,IGARA CTY EAST,KYABUGIMBI,KAJUNJU,BUHIMBA P. SCHOOL II,551,1,0,3,107,290,401,12,413,0,O-4-18-02-03-02
BUSHENYI,IGARA CTY EAST,KYABUGIMBI,KAJUNJU,KAJUNJU P. SCHOOL I,743,5,0,3,160,337,505,21,526,0,O-4-18-02-03-03
BUSHENYI,IGARA CTY EAST,KYABUGIMBI,KAJUNJU,KAJUNJU P. SCHOOL II,481,2,0,2,61,316,381,5,386,0,O-4-18-02-03-04
BUSHENYI,IGARA CTY EAST,KYABUGIMBI,KATIKAMWE,KATIKAMWE C.O.U,615,1,0,1,208,254,464,12,476,0,O-4-18-02-04-01
BUSHENYI,IGARA CTY EAST,KYABUGIMBI,KATIKAMWE,KIHUMURO P. SCHOOL,698,1,2,3,129,409,544,0,544,0,O-4-18-02-04-02
BUSHENYI,IGARA CTY EAST,KYABUGIMBI,KATIKAMWE,KYABUGIMBI SUB COUNTY HQRS,680,3,0,1,144,342,490,6,496,0,O-4-18-02-04-03
BUSHENYI,IGARA CTY EAST,KYABUGIMBI,KYEIGOMBE,KYEIGOMBE C.O.U,709,2,1,3,192,349,547,3,550,0,O-4-18-02-05-01
BUSHENYI,IGARA CTY EAST,KYABUGIMBI,KYEIGOMBE,KIBONA P. SCHOOL,360,0,0,1,102,182,285,12,297,0,O-4-18-02-05-02
BUSHENYI,IGARA CTY EAST,KYABUGIMBI,NYEIBINGO,NYEIBINGO PARISH HQRS,639,4,0,3,108,408,523,14,537,0,O-4-18-02-06-01
BUSHENYI,IGARA CTY EAST,KYABUGIMBI,NYEIBINGO,NYEIBINGO P. SCHOOL I,413,4,0,5,66,240,315,8,323,0,O-4-18-02-06-02
BUSHENYI,IGARA CTY EAST,KYABUGIMBI,NYEIBINGO,NYEIBINGO P. SCHOOL II,419,1,0,2,39,273,315,10,325,0,O-4-18-02-06-03
BUSHENYI,IGARA CTY EAST,KYABUGIMBI,RUHUMURO,RUHUMURO PARISH HQRS,489,3,0,0,39,316,358,3,361,0,O-4-18-02-07-01
BUSHENYI,IGARA CTY EAST,KYABUGIMBI,RUHUMURO,NYAKATEETE HALL,316,1,1,3,34,233,272,1,273,0,O-4-18-02-07-02
BUSHENYI,IGARA CTY EAST,KYABUGIMBI,RUHUMURO,BURUNGIRA T. CENTRE,494,2,1,6,83,306,398,16,414,0,O-4-18-02-07-03
BUSHENYI,IGARA CTY EAST,KYABUGIMBI,RUHUMURO,KAASA P. SCHOOL,320,3,0,2,47,209,261,12,273,0,O-4-18-02-07-04
BUSHENYI,IGARA CTY EAST,KYABUGIMBI,RWENJERU,RWENJERU P. SCHOOL I,459,1,0,1,93,281,376,4,380,0,O-4-18-02-08-01
BUSHENYI,IGARA CTY EAST,KYABUGIMBI,RWENJERU,RWENJERU P. SCHOOL II,280,0,1,0,93,116,210,4,214,0,O-4-18-02-08-02
BUSHENYI,IGARA CTY EAST,KYEIZOBA,BUYANJA,BUYANJA P. SCHOOL,563,1,0,0,118,304,423,9,432,0,O-4-18-03-01-01
BUSHENYI,IGARA CTY EAST,KYEIZOBA,BUYANJA,KATERERO T. CENTRE,553,0,3,1,127,269,400,42,442,0,O-4-18-03-01-02
BUSHENYI,IGARA CTY EAST,KYEIZOBA,BWERA,BWERA PARISH HQRS,417,0,0,1,109,227,337,6,343,0,O-4-18-03-02-01
BUSHENYI,IGARA CTY EAST,KYEIZOBA,BWERA,NTUNGAMO P. SCHOOL,668,2,0,2,147,341,492,2,494,0,O-4-18-03-02-02
BUSHENYI,IGARA CTY EAST,KYEIZOBA,BWERA,BWERA P. SCHOOL,615,1,0,1,136,342,480,17,497,0,O-4-18-03-02-03
BUSHENYI,IGARA CTY EAST,KYEIZOBA,KARARO,KARARO PARISH HQRS,435,3,0,2,104,217,326,5,331,0,O-4-18-03-03-01
BUSHENYI,IGARA CTY EAST,KYEIZOBA,KARARO,MUNGONYA TECH. SCHOOL,423,3,2,1,106,211,323,7,330,0,O-4-18-03-03-02
BUSHENYI,IGARA CTY EAST,KYEIZOBA,KARARO,MUNGONYA P. SCHOOL,573,3,1,0,57,362,423,2,425,0,O-4-18-03-03-03
BUSHENYI,IGARA CTY EAST,KYEIZOBA,KARARO,MUNGONYA PLAY GROUND,515,1,1,2,89,270,363,10,373,0,O-4-18-03-03-04
BUSHENYI,IGARA CTY EAST,KYEIZOBA,KITAGATA,KAKAMBA P. SCHOOL,710,6,0,2,170,350,528,23,551,0,O-4-18-03-04-01
BUSHENYI,IGARA CTY EAST,KYEIZOBA,KITAGATA,KABUBA P. SCHOOL,667,1,0,1,156,329,487,10,497,0,O-4-18-03-04-02
BUSHENYI,IGARA CTY EAST,KYEIZOBA,KITAGATA,RWENYENA P. SCHOOL,471,0,0,3,113,261,377,23,400,0,O-4-18-03-04-03
BUSHENYI,IGARA CTY EAST,KYEIZOBA,KITWE,KITWE PARISH HQRS I,622,2,0,2,119,339,462,7,469,0,O-4-18-03-05-01
BUSHENYI,IGARA CTY EAST,KYEIZOBA,KITWE,RUBINGO PLAY GROUND,592,2,0,6,151,281,440,9,449,0,O-4-18-03-05-02
BUSHENYI,IGARA CTY EAST,KYEIZOBA,KITWE,RWENTUHA P. SCHOOL,589,2,1,4,160,243,410,9,419,0,O-4-18-03-05-03
BUSHENYI,IGARA CTY EAST,KYEIZOBA,KITWE,KITWE PARISH HQRS II,519,0,2,0,97,262,361,4,365,0,O-4-18-03-05-04
BUSHENYI,IGARA CTY EAST,KYEIZOBA,NYAMIYAGA,NYAMIYAGA PARISH HQRS,496,1,1,1,97,259,359,29,388,0,O-4-18-03-06-01
BUSHENYI,IGARA CTY EAST,KYEIZOBA,NYAMIYAGA,RUNYINYA P. SCHOOL,549,0,0,0,73,337,410,3,413,0,O-4-18-03-06-02
BUSHENYI,IGARA CTY EAST,KYEIZOBA,RUTOOMA,MBATAMO P. SCHOOL,576,0,0,0,108,354,462,9,471,0,O-4-18-03-07-01
BUSHENYI,IGARA CTY EAST,KYEIZOBA,RUTOOMA,RUTOOMA PARISH HQRS,561,1,3,1,133,280,418,7,425,0,O-4-18-03-07-02
BUSHENYI,IGARA CTY EAST,KYEIZOBA,RUTOOMA,NYAMIRIMA P. SCHOOL,419,0,1,0,109,159,269,2,271,0,O-4-18-03-07-03
BUSHENYI,IGARA CTY EAST,TOWN COUNCIL,WARD I,KATUNGU MOTHERS UNION,639,1,2,3,163,313,482,1,483,0,O-4-18-04-01-01
BUSHENYI,IGARA CTY EAST,TOWN COUNCIL,WARD I,RUYONZA SCHOOL PLAY GROUN,480,1,0,0,126,167,294,6,300,0,O-4-18-04-01-02
BUSHENYI,IGARA CTY EAST,TOWN COUNCIL,WARD I,BUSHENYI TOWN SCHOOL I,878,3,2,0,181,303,489,8,497,0,O-4-18-04-01-03
BUSHENYI,IGARA CTY EAST,TOWN COUNCIL,WARD I,BOMA GROUND (D.A'S OFFICE),493,0,1,1,127,167,296,5,301,0,O-4-18-04-01-04
BUSHENYI,IGARA CTY EAST,TOWN COUNCIL,WARD I,BUSHENYI TOWN SCHOOL II,523,3,0,0,134,184,321,0,321,0,O-4-18-04-01-05
BUSHENYI,IGARA CTY EAST,TOWN COUNCIL,WARD II,TOWN CLERK'S COMP,451,2,0,2,110,178,292,3,295,0,O-4-18-04-02-01
BUSHENYI,IGARA CTY EAST,TOWN COUNCIL,WARD II,KYEITEMBE P. SCHOOL,545,1,1,0,88,327,417,0,417,0,O-4-18-04-02-02
BUSHENYI,IGARA CTY EAST,TOWN COUNCIL,WARD II,ST. KAGWA P. SCHOOL,566,2,1,4,98,324,429,0,429,0,O-4-18-04-02-03
BUSHENYI,IGARA CTY EAST,TOWN COUNCIL,WARD II,RUHANDAGAZI SCH. OF THE DISA,435,0,1,1,108,220,330,6,336,0,O-4-18-04-02-04
HOIMA,BUGAHYA COUNTY,BUHANIKA,BUCHUNGA,BUHANIKA SCTY,722,4,1,5,81,412,503,7,510,0,O-6-28-01-01-01
HOIMA,BUGAHYA COUNTY,BUHANIKA,BUCHUNGA,KIHEMBA T/C,812,6,6,4,102,446,564,9,573,0,O-6-28-01-01-02
HOIMA,BUGAHYA COUNTY,BUHANIKA,BUCHUNGA,BUCUNGA T/C,473,1,2,0,78,270,351,3,354,0,O-6-28-01-01-03
HOIMA,BUGAHYA COUNTY,BUHANIKA,BUCHUNGA,KIHULE T/C,202,1,0,2,29,133,165,3,168,0,O-6-28-01-01-04
HOIMA,BUGAHYA COUNTY,BUHANIKA,BUTEBERE,BUTEBERE P/S,581,3,1,4,105,290,403,12,415,0,O-6-28-01-02-01
HOIMA,BUGAHYA COUNTY,BUHANIKA,BUTEBERE,KIKWATAMIGO T/C,779,4,0,2,152,415,573,11,584,0,O-6-28-01-02-02
HOIMA,BUGAHYA COUNTY,BUHANIKA,BUTEBERE,MPARO P/S,676,5,0,0,114,342,461,24,485,0,O-6-28-01-02-03
HOIMA,BUGAHYA COUNTY,BUHANIKA,BUTEBERE,BWANYA C.O.U.,385,3,1,0,65,209,278,9,287,0,O-6-28-01-02-04
HOIMA,BUGAHYA COUNTY,BUHANIKA,BUTEMA,BUTEMA COOP SOCIETY,767,2,0,2,51,441,496,13,509,0,O-6-28-01-03-01
HOIMA,BUGAHYA COUNTY,BUHANIKA,BUTEMA,BUTEMA MARKET,696,2,2,4,58,381,447,12,459,0,O-6-28-01-03-02
HOIMA,BUGAHYA COUNTY,BUHANIKA,BUTEMA,KATEREGA P/S,668,3,1,2,42,403,451,14,465,0,O-6-28-01-03-03
HOIMA,BUGAHYA COUNTY,BUHANIKA,KITONYA,KITONYA PARISH HQRS,526,0,0,0,36,309,345,5,350,0,O-6-28-01-04-01
HOIMA,BUGAHYA COUNTY,BUHANIKA,KITONYA,KYOHAIRWE P/S A A-L,833,2,0,0,53,487,542,17,559,0,O-6-28-01-04-02
HOIMA,BUGAHYA COUNTY,BUHANIKA,KITONYA,KABURAMURO P/S,415,2,1,0,27,254,284,1,285,0,O-6-28-01-04-03
HOIMA,BUGAHYA COUNTY,BUHANIKA,KITONYA,KYOHAIRWE P/S B M-Z,463,1,0,2,25,278,306,0,306,0,O-6-28-01-04-04
HOIMA,BUGAHYA COUNTY,BUSERUKA,KABAALE,KABAALE HEALTH CENTRE (A-K),584,7,2,1,39,310,359,13,372,0,O-6-28-02-01-01
HOIMA,BUGAHYA COUNTY,BUSERUKA,KABAALE,NYAMASOGA P/S A,514,10,2,13,90,190,305,13,318,0,O-6-28-02-01-02
HOIMA,BUGAHYA COUNTY,BUSERUKA,KABAALE,KIGAGA P/S,777,6,2,6,62,504,580,12,592,0,O-6-28-02-01-03
HOIMA,BUGAHYA COUNTY,BUSERUKA,KABAALE,KABAALE HEALTH CENTRE (L-Z),740,8,9,4,69,410,500,8,508,0,O-6-28-02-01-04
HOIMA,BUGAHYA COUNTY,BUSERUKA,KABAALE,NYAMASOGA P/S B,572,7,1,9,122,217,356,15,371,0,O-6-28-02-01-05
HOIMA,BUGAHYA COUNTY,BUSERUKA,KABAALE,KABAALE P/S,575,3,0,3,58,323,387,4,391,0,O-6-28-02-01-06
HOIMA,BUGAHYA COUNTY,BUSERUKA,NYAKABINGO,NYAKABINGO (A-J),750,2,0,1,49,447,499,20,519,0,O-6-28-02-02-01
HOIMA,BUGAHYA COUNTY,BUSERUKA,NYAKABINGO,BUSERUKA HQRS,544,3,0,3,27,335,368,10,378,0,O-6-28-02-02-02
HOIMA,BUGAHYA COUNTY,BUSERUKA,NYAKABINGO,NYAKABINGO (K-N),533,1,1,1,30,319,352,7,359,0,O-6-28-02-02-03
HOIMA,BUGAHYA COUNTY,BUSERUKA,NYAKABINGO,NYAKABINGO (O-O),666,2,1,1,49,384,437,71,508,0,O-6-28-02-02-04
HOIMA,BUGAHYA COUNTY,BUSERUKA,NYAKABINGO,NYABIHUKURU AID POST,372,3,1,2,30,203,239,16,255,0,O-6-28-02-02-05
HOIMA,BUGAHYA COUNTY,BUSERUKA,NYAKABINGO,NYAKABINGO (P-Z),430,2,1,4,33,261,301,9,310,0,O-6-28-02-02-06
HOIMA,BUGAHYA COUNTY,BUSERUKA,TONYA,FOFO T/C,540,3,1,4,137,183,328,16,344,0,O-6-28-02-03-01
HOIMA,BUGAHYA COUNTY,BUSERUKA,TONYA,TOONYA P/S,347,0,0,0,28,268,296,7,303,0,O-6-28-02-03-02
HOIMA,BUGAHYA COUNTY,BUSERUKA,TONYA,KIJANGI MARKET,346,1,0,0,69,154,224,2,226,0,O-6-28-02-03-03
HOIMA,BUGAHYA COUNTY,BUSERUKA,TONYA,KIRYAMBOGA MARKET SQUARE,237,2,1,0,32,158,193,8,201,0,O-6-28-02-03-04
HOIMA,BUGAHYA COUNTY,BUSERUKA,TONYA,KAISO MRT SQUARE,262,1,0,0,39,175,215,4,219,0,O-6-28-02-03-05
HOIMA,BUGAHYA COUNTY,BUSIISI,KASINGO,KASASA CATHOLIC CHURCH,711,2,0,3,80,433,518,10,528,0,O-6-28-03-01-01
HOIMA,BUGAHYA COUNTY,BUSIISI,KASINGO,KASINGO CATHOLIC CHURCH,637,2,3,3,79,369,456,12,468,0,O-6-28-03-01-02
HOIMA,BUGAHYA COUNTY,BUSIISI,KASINGO,KATUNGO,231,0,0,0,19,97,116,40,156,0,O-6-28-03-01-03
HOIMA,BUGAHYA COUNTY,BUSIISI,KASINGO,MPAIJA P/S,363,1,0,0,30,244,275,4,279,0,O-6-28-03-01-04
HOIMA,BUGAHYA COUNTY,BUSIISI,KIBINGO,KATASIHA,301,1,0,1,59,146,207,14,221,0,O-6-28-03-02-01
HOIMA,BUGAHYA COUNTY,BUSIISI,KIBINGO,KIBINGO PARISH HQRS,577,1,1,1,55,282,340,58,398,0,O-6-28-03-02-02
HOIMA,BUGAHYA COUNTY,BUSIISI,KIBINGO,KIHOMBOZA COU,753,1,1,0,69,397,468,83,551,0,O-6-28-03-02-03
HOIMA,BUGAHYA COUNTY,BUSIISI,KIBINGO,RUYANJA C.O.U,358,1,0,3,54,230,288,9,297,0,O-6-28-03-02-04
HOIMA,BUGAHYA COUNTY,BUSIISI,KIHUKYA,KIHUKYA T/C,538,1,1,1,45,341,389,17,406,0,O-6-28-03-03-01
HOIMA,BUGAHYA COUNTY,BUSIISI,KIHUKYA,BUSWEKERA P/S (A-J),377,2,0,1,38,238,279,1,280,0,O-6-28-03-03-02
HOIMA,BUGAHYA COUNTY,BUSIISI,KIHUKYA,KAYANJA CHURCH,375,0,0,0,34,262,296,8,304,0,O-6-28-03-03-03
HOIMA,BUGAHYA COUNTY,BUSIISI,KIHUKYA,BUSWEKERA P/S (K-Z),534,1,0,3,40,366,410,13,423,0,O-6-28-03-03-04
HOIMA,BUGAHYA COUNTY,HOIMA TOWN COUNCIL,CENTRAL WARD,BUSISI SCTY HQRS,765,2,2,1,91,373,469,5,474,0,O-6-28-04-01-01
HOIMA,BUGAHYA COUNTY,HOIMA TOWN COUNCIL,CENTRAL WARD,SARAH NTIRO VOC SCH A (A-KA),477,1,1,0,101,203,306,1,307,0,O-6-28-04-01-02
HOIMA,BUGAHYA COUNTY,HOIMA TOWN COUNCIL,CENTRAL WARD,HOIMA PUBLIC SCHOOL (A-F),540,2,3,0,116,182,303,6,309,0,O-6-28-04-01-03
HOIMA,BUGAHYA COUNTY,HOIMA TOWN COUNCIL,CENTRAL WARD,BUNYORO SPORTS CLUB (A-D),863,2,1,0,208,286,497,3,500,0,O-6-28-04-01-04
HOIMA,BUGAHYA COUNTY,HOIMA TOWN COUNCIL,CENTRAL WARD,KITARA COFFEE FACTORY,1035,2,0,1,186,352,541,21,562,0,O-6-28-04-01-05
HOIMA,BUGAHYA COUNTY,HOIMA TOWN COUNCIL,CENTRAL WARD,HOIMA PUBLIC SCHOOL (G-L),556,2,1,1,105,202,311,3,314,0,O-6-28-04-01-06
HOIMA,BUGAHYA COUNTY,HOIMA TOWN COUNCIL,CENTRAL WARD,BUNYORO SPORTS CLUB (E-K),938,3,2,1,193,322,521,4,525,0,O-6-28-04-01-07
HOIMA,BUGAHYA COUNTY,HOIMA TOWN COUNCIL,CENTRAL WARD,MURUBYA P/S,301,1,0,0,29,148,178,3,181,0,O-6-28-04-01-08
HOIMA,BUGAHYA COUNTY,HOIMA TOWN COUNCIL,CENTRAL WARD,SARAH NTIRO VOC SCH B (KE-Z),513,3,0,0,123,204,330,2,332,0,O-6-28-04-01-09
HOIMA,BUGAHYA COUNTY,HOIMA TOWN COUNCIL,CENTRAL WARD,BUNYORO SPORTS CLUB (L-Z),1190,5,1,1,246,374,627,5,632,0,O-6-28-04-01-10
HOIMA,BUGAHYA COUNTY,HOIMA TOWN COUNCIL,CENTRAL WARD,HOIMA PUBLIC SCHOOL (M-Z),681,3,1,1,152,220,377,8,385,0,O-6-28-04-01-11
HOIMA,BUGAHYA COUNTY,HOIMA TOWN COUNCIL,CENTRAL WARD,HOIMA TOWN C.O.U,605,0,1,0,101,260,362,9,371,0,O-6-28-04-01-12
HOIMA,BUGAHYA COUNTY,HOIMA TOWN COUNCIL,NORTHERN WARD,ST ALOYSIUS P/S (A-KA),617,2,1,0,94,290,387,4,391,0,O-6-28-04-02-01
HOIMA,BUGAHYA COUNTY,HOIMA TOWN COUNCIL,NORTHERN WARD,ST.JUDE P/S (A-H),775,4,0,1,141,300,446,6,452,0,O-6-28-04-02-02
HOIMA,BUGAHYA COUNTY,HOIMA TOWN COUNCIL,NORTHERN WARD,BWIKYA P/S A,797,5,2,1,160,277,445,6,451,0,O-6-28-04-02-03
HOIMA,BUGAHYA COUNTY,HOIMA TOWN COUNCIL,NORTHERN WARD,HOIMA INDEPENDENCE MEMORIA,418,1,2,0,80,164,247,17,264,0,O-6-28-04-02-04
HOIMA,BUGAHYA COUNTY,HOIMA TOWN COUNCIL,NORTHERN WARD,BWIKYA P/S B,432,0,0,0,97,144,241,12,253,0,O-6-28-04-02-05
HOIMA,BUGAHYA COUNTY,HOIMA TOWN COUNCIL,NORTHERN WARD,ST.JUDE P/S (I-MF),863,2,0,3,146,339,490,10,500,0,O-6-28-04-02-06
HOIMA,BUGAHYA COUNTY,HOIMA TOWN COUNCIL,NORTHERN WARD,ST ALOYSIUS P/S (KE-Z),630,6,0,1,89,300,396,9,405,0,O-6-28-04-02-07
HOIMA,BUGAHYA COUNTY,HOIMA TOWN COUNCIL,NORTHERN WARD,ST.JUDE P/S (MI-Z),939,1,2,1,180,333,517,10,527,0,O-6-28-04-02-08
HOIMA,BUGAHYA COUNTY,HOIMA TOWN COUNCIL,NORTHERN WARD,KYARWABUYAMBA T/C,336,2,0,0,72,190,264,6,270,0,O-6-28-04-02-09
HOIMA,BUGAHYA COUNTY,HOIMA TOWN COUNCIL,WESTERN WARD,DUHAGA GIRLS SCHOOL,842,3,3,2,151,383,542,14,556,0,O-6-28-04-03-01
HOIMA,BUGAHYA COUNTY,HOIMA TOWN COUNCIL,WESTERN WARD,SAZA HQRS A,535,1,2,1,93,201,298,0,298,0,O-6-28-04-03-02
HOIMA,BUGAHYA COUNTY,HOIMA TOWN COUNCIL,WESTERN WARD,BUSIISI P/S,656,1,1,1,97,299,399,6,405,0,O-6-28-04-03-03
HOIMA,BUGAHYA COUNTY,HOIMA TOWN COUNCIL,WESTERN WARD,SAZA HQRS B,744,2,2,0,151,270,425,23,448,0,O-6-28-04-03-04
HOIMA,BUGAHYA COUNTY,HOIMA TOWN COUNCIL,WESTERN WARD,SAZA HQRS C,308,2,1,0,65,120,188,5,193,0,O-6-28-04-03-05
HOIMA,BUGAHYA COUNTY,KIGOROBYA,BWIKYA,BOMBO (A-E),934,9,3,10,136,479,637,59,696,0,O-6-28-05-01-01
HOIMA,BUGAHYA COUNTY,KIGOROBYA,BWIKYA,BWIKYA,379,2,0,0,43,249,294,9,303,0,O-6-28-05-01-02
HOIMA,BUGAHYA COUNTY,KIGOROBYA,BWIKYA,BOMBO (F-M),394,2,0,2,62,223,289,4,293,0,O-6-28-05-01-03
HOIMA,BUGAHYA COUNTY,KIGOROBYA,BWIKYA,BOMBO (N-Z),549,3,3,6,92,296,400,10,410,0,O-6-28-05-01-04
HOIMA,BUGAHYA COUNTY,KIGOROBYA,KAPAPI,KIBENGEYA (A-KA),578,1,2,0,71,356,430,9,439,0,O-6-28-05-02-01
HOIMA,BUGAHYA COUNTY,KIGOROBYA,KAPAPI,KYAMUKWENDA C.O.U,876,7,4,10,83,532,636,74,710,0,O-6-28-05-02-02
HOIMA,BUGAHYA COUNTY,KIGOROBYA,KAPAPI,KIBENGEYA (KE-Z),367,1,0,1,39,228,269,8,277,0,O-6-28-05-02-03
HOIMA,BUGAHYA COUNTY,KIGOROBYA,KAPAPI,SIIBA T/C,870,2,3,6,147,472,630,14,644,0,O-6-28-05-02-04
HOIMA,BUGAHYA COUNTY,KIGOROBYA,KAPAPI,KAPAPI P/S,499,6,8,3,65,252,334,16,350,0,O-6-28-05-02-05
HOIMA,BUGAHYA COUNTY,KIGOROBYA,KIBIRO,KIBIRO P/S,450,0,0,0,23,267,290,9,299,0,O-6-28-05-03-01
HOIMA,BUGAHYA COUNTY,KIGOROBYA,KIBIRO,RUNGA P/S,132,0,2,0,16,66,84,3,87,0,O-6-28-05-03-02
HOIMA,BUGAHYA COUNTY,KIGOROBYA,KIGANJA,KYERAMYA P/S,650,1,0,1,108,414,524,5,529,0,O-6-28-05-04-01
HOIMA,BUGAHYA COUNTY,KIGOROBYA,KIGANJA,KIGANJA PARISH HQRS,597,1,2,1,54,355,413,22,435,0,O-6-28-05-04-02
HOIMA,BUGAHYA COUNTY,KIGOROBYA,KIGANJA,KIGOROBYA M/S,563,1,2,2,48,351,404,6,410,0,O-6-28-05-04-03
HOIMA,BUGAHYA COUNTY,KIGOROBYA,KIJONGO,KALYAMBUZI C.O.U (A-KA),334,4,1,1,57,182,245,2,247,0,O-6-28-05-05-01
HOIMA,BUGAHYA COUNTY,KIGOROBYA,KIJONGO,KIGOMBA T/C,494,3,3,3,48,320,377,13,390,0,O-6-28-05-05-02
HOIMA,BUGAHYA COUNTY,KIGOROBYA,KIJONGO,KALYAMBUZI C.O.U (KE-Z),528,1,2,5,90,281,379,20,399,0,O-6-28-05-05-03
HOIMA,BUGAHYA COUNTY,KIGOROBYA,KISUKUMA,KISUKUMA PARISH HQRS,772,1,3,2,84,471,561,28,589,0,O-6-28-05-06-01
HOIMA,BUGAHYA COUNTY,KIGOROBYA,KISUKUMA,KIKWANANA PWD,608,4,4,7,94,348,457,18,475,0,O-6-28-05-06-02
HOIMA,BUGAHYA COUNTY,KIGOROBYA,KISUKUMA,HAIBALE/KYAKASATO A,1020,6,4,8,111,571,700,37,737,0,O-6-28-05-06-03
HOIMA,BUGAHYA COUNTY,KIGOROBYA,KISUKUMA,HAIBALE/KYAKASATO B,567,7,2,4,55,338,406,15,421,0,O-6-28-05-06-04
HOIMA,BUGAHYA COUNTY,KIGOROBYA,KYABISAGAZI,KYABISAGAZI COU,656,6,2,4,46,362,420,36,456,0,O-6-28-05-07-01
HOIMA,BUGAHYA COUNTY,KIGOROBYA,KYABISAGAZI,KYABISAGAZI BAT,567,11,2,10,61,300,384,12,396,0,O-6-28-05-07-02
HOIMA,BUGAHYA COUNTY,KIGOROBYA TOWN COUNCIL,NORTH EAST WARD,KIKUMBA CELL,252,1,1,0,48,111,161,6,167,0,O-6-28-06-01-01
HOIMA,BUGAHYA COUNTY,KIGOROBYA TOWN COUNCIL,NORTH EAST WARD,KYAKAZOOBA CELL,219,0,0,2,31,94,127,3,130,0,O-6-28-06-01-02
HOIMA,BUGAHYA COUNTY,KIGOROBYA TOWN COUNCIL,NORTHERN WARD,KIRYANDONGO CELL,430,0,1,1,50,232,284,10,294,0,O-6-28-06-02-01
HOIMA,BUGAHYA COUNTY,KIGOROBYA TOWN COUNCIL,SOUTH EAST WARD,KIGOROBYA CELL (A-KA),589,3,2,2,90,294,391,4,395,0,O-6-28-06-03-01
HOIMA,BUGAHYA COUNTY,KIGOROBYA TOWN COUNCIL,SOUTH EAST WARD,KIGOROBYA CELL (KA-Z),438,2,0,0,54,218,274,7,281,0,O-6-28-06-03-02
HOIMA,BUGAHYA COUNTY,KIGOROBYA TOWN COUNCIL,SOUTH WEST WARD,KIKWANANA,391,1,2,0,71,215,289,7,296,0,O-6-28-06-04-01
HOIMA,BUGAHYA COUNTY,KITOBA,BIRUNGU,KISEKE P/S,682,3,1,1,52,473,530,19,549,0,O-6-28-07-01-01
HOIMA,BUGAHYA COUNTY,KITOBA,BIRUNGU,BUHAMBA P/S,772,5,3,4,114,503,629,17,646,0,O-6-28-07-01-02
HOIMA,BUGAHYA COUNTY,KITOBA,BIRUNGU,BIRUNGU CATHOLIC CHURCH (A-,486,2,1,0,50,307,360,5,365,0,O-6-28-07-01-03
HOIMA,BUGAHYA COUNTY,KITOBA,BIRUNGU,BIRUNGU CATHOLIC CHURCH (KI-,320,1,1,1,26,204,233,11,244,0,O-6-28-07-01-04
HOIMA,BUGAHYA COUNTY,KITOBA,BUDAKA,ISEISA P/S,629,4,3,1,50,421,479,22,501,0,O-6-28-07-02-01
HOIMA,BUGAHYA COUNTY,KITOBA,BUDAKA,BUBAALE T/C,279,1,3,1,23,164,192,7,199,0,O-6-28-07-02-02
HOIMA,BUGAHYA COUNTY,KITOBA,BUDAKA,BUDAKA P/S (A-KA),626,4,0,3,86,327,420,9,429,0,O-6-28-07-02-03
HOIMA,BUGAHYA COUNTY,KITOBA,BUDAKA,BUDAKA P/S (KA-Z),367,0,1,3,56,212,272,4,276,0,O-6-28-07-02-04
HOIMA,BUGAHYA COUNTY,KITOBA,BULYANGO,MBARARA P/S A,1020,7,3,6,63,629,708,24,732,0,O-6-28-07-03-01
HOIMA,BUGAHYA COUNTY,KITOBA,BULYANGO,BULYANGO (A-KA),508,1,0,3,56,335,395,12,407,0,O-6-28-07-03-02
HOIMA,BUGAHYA COUNTY,KITOBA,BULYANGO,MBARARA P/S B,453,5,0,2,19,292,318,15,333,0,O-6-28-07-03-03
HOIMA,BUGAHYA COUNTY,KITOBA,BULYANGO,BULYANGO (KA-Z),339,1,1,1,28,247,278,2,280,0,O-6-28-07-03-04
HOIMA,BUGAHYA COUNTY,KITOBA,KIBANJWA,BUHIGA CATHOLIC CHURCH,376,1,2,3,51,239,296,6,302,0,O-6-28-07-04-01
HOIMA,BUGAHYA COUNTY,KITOBA,KIBANJWA,KIBANJWA P/S,685,0,2,2,54,452,510,11,521,0,O-6-28-07-04-02
HOIMA,BUGAHYA COUNTY,KITOBA,KIBANJWA,BUKERENGE P/S,759,1,2,1,40,454,498,12,510,0,O-6-28-07-04-03
HOIMA,BUGAHYA COUNTY,KITOBA,KIRAGURA,KYESIGA CHURCH (A-KA),634,2,0,2,55,416,475,24,499,0,O-6-28-07-05-01
HOIMA,BUGAHYA COUNTY,KITOBA,KIRAGURA,KITOBA S/C HQRS,680,4,1,1,41,485,532,22,554,0,O-6-28-07-05-02
HOIMA,BUGAHYA COUNTY,KITOBA,KIRAGURA,PARAJWOKI P/S A,745,3,1,3,86,476,569,22,591,0,O-6-28-07-05-03
HOIMA,BUGAHYA COUNTY,KITOBA,KIRAGURA,DWOLI P/S,739,0,1,6,47,527,581,13,594,0,O-6-28-07-05-04
HOIMA,BUGAHYA COUNTY,KITOBA,KIRAGURA,KYESIGA CHURCH (KA-Z),302,3,1,1,28,201,234,8,242,0,O-6-28-07-05-05
HOIMA,BUGAHYA COUNTY,KITOBA,KIRYANGOBE,KIRYANGOBE COCOA NUTS,438,2,2,4,25,299,332,11,343,0,O-6-28-07-06-01
HOIMA,BUGAHYA COUNTY,KITOBA,KIRYANGOBE,KYABASENGYA SSS,906,2,3,7,73,611,696,33,729,0,O-6-28-07-06-02
HOIMA,BUGAHYA COUNTY,KITOBA,KIRYANGOBE,KITOBA P/S,465,4,0,1,33,305,343,8,351,0,O-6-28-07-06-03
HOIMA,BUGAHYA COUNTY,KYABIGAMBIRE,BULINDI,KAKINDO P/S A,512,3,0,1,33,307,344,7,351,0,O-6-28-08-01-01
HOIMA,BUGAHYA COUNTY,KYABIGAMBIRE,BULINDI,KIHORO P/S,702,6,1,3,98,404,512,5,517,0,O-6-28-08-01-02
HOIMA,BUGAHYA COUNTY,KYABIGAMBIRE,BULINDI,BULINDI DFI A,534,2,1,0,87,268,358,11,369,0,O-6-28-08-01-03
HOIMA,BUGAHYA COUNTY,KYABIGAMBIRE,BULINDI,KAKINDO P/S B,512,2,0,0,39,326,367,1,368,0,O-6-28-08-01-04
HOIMA,BUGAHYA COUNTY,KYABIGAMBIRE,BULINDI,BULINDI DFI,256,0,0,1,29,149,179,4,183,0,O-6-28-08-01-05
HOIMA,BUGAHYA COUNTY,KYABIGAMBIRE,BURARU,BURARU DISP,814,3,2,2,61,498,566,59,625,0,O-6-28-08-02-01
HOIMA,BUGAHYA COUNTY,KYABIGAMBIRE,BURARU,BUYANJA P/S (A-KA),509,2,2,7,38,312,361,9,370,0,O-6-28-08-02-02
HOIMA,BUGAHYA COUNTY,KYABIGAMBIRE,BURARU,KIBINGO P/S,754,4,2,1,79,443,529,8,537,0,O-6-28-08-02-03
HOIMA,BUGAHYA COUNTY,KYABIGAMBIRE,BURARU,KIRANGA COOP SOCIETY,752,4,2,5,51,470,532,14,546,0,O-6-28-08-02-04
HOIMA,BUGAHYA COUNTY,KYABIGAMBIRE,BURARU,KYABANATI,467,2,0,1,39,284,326,16,342,0,O-6-28-08-02-05
HOIMA,BUGAHYA COUNTY,KYABIGAMBIRE,BURARU,BUYANJA P/S (KE-Z),381,2,0,5,25,214,246,8,254,0,O-6-28-08-02-06
HOIMA,BUGAHYA COUNTY,KYABIGAMBIRE,KIBUGUBYA,KYABIGAMBIRE P/S 1,431,0,1,1,29,302,333,8,341,0,O-6-28-08-03-01
HOIMA,BUGAHYA COUNTY,KYABIGAMBIRE,KIBUGUBYA,KIBUGUBYA P/S,609,4,0,3,24,454,485,10,495,0,O-6-28-08-03-02
HOIMA,BUGAHYA COUNTY,KYABIGAMBIRE,KIBUGUBYA,KASOMORO P/S,315,0,0,0,29,218,247,5,252,0,O-6-28-08-03-03
HOIMA,BUGAHYA COUNTY,KYABIGAMBIRE,KIBUGUBYA,KATUGO P/S,942,3,3,3,62,656,727,37,764,0,O-6-28-08-03-04
HOIMA,BUGAHYA COUNTY,KYABIGAMBIRE,KIBUGUBYA,KYABIGAMBIRE P/S 2,308,0,1,1,29,221,252,3,255,0,O-6-28-08-03-05
HOIMA,BUGAHYA COUNTY,KYABIGAMBIRE,KIBUGUBYA,KYARUBANGA,310,0,0,5,16,242,263,2,265,0,O-6-28-08-03-06
HOIMA,BUGAHYA COUNTY,KYABIGAMBIRE,KIBUGUBYA,KIRYABUTUZI,384,0,0,0,30,254,284,18,302,0,O-6-28-08-03-07
HOIMA,BUGAHYA COUNTY,KYABIGAMBIRE,KISABAGWA,BUGANDALE P/S A,383,2,0,3,13,259,277,7,284,0,O-6-28-08-04-01
HOIMA,BUGAHYA COUNTY,KYABIGAMBIRE,KISABAGWA,KISABAGWA DISP,601,1,2,3,64,412,482,4,486,0,O-6-28-08-04-02
HOIMA,BUGAHYA COUNTY,KYABIGAMBIRE,KISABAGWA,NYAMIRIMA P/S,465,1,0,3,62,329,395,4,399,0,O-6-28-08-04-03
HOIMA,BUGAHYA COUNTY,KYABIGAMBIRE,KISABAGWA,BUGANDALE P/S B,467,4,4,0,10,320,338,11,349,0,O-6-28-08-04-04
HOIMA,BUGAHYA COUNTY,KYABIGAMBIRE,KISABAGWA,BINENEZA P/S,288,2,1,1,14,213,231,5,236,0,O-6-28-08-04-05
KABALE,KABALE MUNICIPALITY,KABALE CENTRAL,BUTOBERE,BUTOBERE S.S.S II,815,3,0,0,272,333,608,9,617,0,O-9-50-01-01-01
KABALE,KABALE MUNICIPALITY,KABALE CENTRAL,BUTOBERE,BUTOBERE S.S.S I,523,0,1,0,205,133,339,45,384,0,O-9-50-01-01-02
KABALE,KABALE MUNICIPALITY,KABALE CENTRAL,CENTRAL,MAKANGA - GOLF COURSE,515,2,1,0,103,182,288,11,299,0,O-9-50-01-02-01
KABALE,KABALE MUNICIPALITY,KABALE CENTRAL,CENTRAL,CENTRAL EAST,620,1,1,0,149,205,356,23,379,0,O-9-50-01-02-02
KABALE,KABALE MUNICIPALITY,KABALE CENTRAL,CENTRAL,CENTRAL CENTRAL STADIUM I,901,1,1,0,251,273,526,6,532,0,O-9-50-01-02-03
KABALE,KABALE MUNICIPALITY,KABALE CENTRAL,CENTRAL,KABALE STADIUM II,718,0,1,0,175,212,388,37,425,0,O-9-50-01-02-04
KABALE,KABALE MUNICIPALITY,KABALE CENTRAL,KIGONGI WARD,KIGONGI A (NEAR KARIBWIJE),795,2,0,1,224,212,439,65,504,0,O-9-50-01-03-01
KABALE,KABALE MUNICIPALITY,KABALE CENTRAL,KIGONGI WARD,KIGONGI B (NEAR PUB SCH.),943,0,4,1,278,263,546,11,557,0,O-9-50-01-03-02
KABALE,KABALE MUNICIPALITY,KABALE CENTRAL,KIGONGI WARD,KIGONGI C (NEAR BIRYABAREMA,111,0,1,0,23,50,74,3,77,0,O-9-50-01-03-03
KABALE,KABALE MUNICIPALITY,KABALE CENTRAL,KIGONGI WARD,KIGONGI D (NEAR ANGUYU'S CLIN,497,1,0,0,123,129,253,26,279,0,O-9-50-01-03-04
KABALE,KABALE MUNICIPALITY,KABALE CENTRAL,NYABIKONI,NYABIKONI P. SCHOOL I,682,1,1,1,170,243,416,59,475,0,O-9-50-01-04-01
KABALE,KABALE MUNICIPALITY,KABALE CENTRAL,NYABIKONI,NYABIKONI P. SCHOOL II,414,0,0,0,128,118,246,36,282,0,O-9-50-01-04-02
KABALE,KABALE MUNICIPALITY,KABALE CENTRAL,NYABIKONI,GOMBOLOLA HQRS I,556,0,1,0,171,146,318,34,352,0,O-9-50-01-04-03
KABALE,KABALE MUNICIPALITY,KABALE CENTRAL,NYABIKONI,GOMBOLOLA HQRS II,610,0,1,0,174,211,386,55,441,0,O-9-50-01-04-04
KABALE,KABALE MUNICIPALITY,KABALE NORTHERN,KIJUGUTA,RWAKARABA B,433,1,2,2,116,171,292,20,312,0,O-9-50-02-01-01
KABALE,KABALE MUNICIPALITY,KABALE NORTHERN,KIJUGUTA,KYETOBOKYEIRE,650,0,0,0,182,313,495,10,505,0,O-9-50-02-01-02
KABALE,KABALE MUNICIPALITY,KABALE NORTHERN,KIJUGUTA,RUGARAMA,365,1,1,0,85,168,255,8,263,0,O-9-50-02-01-03
KABALE,KABALE MUNICIPALITY,KABALE NORTHERN,KIJUGUTA,KATOJO,597,0,1,0,130,317,448,46,494,0,O-9-50-02-01-04
KABALE,KABALE MUNICIPALITY,KABALE NORTHERN,LOWER BUGONGI,KIGUGWE A K.H.S.P,878,2,0,0,167,283,452,56,508,0,O-9-50-02-02-01
KABALE,KABALE MUNICIPALITY,KABALE NORTHERN,LOWER BUGONGI,KIGUGWE B,147,0,0,0,28,54,82,9,91,0,O-9-50-02-02-02
KABALE,KABALE MUNICIPALITY,KABALE NORTHERN,LOWER BUGONGI,MAKANGA P/SCHOOL,791,0,0,0,179,316,495,7,502,0,O-9-50-02-02-03
KABALE,KABALE MUNICIPALITY,KABALE NORTHERN,RUTOOMA,IBUMBA,484,1,1,0,124,240,366,8,374,0,O-9-50-02-03-01
KABALE,KABALE MUNICIPALITY,KABALE NORTHERN,RUTOOMA,IBUMBA B,331,0,1,0,75,170,246,34,280,0,O-9-50-02-03-02
KABALE,KABALE MUNICIPALITY,KABALE NORTHERN,UPPER BUGONGI,RUSHAMBYA,614,0,1,1,188,330,520,10,530,0,O-9-50-02-04-01
KABALE,KABALE MUNICIPALITY,KABALE NORTHERN,UPPER BUGONGI,KAKABANO,1120,1,0,0,304,431,736,108,844,0,O-9-50-02-04-02
KABALE,KABALE MUNICIPALITY,KABALE SOUTHERN,KARUBANDA,OMUMIHANGA,504,1,1,1,130,194,327,77,404,0,O-9-50-03-01-01
KABALE,KABALE MUNICIPALITY,KABALE SOUTHERN,KARUBANDA,KARUBANDA,555,0,1,1,196,193,391,15,406,0,O-9-50-03-01-02
KABALE,KABALE MUNICIPALITY,KABALE SOUTHERN,KARUBANDA,RUSHOROZA,452,2,0,1,162,89,254,28,282,0,O-9-50-03-01-03
KABALE,KABALE MUNICIPALITY,KABALE SOUTHERN,KARUBANDA,KABAHANGARA,326,1,0,1,107,97,206,50,256,0,O-9-50-03-01-04
KABALE,KABALE MUNICIPALITY,KABALE SOUTHERN,KIRIGIMWE,NDORWA P. SCHOOL,557,1,0,0,192,127,320,45,365,0,O-9-50-03-02-01
KABALE,KABALE MUNICIPALITY,KABALE SOUTHERN,KIRIGIMWE,KAMUKIIRA,805,1,1,3,240,288,533,67,600,0,O-9-50-03-02-02
KABALE,KABALE MUNICIPALITY,KABALE SOUTHERN,KIRIGIMWE,KABALE N.T.C,442,0,0,1,150,128,279,3,282,0,O-9-50-03-02-03
KABALE,KABALE MUNICIPALITY,KABALE SOUTHERN,KIRIGIMWE,N.T.C NEAR LIBRARY,528,0,1,0,155,172,328,5,333,0,O-9-50-03-02-04
KABALE,KABALE MUNICIPALITY,KABALE SOUTHERN,KIRIGIMWE,OUTSIDE Q.GUARD,117,0,0,0,4,93,97,6,103,0,O-9-50-03-02-05
KABALE,KABALE MUNICIPALITY,KABALE SOUTHERN,MWANJARI,CEMETRY AREA,773,2,0,0,241,281,524,81,605,0,O-9-50-03-03-01
KABALE,KABALE MUNICIPALITY,KABALE SOUTHERN,MWANJARI,NDORWA SAZA HQRS,678,2,0,1,190,298,491,1,492,0,O-9-50-03-03-02
KABALE,KABALE MUNICIPALITY,KABALE SOUTHERN,MWANJARI,ST. MARY'S BOYS P. SCHOOL,663,0,0,1,218,198,417,90,507,0,O-9-50-03-03-03
KABALE,KABALE MUNICIPALITY,KABALE SOUTHERN,RUSHAKI,RUSHAKI I,617,3,2,2,218,231,456,11,467,0,O-9-50-03-04-01
KABALE,KABALE MUNICIPALITY,KABALE SOUTHERN,RUSHAKI,RUSHAKI II,585,6,1,0,186,252,445,18,463,0,O-9-50-03-04-02
KABALE,NDORWA CTY EAST,BUHARA,BUGARAMA,AHAMBUGA A,593,2,0,0,56,384,442,58,500,0,O-9-45-01-01-01
KABALE,NDORWA CTY EAST,BUHARA,BUGARAMA,AHAMBUGA B,670,1,0,6,85,462,554,16,570,0,O-9-45-01-01-02
KABALE,NDORWA CTY EAST,BUHARA,BUHARA,KIGUGO,706,3,0,3,128,361,495,36,531,0,O-9-45-01-02-01
KABALE,NDORWA CTY EAST,BUHARA,BUHARA,KASHAKI A,588,0,0,1,155,235,391,75,466,0,O-9-45-01-02-02
KABALE,NDORWA CTY EAST,BUHARA,BUHARA,KIJONJO,497,1,0,2,95,259,357,42,399,0,O-9-45-01-02-03
KABALE,NDORWA CTY EAST,BUHARA,KARWERU (KAFUNJO,NYABICWAMBA,636,1,1,0,72,399,473,60,533,0,O-9-45-01-03-01
KABALE,NDORWA CTY EAST,BUHARA,KARWERU (KAFUNJO,KABANYONYI,646,1,0,1,40,456,498,50,548,0,O-9-45-01-03-02
KABALE,NDORWA CTY EAST,BUHARA,KARWERU (KAFUNJO,KIGYERA,317,1,0,3,33,221,258,5,263,0,O-9-45-01-03-03
KABALE,NDORWA CTY EAST,BUHARA,KARWERU (KAFUNJO,KIRIMBE,440,0,0,1,30,262,293,84,377,0,O-9-45-01-03-04
KABALE,NDORWA CTY EAST,BUHARA,KITANGA,NYAMUCENGYERI,577,0,0,0,12,560,572,4,576,0,O-9-45-01-04-01
KABALE,NDORWA CTY EAST,BUHARA,KITANGA,RWANTAMBARA,509,5,0,2,34,362,403,11,414,0,O-9-45-01-04-02
KABALE,NDORWA CTY EAST,BUHARA,MUYEBE,KAGYENYI A,422,2,0,0,70,199,271,62,333,0,O-9-45-01-05-01
KABALE,NDORWA CTY EAST,BUHARA,MUYEBE,KAGYENYI B,429,1,0,0,63,282,346,6,352,0,O-9-45-01-05-02
KABALE,NDORWA CTY EAST,BUHARA,MUYEBE,KAGYENYI C,454,2,0,0,54,229,285,52,337,0,O-9-45-01-05-03
KABALE,NDORWA CTY EAST,BUHARA,MUYEBE,KAGYENYI D,432,1,2,0,40,265,308,1,309,0,O-9-45-01-05-04
KABALE,NDORWA CTY EAST,BUHARA,NTARABANA,AHAKINIAHAMWE A,630,0,0,0,59,394,453,96,549,0,O-9-45-01-06-01
KABALE,NDORWA CTY EAST,BUHARA,NTARABANA,AHAKINIAHAMWE B,547,1,2,1,56,397,457,12,469,0,O-9-45-01-06-02
KABALE,NDORWA CTY EAST,BUHARA,RWENE,KABAHESI P. SCHOOL,520,3,0,2,99,314,418,29,447,0,O-9-45-01-07-01
KABALE,NDORWA CTY EAST,BUHARA,RWENE,NYAMITEMBE A,795,0,0,1,91,426,518,93,611,0,O-9-45-01-07-02
KABALE,NDORWA CTY EAST,BUHARA,RWENE,RWENE T. CENTRE,630,0,0,0,78,313,391,121,512,0,O-9-45-01-07-03
KABALE,NDORWA CTY EAST,BUHARA,RWENE,NYAMITEMBE B,474,1,0,4,79,266,350,44,394,0,O-9-45-01-07-04
KABALE,NDORWA CTY EAST,KAHARO,BUGARAMA,NKUMBURA P/S,718,0,0,1,131,429,561,4,565,0,O-9-45-02-01-01
KABALE,NDORWA CTY EAST,KAHARO,BUGARAMA,NYAKIGUGWE P/S,325,0,0,1,97,143,241,8,249,0,O-9-45-02-01-02
KABALE,NDORWA CTY EAST,KAHARO,BUGARAMA,AHAKATOJO TRADING CENTRE,518,0,1,3,58,349,411,12,423,0,O-9-45-02-01-03
KABALE,NDORWA CTY EAST,KAHARO,BURAMBIRA,OMUKISYAMA A,538,1,0,0,33,436,470,2,472,0,O-9-45-02-02-01
KABALE,NDORWA CTY EAST,KAHARO,BURAMBIRA,OMUKISYAMA B,437,0,0,1,34,325,360,5,365,0,O-9-45-02-02-02
KABALE,NDORWA CTY EAST,KAHARO,KAHARO,AHAMUREMERE,647,1,0,0,75,411,487,56,543,0,O-9-45-02-03-01
KABALE,NDORWA CTY EAST,KAHARO,KAHARO,NYAKABUNGO,455,4,0,1,90,355,450,5,455,0,O-9-45-02-03-02
KABALE,NDORWA CTY EAST,KAHARO,KAHARO,NYAMUSHUNGWA,373,0,0,1,39,258,298,9,307,0,O-9-45-02-03-03
KABALE,NDORWA CTY EAST,KAHARO,KATENGA,KITOHWA P. SCHOOL A,145,0,0,1,19,122,142,3,145,0,O-9-45-02-04-01
KABALE,NDORWA CTY EAST,KAHARO,KATENGA,KITOHWA P. SCHOOL B,550,0,1,1,46,432,480,16,496,0,O-9-45-02-04-02
KABALE,NDORWA CTY EAST,KAHARO,KATENGA,NTUNGAMO P. SCHOOL,632,0,2,0,77,437,516,5,521,0,O-9-45-02-04-03
KABALE,NDORWA CTY EAST,KAHARO,KITOHWA,RWESASI A,721,0,0,1,94,439,534,60,594,0,O-9-45-02-05-01
KABALE,NDORWA CTY EAST,KAHARO,KITOHWA,RWESASI B,623,1,0,0,65,395,461,67,528,0,O-9-45-02-05-02
KABALE,NDORWA CTY EAST,KAHARO,NYAKASHARARA,KASHANDA A,617,1,0,3,60,430,494,0,494,0,O-9-45-02-06-01
KABALE,NDORWA CTY EAST,KAHARO,NYAKASHARARA,KASHANDA B,548,0,0,1,56,311,368,75,443,0,O-9-45-02-06-02
KABALE,NDORWA CTY EAST,KAHARO,NYAKASHARARA,KASHANDA C,563,0,0,0,60,354,414,58,472,0,O-9-45-02-06-03
KABALE,NDORWA CTY EAST,KAVU,KARWERU,RWAMIHANDA A,606,1,0,2,37,447,487,64,551,0,O-9-45-03-01-01
KABALE,NDORWA CTY EAST,KAVU,KARWERU,RWAMIHANDA B,553,0,0,0,27,442,469,2,471,0,O-9-45-03-01-02
KABALE,NDORWA CTY EAST,KAVU,KARWERU,OMUNKIRO T.C,648,1,0,2,55,444,502,28,530,0,O-9-45-03-01-03
KABALE,NDORWA CTY EAST,KAVU,NYANJA,NYANJA,626,0,0,0,55,430,485,7,492,0,O-9-45-03-02-01
KABALE,NDORWA CTY EAST,KAVU,NYANJA,KIGARAMA A,670,1,1,0,78,486,566,14,580,0,O-9-45-03-02-02
KABALE,NDORWA CTY EAST,KAVU,NYANJA,RWABAKINA,331,1,0,1,32,222,256,26,282,0,O-9-45-03-02-03
KABALE,NDORWA CTY EAST,KAVU,RUGARAMA,MIGYERA/RUGARAMA I,585,0,0,1,141,295,437,49,486,0,O-9-45-03-03-01
KABALE,NDORWA CTY EAST,KAVU,RUGARAMA,MIGYERA/RUGARAMA II,332,0,0,0,57,210,267,5,272,0,O-9-45-03-03-02
KABALE,NDORWA CTY EAST,KAVU,RUGARAMA,MIGYERA/RUGARAMA III,375,0,0,0,62,257,319,20,339,0,O-9-45-03-03-03
KABALE,NDORWA CTY EAST,KYANAMIRA,KANJOBE,NYAKIGA,731,0,1,0,46,596,643,12,655,0,O-9-45-04-01-01
KABALE,NDORWA CTY EAST,KYANAMIRA,KANJOBE,KAMWIRIMA,277,1,0,0,27,215,243,7,250,0,O-9-45-04-01-02
KABALE,NDORWA CTY EAST,KYANAMIRA,KATOKYE,NYAKIJUMBA P. SCHOOL,625,1,1,1,168,270,441,67,508,0,O-9-45-04-02-01
KABALE,NDORWA CTY EAST,KYANAMIRA,KATOKYE,RWAKASHANDE PLAY GROUND,653,8,0,2,192,339,541,10,551,0,O-9-45-04-02-02
KABALE,NDORWA CTY EAST,KYANAMIRA,KIGATA,KANGANZI,539,3,1,4,74,321,403,39,442,0,O-9-45-04-03-01
KABALE,NDORWA CTY EAST,KYANAMIRA,KIGATA,KABIRA,568,2,0,1,80,388,471,8,479,0,O-9-45-04-03-02
KABALE,NDORWA CTY EAST,KYANAMIRA,KIGATA,KAKUMBYA,372,1,2,1,60,231,295,11,306,0,O-9-45-04-03-03
KABALE,NDORWA CTY EAST,KYANAMIRA,KIGATA,NYAKIGANDO,367,0,0,0,57,219,276,14,290,0,O-9-45-04-03-04
KABALE,NDORWA CTY EAST,KYANAMIRA,KYANAMIRA,KYANAMIRA P. SCHOOL,781,2,0,0,126,505,633,25,658,0,O-9-45-04-04-01
KABALE,NDORWA CTY EAST,KYANAMIRA,KYANAMIRA,KYANAMIRA GOMB HQRS,710,2,1,2,140,403,548,11,559,0,O-9-45-04-04-02
KABALE,NDORWA CTY EAST,KYANAMIRA,MUYUMBU,NYAKIJU CATHOLIC CHURCH,413,2,0,1,139,210,352,15,367,0,O-9-45-04-05-01
KABALE,NDORWA CTY EAST,KYANAMIRA,MUYUMBU,KABULA T. CENTRE,504,0,1,1,151,217,370,48,418,0,O-9-45-04-05-02
KABALE,NDORWA CTY EAST,KYANAMIRA,MUYUMBU,HAKISHAAHA,424,3,0,0,126,215,344,3,347,0,O-9-45-04-05-03
KABALE,NDORWA CTY EAST,KYANAMIRA,NYABUSHABI,NYAMWERAMBIKO P. SCHOOL,566,0,0,0,54,353,407,58,465,0,O-9-45-04-06-01
KABALE,NDORWA CTY EAST,KYANAMIRA,NYABUSHABI,KARUBANDA I,515,2,0,0,113,239,354,87,441,0,O-9-45-04-06-02
KABALE,NDORWA CTY EAST,KYANAMIRA,NYABUSHABI,KAYORERO PRIMARY SCHOOL,536,1,0,1,121,251,374,50,424,0,O-9-45-04-06-03
KABALE,NDORWA CTY EAST,KYANAMIRA,NYABUSHABI,BUGOMORA PRIMARY SCHOOL,84,0,0,0,11,41,52,14,66,0,O-9-45-04-06-04
KABALE,NDORWA CTY EAST,KYANAMIRA,NYAKAGYERA,NYAKAGYERA P. SCHOOL,509,0,1,1,115,299,416,14,430,0,O-9-45-04-07-01
KABALE,NDORWA CTY EAST,KYANAMIRA,NYAKAGYERA,RWANSHENYIRE CATH. CHURCH,291,1,2,0,44,153,200,40,240,0,O-9-45-04-07-02
KABALE,NDORWA CTY EAST,MAZIBA,BIRAMBO,BIRAMBO I,554,1,0,0,30,381,412,33,445,0,O-9-45-05-01-01
KABALE,NDORWA CTY EAST,MAZIBA,BIRAMBO,BIRAMBO II,748,2,0,2,122,455,581,8,589,0,O-9-45-05-01-02
KABALE,NDORWA CTY EAST,MAZIBA,BIRAMBO,BIRAMBO III,479,2,0,0,43,385,430,10,440,0,O-9-45-05-01-03
KABALE,NDORWA CTY EAST,MAZIBA,KAHONDO,KAHONDO A,945,2,0,1,116,389,508,0,508,0,O-9-45-05-02-01
KABALE,NDORWA CTY EAST,MAZIBA,KAHONDO,KAHONDO B,735,0,0,1,175,372,548,35,583,0,O-9-45-05-02-02
KABALE,NDORWA CTY EAST,MAZIBA,KARWERU,AKAGANA P. SCHOOL A,687,1,0,4,35,547,587,10,597,0,O-9-45-05-03-01
KABALE,NDORWA CTY EAST,MAZIBA,KARWERU,AKAGANA P. SCHOOL B,357,0,0,0,0,0,0,0,0,1,O-9-45-05-03-02
KABALE,NDORWA CTY WEST,BUTANDA,BIGAAGA,KASUMO,724,3,0,1,41,534,579,11,590,0,O-9-46-01-01-01
KABALE,NDORWA CTY WEST,BUTANDA,BIGAAGA,MURANDAMO,278,0,0,0,16,195,211,6,217,0,O-9-46-01-01-02
KABALE,NDORWA CTY WEST,BUTANDA,BIGAAGA,KAGOGO,749,0,1,3,74,646,724,4,728,0,O-9-46-01-01-03
KABALE,NDORWA CTY WEST,BUTANDA,BIGAAGA,NYINABIRERE,221,0,0,0,6,176,182,4,186,0,O-9-46-01-01-04
KABALE,NDORWA CTY WEST,BUTANDA,BIGAAGA,KABERE,299,2,0,0,12,274,288,0,288,0,O-9-46-01-01-05
KABALE,NDORWA CTY WEST,BUTANDA,BUTANDA,BUTANDA I,514,1,0,0,29,484,514,0,514,0,O-9-46-01-02-01
KABALE,NDORWA CTY WEST,BUTANDA,BUTANDA,BUTANDA II,352,0,1,3,39,306,349,1,350,0,O-9-46-01-02-02
KABALE,NDORWA CTY WEST,BUTANDA,BUTANDA,BUTANDA III,380,0,0,3,24,232,259,49,308,0,O-9-46-01-02-03
KABALE,NDORWA CTY WEST,BUTANDA,BUTANDA,BUTANDA IV,532,4,0,3,38,371,416,1,417,0,O-9-46-01-02-04
KABALE,NDORWA CTY WEST,BUTANDA,BUTANDA,KABAYA PRI SCHOOL,246,0,0,0,23,174,197,18,215,0,O-9-46-01-02-05
KABALE,NDORWA CTY WEST,BUTANDA,KAHUNGYE,RWENKORONGO,573,4,0,2,97,291,394,45,439,0,O-9-46-01-03-01
KABALE,NDORWA CTY WEST,BUTANDA,KAHUNGYE,KINYAMI,529,2,0,2,31,411,446,6,452,0,O-9-46-01-03-02
KABALE,NDORWA CTY WEST,BUTANDA,KAHUNGYE,NYAKAHANDA,410,1,0,2,71,259,333,12,345,0,O-9-46-01-03-03
KABALE,NDORWA CTY WEST,BUTANDA,NYAMIRYANGO,KIFURUGUTU/NYAMIRYANGO,504,0,0,0,47,372,419,38,457,0,O-9-46-01-04-01
KABALE,NDORWA CTY WEST,BUTANDA,NYAMIRYANGO,KYEVU,304,0,0,0,18,281,299,0,299,0,O-9-46-01-04-02
KABALE,NDORWA CTY WEST,BUTANDA,NYAMIRYANGO,KINYAMARI I,273,1,0,1,8,260,270,2,272,0,O-9-46-01-04-03
KABALE,NDORWA CTY WEST,BUTANDA,NYAMIRYANGO,KAGOMA,445,1,0,1,34,375,411,21,432,0,O-9-46-01-04-04
KABALE,NDORWA CTY WEST,BUTANDA,NYAMIRYANGO,RUTOJO PRI. SCHOOL,243,0,0,1,22,179,202,3,205,0,O-9-46-01-04-05
KABALE,NDORWA CTY WEST,KAMUGANGUZI,BURANGA,KABALIISA,672,6,3,1,143,388,541,3,544,0,O-9-46-02-01-01
KABALE,NDORWA CTY WEST,KAMUGANGUZI,BURANGA,KIKOLE,534,0,0,0,80,288,368,61,429,0,O-9-46-02-01-02
KABALE,NDORWA CTY WEST,KAMUGANGUZI,BURANGA,RUKARANGA,323,1,1,0,59,237,298,1,299,0,O-9-46-02-01-03
KABALE,NDORWA CTY WEST,KAMUGANGUZI,KASHEREGYENYI,NYAKARINDI,627,1,0,0,62,381,444,48,492,0,O-9-46-02-02-01
KABALE,NDORWA CTY WEST,KAMUGANGUZI,KASHEREGYENYI,RWAMACHUMU,365,1,0,0,70,199,270,29,299,0,O-9-46-02-02-02
KABALE,NDORWA CTY WEST,KAMUGANGUZI,KASHEREGYENYI,NYAKASHARARA,407,0,0,1,61,276,338,7,345,0,O-9-46-02-02-03
KABALE,NDORWA CTY WEST,KAMUGANGUZI,KATENGA,KATENGA A,786,7,1,3,97,556,664,9,673,0,O-9-46-02-03-01
KABALE,NDORWA CTY WEST,KAMUGANGUZI,KATENGA,KATENGA B,686,0,1,2,97,441,541,17,558,0,O-9-46-02-03-02
KABALE,NDORWA CTY WEST,KAMUGANGUZI,KICUMBI,NYAMABARE,559,0,0,2,75,341,418,80,498,0,O-9-46-02-04-01
KABALE,NDORWA CTY WEST,KAMUGANGUZI,KICUMBI,NYAKATEETE B,586,0,0,0,202,196,398,65,463,0,O-9-46-02-04-02
KABALE,NDORWA CTY WEST,KAMUGANGUZI,KICUMBI,NYAKATOOMA,500,0,1,4,87,311,403,9,412,0,O-9-46-02-04-03
KABALE,NDORWA CTY WEST,KAMUGANGUZI,KISAASA,KITOJO,421,0,0,1,35,370,406,7,413,0,O-9-46-02-05-01
KABALE,NDORWA CTY WEST,KAMUGANGUZI,KISAASA,KAMUKUNGU,405,0,1,0,29,364,394,9,403,0,O-9-46-02-05-02
KABALE,NDORWA CTY WEST,KAMUGANGUZI,KISAASA,NYACONGA,269,0,0,0,36,184,220,14,234,0,O-9-46-02-05-03
KABALE,NDORWA CTY WEST,KAMUGANGUZI,KYASANO,HAKABUNGO,496,2,1,1,90,288,382,58,440,0,O-9-46-02-06-01
KABALE,NDORWA CTY WEST,KAMUGANGUZI,KYASANO,KAGOROGORO,535,0,0,0,37,462,499,5,504,0,O-9-46-02-06-02
KABALE,NDORWA CTY WEST,KAMUGANGUZI,KYASANO,MUGOBOLE,506,0,0,0,20,482,502,0,502,0,O-9-46-02-06-03
KABALE,NDORWA CTY WEST,KAMUGANGUZI,KYASANO,BUMBA,472,2,0,1,29,361,393,47,440,0,O-9-46-02-06-04
KABALE,NDORWA CTY WEST,KAMUGANGUZI,MAYENGO,KINIOGO,994,0,2,0,93,517,612,141,753,0,O-9-46-02-07-01
KABALE,NDORWA CTY WEST,KAMUGANGUZI,MAYENGO,KYONYO C.O.U I,570,0,1,2,69,406,478,13,491,0,O-9-46-02-07-02
KABALE,NDORWA CTY WEST,KAMUGANGUZI,MAYENGO,KYONYO C.O.U II,543,2,1,0,63,394,460,17,477,0,O-9-46-02-07-03
KABALE,NDORWA CTY WEST,KITUMBA,BUKORA,KIJURERA I,472,0,0,0,79,286,365,42,407,0,O-9-46-03-01-01
KABALE,NDORWA CTY WEST,KITUMBA,BUKORA,KIJURERA II,483,0,1,0,78,316,395,25,420,0,O-9-46-03-01-02
KABALE,NDORWA CTY WEST,KITUMBA,BUKORA,HAMUGANDA,674,1,0,0,64,477,542,11,553,0,O-9-46-03-01-03
KABALE,NDORWA CTY WEST,KITUMBA,BUKORA,KABIRA,769,2,0,2,80,539,623,8,631,0,O-9-46-03-01-04
KABALE,NDORWA CTY WEST,KITUMBA,BUSHURO,NKOMBE,815,1,0,2,202,424,629,13,642,0,O-9-46-03-02-01
KABALE,NDORWA CTY WEST,KITUMBA,BUSHURO,KABINDI,661,0,0,1,163,385,549,2,551,0,O-9-46-03-02-02
KABALE,NDORWA CTY WEST,KITUMBA,BUSHURO,KEITANKOMBE,534,4,0,1,111,400,516,7,523,0,O-9-46-03-02-03
KABALE,NDORWA CTY WEST,KITUMBA,BWAMA ISLAND,BWAMA ISLAND,239,2,0,0,71,146,219,1,220,0,O-9-46-03-03-01
KABALE,NDORWA CTY WEST,KITUMBA,KITUMBA,RWABIRUNDO I,624,2,1,2,171,318,494,18,512,0,O-9-46-03-04-01
KABALE,NDORWA CTY WEST,KITUMBA,KITUMBA,RWABIRUNDO II,337,0,1,0,47,199,247,24,271,0,O-9-46-03-04-02
KABALE,NDORWA CTY WEST,KITUMBA,MWENDO,MWIRANGIZO,694,1,1,3,148,327,480,102,582,0,O-9-46-03-05-01
KABALE,NDORWA CTY WEST,KITUMBA,MWENDO,MUTAABA,441,3,0,0,68,292,363,13,376,0,O-9-46-03-05-02
KABALE,NDORWA CTY WEST,KITUMBA,MWENDO,KYAMAREBURA,709,4,3,3,81,413,504,64,568,0,O-9-46-03-05-03
KABALE,NDORWA CTY WEST,KITUMBA,MWENDO,KAKOMO P/S,459,1,3,1,64,328,397,21,418,0,O-9-46-03-05-04
KABALE,NDORWA CTY WEST,RUBAYA,BURAMBA,RWANGANIRO,552,1,0,3,68,356,428,12,440,0,O-9-46-04-01-01
KABALE,NDORWA CTY WEST,RUBAYA,BURAMBA,NYAMUHOMBORI,567,1,1,0,69,357,428,55,483,0,O-9-46-04-01-02
KABALE,NDORWA CTY WEST,RUBAYA,BURAMBA,RWEMIHANGA,660,1,0,0,84,341,426,121,547,0,O-9-46-04-01-03
KABALE,NDORWA CTY WEST,RUBAYA,KARUJANGA,KARUJANGA P. GROUND,658,2,0,0,112,339,453,20,473,0,O-9-46-04-02-01
KABALE,NDORWA CTY WEST,RUBAYA,KARUJANGA,KARUJANGA MARKET,656,1,2,2,115,383,503,18,521,0,O-9-46-04-02-02
KABALE,NDORWA CTY WEST,RUBAYA,KARUJANGA,NYINARUSHENGYE PLAY GROUN,674,0,1,1,127,300,429,65,494,0,O-9-46-04-02-03
KABALE,NDORWA CTY WEST,RUBAYA,KARUJANGA,KISIBO P. GROUND,525,4,0,1,70,298,373,51,424,0,O-9-46-04-02-04
KABALE,NDORWA CTY WEST,RUBAYA,KIBUGA,KIBUGA P. SCHOOL,564,1,1,0,34,385,421,13,434,0,O-9-46-04-03-01
KABALE,NDORWA CTY WEST,RUBAYA,KIBUGA,RWAZA P. SCHOOL,441,1,0,0,72,204,277,44,321,0,O-9-46-04-03-02
KABALE,NDORWA CTY WEST,RUBAYA,KIBUGA,KIBUGA PARISH HQRS,536,1,1,0,34,385,421,13,434,0,O-9-46-04-03-03
KABALE,NDORWA CTY WEST,RUBAYA,KIBUGA,RUTARE P. SCHOOL,535,2,0,1,36,383,422,69,491,0,O-9-46-04-03-04
KABALE,NDORWA CTY WEST,RUBAYA,KITOOMA,RWABIHINDU - KITOOMA S/DISP.,425,0,1,0,25,304,330,4,334,0,O-9-46-04-04-01
KABALE,NDORWA CTY WEST,RUBAYA,KITOOMA,NYABIGORE PLAY GROUND,559,0,0,0,24,411,435,16,451,0,O-9-46-04-04-02
KABALE,NDORWA CTY WEST,RUBAYA,KITOOMA,HABUGARAMA,180,0,0,0,14,149,163,1,164,0,O-9-46-04-04-03
KABALE,NDORWA CTY WEST,RUBAYA,KITOOMA,BUTENGA COU,392,2,0,0,12,305,319,11,330,0,O-9-46-04-04-04
KABALE,NDORWA CTY WEST,RUBAYA,MUGANDU,NYAKITOKORI,717,2,1,0,30,566,599,13,612,0,O-9-46-04-05-01
KABALE,NDORWA CTY WEST,RUBAYA,MUGANDU,RUKORE,423,0,1,0,56,225,282,34,316,0,O-9-46-04-05-02
KABALE,NDORWA CTY WEST,RUBAYA,MUGANDU,KIGARAMA,443,1,1,1,4,361,368,20,388,0,O-9-46-04-05-03
KABALE,NDORWA CTY WEST,RUBAYA,MUGANDU,RYAKARIMIRA MARKET,351,0,0,0,39,223,262,10,272,0,O-9-46-04-05-04
KABALE,NDORWA CTY WEST,RUBAYA,RWANYENA,KABIRAGO,682,2,1,0,44,506,553,5,558,0,O-9-46-04-06-01
KABALE,NDORWA CTY WEST,RUBAYA,RWANYENA,MUSAMBA PITCH,641,2,0,1,53,372,428,56,484,0,O-9-46-04-06-02
KABALE,NDORWA CTY WEST,RUBAYA,RWANYENA,RWANYENA P. SCHOOL,487,1,0,1,11,426,439,1,440,0,O-9-46-04-06-03
KABALE,NDORWA CTY WEST,RUBAYA,RWANYENA,AHAMURAMBO TC,499,0,0,0,57,342,399,5,404,0,O-9-46-04-06-04
KABAROLE,BURAHYA COUNTY,BUKUUKU,KARAGO,BUKUUKU,739,0,0,0,56,246,302,18,320,0,O-10-52-01-01-01
KABAROLE,BURAHYA COUNTY,BUKUUKU,KARAGO,BURERA,588,1,2,2,50,404,459,11,470,0,O-10-52-01-01-02
KABAROLE,BURAHYA COUNTY,BUKUUKU,KARAGO,IBONDE,846,1,1,0,76,414,492,25,517,0,O-10-52-01-01-03
KABAROLE,BURAHYA COUNTY,BUKUUKU,KARAGO,KANYAMURA,544,2,2,11,188,151,354,0,354,0,O-10-52-01-01-04
KABAROLE,BURAHYA COUNTY,BUKUUKU,KARAGO,KARAGO,473,0,0,1,25,300,326,4,330,0,O-10-52-01-01-05
KABAROLE,BURAHYA COUNTY,BUKUUKU,KARAGO,IBONDE C.O.U,262,0,0,0,35,82,117,6,123,0,O-10-52-01-01-06
KABAROLE,BURAHYA COUNTY,BUKUUKU,KARAGO,NYAKITOKOLI,589,2,0,10,186,232,430,6,436,0,O-10-52-01-01-07
KABAROLE,BURAHYA COUNTY,BUKUUKU,KAZINGO,KATUNGURU,855,2,2,5,58,554,621,31,652,0,O-10-52-01-02-01
KABAROLE,BURAHYA COUNTY,BUKUUKU,KAZINGO,KAZINGO,776,1,3,6,60,434,504,20,524,0,O-10-52-01-02-02
KABAROLE,BURAHYA COUNTY,BUKUUKU,KAZINGO,KIBAGA (A-K),540,5,1,5,84,248,343,11,354,0,O-10-52-01-02-03
KABAROLE,BURAHYA COUNTY,BUKUUKU,KAZINGO,NYANGO,809,5,0,5,54,439,503,25,528,0,O-10-52-01-02-04
KABAROLE,BURAHYA COUNTY,BUKUUKU,KAZINGO,KIBAGA B (M-Z),423,3,1,3,98,139,244,18,262,0,O-10-52-01-02-05
KABAROLE,BURAHYA COUNTY,BUKUUKU,KIGUMA,KIGUMA P. SCHOOL,840,2,2,3,51,558,616,14,630,0,O-10-52-01-03-01
KABAROLE,BURAHYA COUNTY,BUKUUKU,KIGUMA,MANYINDO'S COMPOUND,395,0,0,1,36,263,300,7,307,0,O-10-52-01-03-02
KABAROLE,BURAHYA COUNTY,BUKUUKU,KIGUMA,PAT KIIZA'S COMPOUND,248,0,0,0,13,197,210,4,214,0,O-10-52-01-03-03
KABAROLE,BURAHYA COUNTY,BUSORO,BUSORO,BUSORO SUBCOUNTY HQRS,608,2,1,2,45,328,378,13,391,0,O-10-52-02-01-01
KABAROLE,BURAHYA COUNTY,BUSORO,BUSORO,KIRERE SLOW HOUSE,387,2,3,4,23,254,286,11,297,0,O-10-52-02-01-02
KABAROLE,BURAHYA COUNTY,BUSORO,BUSORO,NGOMBE PRIMARY SCHOOL,789,1,0,3,79,418,501,54,555,0,O-10-52-02-01-03
KABAROLE,BURAHYA COUNTY,BUSORO,BUSORO,NYABUSHENYI,403,3,2,1,19,240,265,5,270,0,O-10-52-02-01-04
KABAROLE,BURAHYA COUNTY,BUSORO,IBALE,IBAALE,456,1,1,2,36,293,333,12,345,0,O-10-52-02-02-01
KABAROLE,BURAHYA COUNTY,BUSORO,IBALE,KANYAMAKERRE,99,0,0,0,7,65,72,1,73,0,O-10-52-02-02-02
KABAROLE,BURAHYA COUNTY,BUSORO,KASWA,KASWA T. CENTRE A,1263,5,2,3,74,415,499,24,523,0,O-10-52-02-03-01
KABAROLE,BURAHYA COUNTY,BUSORO,KASWA,KIAMARA A,892,6,4,7,31,317,365,28,393,0,O-10-52-02-03-02
KABAROLE,BURAHYA COUNTY,BUSORO,KASWA,KIAMARA B,758,2,0,2,33,246,283,17,300,0,O-10-52-02-03-03
KABAROLE,BURAHYA COUNTY,BUSORO,KASWA,MPANGA,425,1,0,3,13,137,154,34,188,0,O-10-52-02-03-04
KABAROLE,BURAHYA COUNTY,BUSORO,KASWA,KASWA T. CENTRE B,657,2,0,1,36,317,356,34,390,0,O-10-52-02-03-05
KABAROLE,BURAHYA COUNTY,BUSORO,RWENGAJU,BWABYA,842,4,3,6,52,511,576,24,600,0,O-10-52-02-04-01
KABAROLE,BURAHYA COUNTY,BUSORO,RWENGAJU,KICUNA,720,1,5,4,73,430,513,25,538,0,O-10-52-02-04-02
KABAROLE,BURAHYA COUNTY,BUSORO,RWENGAJU,KIDUBURI A,871,4,2,6,61,536,609,18,627,0,O-10-52-02-04-03
KABAROLE,BURAHYA COUNTY,BUSORO,RWENGAJU,KYEMBOGO,178,1,0,0,13,114,128,8,136,0,O-10-52-02-04-04
KABAROLE,BURAHYA COUNTY,BUSORO,RWENGAJU,KIDUBURI B,732,0,1,0,29,353,383,0,383,0,O-10-52-02-04-05
KABAROLE,BURAHYA COUNTY,HAKIBALE,KABENDE,KABENDE CENTRE A,384,3,1,4,30,263,301,8,309,0,O-10-52-03-01-01
KABAROLE,BURAHYA COUNTY,HAKIBALE,KABENDE,KABENDE CENTRE B,402,2,0,2,20,276,300,19,319,0,O-10-52-03-01-02
KABAROLE,BURAHYA COUNTY,HAKIBALE,KABENDE,KYAKABASEKE,663,3,1,7,48,421,480,23,503,0,O-10-52-03-01-03
KABAROLE,BURAHYA COUNTY,HAKIBALE,KABENDE,KYANGABUKAMA A,444,3,0,2,27,260,292,19,311,0,O-10-52-03-01-04
KABAROLE,BURAHYA COUNTY,HAKIBALE,KABENDE,KABENDE C,602,4,1,3,23,431,462,9,471,0,O-10-52-03-01-05
KABAROLE,BURAHYA COUNTY,HAKIBALE,KABENDE,KABENDE D,269,0,2,1,23,170,196,13,209,0,O-10-52-03-01-06
KABAROLE,BURAHYA COUNTY,HAKIBALE,KABENDE,KYANGABUKAMA B,381,2,1,1,21,251,276,6,282,0,O-10-52-03-01-07
KABAROLE,BURAHYA COUNTY,HAKIBALE,KAHANGI,HAIBALE,536,2,0,3,22,361,388,13,401,0,O-10-52-03-02-01
KABAROLE,BURAHYA COUNTY,HAKIBALE,KAHANGI,KOMYAMPERE P. S.,539,2,2,0,41,388,433,0,433,0,O-10-52-03-02-02
KABAROLE,BURAHYA COUNTY,HAKIBALE,KAHANGI,KYARWAGONYA,479,1,0,3,28,366,398,10,408,0,O-10-52-03-02-03
KABAROLE,BURAHYA COUNTY,HAKIBALE,KAHANGI,NTEZI II,347,1,0,1,24,251,277,4,281,0,O-10-52-03-02-04
KABAROLE,BURAHYA COUNTY,HAKIBALE,KIBASI,BUNYONYI P. SCHOOL,578,1,1,1,14,323,340,110,450,0,O-10-52-03-03-01
KABAROLE,BURAHYA COUNTY,HAKIBALE,KIBASI,KIBASI PARISH HQRS A,656,1,1,4,25,390,421,20,441,0,O-10-52-03-03-02
KABAROLE,BURAHYA COUNTY,HAKIBALE,KIBASI,KIBASI PARISH HQRS B,365,0,0,1,16,244,261,4,265,0,O-10-52-03-03-03
KABAROLE,BURAHYA COUNTY,HAKIBALE,KIBASI,KYAIRUMBA P. SCHOOL,676,3,4,3,52,410,472,14,486,0,O-10-52-03-03-04
KABAROLE,BURAHYA COUNTY,HAKIBALE,KIBASI,MIRONGO VILLAGE,462,2,1,5,19,328,355,24,379,0,O-10-52-03-03-05
KABAROLE,BURAHYA COUNTY,HAKIBALE,KIBURARA,KATUMBA,361,0,0,0,18,264,282,7,289,0,O-10-52-03-04-01
KABAROLE,BURAHYA COUNTY,HAKIBALE,KIBURARA,KIBURARA,608,1,2,3,35,343,384,79,463,0,O-10-52-03-04-02
KABAROLE,BURAHYA COUNTY,HAKIBALE,KIBURARA,NYABUHUKA,637,2,1,1,59,422,485,16,501,0,O-10-52-03-04-03
KABAROLE,BURAHYA COUNTY,HAKIBALE,KIJURA,BUTUKU,464,5,0,5,31,263,304,11,315,0,O-10-52-03-05-01
KABAROLE,BURAHYA COUNTY,HAKIBALE,KIJURA,GOGONYA,750,6,0,4,57,498,565,51,616,0,O-10-52-03-05-02
KABAROLE,BURAHYA COUNTY,HAKIBALE,KIJURA,KYAITAMBA A,535,2,0,2,50,315,369,6,375,0,O-10-52-03-05-03
KABAROLE,BURAHYA COUNTY,HAKIBALE,KIJURA,KYAITAMBA B,1262,5,2,3,80,585,675,28,703,0,O-10-52-03-05-04
KABAROLE,BURAHYA COUNTY,HAKIBALE,KIJURA,MUBALI,803,1,3,12,27,568,611,18,629,0,O-10-52-03-05-05
KABAROLE,BURAHYA COUNTY,HAKIBALE,KIJURA,NSORRO,715,0,8,8,67,404,487,14,501,0,O-10-52-03-05-06
KABAROLE,BURAHYA COUNTY,HAKIBALE,KITULI,KITULE PARISH HQRS,621,0,2,3,33,454,492,17,509,0,O-10-52-03-06-01
KABAROLE,BURAHYA COUNTY,HAKIBALE,KITULI,KYABUBI KAKWORO CELL HQRS,227,0,0,2,8,191,201,10,211,0,O-10-52-03-06-02
KABAROLE,BURAHYA COUNTY,HAKIBALE,KITULI,MUHANGI P. SCHOOL,459,1,0,1,15,393,410,10,420,0,O-10-52-03-06-03
KABAROLE,BURAHYA COUNTY,KARAMBI,BUTEBE,BUTEBE SAZA HQRS,764,1,0,4,78,483,566,9,575,0,O-10-52-04-01-01
KABAROLE,BURAHYA COUNTY,KARAMBI,BUTEBE,JUMA'S PLACE,703,3,2,6,82,445,538,23,561,0,O-10-52-04-01-02
KABAROLE,BURAHYA COUNTY,KARAMBI,BUTEBE,KAHIJU S.S.S.,726,2,1,0,55,436,494,20,514,0,O-10-52-04-01-03
KABAROLE,BURAHYA COUNTY,KARAMBI,BUTEBE,MUKONOMURA CATHOLIC CHURC,613,0,0,1,36,423,460,18,478,0,O-10-52-04-01-04
KABAROLE,BURAHYA COUNTY,KARAMBI,KARAMBI,HUMURA,482,1,1,0,45,304,351,8,359,0,O-10-52-04-02-01
KABAROLE,BURAHYA COUNTY,KARAMBI,KARAMBI,KARAMBI P. SCHOOL,838,4,0,2,69,480,555,10,565,0,O-10-52-04-02-02
KABAROLE,BURAHYA COUNTY,KARAMBI,KARAMBI,KARAMBI PARISH HQRS,521,1,0,0,63,277,341,9,350,0,O-10-52-04-02-03
KABAROLE,BURAHYA COUNTY,KARAMBI,KARAMBI,MILE 6 TRADING CENTRE,807,1,1,1,45,443,491,3,494,0,O-10-52-04-02-04
KABAROLE,BURAHYA COUNTY,KARAMBI,KARAMBI,KIDUKURU,320,0,0,0,37,186,223,5,228,0,O-10-52-04-02-05
KABAROLE,BURAHYA COUNTY,KARAMBI,RUBINGO,KASINDE,737,1,1,4,61,496,563,14,577,0,O-10-52-04-03-01
KABAROLE,BURAHYA COUNTY,KARAMBI,RUBINGO,RUBINGO,650,0,1,3,90,396,490,4,494,0,O-10-52-04-03-02
KABAROLE,BURAHYA COUNTY,KARAMBI,RUBINGO,RWABAGANDA,650,3,1,3,47,433,487,7,494,0,O-10-52-04-03-03
KABAROLE,BURAHYA COUNTY,KARAMBI,RUBINGO,RWABAGANDA B,380,1,0,1,10,292,304,6,310,0,O-10-52-04-03-04
KABAROLE,BURAHYA COUNTY,KICWAMBA,BWANIKA,BUAIGA/WANKYA,625,4,1,2,79,363,449,15,464,0,O-10-52-05-01-01
KABAROLE,BURAHYA COUNTY,KICWAMBA,BWANIKA,GEME/KIKOMBE CENTRE,558,4,0,1,38,370,413,12,425,0,O-10-52-05-01-02
KABAROLE,BURAHYA COUNTY,KICWAMBA,BWANIKA,KINYAMANGI CENTRE,610,2,2,3,108,315,430,20,450,0,O-10-52-05-01-03
KABAROLE,BURAHYA COUNTY,KICWAMBA,BWANIKA,NYANKWAZI T. C.,511,2,1,7,33,356,399,13,412,0,O-10-52-05-01-04
KABAROLE,BURAHYA COUNTY,KICWAMBA,BWANIKA,OMUBUHARA P. SCHOOL,694,3,1,2,43,481,530,18,548,0,O-10-52-05-01-05
KABAROLE,BURAHYA COUNTY,KICWAMBA,KIHONDO,KAGUMA,726,2,1,7,28,544,582,12,594,0,O-10-52-05-02-01
KABAROLE,BURAHYA COUNTY,KICWAMBA,KIHONDO,KIBYO/KIHONDO T/C A,799,4,5,14,184,276,483,13,496,0,O-10-52-05-02-02
KABAROLE,BURAHYA COUNTY,KICWAMBA,KIHONDO,KICWAMBA CATHOLIC C. SUBCOU,223,1,0,1,11,153,166,7,173,0,O-10-52-05-02-03
KABAROLE,BURAHYA COUNTY,KICWAMBA,KIHONDO,KIHONDO T/C B,753,5,0,4,67,412,488,19,507,0,O-10-52-05-02-04
KABAROLE,BURAHYA COUNTY,KICWAMBA,KIHONDO,KITUMBI PARISH,546,0,1,1,40,346,388,9,397,0,O-10-52-05-02-05
KABAROLE,BURAHYA COUNTY,KICWAMBA,KIHONDO,MABAALE,455,0,0,6,16,343,365,4,369,0,O-10-52-05-02-06
KABAROLE,BURAHYA COUNTY,KICWAMBA,NYANTABONA,AT HARUGONGO P. SCHOOL A,414,0,0,3,40,258,301,19,320,0,O-10-52-05-03-01
KABAROLE,BURAHYA COUNTY,KICWAMBA,NYANTABONA,HARUGONGO PR. SCH,782,2,2,2,38,429,473,13,486,0,O-10-52-05-03-02
KABAROLE,BURAHYA COUNTY,KICWAMBA,NYANTABONA,MUGAMBA GROUND,505,2,0,6,23,372,403,12,415,0,O-10-52-05-03-03
KABAROLE,BURAHYA COUNTY,KICWAMBA,NYANTABONA,NYANTABONA T/C,376,4,1,0,18,235,258,16,274,0,O-10-52-05-03-04
KABAROLE,BURAHYA COUNTY,KICWAMBA,NYANTABONA,HARUGONGO TRADING CENTRE,296,1,0,0,17,184,202,7,209,0,O-10-52-05-03-05
KABAROLE,BURAHYA COUNTY,KICWAMBA,NYANTABONA,BULYAMBUZI,427,1,1,0,13,283,298,23,321,0,O-10-52-05-03-06
KABAROLE,BURAHYA COUNTY,MUGUSU,BURUNGU,KABOYO S.S.S.,599,0,0,2,45,384,431,13,444,0,O-10-52-06-01-01
KABAROLE,BURAHYA COUNTY,MUGUSU,BURUNGU,KIRUNGU MILE IX,750,0,1,2,27,461,491,23,514,0,O-10-52-06-01-02
KABAROLE,BURAHYA COUNTY,MUGUSU,KIBOHA,KIBOHA PARISH HQRS STN. A,429,0,2,1,21,305,329,8,337,0,O-10-52-06-02-01
KABAROLE,BURAHYA COUNTY,MUGUSU,KIBOHA,KIBOHA PARISH HQRS STN. B,414,0,0,0,30,307,337,5,342,0,O-10-52-06-02-02
KABAROLE,BURAHYA COUNTY,MUGUSU,KIBOHA,NYANSOZI PRIMARY SCHOOL,775,1,1,1,70,478,551,15,566,0,O-10-52-06-02-03
KABAROLE,BURAHYA COUNTY,MUGUSU,KIRARO,KABAGONA,445,0,0,1,14,357,372,2,374,0,O-10-52-06-03-01
KABAROLE,BURAHYA COUNTY,MUGUSU,KIRARO,KIRARO,698,1,3,0,36,469,509,15,524,0,O-10-52-06-03-02
KABAROLE,BURAHYA COUNTY,MUGUSU,KIRARO,KYEZIRE,764,4,0,7,46,528,585,13,598,0,O-10-52-06-03-03
KABAROLE,BURAHYA COUNTY,MUGUSU,KIRARO,MAGUNGA,376,0,1,1,8,291,301,4,305,0,O-10-52-06-03-04
KABAROLE,BURAHYA COUNTY,MUGUSU,KIRARO,RUKOKO,643,2,0,4,28,433,467,35,502,0,O-10-52-06-03-05
KABAROLE,BURAHYA COUNTY,MUGUSU,NYABUSWA,BUBANDI TRADING CENTRE,617,3,1,3,102,342,451,11,462,0,O-10-52-06-04-01
KABAROLE,BURAHYA COUNTY,MUGUSU,NYABUSWA,KINYANKENDE T. C. A,781,2,0,1,72,441,516,80,596,0,O-10-52-06-04-02
KABAROLE,BURAHYA COUNTY,MUGUSU,NYABUSWA,NYABUWA T. CENTRE,741,5,1,3,172,342,523,2,525,0,O-10-52-06-04-03
KABAROLE,BURAHYA COUNTY,MUGUSU,NYABUSWA,BURUNGU,345,5,0,7,94,140,246,5,251,0,O-10-52-06-04-04
KABAROLE,BURAHYA COUNTY,RUTEETE,ISUNGA,IRUHURA P. SCHOOL,526,3,1,6,18,417,445,4,449,0,O-10-52-07-01-01
KABAROLE,BURAHYA COUNTY,RUTEETE,ISUNGA,ISUNGA (A-K),489,5,1,3,26,281,316,8,324,0,O-10-52-07-01-02
KABAROLE,BURAHYA COUNTY,RUTEETE,ISUNGA,KYANTABARA (A-K),527,1,1,4,21,344,371,1,372,0,O-10-52-07-01-03
KABAROLE,BURAHYA COUNTY,RUTEETE,ISUNGA,ISUNGA B M-Z,379,0,0,2,19,244,265,7,272,0,O-10-52-07-01-04
KABAROLE,BURAHYA COUNTY,RUTEETE,ISUNGA,KYANTABARA B (M-Z),415,0,2,1,26,249,278,14,292,0,O-10-52-07-01-05
KABAROLE,BURAHYA COUNTY,RUTEETE,KASENDA,KABATA PLAYGROUND,733,1,0,1,54,411,467,6,473,0,O-10-52-07-02-01
KABAROLE,BURAHYA COUNTY,RUTEETE,KASENDA,KANYERIIRE T. CENTRE,536,1,1,4,33,366,405,6,411,0,O-10-52-07-02-02
KABAROLE,BURAHYA COUNTY,RUTEETE,KASENDA,KASENDA P. SCHOOL A,478,0,0,5,12,352,369,4,373,0,O-10-52-07-02-03
KABAROLE,BURAHYA COUNTY,RUTEETE,KASENDA,KASENDA P. SCHOOL B,599,0,1,2,30,378,411,10,421,0,O-10-52-07-02-04
KABAROLE,BURAHYA COUNTY,RUTEETE,KASENDA,RWANKYEZI T. CENTRE A (A-K),478,30,3,293,2,5,333,2,335,0,O-10-52-07-02-05
KABAROLE,BURAHYA COUNTY,RUTEETE,KASENDA,KIMYA,527,0,1,2,20,406,429,2,431,0,O-10-52-07-02-06
KABAROLE,BURAHYA COUNTY,RUTEETE,KASENDA,RWANKYEZI T. CENTRE B (M-Z),502,0,1,5,35,336,377,6,383,0,O-10-52-07-02-07
KABAROLE,BURAHYA COUNTY,RUTEETE,KIKO,KANYAMBEHO,541,0,0,4,35,401,440,4,444,0,O-10-52-07-03-01
KABAROLE,BURAHYA COUNTY,RUTEETE,KIKO,KASIISI,380,1,2,3,43,246,295,4,299,0,O-10-52-07-03-02
KABAROLE,BURAHYA COUNTY,RUTEETE,KIKO,KIGARAMA,451,0,0,0,48,259,307,29,336,0,O-10-52-07-03-03
KABAROLE,BURAHYA COUNTY,RUTEETE,KIKO,KIKO TRADING CENTRE,602,0,0,4,35,380,419,9,428,0,O-10-52-07-03-04
KABAROLE,BURAHYA COUNTY,RUTEETE,KIKO,MAKOBYO A,481,1,3,3,22,375,404,10,414,0,O-10-52-07-03-05
KABAROLE,BURAHYA COUNTY,RUTEETE,KIKO,NYABINAMBA,795,2,0,5,73,503,583,12,595,0,O-10-52-07-03-06
KABAROLE,BURAHYA COUNTY,RUTEETE,KIKO,KIMUHONDE,330,2,1,3,10,227,243,13,256,0,O-10-52-07-03-07
KABAROLE,BURAHYA COUNTY,RUTEETE,KYAMUKOKA,IMERANJARA,390,1,0,5,47,246,299,19,318,0,O-10-52-07-04-01
KABAROLE,BURAHYA COUNTY,RUTEETE,KYAMUKOKA,KAMIGANI,612,4,2,1,22,441,470,35,505,0,O-10-52-07-04-02
KABAROLE,BURAHYA COUNTY,RUTEETE,KYAMUKOKA,KIFURUKA/KYANYAITEMBA/KYAKA,287,0,1,4,18,180,203,3,206,0,O-10-52-07-04-03
KABAROLE,BURAHYA COUNTY,RUTEETE,KYAMUKOKA,RUTOMA SUBCOUNTY HQRS,477,0,1,1,38,306,346,6,352,0,O-10-52-07-04-04
KABAROLE,BURAHYA COUNTY,RUTEETE,KYAMUKOKA,RWAIHAMBA A (A-K),624,7,7,3,30,322,369,32,401,0,O-10-52-07-04-05
KABAROLE,BURAHYA COUNTY,RUTEETE,KYAMUKOKA,RWAIHAMBA B (L-Z),409,2,0,1,28,237,268,0,268,0,O-10-52-07-04-06
KABAROLE,BURAHYA COUNTY,RUTEETE,KYAMUKOKA,KANYANDAHI,95,0,1,0,9,64,74,3,77,0,O-10-52-07-04-07
KABAROLE,BURAHYA COUNTY,RUTEETE,KYAMUKOKA,MUTUULI,297,0,0,3,16,223,242,10,252,0,O-10-52-07-04-08
KABAROLE,BURAHYA COUNTY,RUTEETE,NYABWEYA,BURAMBIRA T. CENTRE (A-K),478,1,0,1,21,302,325,3,328,0,O-10-52-07-05-01
KABAROLE,BURAHYA COUNTY,RUTEETE,NYABWEYA,KANYERIIRE T. CENTRE,234,1,0,0,9,174,184,5,189,0,O-10-52-07-05-02
KABAROLE,BURAHYA COUNTY,RUTEETE,NYABWEYA,KASENDA P. SCHOOL,757,2,1,6,54,472,535,11,546,0,O-10-52-07-05-03
KABAROLE,BURAHYA COUNTY,RUTEETE,NYABWEYA,RWENKUBA T. CENTRE,472,0,1,2,20,296,319,6,325,0,O-10-52-07-05-04
KABAROLE,BURAHYA COUNTY,RUTEETE,NYABWEYA,BURAMBIRA T. CENTRE B (M-Z),622,1,0,3,30,384,418,17,435,0,O-10-52-07-05-05
KABAROLE,BURAHYA COUNTY,RUTEETE,NYABWEYA,NYABWEYA,418,2,0,1,24,330,357,5,362,0,O-10-52-07-05-06
KABAROLE,BURAHYA COUNTY,RUTEETE,RURAMA,"KIBO FARM, NYAMIRIMA",396,2,1,3,28,264,298,18,316,0,O-10-52-07-06-01
KABAROLE,BURAHYA COUNTY,RUTEETE,RURAMA,KYABWIJWA M. O. W. CAMP,547,0,1,2,17,416,436,5,441,0,O-10-52-07-06-02
KABAROLE,BURAHYA COUNTY,RUTEETE,RURAMA,RWETERA PRIMARY SCHOOL,737,1,0,3,24,426,454,13,467,0,O-10-52-07-06-03
KABAROLE,BURAHYA COUNTY,RUTEETE,RURAMA,RUSHENYI T. CENTRE,258,2,0,0,19,185,206,5,211,0,O-10-52-07-06-04
KABAROLE,FORT PORTAL MUNICIPALITY,EASTERN ZONE,BUKWALI,BUKWALI P.SCHOOL,477,1,0,2,81,247,331,9,340,0,O-10-58-01-01-01
KABAROLE,FORT PORTAL MUNICIPALITY,EASTERN ZONE,BUKWALI,BUKWALI PARISH A,792,3,1,3,96,395,498,11,509,0,O-10-58-01-01-02
KABAROLE,FORT PORTAL MUNICIPALITY,EASTERN ZONE,BUKWALI,BUKWALI PARISH B,279,2,0,0,25,130,157,11,168,0,O-10-58-01-01-03
KABAROLE,FORT PORTAL MUNICIPALITY,EASTERN ZONE,KITUMBA,KITUMBA T. CENTRE (ZONAL OFFI,489,1,0,2,56,211,270,2,272,0,O-10-58-01-02-01
KABAROLE,FORT PORTAL MUNICIPALITY,EASTERN ZONE,KITUMBA,KABEGIRA,767,1,0,1,120,321,443,9,452,0,O-10-58-01-02-02
KABAROLE,FORT PORTAL MUNICIPALITY,EASTERN ZONE,KITUMBA,KITAGAYOONA,554,2,0,2,81,266,351,5,356,0,O-10-58-01-02-03
KABAROLE,FORT PORTAL MUNICIPALITY,EASTERN ZONE,KITUMBA,KITUMBA T. CENTRE (ZONAL OFFI,514,0,0,0,76,189,265,2,267,0,O-10-58-01-02-04
KABAROLE,FORT PORTAL MUNICIPALITY,EASTERN ZONE,KITUMBA,KITUMBA T. CENTRE (ZONAL OFFI,666,0,2,1,88,276,367,28,395,0,O-10-58-01-02-05
KABAROLE,FORT PORTAL MUNICIPALITY,EASTERN ZONE,NJARA,FORTPORTAL INSTITUTE OF COM,581,2,1,3,82,306,394,18,412,0,O-10-58-01-03-01
KABAROLE,FORT PORTAL MUNICIPALITY,EASTERN ZONE,NJARA,TORO SPORTS CLUB,420,0,1,0,78,115,194,1,195,0,O-10-58-01-03-02
KABAROLE,FORT PORTAL MUNICIPALITY,EASTERN ZONE,NJARA,KAMENGO S. S. S.,642,2,0,1,114,329,446,10,456,0,O-10-58-01-03-03
KABAROLE,FORT PORTAL MUNICIPALITY,EASTERN ZONE,NJARA,FORTPORTAL INSTITUTE OF COM,414,1,1,0,67,165,234,9,243,0,O-10-58-01-03-04
KABAROLE,FORT PORTAL MUNICIPALITY,EASTERN ZONE,NYAKAGONGO,KATARAKA,617,3,0,2,52,370,427,12,439,0,O-10-58-01-04-01
KABAROLE,FORT PORTAL MUNICIPALITY,EASTERN ZONE,NYAKAGONGO,HARUBAHO,522,1,0,1,56,263,321,9,330,0,O-10-58-01-04-02
KABAROLE,FORT PORTAL MUNICIPALITY,EASTERN ZONE,NYAKAGONGO,ST LEOS KYEGOBE,485,1,0,0,54,167,222,8,230,0,O-10-58-01-04-03
KABAROLE,FORT PORTAL MUNICIPALITY,EASTERN ZONE,NYAKAGONGO,NYAKAGONGO PARISH HQRS,409,1,0,1,33,246,281,12,293,0,O-10-58-01-04-04
KABAROLE,FORT PORTAL MUNICIPALITY,SOUTHERN ZONE,BAZAAR,PETROL STATION (MOBILE),631,5,0,0,129,276,410,0,410,0,O-10-58-02-01-01
KABAROLE,FORT PORTAL MUNICIPALITY,SOUTHERN ZONE,BAZAAR,NYAKASHEKE,653,1,1,1,128,255,386,9,395,0,O-10-58-02-01-02
KABAROLE,FORT PORTAL MUNICIPALITY,SOUTHERN ZONE,BAZAAR,NYABURARA (A-K),824,1,0,0,143,374,518,4,522,0,O-10-58-02-01-03
KABAROLE,FORT PORTAL MUNICIPALITY,SOUTHERN ZONE,BAZAAR,KABAROLE P/S (A-K),510,0,1,0,61,232,294,0,294,0,O-10-58-02-01-04
KABAROLE,FORT PORTAL MUNICIPALITY,SOUTHERN ZONE,BAZAAR,PUBLIC LIBRARY,727,0,0,4,135,273,412,7,419,0,O-10-58-02-01-05
KABAROLE,FORT PORTAL MUNICIPALITY,SOUTHERN ZONE,BAZAAR,BUHINGA P. SCHOOL,325,0,0,0,90,132,222,2,224,0,O-10-58-02-01-06
KABAROLE,FORT PORTAL MUNICIPALITY,SOUTHERN ZONE,BAZAAR,MUNGUMWEMA CHURCH,865,1,0,1,182,314,498,8,506,0,O-10-58-02-01-07
KABAROLE,FORT PORTAL MUNICIPALITY,SOUTHERN ZONE,BAZAAR,NYABUBURARA (L-Z),652,0,0,1,144,263,408,2,410,0,O-10-58-02-01-08
KABAROLE,FORT PORTAL MUNICIPALITY,SOUTHERN ZONE,BAZAAR,KABAROLE P/S (L-Z),372,0,1,0,87,139,227,6,233,0,O-10-58-02-01-09
KABAROLE,FORT PORTAL MUNICIPALITY,SOUTHERN ZONE,KASUSU,KASUSU A,531,0,0,0,63,263,326,11,337,0,O-10-58-02-02-01
KABAROLE,FORT PORTAL MUNICIPALITY,SOUTHERN ZONE,KASUSU,KASUSU B,676,2,0,1,70,340,413,3,416,0,O-10-58-02-02-02
KABAROLE,FORT PORTAL MUNICIPALITY,SOUTHERN ZONE,KASUSU,KASUSU C,370,0,1,0,57,194,252,0,252,0,O-10-58-02-02-03
KABAROLE,FORT PORTAL MUNICIPALITY,SOUTHERN ZONE,KIJANJU,VIRIKA,933,0,1,1,122,370,494,6,500,0,O-10-58-02-03-01
KABAROLE,FORT PORTAL MUNICIPALITY,SOUTHERN ZONE,KIJANJU,KINYAMASIKA SEMINARY,832,2,2,6,137,380,527,3,530,0,O-10-58-02-03-02
KABAROLE,FORT PORTAL MUNICIPALITY,SOUTHERN ZONE,KIJANJU,ST. PETERS SCHOOL,910,1,1,0,128,421,551,14,565,0,O-10-58-02-03-03
KABAROLE,FORT PORTAL MUNICIPALITY,WESTERN ZONE,KAGOTE,KAGOTE P. SCHOOL,838,2,1,3,148,355,509,33,542,0,O-10-58-03-01-01
KABAROLE,FORT PORTAL MUNICIPALITY,WESTERN ZONE,KAGOTE,WESAT DIVISION OFFICES,630,1,0,1,104,193,299,4,303,0,O-10-58-03-01-02
KABAROLE,FORT PORTAL MUNICIPALITY,WESTERN ZONE,KIBIMBA,KATOJO PRISON,168,0,0,0,23,66,89,3,92,0,O-10-58-03-02-01
KABAROLE,FORT PORTAL MUNICIPALITY,WESTERN ZONE,KIBIMBA,KIBIMBA TRADING CENTRE,905,3,1,2,98,443,547,0,547,0,O-10-58-03-02-02
KABAROLE,FORT PORTAL MUNICIPALITY,WESTERN ZONE,KIBIMBA,MUHOTI OUTSIDE Q.GUARD A (A-,454,0,0,0,11,229,240,4,244,0,O-10-58-03-02-03
KABAROLE,FORT PORTAL MUNICIPALITY,WESTERN ZONE,KIBIMBA,MUHOTI OUTSIDE Q.GUARD B (L-Z,432,0,0,1,7,179,187,4,191,0,O-10-58-03-02-04
KABAROLE,FORT PORTAL MUNICIPALITY,WESTERN ZONE,NYABUKARA,BOMA GROUND,339,0,1,2,55,189,247,3,250,0,O-10-58-03-03-01
KABAROLE,FORT PORTAL MUNICIPALITY,WESTERN ZONE,NYABUKARA,NYABUKARA BAR,672,2,0,3,96,346,447,10,457,0,O-10-58-03-03-02
KABAROLE,FORT PORTAL MUNICIPALITY,WESTERN ZONE,NYABUKARA,NYABUKARA P/S,494,0,0,1,57,275,333,7,340,0,O-10-58-03-03-03
KABAROLE,FORT PORTAL MUNICIPALITY,WESTERN ZONE,RWENGOMA,KAHINJU P. SCHOOL,467,0,0,0,59,275,334,5,339,0,O-10-58-03-04-01
KABAROLE,FORT PORTAL MUNICIPALITY,WESTERN ZONE,RWENGOMA,MUGUNU,1605,1,1,2,134,478,616,20,636,0,O-10-58-03-04-02
KABAROLE,FORT PORTAL MUNICIPALITY,WESTERN ZONE,RWENGOMA,MUGUNU B,624,1,0,0,83,225,309,4,313,0,O-10-58-03-04-03
KASESE,BUKONZO COUNTY EAST,KISINGA,KAGANDO,KAGANDO II LCI OFFICE,518,3,1,6,296,98,404,6,410,0,O-15-77-01-01-01
KASESE,BUKONZO COUNTY EAST,KISINGA,KAGANDO,KAGANDO PARISH HQRS,457,6,0,7,237,105,355,19,374,0,O-15-77-01-01-02
KASESE,BUKONZO COUNTY EAST,KISINGA,KAGANDO,KAGANDO PR. SCH.,721,4,4,3,281,201,493,0,493,0,O-15-77-01-01-03
KASESE,BUKONZO COUNTY EAST,KISINGA,KAGANDO,KIBURARA BAPTIST CHURCH,229,2,2,4,85,68,161,15,176,0,O-15-77-01-01-04
KASESE,BUKONZO COUNTY EAST,KISINGA,KAGANDO,KIBURARA PR. SCH.,717,3,2,10,324,166,505,2,507,0,O-15-77-01-01-05
KASESE,BUKONZO COUNTY EAST,KISINGA,KAGANDO,KISANGA LCI OFFICE,185,0,0,0,63,62,125,11,136,0,O-15-77-01-01-06
KASESE,BUKONZO COUNTY EAST,KISINGA,KAGANDO,NYAMUGASANI PARISH HQRS.,466,7,2,3,286,87,385,6,391,0,O-15-77-01-01-07
KASESE,BUKONZO COUNTY EAST,KISINGA,KAJWENGE,KAJWENGE PRIMARY SCHOOL B,320,6,1,10,160,64,241,16,257,0,O-15-77-01-02-01
KASESE,BUKONZO COUNTY EAST,KISINGA,KAJWENGE,KAJWENGE T. C. MARKET,574,4,1,11,279,116,411,26,437,0,O-15-77-01-02-02
KASESE,BUKONZO COUNTY EAST,KISINGA,KAJWENGE,KAMUGHOBE PR SCHOOL,311,0,0,9,181,62,252,8,260,0,O-15-77-01-02-03
KASESE,BUKONZO COUNTY EAST,KISINGA,KAJWENGE,KANYUGHUNYU,630,15,4,10,300,169,498,6,504,0,O-15-77-01-02-04
KASESE,BUKONZO COUNTY EAST,KISINGA,NSENYI,BUZIRA PR SCHOOL,478,5,1,10,276,111,403,10,413,0,O-15-77-01-03-01
KASESE,BUKONZO COUNTY EAST,KISINGA,NSENYI,KISINGA S/COUNTY HQRS.,857,4,3,3,359,254,623,22,645,0,O-15-77-01-03-02
KASESE,BUKONZO COUNTY EAST,KISINGA,NSENYI,NSENYI PR. SCHOOL 'A',384,2,1,3,198,112,316,13,329,0,O-15-77-01-03-03
KASESE,BUKONZO COUNTY EAST,KISINGA,NSENYI,KYAMUGHEMA COU,396,5,2,5,294,35,341,5,346,0,O-15-77-01-03-04
KASESE,BUKONZO COUNTY EAST,KISINGA,NSENYI,ST THEREZA SSS,205,1,0,1,69,79,150,11,161,0,O-15-77-01-03-05
KASESE,BUKONZO COUNTY EAST,KISINGA,NYABIRONGO,NYABIRONGO H/CENTRE,972,8,6,12,506,189,721,57,778,0,O-15-77-01-04-01
KASESE,BUKONZO COUNTY EAST,KISINGA,NYABIRONGO,KAMUGHOBE LCI,771,13,0,10,407,112,542,0,542,0,O-15-77-01-04-02
KASESE,BUKONZO COUNTY EAST,KISINGA,NYABIRONGO,BUSYANGWA PRI. SCHOOL,752,8,2,17,501,49,577,31,608,0,O-15-77-01-04-03
KASESE,BUKONZO COUNTY EAST,KISINGA,NYABIRONGO,BUGHEMA S/PARISH HQRS,548,6,2,8,347,43,406,15,421,0,O-15-77-01-04-04
KASESE,BUKONZO COUNTY EAST,KISINGA,RWENGUHYO,KASITHU,273,5,1,4,158,56,224,8,232,0,O-15-77-01-05-01
KASESE,BUKONZO COUNTY EAST,KISINGA,RWENGUHYO,KISINGA T. C.,783,2,6,7,294,204,513,16,529,0,O-15-77-01-05-02
KASESE,BUKONZO COUNTY EAST,KISINGA,RWENGUHYO,RWENGUHYO PR. SCH.,599,6,0,8,272,170,456,16,472,0,O-15-77-01-05-03
KASESE,BUKONZO COUNTY EAST,KYARUMBA,KABIRIZI,KANYABUSOGHA P. SCHOOL (A-L),665,14,3,4,382,116,519,14,533,0,O-15-77-02-01-01
KASESE,BUKONZO COUNTY EAST,KYARUMBA,KABIRIZI,KINYAMINAGHA CATHOLIC CHUR,631,5,1,5,402,69,482,12,494,0,O-15-77-02-01-02
KASESE,BUKONZO COUNTY EAST,KYARUMBA,KABIRIZI,KANYABUSOGHA P. SCHOOL (M-Z,533,11,0,10,276,87,384,13,397,0,O-15-77-02-01-03
KASESE,BUKONZO COUNTY EAST,KYARUMBA,KAGHEMA,BWITHO PRIMARY SCHOOL,698,6,4,9,351,162,532,23,555,0,O-15-77-02-02-01
KASESE,BUKONZO COUNTY EAST,KYARUMBA,KAGHEMA,NYARWANIKA,1092,16,5,10,565,182,778,12,790,0,O-15-77-02-02-02
KASESE,BUKONZO COUNTY EAST,KYARUMBA,KAGHEMA,MUTANYWANA S S S,603,3,4,9,156,243,415,17,432,0,O-15-77-02-02-03
KASESE,BUKONZO COUNTY EAST,KYARUMBA,KALONGE,KAKUNYU PRIMARY SCHOOL,512,4,2,7,279,89,381,5,386,0,O-15-77-02-03-01
KASESE,BUKONZO COUNTY EAST,KYARUMBA,KALONGE,KIBIRIGHA,742,9,1,22,484,41,557,17,574,0,O-15-77-02-03-02
KASESE,BUKONZO COUNTY EAST,KYARUMBA,KALONGE,KITABONA PRIMARY SCHOOL,597,8,3,9,366,93,479,5,484,0,O-15-77-02-03-03
KASESE,BUKONZO COUNTY EAST,KYARUMBA,KALONGE,KATALEBA TC,337,3,1,6,182,82,274,8,282,0,O-15-77-02-03-04
KASESE,BUKONZO COUNTY EAST,KYARUMBA,KIHUNGU,KAMATHONDI CATHOLIC CHURCH,374,5,3,2,204,29,243,5,248,0,O-15-77-02-04-01
KASESE,BUKONZO COUNTY EAST,KYARUMBA,KIHUNGU,KAYEMBE,627,9,2,8,342,118,479,24,503,0,O-15-77-02-04-02
KASESE,BUKONZO COUNTY EAST,KYARUMBA,KIHUNGU,MILHANDU CATHOLIC CHURCH,476,9,0,9,263,43,324,13,337,0,O-15-77-02-04-03
KASESE,BUKONZO COUNTY EAST,KYARUMBA,KIHUNGU,MUGETE PR SCHOOL,554,11,3,14,270,100,398,6,404,0,O-15-77-02-04-04
KASESE,BUKONZO COUNTY EAST,KYARUMBA,KIHUNGU,KIHUNGU,524,3,4,5,358,22,392,7,399,0,O-15-77-02-04-05
KASESE,BUKONZO COUNTY EAST,KYARUMBA,KITABU,KITABU PRIMARY SCHOOL 'A'B,539,3,2,5,324,47,381,13,394,0,O-15-77-02-05-01
KASESE,BUKONZO COUNTY EAST,KYARUMBA,KITABU,NYAKAKINDO PRI. SCH.,374,3,1,1,267,22,294,3,297,0,O-15-77-02-05-02
KASESE,BUKONZO COUNTY EAST,KYARUMBA,KITABU,MUGHETE C. O. U.,682,9,3,9,354,113,488,23,511,0,O-15-77-02-05-03
KASESE,BUKONZO COUNTY EAST,KYARUMBA,KITABU,MUGHETE TRADING CENTRE,628,6,2,9,366,73,456,10,466,0,O-15-77-02-05-04
KASESE,BUKONZO COUNTY EAST,KYARUMBA,KITABU,KALITUSI TC,307,3,3,6,193,32,237,5,242,0,O-15-77-02-05-05
KASESE,BUKONZO COUNTY EAST,KYONDO,BUYAGHA,KINYABISIKI PRIMARY SCHOOL,546,7,3,11,288,101,410,17,427,0,O-15-77-03-01-01
KASESE,BUKONZO COUNTY EAST,KYONDO,BUYAGHA,UNESCO PRIMARY SCHOOL,604,11,0,11,377,61,460,20,480,0,O-15-77-03-01-02
KASESE,BUKONZO COUNTY EAST,KYONDO,BUYAGHA,BUHYOKA PRIMARY SCHOOL,424,4,0,7,266,49,326,16,342,0,O-15-77-03-01-03
KASESE,BUKONZO COUNTY EAST,KYONDO,BUYAGHA,KABANGO CATH. CHURCH,300,6,0,5,202,30,243,4,247,0,O-15-77-03-01-04
KASESE,BUKONZO COUNTY EAST,KYONDO,IBIMBO,KAWEMBE,423,8,2,4,154,149,317,10,327,0,O-15-77-03-02-01
KASESE,BUKONZO COUNTY EAST,KYONDO,IBIMBO,KYONDO T.C,120,3,2,2,44,7,58,1,59,0,O-15-77-03-02-02
KASESE,BUKONZO COUNTY EAST,KYONDO,IBIMBO,NGOMBE C.O.U,383,6,0,9,219,65,299,22,321,0,O-15-77-03-02-03
KASESE,BUKONZO COUNTY EAST,KYONDO,IBIMBO,NGOME PRIMARY SCHOOL,501,4,1,8,258,85,356,25,381,0,O-15-77-03-02-04
KASESE,BUKONZO COUNTY EAST,KYONDO,KANYATSI,MUSASA PRIMARY SCHOOL (A-K),646,7,4,9,256,147,423,13,436,0,O-15-77-03-03-01
KASESE,BUKONZO COUNTY EAST,KYONDO,KANYATSI,BWETHE CATHOLIC CHURCH,645,12,1,8,394,62,477,18,495,0,O-15-77-03-03-02
KASESE,BUKONZO COUNTY EAST,KYONDO,KANYATSI,MUSASA PRIMARY SCHOOL (L-Z),483,3,1,3,222,109,338,16,354,0,O-15-77-03-03-03
KASESE,BUKONZO COUNTY EAST,KYONDO,KANYATSI,KASUNGU CATHOLIC CHURCH,230,6,0,5,141,26,178,12,190,0,O-15-77-03-03-04
KASESE,BUKONZO COUNTY EAST,KYONDO,KASOKERO,KANYANZANGWA,352,2,1,5,123,133,264,11,275,0,O-15-77-03-04-01
KASESE,BUKONZO COUNTY EAST,KYONDO,KASOKERO,KASOKERO,511,6,1,5,259,111,382,11,393,0,O-15-77-03-04-02
KASESE,BUKONZO COUNTY EAST,KYONDO,KASOKERO,BULIGHISA,488,6,1,7,351,41,406,3,409,0,O-15-77-03-04-03
KASESE,BUKONZO COUNTY EAST,MAHANGO,KYABWENGE,BUKUMBYA PRIMARY SCHOOL,728,10,1,8,467,103,589,25,614,0,O-15-77-04-01-01
KASESE,BUKONZO COUNTY EAST,MAHANGO,KYABWENGE,BUTALIMULI LCI OFFICE,379,4,0,10,233,64,311,11,322,0,O-15-77-04-01-02
KASESE,BUKONZO COUNTY EAST,MAHANGO,KYABWENGE,KABURARA Y. M. C. A. SCHOOL,425,5,0,5,183,128,321,15,336,0,O-15-77-04-01-03
KASESE,BUKONZO COUNTY EAST,MAHANGO,LHUHIRI,KINYAMATHE,527,8,2,8,303,60,381,16,397,0,O-15-77-04-02-01
KASESE,BUKONZO COUNTY EAST,MAHANGO,LHUHIRI,BUHANDIRO I,679,9,2,18,429,38,496,11,507,0,O-15-77-04-02-02
KASESE,BUKONZO COUNTY EAST,MAHANGO,MAHANGO,MAHANGO PRIMARY SCHOOL,1017,3,5,12,527,177,724,18,742,0,O-15-77-04-03-01
KASESE,BUKONZO COUNTY EAST,MAHANGO,MAHANGO,IGHANZA PRIMARY SCHOOL,728,13,5,12,354,134,518,10,528,0,O-15-77-04-03-02
KASESE,BUKONZO COUNTY EAST,MAHANGO,NYAMUSULE,NYAMISULE PRIMARY SCHOOL 'A',512,4,4,18,274,83,383,36,419,0,O-15-77-04-04-01
KASESE,BUKONZO COUNTY EAST,MAHANGO,NYAMUSULE,NYAMISULE PRIMARY SCHOOL B,491,4,0,18,271,50,343,15,358,0,O-15-77-04-04-02
KASESE,BUKONZO COUNTY EAST,MAHANGO,NYAMUSULE,KIBALYA PRIMARY SCHOOL,727,19,3,8,399,142,571,18,589,0,O-15-77-04-04-03
KASESE,BUKONZO COUNTY EAST,MUNKUNYU,KABINGO,KATANDA PR. SCH.,333,6,0,13,167,76,262,16,278,0,O-15-77-05-01-01
KASESE,BUKONZO COUNTY EAST,MUNKUNYU,KABINGO,KILHAMBAYIRO C. O. U.,590,5,2,11,338,100,456,17,473,0,O-15-77-05-01-02
KASESE,BUKONZO COUNTY EAST,MUNKUNYU,KABINGO,KABINGO,219,6,0,2,104,66,178,3,181,0,O-15-77-05-01-03
KASESE,BUKONZO COUNTY EAST,MUNKUNYU,KABINGO,KYABISERI,194,6,3,8,94,53,164,7,171,0,O-15-77-05-01-04
KASESE,BUKONZO COUNTY EAST,MUNKUNYU,KACUNGIRO,KACUNGIRO PRI. SCH. 'A',334,3,0,2,147,116,268,5,273,0,O-15-77-05-02-01
KASESE,BUKONZO COUNTY EAST,MUNKUNYU,KACUNGIRO,KACUNGIRO PRI. SCH. 'B',643,9,3,9,183,293,497,14,511,0,O-15-77-05-02-02
KASESE,BUKONZO COUNTY EAST,MUNKUNYU,KACUNGIRO,KANYAMPARA C. C.,531,11,4,15,156,160,346,19,365,0,O-15-77-05-02-03
KASESE,BUKONZO COUNTY EAST,MUNKUNYU,KACUNGIRO,KANYAMPARA MARKET,662,9,1,8,274,199,491,33,524,0,O-15-77-05-02-04
KASESE,BUKONZO COUNTY EAST,MUNKUNYU,KACUNGIRO,KEMANGO,318,10,1,6,95,163,275,7,282,0,O-15-77-05-02-05
KASESE,BUKONZO COUNTY EAST,MUNKUNYU,KINYAMASEKE,KASOMORO C. O. U.,653,6,2,8,149,283,448,17,465,0,O-15-77-05-03-01
KASESE,BUKONZO COUNTY EAST,MUNKUNYU,KINYAMASEKE,TRACTOR HIRE UNIT,404,1,0,3,17,275,296,7,303,0,O-15-77-05-03-02
KASESE,BUKONZO COUNTY EAST,MUNKUNYU,KINYAMASEKE T. C.,KINYAMASEKE PRIMARY SCHOOL,1049,6,3,6,236,410,661,34,695,0,O-15-77-05-04-01
KASESE,BUKONZO COUNTY EAST,MUNKUNYU,KITSUTSU,KICUCU PRIMARY SCHOOL,822,15,3,18,358,222,616,36,652,0,O-15-77-05-05-01
KASESE,BUKONZO COUNTY EAST,MUNKUNYU,KITSUTSU,KYESERO I,304,4,0,1,95,140,240,8,248,0,O-15-77-05-05-02
KASESE,BUKONZO COUNTY EAST,MUNKUNYU,KITSUTSU,MUKUNYU PR. SCH.,674,14,2,4,194,283,497,14,511,0,O-15-77-05-05-03
KASESE,BUKONZO COUNTY EAST,MUNKUNYU,KITSUTSU,MUNKUNYU S. S. S.,477,8,1,8,206,145,368,10,378,0,O-15-77-05-05-04
KASESE,BUKONZO COUNTY EAST,MUNKUNYU,KITSUTSU,S/COUNTY HEADQUATERS,462,4,5,3,135,231,378,17,395,0,O-15-77-05-05-05
KASESE,BUKONZO COUNTY EAST,MUNKUNYU,NYAKATONZI,BUKANGARA C. O. U. 'A',432,3,3,6,119,204,335,6,341,0,O-15-77-05-06-01
KASESE,BUKONZO COUNTY EAST,MUNKUNYU,NYAKATONZI,BUKANGARA C. O. U. 'B',493,1,2,2,124,208,337,31,368,0,O-15-77-05-06-02
KASESE,BUKONZO COUNTY EAST,MUNKUNYU,NYAKATONZI,NYAKATONZI PRIMARY SCHOOL,386,3,3,2,16,360,384,0,384,0,O-15-77-05-06-03
KASESE,BUKONZO COUNTY WEST,BWERA,BUNYISWA,BUNYISWA I VILLAGE HQRS.,792,6,3,6,202,453,670,20,690,0,O-15-78-01-01-01
KASESE,BUKONZO COUNTY WEST,BWERA,BWERA TOWNSHIP,MPONDWE PRIMARY SCHOOL,1086,9,3,0,361,147,520,21,541,0,O-15-78-01-02-01
KASESE,BUKONZO COUNTY WEST,BWERA,BWERA TOWNSHIP,OLD CAR PARK,640,1,2,1,214,217,435,28,463,0,O-15-78-01-02-02
KASESE,BUKONZO COUNTY WEST,BWERA,KISAKA,KISAKA P/HQRS,554,3,0,4,152,288,447,6,453,0,O-15-78-01-03-01
KASESE,BUKONZO COUNTY WEST,BWERA,KISAKA,NYAMUGHONA I CATH. CHURCH,585,4,1,1,95,397,498,6,504,0,O-15-78-01-03-02
KASESE,BUKONZO COUNTY WEST,BWERA,KISAKA,MITHIMUSANJU COU,589,7,1,6,171,303,488,8,496,0,O-15-78-01-03-03
KASESE,BUKONZO COUNTY WEST,BWERA,KYEMPARA,KYEMPARA PRI. SCHOOL,546,3,1,7,84,332,427,25,452,0,O-15-78-01-04-01
KASESE,BUKONZO COUNTY WEST,BWERA,KYEMPARA,KYEMPARA CATH. CHURCH 'A',707,5,1,5,162,389,562,23,585,0,O-15-78-01-04-02
KASESE,BUKONZO COUNTY WEST,BWERA,KYEMPARA,KYEMPARA CATH. CHURCH 'B',507,2,0,4,101,304,411,6,417,0,O-15-78-01-04-03
KASESE,BUKONZO COUNTY WEST,BWERA,KYEMPARA,KYOBOLOKYA STC,452,4,0,1,125,252,382,10,392,0,O-15-78-01-04-04
KASESE,BUKONZO COUNTY WEST,BWERA,KYOGHA,KANYASABU LC1 HQTRS,793,4,0,4,192,450,650,9,659,0,O-15-78-01-05-01
KASESE,BUKONZO COUNTY WEST,BWERA,KYOGHA,KYOGHA,565,8,4,2,346,118,478,0,478,0,O-15-78-01-05-02
KASESE,BUKONZO COUNTY WEST,BWERA,KYOGHA,KYOGHA C.O.U,761,14,4,5,346,215,584,23,607,0,O-15-78-01-05-03
KASESE,BUKONZO COUNTY WEST,BWERA,MPONDWE,KASERENGETHE,937,5,3,6,267,367,648,19,667,0,O-15-78-01-06-01
KASESE,BUKONZO COUNTY WEST,BWERA,MPONDWE,KYANZI ISLAMIC INSTITUTE,503,6,0,6,130,206,348,29,377,0,O-15-78-01-06-02
KASESE,BUKONZO COUNTY WEST,BWERA,MPONDWE,KYABOLOKYA CATHOLIC CHURCH,692,6,0,5,292,237,540,7,547,0,O-15-78-01-06-03
KASESE,BUKONZO COUNTY WEST,BWERA,MPONDWE,NYAMAMBUKA (A-L),610,3,2,3,152,273,433,16,449,0,O-15-78-01-06-04
KASESE,BUKONZO COUNTY WEST,BWERA,MPONDWE,NYAMAMBUKA (M-Z),904,3,5,5,251,384,648,26,674,0,O-15-78-01-06-05
KASESE,BUKONZO COUNTY WEST,BWERA,RUSESE,BWERA DEMO. SCHOOL,584,3,6,8,177,251,445,12,457,0,O-15-78-01-07-01
KASESE,BUKONZO COUNTY WEST,BWERA,RUSESE,CHURCH OF UGANDA,563,5,3,2,124,312,446,18,464,0,O-15-78-01-07-02
KASESE,BUKONZO COUNTY WEST,BWERA,RUSESE,RUSESE T. C. 'A',340,3,0,2,65,196,266,10,276,0,O-15-78-01-07-03
KASESE,BUKONZO COUNTY WEST,BWERA,RUSESE,RUSESE T. C. 'B',815,6,4,1,175,456,642,17,659,0,O-15-78-01-07-04
KASESE,BUKONZO COUNTY WEST,BWERA,RUSESE,OUTSIDE Q. GUARD,483,1,1,1,31,409,443,3,446,0,O-15-78-01-07-05
KASESE,BUKONZO COUNTY WEST,BWERA,RWENGUBA,KASANGA/KITAKOMBYA,637,7,0,5,169,364,545,15,560,0,O-15-78-01-08-01
KASESE,BUKONZO COUNTY WEST,BWERA,RWENGUBA,KAKONE SUB/ TR/ CTRE,561,5,1,3,282,192,483,10,493,0,O-15-78-01-08-02
KASESE,BUKONZO COUNTY WEST,BWERA,RWENGUBA,NYAKABALE COU,405,2,1,1,85,247,336,10,346,0,O-15-78-01-08-03
KASESE,BUKONZO COUNTY WEST,IHANDIRO,BUBOTYO,IHANDIRO DISPENSARY,505,6,3,9,108,302,428,12,440,0,O-15-78-02-01-01
KASESE,BUKONZO COUNTY WEST,IHANDIRO,BUHATIRO,BUHATIRO PRIMARY SCHOOL,678,7,3,6,234,322,572,23,595,0,O-15-78-02-02-01
KASESE,BUKONZO COUNTY WEST,IHANDIRO,BUHATIRO,KAMASTUKU PRIMARY SCHOOL,460,4,2,9,186,198,399,5,404,0,O-15-78-02-02-02
KASESE,BUKONZO COUNTY WEST,IHANDIRO,IHANGO,BUHUNGAMUYAGHA RC I OFFICE,615,4,1,4,142,394,545,7,552,0,O-15-78-02-03-01
KASESE,BUKONZO COUNTY WEST,IHANDIRO,IHANGO,KITOMA,612,4,7,12,162,355,540,5,545,0,O-15-78-02-03-02
KASESE,BUKONZO COUNTY WEST,IHANDIRO,KIHOKO,KABUSONGORA PRI. SCHOOL,294,2,0,1,29,225,257,5,262,0,O-15-78-02-04-01
KASESE,BUKONZO COUNTY WEST,IHANDIRO,KIHOKO,KIHOKO RC I OFFICE,585,2,1,4,125,373,505,8,513,0,O-15-78-02-04-02
KASESE,BUKONZO COUNTY WEST,IHANDIRO,KIKYO,KAWEMBE,704,8,3,6,137,433,587,15,602,0,O-15-78-02-05-01
KASESE,BUKONZO COUNTY WEST,IHANDIRO,KIKYO,KIHONDO RC I OFFICE,358,4,1,1,114,181,301,6,307,0,O-15-78-02-05-02
KASESE,BUKONZO COUNTY WEST,KARAMBI,BIKUNYA,BIKUNYA TC I,381,7,1,5,188,94,295,11,306,0,O-15-78-03-01-01
KASESE,BUKONZO COUNTY WEST,KARAMBI,BIKUNYA,BIKUNYA TC II,478,3,3,6,266,115,393,2,395,0,O-15-78-03-01-02
KASESE,BUKONZO COUNTY WEST,KARAMBI,BUHUNA,KARAMBI T. C. I,802,5,4,5,288,324,626,20,646,0,O-15-78-03-02-01
KASESE,BUKONZO COUNTY WEST,KARAMBI,BUHUNA,KARAMBI T. C. II,239,1,2,0,110,67,180,2,182,0,O-15-78-03-02-02
KASESE,BUKONZO COUNTY WEST,KARAMBI,BUHUNA,KARAMBI MARKET,383,4,2,3,129,181,319,14,333,0,O-15-78-03-02-03
KASESE,BUKONZO COUNTY WEST,KARAMBI,BUHUNA,KARAMBI PRIMARY SCHOOL,710,4,2,2,198,379,585,13,598,0,O-15-78-03-02-04
KASESE,BUKONZO COUNTY WEST,KARAMBI,BUHUNA,KITUTI CATHOLIC CHURCH,575,0,1,5,232,223,461,23,484,0,O-15-78-03-02-05
KASESE,BUKONZO COUNTY WEST,KARAMBI,KAMASASA,KAMASASA C.O.U,570,8,3,7,262,180,460,15,475,0,O-15-78-03-03-01
KASESE,BUKONZO COUNTY WEST,KARAMBI,KAMASASA,CUSTOMS C. O. U.,656,4,4,5,271,171,455,17,472,0,O-15-78-03-03-02
KASESE,BUKONZO COUNTY WEST,KARAMBI,KAMASASA,KAMASASA PR. SCH.,567,6,1,7,268,188,470,22,492,0,O-15-78-03-03-03
KASESE,BUKONZO COUNTY WEST,KARAMBI,KARAMBI,KARAMBI PARISH DISPENSARY,702,4,0,4,190,359,557,16,573,0,O-15-78-03-04-01
KASESE,BUKONZO COUNTY WEST,KARAMBI,KARAMBI,KYASENDA - MIRAMI A,473,5,3,3,199,174,384,14,398,0,O-15-78-03-04-02
KASESE,BUKONZO COUNTY WEST,KARAMBI,KARAMBI,KYASENDA - MIRAMI 'B',410,0,1,3,193,147,344,10,354,0,O-15-78-03-04-03
KASESE,BUKONZO COUNTY WEST,KARAMBI,KARAMBI,FIRIMINE TC,418,9,1,7,176,158,351,14,365,0,O-15-78-03-04-04
KASESE,BUKONZO COUNTY WEST,KARAMBI,KISOLHOLHO,KISOLHOLHO T. C.,693,3,3,5,281,233,525,25,550,0,O-15-78-03-05-01
KASESE,BUKONZO COUNTY WEST,KARAMBI,KISOLHOLHO,KISOLHOLHO PR. SCHOOL,642,0,0,2,321,190,513,8,521,0,O-15-78-03-05-02
KASESE,BUKONZO COUNTY WEST,KARAMBI,KISOLHOLHO,HABBITANT OFFICE,215,0,2,1,77,93,173,7,180,0,O-15-78-03-05-03
KASESE,BUKONZO COUNTY WEST,KARAMBI,KISOLHOLHO,KYABAHENZE TC,241,2,1,1,121,72,197,5,202,0,O-15-78-03-05-04
KASESE,BUKONZO COUNTY WEST,KARAMBI,KYAMBOGHO,NYABUGANDO PR. SCHOOL,547,3,2,1,159,276,441,13,454,0,O-15-78-03-06-01
KASESE,BUKONZO COUNTY WEST,KARAMBI,KYAMBOGHO,KAMAKUMBI PR. SCHOOL,824,3,0,8,252,387,650,20,670,0,O-15-78-03-06-02
KASESE,BUKONZO COUNTY WEST,KARAMBI,KYAMBOGHO,NYABUGANDO C.O.U,620,2,2,10,231,247,492,18,510,0,O-15-78-03-06-03
KASESE,BUKONZO COUNTY WEST,KARAMBI,NYABUGANDO,NYABUGANDO 'A',665,0,1,4,184,314,503,0,503,0,O-15-78-03-07-01
KASESE,BUKONZO COUNTY WEST,KARAMBI,NYABUGANDO,NYABUGANDO 'B',658,4,1,4,283,161,453,19,472,0,O-15-78-03-07-02
KASESE,BUKONZO COUNTY WEST,KARAMBI,NYABUGANDO,LOWER CUSTOMS MARKET A,449,2,0,3,220,114,339,18,357,0,O-15-78-03-07-03
KASESE,BUKONZO COUNTY WEST,KARAMBI,NYABUGANDO,LOWER CUSTOMS MARKET 'B',562,3,1,3,194,243,444,16,460,0,O-15-78-03-07-04
KASESE,BUKONZO COUNTY WEST,KARAMBI,NYABUGANDO,KABIRITI TC,524,4,0,4,166,252,426,4,430,0,O-15-78-03-07-05
KASESE,BUKONZO COUNTY WEST,KARAMBI,NYAKAHYA,NYAKAHYA PRIMARY SCHOOL,362,3,1,3,157,130,294,21,315,0,O-15-78-03-08-01
KASESE,BUKONZO COUNTY WEST,KARAMBI,NYAKAHYA,NYAKAHYA C.O.U,495,4,0,5,253,153,415,22,437,0,O-15-78-03-08-02
KASESE,BUKONZO COUNTY WEST,KARAMBI,NYAKAHYA,KIBLOCK PLACE,425,2,3,4,239,115,363,13,376,0,O-15-78-03-08-03
KASESE,BUKONZO COUNTY WEST,KARAMBI,NYAKAHYA,SESELE,540,2,1,4,241,205,453,12,465,0,O-15-78-03-08-04
KASESE,BUKONZO COUNTY WEST,KITHOLU,KINYATSI,KANYATSI PRIMARY SCHOOL A,733,8,1,4,329,229,571,23,594,0,O-15-78-04-01-01
KASESE,BUKONZO COUNTY WEST,KITHOLU,KINYATSI,KANYATSI CATHOLIC CHURCH,318,6,1,4,159,110,280,3,283,0,O-15-78-04-01-02
KASESE,BUKONZO COUNTY WEST,KITHOLU,KINYATSI,KATHEMBO PRI.SCHOOL,250,4,0,1,103,90,198,6,204,0,O-15-78-04-01-03
KASESE,BUKONZO COUNTY WEST,KITHOLU,KINYATSI,KISABU,465,3,0,5,250,142,400,9,409,0,O-15-78-04-01-04
KASESE,BUKONZO COUNTY WEST,KITHOLU,KIRARO,KIRARO CATHOLIC CHURCH,726,8,2,12,129,484,635,14,649,0,O-15-78-04-02-01
KASESE,BUKONZO COUNTY WEST,KITHOLU,KIRARO,KINONE CHURCH OF UGANDA,272,1,0,5,83,163,252,0,252,0,O-15-78-04-02-02
KASESE,BUKONZO COUNTY WEST,KITHOLU,KIRARO,KISEBERE OUTSIDE Q.GUARD,134,0,0,1,6,127,134,0,134,0,O-15-78-04-02-03
KASESE,BUKONZO COUNTY WEST,KITHOLU,KITHOLU,KITHOLHU DISPENSARY,545,7,0,3,201,242,453,6,459,0,O-15-78-04-03-01
KASESE,BUKONZO COUNTY WEST,KITHOLU,KITHOLU,KITHOLHU PRIMARY SCHOOL,286,0,0,0,29,216,245,8,253,0,O-15-78-04-03-02
KASESE,BUKONZO COUNTY WEST,KITHOLU,KITHOLU,KABWE DAY CARE CENTRE,277,3,0,2,78,145,228,18,246,0,O-15-78-04-03-03
KASESE,BUKONZO COUNTY WEST,KITHOLU,KITOBIRA,KITHOBIRA PRIMARY SCHOOL,287,1,0,2,48,204,255,0,255,0,O-15-78-04-04-01
KASESE,BUKONZO COUNTY WEST,KITHOLU,KYABIKERE,BULEMERA,464,3,2,5,262,116,388,11,399,0,O-15-78-04-05-01
KASESE,BUKONZO COUNTY WEST,KITHOLU,KYABIKERE,KYABIKERE TC,466,4,0,3,254,143,404,11,415,0,O-15-78-04-05-02
KASESE,BUKONZO COUNTY WEST,KITHOLU,KYABIKERE,ISANGO SUB-TRADING CENTRE,432,1,1,3,165,152,322,17,339,0,O-15-78-04-05-03
KASESE,BUKONZO COUNTY WEST,KITHOLU,KYABIKERE,IKOBERO LC1 OFFICE,417,3,1,4,109,239,356,14,370,0,O-15-78-04-05-04
KASESE,BUKONZO COUNTY WEST,NYAKIYUMBU,BUKANGARA,KYAMINYAWANDI PR. SCH.,681,3,1,5,227,329,565,14,579,0,O-15-78-05-01-01
KASESE,BUKONZO COUNTY WEST,NYAKIYUMBU,BUKANGARA,ST JOHN'S BUKANGARA,433,3,0,2,164,180,349,8,357,0,O-15-78-05-01-02
KASESE,BUKONZO COUNTY WEST,NYAKIYUMBU,KAGHORWE,JAJA STC,726,6,0,0,291,2,299,5,304,0,O-15-78-05-02-01
KASESE,BUKONZO COUNTY WEST,NYAKIYUMBU,KAGHORWE,KARONGORI SUB-TRADING CENT,590,2,4,1,123,326,456,9,465,0,O-15-78-05-02-02
KASESE,BUKONZO COUNTY WEST,NYAKIYUMBU,KAGHORWE,NDONGO PR. SCH.,758,0,1,9,193,432,635,17,652,0,O-15-78-05-02-03
KASESE,BUKONZO COUNTY WEST,NYAKIYUMBU,KAGHORWE,MUSISYO TC,358,3,1,0,89,219,312,8,320,0,O-15-78-05-02-04
KASESE,BUKONZO COUNTY WEST,NYAKIYUMBU,KATOJO (KATHOLU),KATHOLHU,629,3,0,11,143,298,455,8,463,0,O-15-78-05-03-01
KASESE,BUKONZO COUNTY WEST,NYAKIYUMBU,KATOJO (KATHOLU),KATHOLHU PR. SCH.,713,2,2,3,149,422,578,10,588,0,O-15-78-05-03-02
KASESE,BUKONZO COUNTY WEST,NYAKIYUMBU,KAYANJA,KAYANJA FISH LANDING,416,4,1,0,52,261,318,11,329,0,O-15-78-05-04-01
KASESE,BUKONZO COUNTY WEST,NYAKIYUMBU,KAYANJA,KITATURA,170,1,0,2,29,100,132,3,135,0,O-15-78-05-04-02
KASESE,BUKONZO COUNTY WEST,NYAKIYUMBU,LYAKIREMA,NYAMIGHERA PRIMARY SCHOOL,456,1,0,0,107,297,405,2,407,0,O-15-78-05-05-01
KASESE,BUKONZO COUNTY WEST,NYAKIYUMBU,LYAKIREMA,LYAKIREMA C. O. U.,636,0,0,0,145,374,519,13,532,0,O-15-78-05-05-02
KASESE,BUKONZO COUNTY WEST,NYAKIYUMBU,LYAKIREMA,MUSYENENE TRADING CENTRE,604,5,0,3,183,309,500,20,520,0,O-15-78-05-05-03
KASESE,BUKONZO COUNTY WEST,NYAKIYUMBU,LYAKIREMA,NYAKASOJO COU,279,1,0,1,131,125,258,1,259,0,O-15-78-05-05-04
KASESE,BUKONZO COUNTY WEST,NYAKIYUMBU,LYAKIREMA,KABAGHOLE LC1 OFFICE,312,1,1,1,59,193,255,9,264,0,O-15-78-05-05-05
KASESE,BUKONZO COUNTY WEST,NYAKIYUMBU,MUHINDI,KIGHUTU,610,6,1,11,189,294,501,16,517,0,O-15-78-05-06-01
KASESE,BUKONZO COUNTY WEST,NYAKIYUMBU,MUHINDI,MUHINDI PRI. SCH.,442,1,2,3,179,178,363,9,372,0,O-15-78-05-06-02
KASESE,BUKONZO COUNTY WEST,NYAKIYUMBU,NYAKIYUMBU,KITAGATA,696,6,2,6,305,287,606,12,618,0,O-15-78-05-07-01
KASESE,BUKONZO COUNTY WEST,NYAKIYUMBU,NYAKIYUMBU,NYAKIYUMBU II,736,2,0,4,285,332,623,18,641,0,O-15-78-05-07-02
KASESE,BUSONGORA COUNTY NORTH,BUGOYE,BUGOYE,BUGOYE TEACHING HEALTH CEN,705,6,1,4,135,338,484,14,498,0,O-15-79-01-01-01
KASESE,BUSONGORA COUNTY NORTH,BUGOYE,BUGOYE,RWAKINGI CATH. CHURCH,483,0,0,2,73,263,338,12,350,0,O-15-79-01-01-02
KASESE,BUSONGORA COUNTY NORTH,BUGOYE,BUGOYE,MURAMBA PRI. SCHOOL,618,4,1,3,232,218,458,7,465,0,O-15-79-01-01-03
KASESE,BUSONGORA COUNTY NORTH,BUGOYE,BUGOYE,KISAMBA S/TRADING CENTRE,438,8,0,8,318,30,364,2,366,0,O-15-79-01-01-04
KASESE,BUSONGORA COUNTY NORTH,BUGOYE,IBANDA,IBANDA PR. SCH. 'A',729,4,4,2,258,211,479,19,498,0,O-15-79-01-02-01
KASESE,BUSONGORA COUNTY NORTH,BUGOYE,IBANDA,IBANDA PR. SCH. 'B',748,5,0,6,258,183,452,3,455,0,O-15-79-01-02-02
KASESE,BUSONGORA COUNTY NORTH,BUGOYE,IBANDA,KIHARARA PR. SCH.,412,15,1,8,189,84,297,5,302,0,O-15-79-01-02-03
KASESE,BUSONGORA COUNTY NORTH,BUGOYE,IBANDA,NYAKABUGHA,361,2,1,4,202,87,296,8,304,0,O-15-79-01-02-04
KASESE,BUSONGORA COUNTY NORTH,BUGOYE,IBANDA,NYAKALENGIJOS TRADING CENT,449,5,3,2,230,96,336,13,349,0,O-15-79-01-02-05
KASESE,BUSONGORA COUNTY NORTH,BUGOYE,KATOOKE,KEMIHOKO CATH. CHURCH,386,3,1,6,64,245,319,6,325,0,O-15-79-01-03-01
KASESE,BUSONGORA COUNTY NORTH,BUGOYE,KATOOKE,NYANGONGE P/SCHOOL,495,10,0,7,342,20,379,16,395,0,O-15-79-01-03-02
KASESE,BUSONGORA COUNTY NORTH,BUGOYE,KATOOKE,KATOOKE PR. SCH.,517,6,0,4,237,101,348,12,360,0,O-15-79-01-03-03
KASESE,BUSONGORA COUNTY NORTH,BUGOYE,KATOOKE,NYISANGO PRIMARY SCHOOL,269,6,2,7,192,11,218,5,223,0,O-15-79-01-03-04
KASESE,BUSONGORA COUNTY NORTH,BUGOYE,KATOOKE,KIRONGO STC,365,3,0,3,152,111,269,5,274,0,O-15-79-01-03-05
KASESE,BUSONGORA COUNTY NORTH,BUGOYE,KATOOKE,KIHINDI,295,2,2,5,193,20,222,0,222,0,O-15-79-01-03-06
KASESE,BUSONGORA COUNTY NORTH,BUGOYE,KIBIRIZI,IHANI,551,9,0,11,224,149,393,5,398,0,O-15-79-01-04-01
KASESE,BUSONGORA COUNTY NORTH,BUGOYE,KIBIRIZI,KASANZI PRIMARY SCHOOL,277,7,0,1,137,48,193,7,200,0,O-15-79-01-04-02
KASESE,BUSONGORA COUNTY NORTH,BUGOYE,MUHAMBO,MAGHOMA PR. SCH.,316,6,0,2,188,16,212,5,217,0,O-15-79-01-05-01
KASESE,BUSONGORA COUNTY NORTH,BUGOYE,MUHAMBO,MUHAMBO COU,305,3,0,2,192,45,242,9,251,0,O-15-79-01-05-02
KASESE,BUSONGORA COUNTY NORTH,BUGOYE,MUHAMBO,NDUGUTU PR. SCH.,521,2,1,1,155,242,401,9,410,0,O-15-79-01-05-03
KASESE,BUSONGORA COUNTY NORTH,BUGOYE,MUHAMBO,BESANIA C.O.U,578,1,1,8,289,91,390,1,391,0,O-15-79-01-05-04
KASESE,BUSONGORA COUNTY NORTH,HIMA TOWN COUNCIL,KARUNGIBATE,KARUNGIBATE A,378,3,0,1,62,136,202,7,209,0,O-15-79-02-01-01
KASESE,BUSONGORA COUNTY NORTH,HIMA TOWN COUNCIL,KARUNGIBATE,KARUNGIBATE B,336,1,0,0,12,19,32,0,32,0,O-15-79-02-01-02
KASESE,BUSONGORA COUNTY NORTH,HIMA TOWN COUNCIL,KARUNGIBATE,OUTSIDE Q. GUARD,825,1,1,3,53,732,790,8,798,0,O-15-79-02-01-03
KASESE,BUSONGORA COUNTY NORTH,HIMA TOWN COUNCIL,KENDAHI,HIMA PUBLIC P/S,778,5,1,8,212,136,362,10,372,0,O-15-79-02-02-01
KASESE,BUSONGORA COUNTY NORTH,HIMA TOWN COUNCIL,KISENYI,ST. JOSEPH'S P/S,309,2,2,1,66,113,184,7,191,0,O-15-79-02-03-01
KASESE,BUSONGORA COUNTY NORTH,HIMA TOWN COUNCIL,MOWLEM,HIMA PRIMARY SCHOOL A,619,4,0,1,94,183,282,11,293,0,O-15-79-02-04-01
KASESE,BUSONGORA COUNTY NORTH,HIMA TOWN COUNCIL,MOWLEM,HIMA PRIMARY SCHOOL B,471,1,1,1,84,144,231,8,239,0,O-15-79-02-04-02
KASESE,BUSONGORA COUNTY NORTH,HIMA TOWN COUNCIL,TOWN ZONE,HIMA T.C. OFFICES,1227,2,4,8,107,280,401,43,444,0,O-15-79-02-05-01
KASESE,BUSONGORA COUNTY NORTH,HIMA TOWN COUNCIL,TOWN ZONE,HIMA MAIN GATE (A-K),776,3,1,0,109,245,358,8,366,0,O-15-79-02-05-02
KASESE,BUSONGORA COUNTY NORTH,HIMA TOWN COUNCIL,TOWN ZONE,HIMA MAIN GATE (L-M),528,0,1,0,93,167,261,0,261,0,O-15-79-02-05-03
KASESE,BUSONGORA COUNTY NORTH,ISULE,NYANGORONGO,KITOKO PRI. SCH.,280,1,0,0,121,65,187,7,194,0,O-15-79-03-01-01
KASESE,BUSONGORA COUNTY NORTH,ISULE,NYANGORONGO,ISULE T. C.,553,4,2,10,299,76,391,13,404,0,O-15-79-03-01-02
KASESE,BUSONGORA COUNTY NORTH,ISULE,NYANGORONGO,KYABIKUHA PR. SCH.,608,6,0,3,314,70,393,26,419,0,O-15-79-03-01-03
KASESE,BUSONGORA COUNTY NORTH,ISULE,NYANGORONGO,BWEYALE,557,2,0,7,265,106,380,6,386,0,O-15-79-03-01-04
KASESE,BUSONGORA COUNTY NORTH,KITSWAMBA,HIIMA,NKOKO T. C.,292,4,0,0,32,145,181,0,181,0,O-15-79-04-01-01
KASESE,BUSONGORA COUNTY NORTH,KITSWAMBA,HIIMA,RUHITA,639,3,1,3,91,168,266,16,282,0,O-15-79-04-01-02
KASESE,BUSONGORA COUNTY NORTH,KITSWAMBA,KIHYO,KINYABWAMBA TC,603,6,7,3,276,45,337,16,353,0,O-15-79-04-02-01
KASESE,BUSONGORA COUNTY NORTH,KITSWAMBA,KIHYO,MUZAHURA CHURCH,743,11,1,7,376,86,481,2,483,0,O-15-79-04-02-02
KASESE,BUSONGORA COUNTY NORTH,KITSWAMBA,KIHYO,MOTOMOTO PRIMARY SCHOOL,617,6,3,4,318,72,403,7,410,0,O-15-79-04-02-03
KASESE,BUSONGORA COUNTY NORTH,KITSWAMBA,KIHYO,MIRAMBI S. D. A. CHURCH,162,1,0,2,96,31,130,4,134,0,O-15-79-04-02-04
KASESE,BUSONGORA COUNTY NORTH,KITSWAMBA,KITSWAMBA,BOMA GROUND,1016,10,2,6,444,101,563,24,587,0,O-15-79-04-03-01
KASESE,BUSONGORA COUNTY NORTH,KITSWAMBA,KITSWAMBA,MARKET PLACE,795,4,2,3,372,78,459,11,470,0,O-15-79-04-03-02
KASESE,BUSONGORA COUNTY NORTH,KITSWAMBA,KITSWAMBA,KYANGWALE (A-L),731,5,2,8,284,64,363,8,371,0,O-15-79-04-03-03
KASESE,BUSONGORA COUNTY NORTH,KITSWAMBA,KITSWAMBA,NYAKABALE LCI OFFICE,458,4,2,4,220,50,280,20,300,0,O-15-79-04-03-04
KASESE,BUSONGORA COUNTY NORTH,KITSWAMBA,KITSWAMBA,KYANGWALE (M-Z),731,13,3,8,273,62,359,5,364,0,O-15-79-04-03-05
KASESE,BUSONGORA COUNTY NORTH,KITSWAMBA,RUGENDABARA,RUGENDABARA P/SCHOOL,761,3,4,4,131,259,401,14,415,0,O-15-79-04-04-01
KASESE,BUSONGORA COUNTY NORTH,KITSWAMBA,RUGENDABARA,RUGENDABARA FARM,946,7,6,5,160,270,448,15,463,0,O-15-79-04-04-02
KASESE,BUSONGORA COUNTY NORTH,KITSWAMBA,RUGENDABARA,IBUGA T. C.,944,6,5,11,213,266,501,27,528,0,O-15-79-04-04-03
KASESE,BUSONGORA COUNTY NORTH,KITSWAMBA,RUGENDABARA,IBUGA DISPENSARY,351,1,0,0,49,151,201,7,208,0,O-15-79-04-04-04
KASESE,BUSONGORA COUNTY NORTH,KITSWAMBA,RUGENDABARA,KIKONGO T. C.,266,1,1,0,75,67,144,7,151,0,O-15-79-04-04-05
KASESE,BUSONGORA COUNTY NORTH,KYABARUNGIRA,BUGHENDERO,BUTERA,343,5,2,4,187,28,226,7,233,0,O-15-79-05-01-01
KASESE,BUSONGORA COUNTY NORTH,KYABARUNGIRA,BUGHENDERO,BUGHENDERO P/SCHOOL,355,5,2,11,175,39,232,17,249,0,O-15-79-05-01-02
KASESE,BUSONGORA COUNTY NORTH,KYABARUNGIRA,BUGHENDERO,IBUNDA,225,3,2,5,141,29,180,7,187,0,O-15-79-05-01-03
KASESE,BUSONGORA COUNTY NORTH,KYABARUNGIRA,BUHUHIRA,KURUHE,227,9,2,2,110,32,155,5,160,0,O-15-79-05-02-01
KASESE,BUSONGORA COUNTY NORTH,KYABARUNGIRA,BUHUHIRA,BUHUHIRA,365,6,1,4,186,62,259,4,263,0,O-15-79-05-02-02
KASESE,BUSONGORA COUNTY NORTH,KYABARUNGIRA,BUHUHIRA,NTUNGA PR. SCH.,514,12,1,2,291,41,347,19,366,0,O-15-79-05-02-03
KASESE,BUSONGORA COUNTY NORTH,KYABARUNGIRA,BUNYAMURWA,KYOHO/KANYANGWANJI,353,4,2,2,187,40,235,4,239,0,O-15-79-05-03-01
KASESE,BUSONGORA COUNTY NORTH,KYABARUNGIRA,BUNYAMURWA,KASANGALI GOVT. SCHOOL,408,10,1,7,221,30,269,13,282,0,O-15-79-05-03-02
KASESE,BUSONGORA COUNTY NORTH,KYABARUNGIRA,BWESUMBU,KYABULERA,419,4,2,6,250,30,292,9,301,0,O-15-79-05-04-01
KASESE,BUSONGORA COUNTY NORTH,KYABARUNGIRA,BWESUMBU,BWESUMBU AT NDANDA'S (A-L),405,4,2,6,250,30,292,9,301,0,O-15-79-05-04-02
KASESE,BUSONGORA COUNTY NORTH,KYABARUNGIRA,BWESUMBU,KAGHANDO,187,3,0,1,125,18,147,2,149,0,O-15-79-05-04-03
KASESE,BUSONGORA COUNTY NORTH,KYABARUNGIRA,BWESUMBU,BWESUMBU AT NDANDA'S (M-Z),391,9,0,4,240,20,273,9,282,0,O-15-79-05-04-04
KASESE,BUSONGORA COUNTY NORTH,KYABARUNGIRA,KABATUNDA,KABATUNDA DISPENSARY,317,1,1,3,158,27,190,4,194,0,O-15-79-05-05-01
KASESE,BUSONGORA COUNTY NORTH,KYABARUNGIRA,KABATUNDA,KABATUNDA T/C (A-J),266,0,0,1,112,18,131,4,135,0,O-15-79-05-05-02
KASESE,BUSONGORA COUNTY NORTH,KYABARUNGIRA,KABATUNDA,KABATUNDA T/C (K-Z),543,4,3,3,260,46,316,10,326,0,O-15-79-05-05-03
KASESE,BUSONGORA COUNTY NORTH,KYABARUNGIRA,KARAMBI,KARAMBI SDA CHURCH,577,8,0,5,277,43,333,6,339,0,O-15-79-05-06-01
KASESE,BUSONGORA COUNTY NORTH,KYABARUNGIRA,KASAMBYA,MINANA P/SCHOOL,506,1,0,2,284,53,340,10,350,0,O-15-79-05-07-01
KASESE,BUSONGORA COUNTY NORTH,KYABARUNGIRA,KASAMBYA,KASAMBYA,332,5,0,1,141,69,216,11,227,0,O-15-79-05-07-02
KASESE,BUSONGORA COUNTY NORTH,KYABARUNGIRA,KASANGALI,NYAKANENGO,143,0,0,3,97,13,113,4,117,0,O-15-79-05-08-01
KASESE,BUSONGORA COUNTY NORTH,KYABARUNGIRA,KASANGALI,KASANGALI LC I OFFICE,618,20,3,11,383,38,455,33,488,0,O-15-79-05-08-02
KASESE,BUSONGORA COUNTY NORTH,KYABARUNGIRA,KASWA,KASWA PRIMARY SCHOOL,352,5,1,6,218,28,258,13,271,0,O-15-79-05-09-01
KASESE,BUSONGORA COUNTY NORTH,KYABARUNGIRA,KASWA,KABUTILIMBA,278,6,2,4,166,32,210,7,217,0,O-15-79-05-09-02
KASESE,BUSONGORA COUNTY NORTH,KYABARUNGIRA,KIRABAHO,KIRABAHO P/SCH. A,465,10,1,4,223,57,295,13,308,0,O-15-79-05-10-01
KASESE,BUSONGORA COUNTY NORTH,KYABARUNGIRA,KIRABAHO,KIRABAHO SDA P/SCH. B,279,2,1,2,130,44,179,5,184,0,O-15-79-05-10-02
KASESE,BUSONGORA COUNTY NORTH,KYABARUNGIRA,KIRABAHO,BUTSWA,286,3,0,2,161,33,199,6,205,0,O-15-79-05-10-03
KASESE,BUSONGORA COUNTY NORTH,KYABARUNGIRA,KITHOMA,KIKOKA TRADING CENTRE,228,2,0,2,107,47,158,6,164,0,O-15-79-05-11-01
KASESE,BUSONGORA COUNTY NORTH,KYABARUNGIRA,KITHOMA,KITHOMA T.C,490,2,2,3,246,57,310,5,315,0,O-15-79-05-11-02
KASESE,BUSONGORA COUNTY NORTH,KYABARUNGIRA,KYABARUNGIRA,KAGHORWE,212,2,0,1,97,36,136,11,147,0,O-15-79-05-12-01
KASESE,BUSONGORA COUNTY NORTH,KYABARUNGIRA,KYABARUNGIRA,KISODO,240,0,0,1,142,19,162,25,187,0,O-15-79-05-12-02
KASESE,BUSONGORA COUNTY NORTH,KYABARUNGIRA,KYABARUNGIRA,KABAGAGA T.C,607,6,5,4,252,76,343,12,355,0,O-15-79-05-12-03
KASESE,BUSONGORA COUNTY NORTH,KYABARUNGIRA,MBATA,MBATA,773,11,0,6,346,20,383,11,394,0,O-15-79-05-13-01
KASESE,BUSONGORA COUNTY NORTH,KYABARUNGIRA,MUHUMUZA,KEMINYOKU,521,5,0,5,228,65,303,12,315,0,O-15-79-05-14-01
KASESE,BUSONGORA COUNTY NORTH,KYABARUNGIRA,RWESANDE,RWESANDE T. C. I,292,2,0,5,122,38,167,11,178,0,O-15-79-05-15-01
KASESE,BUSONGORA COUNTY NORTH,KYABARUNGIRA,RWESANDE,RWESANDE P/S,309,4,1,3,171,38,217,6,223,0,O-15-79-05-15-02
KASESE,BUSONGORA COUNTY NORTH,KYABARUNGIRA,RWESANDE,KEMIKONDE,422,6,3,6,186,52,253,11,264,0,O-15-79-05-15-03
KASESE,BUSONGORA COUNTY NORTH,MALIBA,BIKONE,NYAMBUKO C. O. U. (A-L),558,1,1,1,305,68,376,0,376,0,O-15-79-06-01-01
KASESE,BUSONGORA COUNTY NORTH,MALIBA,BIKONE,NYAMBUKO - BIKONE 'A',325,6,0,3,198,44,251,9,260,0,O-15-79-06-01-02
KASESE,BUSONGORA COUNTY NORTH,MALIBA,BIKONE,NYAMBUKO - BIKONE 'B',455,8,2,6,255,65,336,9,345,0,O-15-79-06-01-03
KASESE,BUSONGORA COUNTY NORTH,MALIBA,BIKONE,BUHUNGA PR. SCH.,564,2,1,3,284,53,343,7,350,0,O-15-79-06-01-04
KASESE,BUSONGORA COUNTY NORTH,MALIBA,BIKONE,NYAMBUKO C. O. U. (M-Z),630,1,1,2,346,80,430,4,434,0,O-15-79-06-01-05
KASESE,BUSONGORA COUNTY NORTH,MALIBA,BUHUNGA,NGAIGA PRIMARY SCHOOL,610,2,1,3,208,133,347,8,355,0,O-15-79-06-02-01
KASESE,BUSONGORA COUNTY NORTH,MALIBA,BUHUNGA,KYANJIMA,479,3,1,10,209,110,333,11,344,0,O-15-79-06-02-02
KASESE,BUSONGORA COUNTY NORTH,MALIBA,BUHUNGA,MALIBA C. O. U. III,299,5,4,3,129,56,197,2,199,0,O-15-79-06-02-03
KASESE,BUSONGORA COUNTY NORTH,MALIBA,BUHUNGA,KAKIRA T. C.,575,3,2,3,154,109,271,16,287,0,O-15-79-06-02-04
KASESE,BUSONGORA COUNTY NORTH,MALIBA,BUHUNGA,MALIBA S.S,332,4,0,4,162,57,227,2,229,0,O-15-79-06-02-05
KASESE,BUSONGORA COUNTY NORTH,MALIBA,MUBUKU,MUBUKU PRISONS HALL GROUND,543,2,0,1,48,264,315,6,321,0,O-15-79-06-03-01
KASESE,BUSONGORA COUNTY NORTH,MALIBA,MUBUKU,MUBUKU PRISONS HALL GROUND,397,1,0,0,62,253,316,6,322,0,O-15-79-06-03-02
KASESE,BUSONGORA COUNTY NORTH,MALIBA,MUBUKU,KISOJO T. C.,465,5,1,1,165,138,310,13,323,0,O-15-79-06-03-03
KASESE,BUSONGORA COUNTY NORTH,MALIBA,MUBUKU,BWIZIBWERA C.O.U,358,4,1,6,92,143,246,15,261,0,O-15-79-06-03-04
KASESE,BUSONGORA COUNTY NORTH,MALIBA,MUBUKU,NYAKAKINDO,170,3,1,3,22,99,128,8,136,0,O-15-79-06-03-05
KASESE,BUSONGORA COUNTY NORTH,MALIBA,NYABISUSU,KAGHANDO COU,473,3,0,0,305,48,356,5,361,0,O-15-79-06-04-01
KASESE,BUSONGORA COUNTY NORTH,MALIBA,NYABISUSU,KIREMBERI RC I,533,5,0,3,288,57,353,8,361,0,O-15-79-06-04-02
KASESE,BUSONGORA COUNTY NORTH,MALIBA,NYABISUSU,MUKATI (A-L),635,7,4,7,325,141,484,15,499,0,O-15-79-06-04-03
KASESE,BUSONGORA COUNTY NORTH,MALIBA,NYABISUSU,MUKATI (M-Z),640,10,1,2,256,139,408,9,417,0,O-15-79-06-04-04
KASESE,BUSONGORA COUNTY NORTH,MALIBA,NYANGORONGO,KABUYIRI PRIMARY SCHOOL,576,8,1,3,312,64,388,16,404,0,O-15-79-06-05-01
KASESE,BUSONGORA COUNTY NORTH,MALIBA,NYANGORONGO,KATEBE,604,6,0,5,342,46,399,20,419,0,O-15-79-06-05-02
KASESE,BUSONGORA COUNTY NORTH,MALIBA,NYANGORONGO,NYANGORONGO PR SCHOOL,503,9,1,3,265,68,346,11,357,0,O-15-79-06-05-03
KASESE,BUSONGORA COUNTY SOUTH,KARUSANDARA,KANAMBA,KANAMBA PR. SCH.,684,4,1,1,23,443,472,14,486,0,O-15-80-01-01-01
KASESE,BUSONGORA COUNTY SOUTH,KARUSANDARA,KANAMBA,NYAKANYINYA RC I LOCAL PARLIA,385,3,0,2,40,268,313,10,323,0,O-15-80-01-01-02
KASESE,BUSONGORA COUNTY SOUTH,KARUSANDARA,KARUSANDARA,KARUSANDARA COU,376,0,2,4,17,275,298,3,301,0,O-15-80-01-02-01
KASESE,BUSONGORA COUNTY SOUTH,KARUSANDARA,KARUSANDARA,KARUSANDARA P/SCHOOL,699,3,0,2,54,422,481,7,488,0,O-15-80-01-02-02
KASESE,BUSONGORA COUNTY SOUTH,KARUSANDARA,KARUSANDARA,S. D. A. P/SCHOOL,564,0,0,3,129,294,426,16,442,0,O-15-80-01-02-03
KASESE,BUSONGORA COUNTY SOUTH,KARUSANDARA,KARUSANDARA,KABUKERO C.O.U,272,2,0,1,78,106,187,1,188,0,O-15-80-01-02-04
KASESE,BUSONGORA COUNTY SOUTH,KARUSANDARA,KIBUGA,KIKOGA COU,293,2,0,3,18,204,227,18,245,0,O-15-80-01-03-01
KASESE,BUSONGORA COUNTY SOUTH,KARUSANDARA,KIBUGA,NYABUBALE,381,0,0,1,31,284,316,2,318,0,O-15-80-01-03-02
KASESE,BUSONGORA COUNTY SOUTH,KARUSANDARA,KIBUGA,KIBUGA PR. SCH.,508,2,1,0,20,342,365,0,365,0,O-15-80-01-03-03
KASESE,BUSONGORA COUNTY SOUTH,KARUSANDARA,KYALANGA,KYALANGA MOSQUE,554,6,0,5,70,312,393,11,404,0,O-15-80-01-04-01
KASESE,BUSONGORA COUNTY SOUTH,KASESE TOWN COUNCIL,BASE CAMP,BASE CAMP PRI. SCH.,605,0,1,1,223,177,402,4,406,0,O-15-80-02-01-01
KASESE,BUSONGORA COUNTY SOUTH,KASESE TOWN COUNCIL,BASE CAMP,BASE CAMP PLAY GROUND,852,1,1,1,256,274,533,13,546,0,O-15-80-02-01-02
KASESE,BUSONGORA COUNTY SOUTH,KASESE TOWN COUNCIL,KAMAIBA,KAMAIBA PRI. SCH. (A-L),713,3,2,1,213,163,382,6,388,0,O-15-80-02-02-01
KASESE,BUSONGORA COUNTY SOUTH,KASESE TOWN COUNCIL,KAMAIBA,KILEMBE QTR P/GROUND (A-K),691,2,1,0,166,257,426,7,433,0,O-15-80-02-02-02
KASESE,BUSONGORA COUNTY SOUTH,KASESE TOWN COUNCIL,KAMAIBA,KAMAIBA PRI. SCH. (M-Z),727,2,2,1,219,187,411,20,431,0,O-15-80-02-02-03
KASESE,BUSONGORA COUNTY SOUTH,KASESE TOWN COUNCIL,KAMAIBA,KILEMBE QTR P/GROUND (L-Z),477,0,1,0,97,156,254,11,265,0,O-15-80-02-02-04
KASESE,BUSONGORA COUNTY SOUTH,KASESE TOWN COUNCIL,KANYANGEYA,SALUTI (A-L),959,4,1,0,265,267,537,10,547,0,O-15-80-02-03-01
KASESE,BUSONGORA COUNTY SOUTH,KASESE TOWN COUNCIL,KANYANGEYA,SALUTI (M-Z),911,1,0,1,194,268,464,14,478,0,O-15-80-02-03-02
KASESE,BUSONGORA COUNTY SOUTH,KASESE TOWN COUNCIL,KISANGA,KASESE DISPENSARY,316,1,0,0,107,72,180,5,185,0,O-15-80-02-04-01
KASESE,BUSONGORA COUNTY SOUTH,KASESE TOWN COUNCIL,KISANGA,KISANGA MARKET,370,1,1,0,93,74,169,7,176,0,O-15-80-02-04-02
KASESE,BUSONGORA COUNTY SOUTH,KASESE TOWN COUNCIL,NYAKABINGO II,MULONGOTI PRI. SCH.,662,3,1,2,268,129,403,53,456,0,O-15-80-02-05-01
KASESE,BUSONGORA COUNTY SOUTH,KASESE TOWN COUNCIL,NYAKASANGA I,KISAGAZI COU,754,3,1,3,144,281,432,18,450,0,O-15-80-02-06-01
KASESE,BUSONGORA COUNTY SOUTH,KASESE TOWN COUNCIL,NYAKASANGA I,NYAKASANGA PRI. SCH.,899,3,3,2,168,319,495,15,510,0,O-15-80-02-06-02
KASESE,BUSONGORA COUNTY SOUTH,KASESE TOWN COUNCIL,NYAKASANGA I,NYAKASANGA MKT (A-K),824,0,1,0,69,306,376,4,380,0,O-15-80-02-06-03
KASESE,BUSONGORA COUNTY SOUTH,KASESE TOWN COUNCIL,NYAKASANGA I,NYAKASANGA PENT. CHURCH (A-I,364,0,0,0,72,126,198,1,199,0,O-15-80-02-06-04
KASESE,BUSONGORA COUNTY SOUTH,KASESE TOWN COUNCIL,NYAKASANGA I,BELOW T. A. H. (MALIS) (A-I),472,0,0,0,165,64,229,5,234,0,O-15-80-02-06-05
KASESE,BUSONGORA COUNTY SOUTH,KASESE TOWN COUNCIL,NYAKASANGA I,NYAKASANGA PENT. CH. (J-K),944,0,1,0,101,190,292,8,300,0,O-15-80-02-06-06
KASESE,BUSONGORA COUNTY SOUTH,KASESE TOWN COUNCIL,NYAKASANGA I,BELOW T. A. H. (MALIS) (J-L),539,3,1,2,157,98,261,6,267,0,O-15-80-02-06-07
KASESE,BUSONGORA COUNTY SOUTH,KASESE TOWN COUNCIL,NYAKASANGA I,NYAKASANGA PENT. CHURCH (L-,314,0,3,3,65,79,150,0,150,0,O-15-80-02-06-08
KASESE,BUSONGORA COUNTY SOUTH,KASESE TOWN COUNCIL,NYAKASANGA I,NYAKASANGA MKT (L-Z),398,0,0,1,58,155,214,2,216,0,O-15-80-02-06-09
KASESE,BUSONGORA COUNTY SOUTH,KASESE TOWN COUNCIL,NYAKASANGA I,BELOW T. A. H. (MALIS) (M-M),508,1,0,1,207,77,286,5,291,0,O-15-80-02-06-10
KASESE,BUSONGORA COUNTY SOUTH,KASESE TOWN COUNCIL,NYAKASANGA I,BELOW T. A. H. (MALIS) (N-Z),301,1,2,0,104,74,181,3,184,0,O-15-80-02-06-11
KASESE,BUSONGORA COUNTY SOUTH,KASESE TOWN COUNCIL,NYAKASANGA I,NYAKASANGA PENT. CHURCH (N-,268,0,1,0,28,129,158,3,161,0,O-15-80-02-06-12
KASESE,BUSONGORA COUNTY SOUTH,KASESE TOWN COUNCIL,NYAKASANGA II,KITOORO,582,2,1,0,72,254,329,10,339,0,O-15-80-02-07-01
KASESE,BUSONGORA COUNTY SOUTH,KASESE TOWN COUNCIL,NYAKASANGA II,JUNCTION NYAMWAMBA (A-L),893,1,1,3,229,188,422,0,422,0,O-15-80-02-07-02
KASESE,BUSONGORA COUNTY SOUTH,KASESE TOWN COUNCIL,NYAKASANGA II,JUNCTION NYAMWAMBA (M-Z),714,2,1,1,183,156,343,12,355,0,O-15-80-02-07-03
KASESE,BUSONGORA COUNTY SOUTH,KASESE TOWN COUNCIL,TOWN CENTRE,KASESE PR SCHOOL,897,2,0,1,177,217,397,0,397,0,O-15-80-02-08-01
KASESE,BUSONGORA COUNTY SOUTH,KASESE TOWN COUNCIL,TOWN CENTRE,BOMA GROUND (A-L),973,2,0,0,166,210,378,7,385,0,O-15-80-02-08-02
KASESE,BUSONGORA COUNTY SOUTH,KASESE TOWN COUNCIL,TOWN CENTRE,RWENZORI SQUARE (A-K),985,0,1,2,234,189,426,4,430,0,O-15-80-02-08-03
KASESE,BUSONGORA COUNTY SOUTH,KASESE TOWN COUNCIL,TOWN CENTRE,NEW BUS PARK,300,1,0,0,58,84,143,0,143,0,O-15-80-02-08-04
KASESE,BUSONGORA COUNTY SOUTH,KASESE TOWN COUNCIL,TOWN CENTRE,RAILWAYS P/SCHOOL,610,3,1,1,177,189,371,11,382,0,O-15-80-02-08-05
KASESE,BUSONGORA COUNTY SOUTH,KASESE TOWN COUNCIL,TOWN CENTRE,BOMA GROUND (M-Z),829,2,0,0,185,161,348,7,355,0,O-15-80-02-08-06
KASESE,BUSONGORA COUNTY SOUTH,KASESE TOWN COUNCIL,TOWN CENTRE,RWENZORI SQUARE (L-Z),529,0,0,1,168,130,299,2,301,0,O-15-80-02-08-07
KASESE,BUSONGORA COUNTY SOUTH,KILEMBE,BUNYANDIKU,BUWATA NURSERY SCHOOL,307,6,1,5,163,64,239,21,260,0,O-15-80-03-01-01
KASESE,BUSONGORA COUNTY SOUTH,KILEMBE,BUNYANDIKU,BUNYANDIKO P/SCHOOL,341,2,2,3,210,69,286,12,298,0,O-15-80-03-01-02
KASESE,BUSONGORA COUNTY SOUTH,KILEMBE,BUNYANDIKU,KYAMBOGHO PR SCHOOL,408,3,1,5,192,102,303,0,303,0,O-15-80-03-01-03
KASESE,BUSONGORA COUNTY SOUTH,KILEMBE,BUNYANDIKU,KYANJUKI PR SCHOOL,555,3,1,0,117,256,377,0,377,0,O-15-80-03-01-04
KASESE,BUSONGORA COUNTY SOUTH,KILEMBE,KATIRI,BULEMBIA PR SCHOOL,417,0,0,0,67,206,273,8,281,0,O-15-80-03-02-01
KASESE,BUSONGORA COUNTY SOUTH,KILEMBE,KATIRI,KATIRI,754,5,2,2,180,291,480,8,488,0,O-15-80-03-02-02
KASESE,BUSONGORA COUNTY SOUTH,KILEMBE,KIBANDAMA,KIBANDAMA PRIMARY SCHOOL,452,2,1,3,203,108,317,34,351,0,O-15-80-03-03-01
KASESE,BUSONGORA COUNTY SOUTH,KILEMBE,KIBANDAMA,BULIMI PR SCHOOL,355,3,0,3,237,26,269,15,284,0,O-15-80-03-03-02
KASESE,BUSONGORA COUNTY SOUTH,KILEMBE,KIBANDAMA,BUHUNGA NURSERY SCHOOL,371,6,3,6,171,77,263,16,279,0,O-15-80-03-03-03
KASESE,BUSONGORA COUNTY SOUTH,KILEMBE,KIBANDAMA,NGAGGI PR. SCH.,431,6,1,5,276,49,337,23,360,0,O-15-80-03-03-04
KASESE,BUSONGORA COUNTY SOUTH,KILEMBE,KIBANDAMA,KISANGA N.SCHOOL,459,5,0,3,196,142,346,8,354,0,O-15-80-03-03-05
KASESE,BUSONGORA COUNTY SOUTH,KILEMBE,MBUNGA,MBUGA PRI. SCH.,537,4,2,6,367,56,435,10,445,0,O-15-80-03-04-01
KASESE,BUSONGORA COUNTY SOUTH,KILEMBE,MBUNGA,BUNYAKALIJA N.SCHOOL,352,4,3,3,155,92,257,15,272,0,O-15-80-03-04-02
KASESE,BUSONGORA COUNTY SOUTH,KILEMBE,MBUNGA,MASULE PRIMARY SCH.,384,4,4,6,184,91,289,6,295,0,O-15-80-03-04-03
KASESE,BUSONGORA COUNTY SOUTH,KILEMBE,NAMUHUGA,ROAD BARRIER,379,3,3,3,161,104,274,8,282,0,O-15-80-03-05-01
KASESE,BUSONGORA COUNTY SOUTH,KILEMBE,NAMUHUGA,NAMUHUGA PRIMARY SCHOOL,462,0,3,0,123,175,301,8,309,0,O-15-80-03-05-02
KASESE,BUSONGORA COUNTY SOUTH,KILEMBE,NYAKAZINGA,KATIRI HILLS,220,0,2,1,112,47,162,9,171,0,O-15-80-03-06-01
KASESE,BUSONGORA COUNTY SOUTH,KILEMBE,NYAKAZINGA,NYAKAZINGA SCHOOL (A),608,7,5,8,404,69,493,11,504,0,O-15-80-03-06-02
KASESE,BUSONGORA COUNTY SOUTH,KILEMBE,NYAKAZINGA,MBURAKASAKA PRI. SCHOOL,318,1,0,1,209,42,253,3,256,0,O-15-80-03-06-03
KASESE,BUSONGORA COUNTY SOUTH,LAKE KABATORO,KYAKITALE,SALT INDUSTRY,719,3,3,4,62,410,482,28,510,0,O-15-80-04-01-01
KASESE,BUSONGORA COUNTY SOUTH,LAKE KABATORO,KYAKITALE,U. D. C. QUARTERS,252,1,2,4,49,132,188,13,201,0,O-15-80-04-01-02
KASESE,BUSONGORA COUNTY SOUTH,LAKE KABATORO,KYARUKARA,UDC OFFICE,696,4,2,2,88,371,467,17,484,0,O-15-80-04-02-01
KASESE,BUSONGORA COUNTY SOUTH,LAKE KABATORO,KYARUKARA,KATWE PRIMARY SCHOOL,418,4,1,1,63,224,293,7,300,0,O-15-80-04-02-02
KASESE,BUSONGORA COUNTY SOUTH,LAKE KABATORO,RWENJUBU,TECHNICAL SCHOOL,680,6,1,0,95,337,439,36,475,0,O-15-80-04-03-01
KASESE,BUSONGORA COUNTY SOUTH,LAKE KABATORO,RWENJUBU,QUARAN PRIMARY SCHOOL (A-L),519,1,2,0,65,273,341,17,358,0,O-15-80-04-03-02
KASESE,BUSONGORA COUNTY SOUTH,LAKE KABATORO,RWENJUBU,QUARAN PRIMARY SCHOOL (M-Z),361,2,0,0,41,178,221,4,225,0,O-15-80-04-03-03
KASESE,BUSONGORA COUNTY SOUTH,LAKE KATWE,HAMUKUNGU,HAMUKUNGU 'A',396,1,1,2,41,189,234,1,235,0,O-15-80-05-01-01
KASESE,BUSONGORA COUNTY SOUTH,LAKE KATWE,HAMUKUNGU,HAMUKUNGU 'B',530,4,0,3,114,139,260,12,272,0,O-15-80-05-01-02
KASESE,BUSONGORA COUNTY SOUTH,LAKE KATWE,KABIRIZI,RWENTUTU COU,281,1,0,3,83,57,144,5,149,0,O-15-80-05-02-01
KASESE,BUSONGORA COUNTY SOUTH,LAKE KATWE,KABIRIZI,KABIRIZI STORE,348,4,0,3,86,110,203,5,208,0,O-15-80-05-02-02
KASESE,BUSONGORA COUNTY SOUTH,LAKE KATWE,KABIRIZI,BUSUNGA PRIMARY SCHOOL,264,0,0,0,1,252,253,1,254,0,O-15-80-05-02-03
KASESE,BUSONGORA COUNTY SOUTH,LAKE KATWE,KAHOKYA,KINYATEKE T.C,631,3,0,1,355,22,381,22,403,0,O-15-80-05-03-01
KASESE,BUSONGORA COUNTY SOUTH,LAKE KATWE,KAHOKYA,KAHOKYA PRIMARY SCHOOL (A-K),598,7,3,3,257,65,335,14,349,0,O-15-80-05-03-02
KASESE,BUSONGORA COUNTY SOUTH,LAKE KATWE,KAHOKYA,MURAMBI TC,826,6,0,2,388,55,451,12,463,0,O-15-80-05-03-03
KASESE,BUSONGORA COUNTY SOUTH,LAKE KATWE,KAHOKYA,KIKORONGO MARKET,147,1,0,0,76,47,124,2,126,0,O-15-80-05-03-04
KASESE,BUSONGORA COUNTY SOUTH,LAKE KATWE,KAHOKYA,KAHOKYA PRIMARY SCHOOL (L-Z),350,12,0,4,187,56,259,5,264,0,O-15-80-05-03-05
KASESE,BUSONGORA COUNTY SOUTH,LAKE KATWE,KASENYI,KASENYI DISPENSARY,405,3,3,6,58,192,262,8,270,0,O-15-80-05-04-01
KASESE,BUSONGORA COUNTY SOUTH,LAKE KATWE,KATUNGURU,KATUNGURU PRI. SCH.,710,0,1,4,96,336,437,9,446,0,O-15-80-05-05-01
KASESE,BUSONGORA COUNTY SOUTH,LAKE KATWE,MWEYA,MWEYA PRIMARY SCHOOL,226,0,0,0,41,49,90,1,91,0,O-15-80-05-06-01
KASESE,BUSONGORA COUNTY SOUTH,MUHOKYA,KAHENDERO,CANOE LANDING AREA,651,3,1,3,78,274,359,0,359,0,O-15-80-06-01-01
KASESE,BUSONGORA COUNTY SOUTH,MUHOKYA,KAHENDERO,KAHENDERO PRIMARY SCHOOL,415,2,0,3,43,183,231,5,236,0,O-15-80-06-01-02
KASESE,BUSONGORA COUNTY SOUTH,MUHOKYA,KAHENDERO,LYEMUBUZA CATH. SCH.,165,2,0,1,65,19,87,3,90,0,O-15-80-06-01-03
KASESE,BUSONGORA COUNTY SOUTH,MUHOKYA,KAHENDERO,BWENANULE,158,3,0,2,75,20,100,0,100,0,O-15-80-06-01-04
KASESE,BUSONGORA COUNTY SOUTH,MUHOKYA,KIBIRI,KIBIRI PR. SCH.,673,5,1,14,339,90,449,10,459,0,O-15-80-06-02-01
KASESE,BUSONGORA COUNTY SOUTH,MUHOKYA,KIBIRI,BUSARA PR. SCH.,684,4,1,8,399,76,488,11,499,0,O-15-80-06-02-02
KASESE,BUSONGORA COUNTY SOUTH,MUHOKYA,KIBIRI,KYAMIZA,229,1,1,3,147,19,171,8,179,0,O-15-80-06-02-03
KASESE,BUSONGORA COUNTY SOUTH,MUHOKYA,KIBIRI,RWABITOKE P/SCHOOL,220,3,0,6,80,84,173,5,178,0,O-15-80-06-02-04
KASESE,BUSONGORA COUNTY SOUTH,MUHOKYA,KIREMBE,KIREMBE PR. SCH.,544,4,0,10,272,113,399,16,415,0,O-15-80-06-03-01
KASESE,BUSONGORA COUNTY SOUTH,MUHOKYA,KIREMBE,BIBWE PR SCHOOL,453,0,0,0,248,69,317,7,324,0,O-15-80-06-03-02
KASESE,BUSONGORA COUNTY SOUTH,MUHOKYA,MUHOKYA,MUHOKYA PR/ SCHOOL,893,3,3,6,114,461,587,9,596,0,O-15-80-06-04-01
KASESE,BUSONGORA COUNTY SOUTH,MUHOKYA,MUHOKYA,MUHOKYA MARKET,297,0,0,0,16,159,175,6,181,0,O-15-80-06-04-02
KASESE,BUSONGORA COUNTY SOUTH,MUHOKYA,NYAMIRAMI,KITABU TRADING CENTRE (A-K),743,13,3,5,547,52,620,10,630,0,O-15-80-06-05-01
KASESE,BUSONGORA COUNTY SOUTH,MUHOKYA,NYAMIRAMI,NYAMIRAMI C.O.U.,600,4,2,3,410,41,460,9,469,0,O-15-80-06-05-02
KASESE,BUSONGORA COUNTY SOUTH,MUHOKYA,NYAMIRAMI,KITABU TRADING CENTRE (L-M),440,4,0,5,306,20,335,4,339,0,O-15-80-06-05-03
KASESE,BUSONGORA COUNTY SOUTH,RUKOKI,KIGORO I,KIGORO PRIMARY SCHOOL,495,2,1,3,273,73,352,14,366,0,O-15-80-07-01-01
KASESE,BUSONGORA COUNTY SOUTH,RUKOKI,KIGORO I,MUKATHI TC,515,4,1,3,271,73,352,19,371,0,O-15-80-07-01-02
KASESE,BUSONGORA COUNTY SOUTH,RUKOKI,KIHARA,BUHANGHURA PR. SCH.,656,7,4,12,363,104,490,12,502,0,O-15-80-07-02-01
KASESE,BUSONGORA COUNTY SOUTH,RUKOKI,KIHARA,KARONGO C. O. U.,372,6,1,2,230,55,294,8,302,0,O-15-80-07-02-02
KASESE,BUSONGORA COUNTY SOUTH,RUKOKI,KIHARA,KIHARA T. C.,547,4,1,4,190,35,234,5,239,0,O-15-80-07-02-03
KASESE,BUSONGORA COUNTY SOUTH,RUKOKI,KIHARA,KAPOKO T/C,279,4,1,4,190,35,234,5,239,0,O-15-80-07-02-04
KASESE,BUSONGORA COUNTY SOUTH,RUKOKI,NYAKABINGO I,NYAKABINGO H/UNIT (A-K),495,3,0,2,305,82,392,4,396,0,O-15-80-07-03-01
KASESE,BUSONGORA COUNTY SOUTH,RUKOKI,NYAKABINGO I,GOLF CLUB,637,5,5,4,325,82,421,14,435,0,O-15-80-07-03-02
KASESE,BUSONGORA COUNTY SOUTH,RUKOKI,NYAKABINGO I,NYAKABINGO H/UNIT (L-Z),391,0,1,1,246,71,319,2,321,0,O-15-80-07-03-03
KASESE,BUSONGORA COUNTY SOUTH,RUKOKI,RUKOOKI,MWARO MARKET,391,0,0,3,33,235,271,13,284,0,O-15-80-07-04-01
KASESE,BUSONGORA COUNTY SOUTH,RUKOKI,RUKOOKI,RUKOOKI DISPENSARY,450,2,0,4,66,209,281,8,289,0,O-15-80-07-04-02
KASESE,BUSONGORA COUNTY SOUTH,RUKOKI,RUKOOKI,KIGORO CATHOLIC CHURCH,439,0,1,6,95,169,271,12,283,0,O-15-80-07-04-03
KASESE,BUSONGORA COUNTY SOUTH,RUKOKI,RUKOOKI,KIGORO MARKET (A-K),645,3,0,3,149,218,373,9,382,0,O-15-80-07-04-04
KASESE,BUSONGORA COUNTY SOUTH,RUKOKI,RUKOOKI,KIGORO MARKET (L-M),362,2,0,2,103,135,242,2,244,0,O-15-80-07-04-05
KASESE,BUSONGORA COUNTY SOUTH,RUKOKI,SCHEME,SEBWE P/SCHOOL,483,1,2,1,60,249,313,19,332,0,O-15-80-07-05-01
KASESE,BUSONGORA COUNTY SOUTH,RUKOKI,SCHEME,CATHOLIC CHURCH KIBATE,248,0,0,0,62,117,179,7,186,0,O-15-80-07-05-02
KASESE,BUSONGORA COUNTY SOUTH,RUKOKI,SCHEME,KIBATE PRI. SCH.,86,0,1,2,20,56,79,0,79,0,O-15-80-07-05-03
KASESE,BUSONGORA COUNTY SOUTH,RUKOKI,SCHEME,KALEMA'S PLACE,662,4,1,5,101,291,402,5,407,0,O-15-80-07-05-04
KIBAALE,BUYANJA COUNTY,BWAMIRAMIRA,BUBANGO,BUBANGO T/C A,235,0,0,0,11,178,189,0,189,0,O-16-83-01-01-01
KIBAALE,BUYANJA COUNTY,BWAMIRAMIRA,BUBANGO,KIGUJU CENTRE,370,0,0,0,7,306,313,5,318,0,O-16-83-01-01-02
KIBAALE,BUYANJA COUNTY,BWAMIRAMIRA,BUBANGO,BUBANGO T/C B,168,0,0,1,3,136,140,1,141,0,O-16-83-01-01-03
KIBAALE,BUYANJA COUNTY,BWAMIRAMIRA,BUBANGO,NYABWARAALE KACU ROCK,340,0,1,1,1,258,261,15,276,0,O-16-83-01-01-04
KIBAALE,BUYANJA COUNTY,BWAMIRAMIRA,BUKONDA,BUKONDA P/S,512,3,1,1,18,344,367,7,374,0,O-16-83-01-02-01
KIBAALE,BUYANJA COUNTY,BWAMIRAMIRA,BUKONDA,NYAMUGUSA T/C,448,0,0,8,18,287,313,16,329,0,O-16-83-01-02-02
KIBAALE,BUYANJA COUNTY,BWAMIRAMIRA,BUKONDA,NYAMUGURA PR SCHOOL,452,1,0,3,22,269,295,12,307,0,O-16-83-01-02-03
KIBAALE,BUYANJA COUNTY,BWAMIRAMIRA,BUKONDA,KABASEKENDE T/C,554,3,0,3,32,340,378,8,386,0,O-16-83-01-02-04
KIBAALE,BUYANJA COUNTY,BWAMIRAMIRA,KIBAALI,KARUGUUZA T.C,322,1,2,1,22,182,208,25,233,0,O-16-83-01-03-01
KIBAALE,BUYANJA COUNTY,BWAMIRAMIRA,KIBAALI,HAKITUUTI,510,0,1,1,20,381,403,5,408,0,O-16-83-01-03-02
KIBAALE,BUYANJA COUNTY,BWAMIRAMIRA,KIBAALI,KASAMBYA CHURCH,476,1,1,3,12,325,342,30,372,0,O-16-83-01-03-03
KIBAALE,BUYANJA COUNTY,BWAMIRAMIRA,KIBINGO,KIBINGO T/C A,256,1,1,1,20,194,217,1,218,0,O-16-83-01-04-01
KIBAALE,BUYANJA COUNTY,BWAMIRAMIRA,KIBINGO,KIBINGO TC B,153,1,1,0,8,105,115,0,115,0,O-16-83-01-04-02
KIBAALE,BUYANJA COUNTY,BWAMIRAMIRA,KIBINGO,KAHYORO P/S,508,1,1,0,21,370,393,15,408,0,O-16-83-01-04-03
KIBAALE,BUYANJA COUNTY,BWAMIRAMIRA,KIBINGO,KIGAAZA CENTRE,366,0,0,1,15,303,319,3,322,0,O-16-83-01-04-04
KIBAALE,BUYANJA COUNTY,BWAMIRAMIRA,RWAMAGANDO,KYAMUKUBIRWA P/SCHOOL,397,0,1,1,13,310,325,11,336,0,O-16-83-01-05-01
KIBAALE,BUYANJA COUNTY,BWAMIRAMIRA,RWAMAGANDO,RUBONA T/C,140,0,0,0,1,103,104,5,109,0,O-16-83-01-05-02
KIBAALE,BUYANJA COUNTY,BWAMIRAMIRA,RWEGA,RWEBISARALE T/C,588,2,0,5,12,360,379,4,383,0,O-16-83-01-06-01
KIBAALE,BUYANJA COUNTY,BWAMIRAMIRA,RWEGA,BUCUUHYA TRADING CENTRE,220,1,0,0,25,122,148,8,156,0,O-16-83-01-06-02
KIBAALE,BUYANJA COUNTY,KIBAALE TOWN COUNCIL,KABALEEGA,BUSAANA CENTRE,372,0,0,3,37,238,278,3,281,0,O-16-83-02-01-01
KIBAALE,BUYANJA COUNTY,KIBAALE TOWN COUNCIL,MASAAZA,KIBAALE HEALTH UNIT,606,0,0,2,64,378,444,4,448,0,O-16-83-02-02-01
KIBAALE,BUYANJA COUNTY,KIBAALE TOWN COUNCIL,RUGUUZA,BUJUNI P/S,823,1,2,1,82,453,539,9,548,0,O-16-83-02-03-01
KIBAALE,BUYANJA COUNTY,KIBAALE TOWN COUNCIL,RUGUUZA,NGANGI TRADING CENTRE,280,1,2,0,13,188,204,9,213,0,O-16-83-02-03-02
KIBAALE,BUYANJA COUNTY,KYEBANDO,KICUNDA,KYEBADO P/SCHOOL,557,0,1,1,33,445,480,7,487,0,O-16-83-03-01-01
KIBAALE,BUYANJA COUNTY,KYEBANDO,KICUNDA,KASIMBI CENTRE,614,2,3,3,31,376,415,20,435,0,O-16-83-03-01-02
KIBAALE,BUYANJA COUNTY,KYEBANDO,KICUNDA,BWEYALE CENTRE,522,0,2,1,19,388,410,22,432,0,O-16-83-03-01-03
KIBAALE,BUYANJA COUNTY,KYEBANDO,KICUNDA,KYEMBOGO CHURCH,390,3,2,2,5,306,318,9,327,0,O-16-83-03-01-04
KIBAALE,BUYANJA COUNTY,KYEBANDO,KISOJO,KISAALIZI P/SCHOOL,523,2,1,2,46,332,383,31,414,0,O-16-83-03-02-01
KIBAALE,BUYANJA COUNTY,KYEBANDO,KISOJO,KAYANJA T/C,509,1,1,4,26,390,422,0,422,0,O-16-83-03-02-02
KIBAALE,BUYANJA COUNTY,KYEBANDO,KISOJO,KISOJO T/C,388,1,1,0,24,276,302,17,319,0,O-16-83-03-02-03
KIBAALE,BUYANJA COUNTY,KYEBANDO,KISOJO,MUTAGATA CENTRE,704,0,1,0,16,516,533,22,555,0,O-16-83-03-02-04
KIBAALE,BUYANJA COUNTY,KYEBANDO,KISOJO,KIKOONA PRIMARY SCHOOL,357,0,2,1,17,272,292,11,303,0,O-16-83-03-02-05
KIBAALE,BUYANJA COUNTY,MATALE,KAMONDO,MITUJU TC A,314,3,0,2,13,168,186,5,191,0,O-16-83-04-01-01
KIBAALE,BUYANJA COUNTY,MATALE,KAMONDO,MITUJU TC B,237,0,0,0,8,130,138,4,142,0,O-16-83-04-01-02
KIBAALE,BUYANJA COUNTY,MATALE,KAMONDO,KAMONDO T/C,458,1,0,6,21,290,318,14,332,0,O-16-83-04-01-03
KIBAALE,BUYANJA COUNTY,MATALE,KARANGARA,KITENGETO T/CENTRE,362,3,3,0,23,253,282,15,297,0,O-16-83-04-02-01
KIBAALE,BUYANJA COUNTY,MATALE,KARANGARA,MULIIKA T/C,375,0,2,4,21,261,288,2,290,0,O-16-83-04-02-02
KIBAALE,BUYANJA COUNTY,MATALE,KARANGARA,KAKIHIMBARA T/C,396,0,1,2,12,254,269,6,275,0,O-16-83-04-02-03
KIBAALE,BUYANJA COUNTY,MATALE,KARANGARA,KITOMA T/C,292,0,0,2,22,211,235,7,242,0,O-16-83-04-02-04
KIBAALE,BUYANJA COUNTY,MATALE,KITABA,KITABA P/S,304,0,0,0,10,220,230,8,238,0,O-16-83-04-03-01
KIBAALE,BUYANJA COUNTY,MATALE,KITABA,MATALE SUB COUNTY HQRS,696,2,3,3,25,487,520,6,526,0,O-16-83-04-03-02
KIBAALE,BUYANJA COUNTY,MATALE,KITABA,HAKABANDA T/C,426,0,3,3,29,270,305,13,318,0,O-16-83-04-03-03
KIBAALE,BUYANJA COUNTY,MATALE,KITABA,KYAMALYANTE T/C,214,0,0,1,11,161,173,1,174,0,O-16-83-04-03-04
KIBAALE,BUYANJA COUNTY,MATALE,NKENDA,KYAKATWANGA T/C,678,1,2,6,21,454,484,7,491,0,O-16-83-04-04-01
KIBAALE,BUYANJA COUNTY,MATALE,NKENDA,KITUTU T/C,542,1,2,2,22,348,375,12,387,0,O-16-83-04-04-02
KIBAALE,BUYANJA COUNTY,MATALE,NKENDA,KARAMA P/S,626,1,0,1,9,459,470,6,476,0,O-16-83-04-04-03
KIBAALE,BUYANJA COUNTY,MATALE,NYAMARWA,NYAMARWA TC,887,2,5,11,50,488,556,14,570,0,O-16-83-04-05-01
KIBAALE,BUYANJA COUNTY,MATALE,NYAMARWA,BUBAMBA TRADING CENTRE,131,0,0,0,9,81,90,2,92,0,O-16-83-04-05-02
KIBAALE,BUYANJA COUNTY,MUGARAMA,KEZIMBIRA,MUHANGI CENTRE A,260,0,0,2,6,177,185,8,193,0,O-16-83-05-01-01
KIBAALE,BUYANJA COUNTY,MUGARAMA,KEZIMBIRA,KYENGABI T/C,473,2,3,10,45,288,348,7,355,0,O-16-83-05-01-02
KIBAALE,BUYANJA COUNTY,MUGARAMA,KEZIMBIRA,IMARA CENTRE,677,1,6,6,23,485,521,49,570,0,O-16-83-05-01-03
KIBAALE,BUYANJA COUNTY,MUGARAMA,KEZIMBIRA,MUHANGI CENTRE B,29,0,0,0,3,15,18,0,18,0,O-16-83-05-01-04
KIBAALE,BUYANJA COUNTY,MUGARAMA,KEZIMBIRA,KITUUMA T/C,342,0,0,2,18,218,238,7,245,0,O-16-83-05-01-05
KIBAALE,BUYANJA COUNTY,MUGARAMA,KIBOGO,KIBOGO PRIMARY SCHOOL,736,3,0,2,54,410,469,40,509,0,O-16-83-05-02-01
KIBAALE,BUYANJA COUNTY,MUGARAMA,KIBOGO,KYANYI P/SCHOOL,728,2,2,10,35,498,547,22,569,0,O-16-83-05-02-02
KIBAALE,BUYANJA COUNTY,MUGARAMA,KIBOGO,KITONEZI TRADING CENTRE,229,1,0,1,16,132,150,10,160,0,O-16-83-05-02-03
KIBAALE,BUYANJA COUNTY,MUGARAMA,KIBOGO,KICUMAAZI TRADING CENTRE,198,0,1,0,20,136,157,4,161,0,O-16-83-05-02-04
KIBAALE,BUYANJA COUNTY,MUGARAMA,KITUUMA,MAGARAMA S/CTY HQRS,715,1,3,4,40,467,515,26,541,0,O-16-83-05-03-01
KIBAALE,BUYANJA COUNTY,MUGARAMA,NYAMARUNDA,KIBEEDI P/SCHOOL,451,0,2,1,24,325,352,11,363,0,O-16-83-05-04-01
KIBAALE,BUYANJA COUNTY,MUGARAMA,NYAMARUNDA,NYAMARUNDA PRIMARY SCHOOL,492,0,3,4,29,331,367,15,382,0,O-16-83-05-04-02
KIBAALE,BUYANJA COUNTY,MUGARAMA,NYAMARUNDA,BURONZI CHAPEL,546,0,0,1,24,379,404,22,426,0,O-16-83-05-04-03
KIBAALE,BUYANJA COUNTY,MUGARAMA,NYAMARUNDA,BUJOGORO PRI. SCHOOL,439,2,4,4,10,328,348,15,363,0,O-16-83-05-04-04
KIBAALE,BUYANJA COUNTY,MUGARAMA,NYAMARUNDA,KATEETE TRADING CENTRE,482,0,3,6,10,319,338,12,350,0,O-16-83-05-04-05
KISORO,BUFUMBIRA CTY EAST,BUKIMBIRI,IREMERA,REMERA DISPENSARY,474,0,3,3,75,319,400,14,414,0,O-18-86-01-01-01
KISORO,BUFUMBIRA CTY EAST,BUKIMBIRI,IREMERA,BUTENGO T. CENTRE,579,1,1,0,80,396,478,14,492,0,O-18-86-01-01-02
KISORO,BUFUMBIRA CTY EAST,BUKIMBIRI,IREMERA,NYANAMO T. C.,269,1,1,0,26,189,217,4,221,0,O-18-86-01-01-03
KISORO,BUFUMBIRA CTY EAST,BUKIMBIRI,IREMERA,KASHENYI,639,1,0,3,34,484,522,10,532,0,O-18-86-01-01-04
KISORO,BUFUMBIRA CTY EAST,BUKIMBIRI,IREMERA,NYAMIREMBE S. S. S.,373,2,0,0,48,267,317,10,327,0,O-18-86-01-01-05
KISORO,BUFUMBIRA CTY EAST,BUKIMBIRI,IREMERA,NYAMIREMBE P. S.,240,0,0,0,22,187,209,11,220,0,O-18-86-01-01-06
KISORO,BUFUMBIRA CTY EAST,BUKIMBIRI,IREMERA,KIJUGUTA P/S,326,0,0,2,23,247,272,7,279,0,O-18-86-01-01-07
KISORO,BUFUMBIRA CTY EAST,BUKIMBIRI,IREMERA,NYAMASINDA P/S,327,1,1,2,69,221,294,0,294,0,O-18-86-01-01-08
KISORO,BUFUMBIRA CTY EAST,BUKIMBIRI,KAGUNGA,BUGARA,593,1,2,11,36,446,496,9,505,0,O-18-86-01-02-01
KISORO,BUFUMBIRA CTY EAST,BUKIMBIRI,KAGUNGA,KATERETERE T. C.,542,1,1,1,25,413,441,11,452,0,O-18-86-01-02-02
KISORO,BUFUMBIRA CTY EAST,BUKIMBIRI,KAGUNGA,NYAKAREMBE TC,589,2,2,5,35,447,491,14,505,0,O-18-86-01-02-03
KISORO,BUFUMBIRA CTY EAST,KANABA,KAGEZI,BUTOKE P.S.,484,2,1,0,21,379,403,6,409,0,O-18-86-02-01-01
KISORO,BUFUMBIRA CTY EAST,KANABA,KAGEZI,KIKANGAGA T.C,551,2,1,0,15,399,417,21,438,0,O-18-86-02-01-02
KISORO,BUFUMBIRA CTY EAST,KANABA,KAGEZI,BAHATI,451,0,0,2,11,363,376,5,381,0,O-18-86-02-01-03
KISORO,BUFUMBIRA CTY EAST,KANABA,KAGEZI,GOOLA C. O.U,516,1,0,3,41,369,414,8,422,0,O-18-86-02-01-04
KISORO,BUFUMBIRA CTY EAST,KANABA,KAGEZI,KANABA S.S.S,483,0,0,4,24,343,371,21,392,0,O-18-86-02-01-05
KISORO,BUFUMBIRA CTY EAST,KANABA,MUHINDURA,GIFUMBA P. S.,720,0,0,3,18,575,596,4,600,0,O-18-86-02-02-01
KISORO,BUFUMBIRA CTY EAST,KANABA,MUHINDURA,KAGANO P. S.,548,1,1,4,65,371,442,22,464,0,O-18-86-02-02-02
KISORO,BUFUMBIRA CTY EAST,KANABA,MUHINDURA,KANABA COPE CENTER,527,1,0,3,37,359,400,7,407,0,O-18-86-02-02-03
KISORO,BUFUMBIRA CTY EAST,KANABA,MUHINDURA,KANABA S/C HQS,865,4,2,3,73,574,656,9,665,0,O-18-86-02-02-04
KISORO,BUFUMBIRA CTY EAST,KANABA,MUHINDURA,KARWA C.O.U,277,1,0,1,17,209,228,14,242,0,O-18-86-02-02-05
KISORO,BUFUMBIRA CTY EAST,MURORA,CHAHAFI,GATETE P. S.,590,3,1,4,37,419,464,27,491,0,O-18-86-03-01-01
KISORO,BUFUMBIRA CTY EAST,MURORA,CHAHAFI,CHAHAFI PARISH HQRS.,756,4,4,3,52,534,597,12,609,0,O-18-86-03-01-02
KISORO,BUFUMBIRA CTY EAST,MURORA,CHAHAFI,RWABARA P/S,466,1,2,5,15,362,385,15,400,0,O-18-86-03-01-03
KISORO,BUFUMBIRA CTY EAST,MURORA,CHAHAFI,KABAMI P. S.,564,1,0,4,31,431,467,0,467,0,O-18-86-03-01-04
KISORO,BUFUMBIRA CTY EAST,MURORA,CHAHAFI,KAGEZI T. CENTRE,310,1,0,2,23,211,237,10,247,0,O-18-86-03-01-05
KISORO,BUFUMBIRA CTY EAST,MURORA,CHAHAFI,KARAGO P. S.,701,1,9,1,20,484,515,10,525,0,O-18-86-03-01-06
KISORO,BUFUMBIRA CTY EAST,MURORA,CHAHAFI,KABINGO P.S,381,1,1,3,17,260,282,18,300,0,O-18-86-03-01-07
KISORO,BUFUMBIRA CTY EAST,MURORA,CHIBUMBA,CHIBUMBA P. S.,522,0,1,1,39,363,404,16,420,0,O-18-86-03-02-01
KISORO,BUFUMBIRA CTY EAST,MURORA,CHIBUMBA,KARAMBO T. CENTRE,602,2,1,3,25,430,461,8,469,0,O-18-86-03-02-02
KISORO,BUFUMBIRA CTY EAST,MURORA,CHIBUMBA,MAREGAMO P. S.,607,1,0,2,22,422,447,11,458,0,O-18-86-03-02-03
KISORO,BUFUMBIRA CTY EAST,MURORA,CHIBUMBA,RUGESHI P. S.,728,1,2,6,23,485,517,46,563,0,O-18-86-03-02-04
KISORO,BUFUMBIRA CTY EAST,MURORA,CHIBUMBA,KANYAMAHORO PRI. SCHOOL,613,0,0,2,28,450,480,2,482,0,O-18-86-03-02-05
KISORO,BUFUMBIRA CTY EAST,NYAKABANDE,GASIZA,MR. RURATUYE'S BUTCHERY,609,1,2,3,80,420,506,7,513,0,O-18-86-04-01-01
KISORO,BUFUMBIRA CTY EAST,NYAKABANDE,GASIZA,MUTOLERE S. S. S.,410,2,0,2,48,271,323,19,342,0,O-18-86-04-01-02
KISORO,BUFUMBIRA CTY EAST,NYAKABANDE,GASIZA,MUTOLERE P. SCHOOL,774,5,2,0,79,489,575,23,598,0,O-18-86-04-01-03
KISORO,BUFUMBIRA CTY EAST,NYAKABANDE,GASIZA,GASIZA T. CENTRE,635,2,2,3,48,403,458,6,464,0,O-18-86-04-01-04
KISORO,BUFUMBIRA CTY EAST,NYAKABANDE,GASIZA,KABIRA T. CENTRE,346,1,1,0,31,248,281,8,289,0,O-18-86-04-01-05
KISORO,BUFUMBIRA CTY EAST,NYAKABANDE,GISORORA,GAKORO,548,2,1,4,36,357,400,24,424,0,O-18-86-04-02-01
KISORO,BUFUMBIRA CTY EAST,NYAKABANDE,GISORORA,NYAKABANDE SUB-COUNTY HQR,734,3,4,3,74,454,538,17,555,0,O-18-86-04-02-02
KISORO,BUFUMBIRA CTY EAST,NYAKABANDE,GISORORA,CHAPA T. CENTRE,629,0,2,4,66,407,479,19,498,0,O-18-86-04-02-03
KISORO,BUFUMBIRA CTY EAST,NYAKABANDE,GISORORA,BUBAGA T. CENTRE,516,0,0,3,40,380,423,22,445,0,O-18-86-04-02-04
KISORO,BUFUMBIRA CTY EAST,NYAKABANDE,GISORORA,MBONJERA T. CENTRE,466,0,2,4,34,322,362,11,373,0,O-18-86-04-02-05
KISORO,BUFUMBIRA CTY EAST,NYAKABANDE,GISORORA,NTURO T. CENTRE,524,1,2,6,11,374,394,28,422,0,O-18-86-04-02-06
KISORO,BUFUMBIRA CTY EAST,NYAKABANDE,GISORORA,BUSHOKA T.C,613,0,2,3,32,457,494,19,513,0,O-18-86-04-02-07
KISORO,BUFUMBIRA CTY EAST,NYAKABANDE,RWINGWE,MATINZA P. S.,532,1,0,2,43,350,396,33,429,0,O-18-86-04-03-01
KISORO,BUFUMBIRA CTY EAST,NYAKABANDE,RWINGWE,GIKORO P/S,870,2,4,1,67,591,665,17,682,0,O-18-86-04-03-02
KISORO,BUFUMBIRA CTY EAST,NYAKABANDE,RWINGWE,RWINGWE PARISH HQRS,423,3,1,1,52,228,285,28,313,0,O-18-86-04-03-03
KISORO,BUFUMBIRA CTY EAST,NYAKABANDE,RWINGWE,MATINZA CLINIC,695,0,2,1,60,458,521,24,545,0,O-18-86-04-03-04
KISORO,BUFUMBIRA CTY EAST,NYUNDO,BUBUYE,KALEHE T.C,512,2,0,5,35,359,401,18,419,0,O-18-86-05-01-01
KISORO,BUFUMBIRA CTY EAST,NYUNDO,BUBUYE,MULEHE,504,2,0,4,8,412,426,5,431,0,O-18-86-05-01-02
KISORO,BUFUMBIRA CTY EAST,NYUNDO,NYUNDO,RYABATAHA,763,1,0,6,25,559,591,8,599,0,O-18-86-05-02-01
KISORO,BUFUMBIRA CTY EAST,NYUNDO,NYUNDO,MUFUMBA,502,2,0,3,23,423,451,8,459,0,O-18-86-05-02-02
KISORO,BUFUMBIRA CTY EAST,NYUNDO,NYUNDO,KABAHUNDE,723,0,2,4,46,505,557,3,560,0,O-18-86-05-02-03
KISORO,BUFUMBIRA CTY EAST,NYUNDO,NYUNDO,MUKOZI,636,1,0,3,26,460,490,8,498,0,O-18-86-05-02-04
KISORO,BUFUMBIRA CTY EAST,NYUNDO,NYUNDO,RWEBIKONKO,697,0,3,2,36,446,487,21,508,0,O-18-86-05-02-05
KISORO,BUFUMBIRA CTY EAST,NYUNDO,NYUNDO,MUTANDA,54,0,0,0,0,47,47,2,49,0,O-18-86-05-02-06
KISORO,BUFUMBIRA CTY EAST,NYUNDO,NYUNDO,MUSEZERO,327,2,1,0,24,225,252,5,257,0,O-18-86-05-02-07
KISORO,BUFUMBIRA CTY NORTH,BUSANZA,BUHOZI,NYANAMO P/S,559,0,1,8,19,412,440,14,454,0,O-18-87-01-01-01
KISORO,BUFUMBIRA CTY NORTH,BUSANZA,BUHOZI,BUHOZI PARISH HQRS,695,4,0,5,27,499,535,2,537,0,O-18-87-01-01-02
KISORO,BUFUMBIRA CTY NORTH,BUSANZA,BUHOZI,BUHOZI P. SCHOOL,644,1,2,0,18,454,475,15,490,0,O-18-87-01-01-03
KISORO,BUFUMBIRA CTY NORTH,BUSANZA,BUHOZI,BUHOZI HEALTH UNIT,448,0,2,2,10,342,356,13,369,0,O-18-87-01-01-04
KISORO,BUFUMBIRA CTY NORTH,BUSANZA,BUHOZI,MBURAMAZI T.C,519,1,1,0,30,341,373,17,390,0,O-18-87-01-01-05
KISORO,BUFUMBIRA CTY NORTH,BUSANZA,BUHUMBU,KAGUHU T. CENTRE,719,2,0,2,33,521,558,9,567,0,O-18-87-01-02-01
KISORO,BUFUMBIRA CTY NORTH,BUSANZA,BUHUMBU,MUGUMIRA T. CENTRE,463,1,1,1,15,282,300,16,316,0,O-18-87-01-02-02
KISORO,BUFUMBIRA CTY NORTH,BUSANZA,BUHUMBU,GACACYA T.C,349,0,0,0,13,261,274,10,284,0,O-18-87-01-02-03
KISORO,BUFUMBIRA CTY NORTH,BUSANZA,GITOVU,GITOVU P. SCHOOL,493,3,1,1,19,367,391,2,393,0,O-18-87-01-03-01
KISORO,BUFUMBIRA CTY NORTH,BUSANZA,GITOVU,KINANIRA P. SCHOOL,637,2,0,7,14,472,495,6,501,0,O-18-87-01-03-02
KISORO,BUFUMBIRA CTY NORTH,BUSANZA,GITOVU,BUSIGI T. CENTRE,609,1,0,0,8,471,480,2,482,0,O-18-87-01-03-03
KISORO,BUFUMBIRA CTY NORTH,BUSANZA,GITOVU,GITOVU PARISH H/QS,459,0,0,4,8,368,380,13,393,0,O-18-87-01-03-04
KISORO,BUFUMBIRA CTY NORTH,KIRUNDO,RUBUGURI,KAFUGA,485,0,2,1,24,388,415,7,422,0,O-18-87-02-01-01
KISORO,BUFUMBIRA CTY NORTH,KIRUNDO,RUBUGURI,KASHAKA,228,0,0,0,3,181,184,5,189,0,O-18-87-02-01-02
KISORO,BUFUMBIRA CTY NORTH,KIRUNDO,RUBUGURI,KAMUCWAMBA,357,0,0,0,9,322,331,2,333,0,O-18-87-02-01-03
KISORO,BUFUMBIRA CTY NORTH,KIRUNDO,RUBUGURI,NOMBE P. SCHOOL,636,0,0,2,24,352,378,6,384,0,O-18-87-02-01-04
KISORO,BUFUMBIRA CTY NORTH,KIRUNDO,RUBUGURI,KASHIJA T. CENTRE [A - L],330,1,0,0,46,236,283,2,285,0,O-18-87-02-01-05
KISORO,BUFUMBIRA CTY NORTH,KIRUNDO,RUBUGURI,KASHIJA T. CENTRE [M - Z],463,0,0,4,59,300,363,8,371,0,O-18-87-02-01-06
KISORO,BUFUMBIRA CTY NORTH,KIRUNDO,RUBUGURI,NYABAREMURA,317,1,0,1,74,180,256,3,259,0,O-18-87-02-01-07
KISORO,BUFUMBIRA CTY NORTH,KIRUNDO,RUBUGURI,RUSHAGA,441,0,0,2,29,343,374,3,377,0,O-18-87-02-01-08
KISORO,BUFUMBIRA CTY NORTH,KIRUNDO,RUBUGURI,RUBUGURI P/S,325,1,0,0,49,227,277,2,279,0,O-18-87-02-01-09
KISORO,BUFUMBIRA CTY NORTH,KIRUNDO,RUBUGURI,RUGANDU P/SCH,397,0,1,2,34,271,308,8,316,0,O-18-87-02-01-10
KISORO,BUFUMBIRA CTY NORTH,KIRUNDO,RUBUGURI,RUTAAKA S.S.S,569,1,0,5,4,458,468,8,476,0,O-18-87-02-01-11
KISORO,BUFUMBIRA CTY NORTH,KIRUNDO,RUTAKA,KIBUGU PRIMARY SCHOOL,366,0,0,3,6,280,289,2,291,0,O-18-87-02-02-01
KISORO,BUFUMBIRA CTY NORTH,KIRUNDO,RUTAKA,HAKANGURIRO,427,3,1,7,15,324,350,10,360,0,O-18-87-02-02-02
KISORO,BUFUMBIRA CTY NORTH,KIRUNDO,RUTAKA,RUTAKA P. SCHOOL,513,3,1,2,36,392,434,9,443,0,O-18-87-02-02-03
KISORO,BUFUMBIRA CTY NORTH,KIRUNDO,RUTAKA,KISHARU P. SCHOOL,346,1,0,2,18,257,278,8,286,0,O-18-87-02-02-04
KISORO,BUFUMBIRA CTY NORTH,KIRUNDO,RUTAKA,KIRUNDO P/SCH,413,1,0,4,18,331,354,12,366,0,O-18-87-02-02-05
KISORO,BUFUMBIRA CTY NORTH,KIRUNDO,RUTAKA,MUKERERE,383,0,0,2,7,297,306,8,314,0,O-18-87-02-02-06
KISORO,BUFUMBIRA CTY NORTH,KIRUNDO,RUTAKA,KISENYI,326,0,0,5,8,242,255,11,266,0,O-18-87-02-02-07
KISORO,BUFUMBIRA CTY NORTH,NYABWISHENYA,NTEKO,NTUNGAMO T. CENTRE,673,4,3,7,31,497,542,16,558,0,O-18-87-03-01-01
KISORO,BUFUMBIRA CTY NORTH,NYABWISHENYA,NTEKO,KIKOMO T. CENTRE,863,1,0,4,4,628,637,2,639,0,O-18-87-03-01-02
KISORO,BUFUMBIRA CTY NORTH,NYABWISHENYA,NTEKO,NTEKO P. SCHOOL,512,5,2,3,33,348,391,10,401,0,O-18-87-03-01-03
KISORO,BUFUMBIRA CTY NORTH,NYABWISHENYA,NTEKO,MWUMBA P. SCHOOL,586,0,1,3,18,484,506,4,510,0,O-18-87-03-01-04
KISORO,BUFUMBIRA CTY NORTH,NYABWISHENYA,NTEKO,HAMABEDI PLAYGROUND,420,5,0,4,6,346,361,7,368,0,O-18-87-03-01-05
KISORO,BUFUMBIRA CTY NORTH,NYABWISHENYA,NYARUTEMBE,BUGEYO,536,3,4,4,20,426,457,10,467,0,O-18-87-03-02-01
KISORO,BUFUMBIRA CTY NORTH,NYABWISHENYA,NYARUTEMBE,KAMUGEMANYI,659,2,3,8,68,458,539,19,558,0,O-18-87-03-02-02
KISORO,BUFUMBIRA CTY NORTH,NYABWISHENYA,NYARUTEMBE,GASOVU,436,3,2,4,2,346,357,9,366,0,O-18-87-03-02-03
KISORO,BUFUMBIRA CTY NORTH,NYABWISHENYA,NYARUTEMBE,MUKO P/S,260,0,0,2,4,218,224,12,236,0,O-18-87-03-02-04
KISORO,BUFUMBIRA CTY NORTH,NYARUBUYE,BUSENGO,KABWOTSA,660,0,0,2,20,484,506,22,528,0,O-18-87-04-01-01
KISORO,BUFUMBIRA CTY NORTH,NYARUBUYE,BUSENGO,GITEBYI,701,0,0,1,14,529,544,14,558,0,O-18-87-04-01-02
KISORO,BUFUMBIRA CTY NORTH,NYARUBUYE,BUSENGO,RUGABANO,697,0,0,3,17,540,560,10,570,0,O-18-87-04-01-03
KISORO,BUFUMBIRA CTY NORTH,NYARUBUYE,BUSENGO,GATOBO,734,1,0,4,15,570,590,16,606,0,O-18-87-04-01-04
KISORO,BUFUMBIRA CTY NORTH,NYARUBUYE,KALAMBI,GATETE T. CENTRE,708,0,2,0,20,524,546,18,564,0,O-18-87-04-02-01
KISORO,BUFUMBIRA CTY NORTH,NYARUBUYE,KALAMBI,RUKUNDO T. CENTRE,587,0,0,1,17,463,481,4,485,0,O-18-87-04-02-02
KISORO,BUFUMBIRA CTY NORTH,NYARUBUYE,KALAMBI,RUKO,728,0,0,3,25,531,559,0,559,0,O-18-87-04-02-03
KISORO,BUFUMBIRA CTY NORTH,NYARUBUYE,KALAMBI,KINYABABA CHURCH SCHOOL (A-,318,1,0,2,10,237,250,9,259,0,O-18-87-04-02-04
KISORO,BUFUMBIRA CTY NORTH,NYARUBUYE,KALAMBI,BUCYEBEKA,463,2,0,4,35,301,342,15,357,0,O-18-87-04-02-05
KISORO,BUFUMBIRA CTY NORTH,NYARUBUYE,KALAMBI,GITUFE,727,4,2,2,23,540,571,24,595,0,O-18-87-04-02-06
KISORO,BUFUMBIRA CTY NORTH,NYARUBUYE,KALAMBI,KINYABABA CHURCH SCHOOL (N-,601,0,0,2,11,516,529,14,543,0,O-18-87-04-02-07
KISORO,BUFUMBIRA CTY SOUTH,CHAHI,MUGANZA,MUGANZA P. SCHOOL 'A',577,1,1,9,45,408,464,9,473,0,O-18-88-01-01-01
KISORO,BUFUMBIRA CTY SOUTH,CHAHI,MUGANZA,MUGANZA P. SCHOOL 'B',771,1,0,3,53,564,621,13,634,0,O-18-88-01-01-02
KISORO,BUFUMBIRA CTY SOUTH,CHAHI,NYAKABINGO,BUHAYO P/S,751,3,1,7,35,522,568,40,608,0,O-18-88-01-02-01
KISORO,BUFUMBIRA CTY SOUTH,CHAHI,NYAKABINGO,MASAKA,567,6,0,9,44,402,461,16,477,0,O-18-88-01-02-02
KISORO,BUFUMBIRA CTY SOUTH,CHAHI,NYAKABINGO,IRYARUHURI T. CENTRE 'A',735,2,0,11,37,542,592,19,611,0,O-18-88-01-02-03
KISORO,BUFUMBIRA CTY SOUTH,CHAHI,NYAKABINGO,IRYARUHURI T. MARKET,626,2,0,8,22,463,495,40,535,0,O-18-88-01-02-04
KISORO,BUFUMBIRA CTY SOUTH,CHAHI,RUTARE,KABIRA,557,5,2,8,15,425,455,28,483,0,O-18-88-01-03-01
KISORO,BUFUMBIRA CTY SOUTH,CHAHI,RUTARE,RUBAGABAGA,456,2,4,6,23,358,393,10,403,0,O-18-88-01-03-02
KISORO,BUFUMBIRA CTY SOUTH,CHAHI,RUTARE,KABERE P. SCHOOL,699,4,1,13,18,534,570,16,586,0,O-18-88-01-03-03
KISORO,BUFUMBIRA CTY SOUTH,CHAHI,RUTARE,NYABIHUNIKO,734,4,2,3,18,507,534,68,602,0,O-18-88-01-03-04
KISORO,BUFUMBIRA CTY SOUTH,KISORO T. C.,NORTH WARD,KAMONYI PLAY GROUND,559,1,0,2,72,334,409,22,431,0,O-18-88-02-01-01
KISORO,BUFUMBIRA CTY SOUTH,KISORO T. C.,NORTH WARD,KISORO HOSPITAL,584,1,0,3,87,349,440,17,457,0,O-18-88-02-01-02
KISORO,BUFUMBIRA CTY SOUTH,KISORO T. C.,NORTH WARD,SESEME P. SCHOOL,606,2,3,3,54,458,520,23,543,0,O-18-88-02-01-03
KISORO,BUFUMBIRA CTY SOUTH,KISORO T. C.,NORTH WARD,KISORO TOWN AGENT'S OFFICE,758,3,0,1,130,359,493,12,505,0,O-18-88-02-01-04
KISORO,BUFUMBIRA CTY SOUTH,KISORO T. C.,NORTH WARD,KUKAGINA PLAYGROUND,417,1,1,3,71,261,337,20,357,0,O-18-88-02-01-05
KISORO,BUFUMBIRA CTY SOUTH,KISORO T. C.,NORTH WARD,SESEME C.O.U,472,0,2,0,80,237,319,4,323,0,O-18-88-02-01-06
KISORO,BUFUMBIRA CTY SOUTH,KISORO T. C.,SOUTH WARD,CHAHI SUB-COUNTY HQRS,587,0,1,3,54,367,425,14,439,0,O-18-88-02-02-01
KISORO,BUFUMBIRA CTY SOUTH,KISORO T. C.,SOUTH WARD,KISORO T. T. C.,504,5,0,3,46,344,398,52,450,0,O-18-88-02-02-02
KISORO,BUFUMBIRA CTY SOUTH,KISORO T. C.,SOUTH WARD,KISORO P. SCHOOL,646,1,0,1,75,470,547,14,561,0,O-18-88-02-02-03
KISORO,BUFUMBIRA CTY SOUTH,KISORO T. C.,SOUTH WARD,KISORO PAVILLION,628,2,1,4,64,356,427,19,446,0,O-18-88-02-02-04
KISORO,BUFUMBIRA CTY SOUTH,MURAMBA,BUNAGANA,GIHARO C. O. U. PARISH,476,0,2,1,17,368,388,11,399,0,O-18-88-03-01-01
KISORO,BUFUMBIRA CTY SOUTH,MURAMBA,BUNAGANA,BUNAGANA P. SCHOOL,856,4,0,4,45,615,668,15,683,0,O-18-88-03-01-02
KISORO,BUFUMBIRA CTY SOUTH,MURAMBA,BUNAGANA,GIHARO P. SCHOOL,560,3,0,6,8,418,435,34,469,0,O-18-88-03-01-03
KISORO,BUFUMBIRA CTY SOUTH,MURAMBA,BUNAGANA,MURAMBA SECONDRY SCHOOL,566,3,1,9,3,419,435,25,460,0,O-18-88-03-01-04
KISORO,BUFUMBIRA CTY SOUTH,MURAMBA,GISOZI,GISOZI P. SCHOOL,671,3,0,4,11,554,572,11,583,0,O-18-88-03-02-01
KISORO,BUFUMBIRA CTY SOUTH,MURAMBA,GISOZI,RWERERI 7TH DAY ADV. CHURCH,642,1,4,4,21,496,526,16,542,0,O-18-88-03-02-02
KISORO,BUFUMBIRA CTY SOUTH,MURAMBA,GISOZI,BWANJEBE CATHOLIC CHURCH,598,3,1,10,14,446,474,26,500,0,O-18-88-03-02-03
KISORO,BUFUMBIRA CTY SOUTH,MURAMBA,GISOZI,BUKAZI P. SCHOOL,754,5,1,7,13,549,575,44,619,0,O-18-88-03-02-04
KISORO,BUFUMBIRA CTY SOUTH,MURAMBA,GISOZI,KABUHORO,591,6,0,10,11,446,473,28,501,0,O-18-88-03-02-05
KISORO,BUFUMBIRA CTY SOUTH,MURAMBA,MURAMBA,MURINZI AGRIC. STORE,776,2,0,6,16,629,653,19,672,0,O-18-88-03-03-01
KISORO,BUFUMBIRA CTY SOUTH,MURAMBA,MURAMBA,BURERE UNION,786,2,1,15,10,637,665,26,691,0,O-18-88-03-03-02
KISORO,BUFUMBIRA CTY SOUTH,MURAMBA,MURAMBA,ROAD CAMP - SEBUTALE'S PLACE,594,3,0,3,15,468,489,33,522,0,O-18-88-03-03-03
KISORO,BUFUMBIRA CTY SOUTH,MURAMBA,MURAMBA,NANGO P. SCHOOL,566,7,2,11,25,413,458,17,475,0,O-18-88-03-03-04
KISORO,BUFUMBIRA CTY SOUTH,MURAMBA,MURAMBA,MURAMBA SUB-COUNTY HQRS/ K,670,6,1,8,26,507,548,25,573,0,O-18-88-03-03-05
KISORO,BUFUMBIRA CTY SOUTH,MURAMBA,MURAMBA,MURAMBA P. SCHOOL,568,2,0,4,15,461,482,23,505,0,O-18-88-03-03-06
KISORO,BUFUMBIRA CTY SOUTH,MURAMBA,MURAMBA,KANYENKA MARKET,487,2,0,5,20,359,386,15,401,0,O-18-88-03-03-07
KISORO,BUFUMBIRA CTY SOUTH,MURAMBA,SOOKO,SOOKO P. SCHOOL,437,1,0,4,32,323,360,22,382,0,O-18-88-03-04-01
KISORO,BUFUMBIRA CTY SOUTH,MURAMBA,SOOKO,SOOKO C. O. U. PARISH,603,4,1,7,25,465,502,24,526,0,O-18-88-03-04-02
KISORO,BUFUMBIRA CTY SOUTH,MURAMBA,SOOKO,KAMFIZI P. SCHOOL,752,5,0,9,13,551,578,88,666,0,O-18-88-03-04-03
KISORO,BUFUMBIRA CTY SOUTH,MURAMBA,SOOKO,KURWARA,657,6,0,12,1,510,529,35,564,0,O-18-88-03-04-04
KISORO,BUFUMBIRA CTY SOUTH,MURAMBA,SOOKO,KASHINGE P.SCH,565,4,0,2,10,438,454,23,477,0,O-18-88-03-04-05
KISORO,BUFUMBIRA CTY SOUTH,NYAKINAMA,CHIHE,RASHA T. CENTRE,455,2,2,3,21,364,392,9,401,0,O-18-88-04-01-01
KISORO,BUFUMBIRA CTY SOUTH,NYAKINAMA,CHIHE,CHIHE P. SCHOOL,594,1,0,0,12,478,491,7,498,0,O-18-88-04-01-02
KISORO,BUFUMBIRA CTY SOUTH,NYAKINAMA,CHIHE,MUBUGA P. SCHOOL,572,2,0,3,35,436,476,12,488,0,O-18-88-04-01-03
KISORO,BUFUMBIRA CTY SOUTH,NYAKINAMA,CHIHE,KABOKO P. SCHOOL,369,5,0,2,18,301,326,7,333,0,O-18-88-04-01-04
KISORO,BUFUMBIRA CTY SOUTH,NYAKINAMA,MBUGA,BUHAYO T. CENTRE,574,2,3,7,31,426,469,10,479,0,O-18-88-04-02-01
KISORO,BUFUMBIRA CTY SOUTH,NYAKINAMA,MBUGA,MBUGA P. SCHOOL,593,2,1,7,43,430,483,17,500,0,O-18-88-04-02-02
KISORO,BUFUMBIRA CTY SOUTH,NYAKINAMA,RWARAMBA,RWARAMBA PARISH HQRS. MULU,711,2,2,6,30,566,606,23,629,0,O-18-88-04-03-01
KISORO,BUFUMBIRA CTY SOUTH,NYAKINAMA,RWARAMBA,MUKABYIGO,700,1,0,2,50,587,640,0,640,0,O-18-88-04-03-02
KISORO,BUFUMBIRA CTY SOUTH,NYAKINAMA,RWARAMBA,RWARAMBA P. SCHOOL,704,0,1,1,26,560,588,17,605,0,O-18-88-04-03-03
KISORO,BUFUMBIRA CTY SOUTH,NYAKINAMA,RWARAMBA,GASAVE P. SCHOOL,673,6,1,5,27,510,549,31,580,0,O-18-88-04-03-04
KISORO,BUFUMBIRA CTY SOUTH,NYAKINAMA,RWARAMBA,MUBUGA MARKET,659,3,0,0,16,446,465,112,577,0,O-18-88-04-03-05
KISORO,BUFUMBIRA CTY SOUTH,NYARUSIZA,GASOVU,KABAYA P. SCHOOL,812,1,1,7,24,657,690,21,711,0,O-18-88-05-01-01
KISORO,BUFUMBIRA CTY SOUTH,NYARUSIZA,GASOVU,GASOVU P. SCHOOL,506,0,1,6,11,408,426,6,432,0,O-18-88-05-01-02
KISORO,BUFUMBIRA CTY SOUTH,NYARUSIZA,GASOVU,MUKAJAGA CENTRE,481,3,2,7,5,387,404,16,420,0,O-18-88-05-01-03
KISORO,BUFUMBIRA CTY SOUTH,NYARUSIZA,GASOVU,BUNAMA CENTRE,685,4,4,20,17,529,574,23,597,0,O-18-88-05-01-04
KISORO,BUFUMBIRA CTY SOUTH,NYARUSIZA,GITENDERI,MUBUGA,638,5,2,5,21,535,568,70,638,0,O-18-88-05-02-01
KISORO,BUFUMBIRA CTY SOUTH,NYARUSIZA,GITENDERI,RUGINA STORE,413,4,1,5,6,297,313,27,340,0,O-18-88-05-02-02
KISORO,BUFUMBIRA CTY SOUTH,NYARUSIZA,GITENDERI,RUREMBWE P. SCHOOL,566,3,0,7,11,496,517,3,520,0,O-18-88-05-02-03
KISORO,BUFUMBIRA CTY SOUTH,NYARUSIZA,GITENDERI,KABANDE,539,4,1,10,5,431,451,30,481,0,O-18-88-05-02-04
KISORO,BUFUMBIRA CTY SOUTH,NYARUSIZA,GITENDERI,RUGINA MARKET,596,3,1,5,5,500,514,11,525,0,O-18-88-05-02-05
KISORO,BUFUMBIRA CTY SOUTH,NYARUSIZA,MABUNGO,NYARUSIZA SUB-COUNTY HQRS,457,0,0,4,15,353,372,23,395,0,O-18-88-05-03-01
KISORO,BUFUMBIRA CTY SOUTH,NYARUSIZA,MABUNGO,KABINDI MIXED SCHOOL,650,2,1,4,24,487,518,24,542,0,O-18-88-05-03-02
KISORO,BUFUMBIRA CTY SOUTH,NYARUSIZA,MABUNGO,MABUNGO P. SCHOOL,667,3,0,3,18,532,556,12,568,0,O-18-88-05-03-03
KISORO,BUFUMBIRA CTY SOUTH,NYARUSIZA,MABUNGO,KABUHUNGIRO P.SCH,385,0,1,4,16,310,331,9,340,0,O-18-88-05-03-04
KISORO,BUFUMBIRA CTY SOUTH,NYARUSIZA,MABUNGO,SAGITWE CATHOLIC CHURCH,367,3,2,2,9,298,314,8,322,0,O-18-88-05-03-05
KISORO,BUFUMBIRA CTY SOUTH,NYARUSIZA,RUKONGI,GITENDERI P. SCHOOL,793,1,1,1,34,615,652,42,694,0,O-18-88-05-04-01
KISORO,BUFUMBIRA CTY SOUTH,NYARUSIZA,RUKONGI,KANYAKWEZI,555,6,1,4,15,410,436,2,438,0,O-18-88-05-04-02
KISORO,BUFUMBIRA CTY SOUTH,NYARUSIZA,RUKONGI,GASIZA T. CENTRE,650,6,0,5,9,524,544,16,560,0,O-18-88-05-04-03
KISORO,BUFUMBIRA CTY SOUTH,NYARUSIZA,RUKONGI,RUKONGI P.SCHOOL,578,5,0,5,6,481,497,20,517,0,O-18-88-05-04-04
MASINDI,BUJENJE COUNTY,BUDONGO,KABANGO,BWINAMIRA,1018,16,5,10,90,560,681,46,727,0,O-25-122-01-01-01
MASINDI,BUJENJE COUNTY,BUDONGO,KABANGO,KABANGO P/S (A-K),1107,1,2,0,224,420,647,9,656,0,O-25-122-01-01-02
MASINDI,BUJENJE COUNTY,BUDONGO,KABANGO,KADUKURU COU,731,9,4,9,53,421,496,14,510,0,O-25-122-01-01-03
MASINDI,BUJENJE COUNTY,BUDONGO,KABANGO,MUBENDE COU (A - M),1036,11,4,2,214,417,648,48,696,0,O-25-122-01-01-04
MASINDI,BUJENJE COUNTY,BUDONGO,KABANGO,MUBENDE COU (N - Z),389,0,1,2,67,164,234,12,246,0,O-25-122-01-01-05
MASINDI,BUJENJE COUNTY,BUDONGO,KABANGO,BWINAMIRA T.C,202,3,3,2,17,111,136,6,142,0,O-25-122-01-01-06
MASINDI,BUJENJE COUNTY,BUDONGO,KABANGO,KAPEKA T.C,576,7,7,10,50,289,363,18,381,0,O-25-122-01-01-07
MASINDI,BUJENJE COUNTY,BUDONGO,KABANGO,KABANGO P/S (L-Z),385,1,1,1,61,152,216,8,224,0,O-25-122-01-01-08
MASINDI,BUJENJE COUNTY,BUDONGO,KASENENE,KASENENE T/C A,688,16,7,11,22,434,490,23,513,0,O-25-122-01-02-01
MASINDI,BUJENJE COUNTY,BUDONGO,KASENENE,KASENENE T/C B,634,10,4,6,17,398,435,45,480,0,O-25-122-01-02-02
MASINDI,BUJENJE COUNTY,BUDONGO,KASENENE,EJINGA T.C,166,3,0,2,3,117,125,16,141,0,O-25-122-01-02-03
MASINDI,BUJENJE COUNTY,BUDONGO,KASONGOIRE,BULYANGO,625,9,2,7,43,412,473,13,486,0,O-25-122-01-03-01
MASINDI,BUJENJE COUNTY,BUDONGO,KASONGOIRE,KISAGURA,897,2,3,7,33,622,667,32,699,0,O-25-122-01-03-02
MASINDI,BUJENJE COUNTY,BUDONGO,KINYALA,KINYALA I (A - L),760,7,1,3,225,167,403,9,412,0,O-25-122-01-04-01
MASINDI,BUJENJE COUNTY,BUDONGO,KINYALA,KINYALA II,618,0,0,3,206,128,337,5,342,0,O-25-122-01-04-02
MASINDI,BUJENJE COUNTY,BUDONGO,KINYALA,KINYALA I (M - Z),1250,6,1,5,440,180,632,9,641,0,O-25-122-01-04-03
MASINDI,BUJENJE COUNTY,BUDONGO,NYABYEYA,KARONGO MARKET,992,13,9,5,138,500,665,38,703,0,O-25-122-01-05-01
MASINDI,BUJENJE COUNTY,BUDONGO,NYABYEYA,NYABYEYA PRI. SCHOOL,541,5,3,4,67,257,336,31,367,0,O-25-122-01-05-02
MASINDI,BUJENJE COUNTY,BUDONGO,NYABYEYA,NYABIGOMA T.C,145,1,2,2,5,105,115,7,122,0,O-25-122-01-05-03
MASINDI,BUJENJE COUNTY,BUDONGO,NYABYEYA,NYABYEYA,650,2,9,13,74,386,484,26,510,0,O-25-122-01-05-04
MASINDI,BUJENJE COUNTY,BUDONGO,NYANTONZI,AMBAKA,852,20,12,20,64,486,602,49,651,0,O-25-122-01-06-01
MASINDI,BUJENJE COUNTY,BUDONGO,NYANTONZI,KATANGA T/CENTRE,632,2,4,8,26,480,520,17,537,0,O-25-122-01-06-02
MASINDI,BUJENJE COUNTY,BUDONGO,NYANTONZI,KIMANYA P/S,857,13,12,12,57,528,622,53,675,0,O-25-122-01-06-03
MASINDI,BUJENJE COUNTY,BUDONGO,NYANTONZI,NYANTONZI P/S,833,12,3,14,85,430,544,68,612,0,O-25-122-01-06-04
MASINDI,BUJENJE COUNTY,BUDONGO,NYANTONZI,RWEMPISI,526,18,5,8,85,320,436,4,440,0,O-25-122-01-06-05
MASINDI,BUJENJE COUNTY,BWIJANGA,BIKONZI,BIKONZI,569,3,1,4,45,365,418,23,441,0,O-25-122-02-01-01
MASINDI,BUJENJE COUNTY,BWIJANGA,BIKONZI,IKOBA,711,2,1,4,86,420,513,35,548,0,O-25-122-02-01-02
MASINDI,BUJENJE COUNTY,BWIJANGA,BIKONZI,KATUUGO,768,5,2,7,88,478,580,22,602,0,O-25-122-02-01-03
MASINDI,BUJENJE COUNTY,BWIJANGA,BIKONZI,BALYEIJUKIRA T.C,304,4,2,8,17,202,233,5,238,0,O-25-122-02-01-04
MASINDI,BUJENJE COUNTY,BWIJANGA,BIKONZI,KIKUBE,798,10,5,10,87,449,561,27,588,0,O-25-122-02-01-05
MASINDI,BUJENJE COUNTY,BWIJANGA,KAHEMBE,KAHEMBE,803,4,2,9,71,428,514,34,548,0,O-25-122-02-02-01
MASINDI,BUJENJE COUNTY,BWIJANGA,KAHEMBE,KISALIZI P/S,736,10,5,3,96,432,546,20,566,0,O-25-122-02-02-02
MASINDI,BUJENJE COUNTY,BWIJANGA,KAHEMBE,MARONGO T/C,783,1,2,3,76,483,565,30,595,0,O-25-122-02-02-03
MASINDI,BUJENJE COUNTY,BWIJANGA,KAHEMBE,MURRO PRIMARY SCHOOL,624,1,1,1,54,412,469,15,484,0,O-25-122-02-02-04
MASINDI,BUJENJE COUNTY,BWIJANGA,KAHEMBE,KYABABANDE P/S,347,2,0,0,35,243,280,7,287,0,O-25-122-02-02-05
MASINDI,BUJENJE COUNTY,BWIJANGA,KAHEMBE,RUBONA,374,1,1,5,44,253,304,3,307,0,O-25-122-02-02-06
MASINDI,BUJENJE COUNTY,BWIJANGA,KITAMBA,BYEBEGA,434,0,1,4,24,328,357,16,373,0,O-25-122-02-03-01
MASINDI,BUJENJE COUNTY,BWIJANGA,KITAMBA,ISIMBA,705,2,3,2,56,414,477,32,509,0,O-25-122-02-03-02
MASINDI,BUJENJE COUNTY,BWIJANGA,KITAMBA,KIKINGURURA (A-K),658,7,2,0,49,411,469,21,490,0,O-25-122-02-03-03
MASINDI,BUJENJE COUNTY,BWIJANGA,KITAMBA,KISAMBO,616,2,0,5,32,439,478,14,492,0,O-25-122-02-03-04
MASINDI,BUJENJE COUNTY,BWIJANGA,KITAMBA,KITAMBA P/S,890,2,1,4,90,492,589,44,633,0,O-25-122-02-03-05
MASINDI,BUJENJE COUNTY,BWIJANGA,KITAMBA,KIKINGURURA (L - Z),448,5,1,2,25,268,301,15,316,0,O-25-122-02-03-06
MASINDI,BUJENJE COUNTY,BWIJANGA,KITAMBA,KYAMAISO T.C,471,3,1,3,21,298,326,16,342,0,O-25-122-02-03-07
MASINDI,BUJENJE COUNTY,BWIJANGA,NTOMA,KYABAKOOTO,774,4,1,6,46,465,522,22,544,0,O-25-122-02-04-01
MASINDI,BUJENJE COUNTY,BWIJANGA,NTOMA,KYEBIKULE (A - K),855,7,3,7,63,434,514,23,537,0,O-25-122-02-04-02
MASINDI,BUJENJE COUNTY,BWIJANGA,NTOMA,KYEBIKULE (N - Z),573,2,0,3,43,270,318,18,336,0,O-25-122-02-04-03
MASINDI,BUJENJE COUNTY,BWIJANGA,RUKONDWA,KITONOZI TC (A-K),865,6,2,5,156,378,547,26,573,0,O-25-122-02-05-01
MASINDI,BUJENJE COUNTY,BWIJANGA,RUKONDWA,RUKONDWA,680,2,0,3,87,403,495,34,529,0,O-25-122-02-05-02
MASINDI,BUJENJE COUNTY,BWIJANGA,RUKONDWA,RUBBANI,741,7,8,8,23,507,553,51,604,0,O-25-122-02-05-03
MASINDI,BUJENJE COUNTY,BWIJANGA,RUKONDWA,KIINA,665,3,1,4,57,438,503,33,536,0,O-25-122-02-05-04
MASINDI,BUJENJE COUNTY,BWIJANGA,RUKONDWA,KITONOZI TC (L-Z),278,1,1,3,28,146,179,9,188,0,O-25-122-02-05-05
MASINDI,BURULI COUNTY,KARUJUBU,KIBWONA,BULYANGO (A - K),693,9,5,7,105,246,372,62,434,0,O-25-124-01-01-01
MASINDI,BURULI COUNTY,KARUJUBU,KIBWONA,BULYANGO (L - Z),815,7,0,4,147,327,485,36,521,0,O-25-124-01-01-02
MASINDI,BURULI COUNTY,KARUJUBU,KIBWONA,KIBWONA,651,2,2,8,36,408,456,40,496,0,O-25-124-01-01-03
MASINDI,BURULI COUNTY,KARUJUBU,KIBWONA,KIBWONA HEALTH CENTRE,328,3,2,2,32,202,241,13,254,0,O-25-124-01-01-04
MASINDI,BURULI COUNTY,KARUJUBU,KIHUBA,KABALYE,799,7,6,7,118,413,551,22,573,0,O-25-124-01-02-01
MASINDI,BURULI COUNTY,KARUJUBU,KIHUBA,KIHUUBA,862,1,4,7,115,505,632,25,657,0,O-25-124-01-02-02
MASINDI,BURULI COUNTY,KARUJUBU,KIHUBA,KISWATA,562,2,1,2,41,412,458,9,467,0,O-25-124-01-02-03
MASINDI,BURULI COUNTY,KARUJUBU,KIHUBA,KYEMA,582,1,0,1,73,363,438,12,450,0,O-25-124-01-02-04
MASINDI,BURULI COUNTY,KARUJUBU,KIHUBA,KISARABWIRE P/S,398,1,1,3,54,231,290,17,307,0,O-25-124-01-02-05
MASINDI,BURULI COUNTY,KARUJUBU,KISIITA,KIRIMA T.C,683,10,7,9,84,351,461,43,504,0,O-25-124-01-03-01
MASINDI,BURULI COUNTY,KARUJUBU,KISIITA,KARUJUBU,517,2,2,2,89,287,382,24,406,0,O-25-124-01-03-02
MASINDI,BURULI COUNTY,KARUJUBU,KISIITA,KINOGOZI,733,2,3,0,105,354,464,76,540,0,O-25-124-01-03-03
MASINDI,BURULI COUNTY,KARUJUBU,KISIITA,KITOJO T.C,175,0,0,2,43,94,139,8,147,0,O-25-124-01-03-04
MASINDI,BURULI COUNTY,KIMENGO,KIJUNJUBWA,BUKOOBA,173,1,0,0,5,103,109,2,111,0,O-25-124-02-01-01
MASINDI,BURULI COUNTY,KIMENGO,KIJUNJUBWA,KIJUNJUBWA (A-L),915,0,0,1,19,419,439,11,450,0,O-25-124-02-01-02
MASINDI,BURULI COUNTY,KIMENGO,KIJUNJUBWA,KYARUTANGA,484,0,1,1,11,246,259,1,260,0,O-25-124-02-01-03
MASINDI,BURULI COUNTY,KIMENGO,KIJUNJUBWA,KYETUNGAMYA,272,0,1,2,15,149,167,9,176,0,O-25-124-02-01-04
MASINDI,BURULI COUNTY,KIMENGO,KIJUNJUBWA,MWIGURU P/S,761,0,0,2,6,573,581,10,591,0,O-25-124-02-01-05
MASINDI,BURULI COUNTY,KIMENGO,KIJUNJUBWA,KAIKUKU,379,1,0,2,6,241,250,16,266,0,O-25-124-02-01-06
MASINDI,BURULI COUNTY,KIMENGO,KIJUNJUBWA,KIJUNJUBWA (M-Z),337,0,0,0,9,133,142,0,142,0,O-25-124-02-01-07
MASINDI,BURULI COUNTY,KIMENGO,KIMENGO,KIBANGYA,904,0,2,5,56,430,493,24,517,0,O-25-124-02-02-01
MASINDI,BURULI COUNTY,KIMENGO,KIMENGO,KIMENGO SCTY HQRS,937,1,0,2,31,381,415,20,435,0,O-25-124-02-02-02
MASINDI,BURULI COUNTY,KIMENGO,KIMENGO,NYAKARONGO P/S,553,3,0,0,17,214,234,9,243,0,O-25-124-02-02-03
MASINDI,BURULI COUNTY,MASINDI TOWN COUNCIL,CIVIC CENTRE,CENTRAL WARD I (A - KE),468,0,0,1,109,201,311,4,315,0,O-25-124-03-01-01
MASINDI,BURULI COUNTY,MASINDI TOWN COUNCIL,CIVIC CENTRE,CENTRAL WARD II (A-KI),648,1,1,0,150,227,379,20,399,0,O-25-124-03-01-02
MASINDI,BURULI COUNTY,MASINDI TOWN COUNCIL,CIVIC CENTRE,EASTERN WARD,715,2,0,0,180,189,371,58,429,0,O-25-124-03-01-03
MASINDI,BURULI COUNTY,MASINDI TOWN COUNCIL,CIVIC CENTRE,NORTHERN WARD A,883,1,3,2,142,294,442,9,451,0,O-25-124-03-01-04
MASINDI,BURULI COUNTY,MASINDI TOWN COUNCIL,CIVIC CENTRE,CENTRAL WARD II (KO-Z),632,2,4,3,129,197,335,1,336,0,O-25-124-03-01-05
MASINDI,BURULI COUNTY,MASINDI TOWN COUNCIL,CIVIC CENTRE,SOUTHERN WARD (A - L),633,2,1,0,146,215,364,7,371,0,O-25-124-03-01-06
MASINDI,BURULI COUNTY,MASINDI TOWN COUNCIL,CIVIC CENTRE,WESTERN WARD,296,2,1,0,75,93,171,9,180,0,O-25-124-03-01-07
MASINDI,BURULI COUNTY,MASINDI TOWN COUNCIL,CIVIC CENTRE,CENTRAL WARD I (KI -Z),482,0,0,0,133,167,300,9,309,0,O-25-124-03-01-08
MASINDI,BURULI COUNTY,MASINDI TOWN COUNCIL,CIVIC CENTRE,SOUTHERN WARD (M - Z),758,4,1,0,147,250,402,28,430,0,O-25-124-03-01-09
MASINDI,BURULI COUNTY,MASINDI TOWN COUNCIL,CIVIC CENTRE,SOUTHERN WARD (K -M),494,2,0,0,85,204,291,7,298,0,O-25-124-03-01-10
MASINDI,BURULI COUNTY,MASINDI TOWN COUNCIL,CIVIC CENTRE,NORTHERN WARD(A-L),941,3,0,3,146,325,477,3,480,0,O-25-124-03-01-11
MASINDI,BURULI COUNTY,MASINDI TOWN COUNCIL,CIVIC CENTRE,NORTHERN WARD (M-Z),771,1,2,0,108,292,403,5,408,0,O-25-124-03-01-12
MASINDI,BURULI COUNTY,MASINDI TOWN COUNCIL,SOUTHERN WARD,KIRASA (A-L),679,3,0,3,218,182,406,20,426,0,O-25-124-03-02-01
MASINDI,BURULI COUNTY,MASINDI TOWN COUNCIL,SOUTHERN WARD,NYAMIGISA,247,1,0,0,33,139,173,5,178,0,O-25-124-03-02-02
MASINDI,BURULI COUNTY,MASINDI TOWN COUNCIL,SOUTHERN WARD,NYANGAHYA 1 (A-L),646,3,1,1,121,276,402,11,413,0,O-25-124-03-02-03
MASINDI,BURULI COUNTY,MASINDI TOWN COUNCIL,SOUTHERN WARD,NYANGAHYA 2,462,5,0,2,103,161,271,5,276,0,O-25-124-03-02-04
MASINDI,BURULI COUNTY,MASINDI TOWN COUNCIL,SOUTHERN WARD,KIRASA (M-Z),580,1,2,7,202,153,365,3,368,0,O-25-124-03-02-05
MASINDI,BURULI COUNTY,MASINDI TOWN COUNCIL,SOUTHERN WARD,NYANGAHYA 1 (M-Z),449,3,0,4,114,162,283,8,291,0,O-25-124-03-02-06
MASINDI,BURULI COUNTY,MASINDI TOWN COUNCIL,WESTERN WARD,BULYASOJO,735,4,5,0,125,326,460,7,467,0,O-25-124-03-03-01
MASINDI,BURULI COUNTY,MASINDI TOWN COUNCIL,WESTERN WARD,KIHANDE I/II (A-L),659,3,1,0,145,303,452,12,464,0,O-25-124-03-03-02
MASINDI,BURULI COUNTY,MASINDI TOWN COUNCIL,WESTERN WARD,KIJURA I (A-I),440,1,2,0,103,179,285,3,288,0,O-25-124-03-03-03
MASINDI,BURULI COUNTY,MASINDI TOWN COUNCIL,WESTERN WARD,KIJURA II (A-K),924,6,5,1,187,384,583,29,612,0,O-25-124-03-03-04
MASINDI,BURULI COUNTY,MASINDI TOWN COUNCIL,WESTERN WARD,KISIITA,509,2,1,2,97,288,390,14,404,0,O-25-124-03-03-05
MASINDI,BURULI COUNTY,MASINDI TOWN COUNCIL,WESTERN WARD,KIJURA II (L- Z),700,4,2,2,190,262,460,8,468,0,O-25-124-03-03-06
MASINDI,BURULI COUNTY,MASINDI TOWN COUNCIL,WESTERN WARD,KIHANDE I/II (M-Z),448,2,0,0,85,200,287,25,312,0,O-25-124-03-03-07
MASINDI,BURULI COUNTY,MASINDI TOWN COUNCIL,WESTERN WARD,KIJURA I (J-Z),682,0,6,2,144,285,437,13,450,0,O-25-124-03-03-08
MASINDI,BURULI COUNTY,MIIRYA,BIGANDO,BIGANDO (A-L),561,4,3,2,140,264,413,22,435,0,O-25-124-04-01-01
MASINDI,BURULI COUNTY,MIIRYA,BIGANDO,KAHARA,632,5,2,9,61,426,503,22,525,0,O-25-124-04-01-02
MASINDI,BURULI COUNTY,MIIRYA,BIGANDO,KINUUMA,549,4,1,3,69,329,406,21,427,0,O-25-124-04-01-03
MASINDI,BURULI COUNTY,MIIRYA,BIGANDO,KYAMUJWALA,175,0,0,0,10,116,126,12,138,0,O-25-124-04-01-04
MASINDI,BURULI COUNTY,MIIRYA,BIGANDO,KYAMWITA T.C,334,0,1,3,53,188,245,12,257,0,O-25-124-04-01-05
MASINDI,BURULI COUNTY,MIIRYA,BIGANDO,KABATUKURU MIRACLE CENTRE,301,0,0,3,16,138,157,8,165,0,O-25-124-04-01-06
MASINDI,BURULI COUNTY,MIIRYA,BIGANDO,BIGANDO (M-Z),314,2,2,0,48,143,195,33,228,0,O-25-124-04-01-07
MASINDI,BURULI COUNTY,MIIRYA,BIGANDO,KABALI P/S,451,1,0,1,34,247,283,21,304,0,O-25-124-04-01-08
MASINDI,BURULI COUNTY,MIIRYA,ISIMBA,ISIMBA P/HQTRS,560,3,4,9,85,281,382,20,402,0,O-25-124-04-02-01
MASINDI,BURULI COUNTY,MIIRYA,ISIMBA,KIJOOGO,263,1,0,3,36,160,200,15,215,0,O-25-124-04-02-02
MASINDI,BURULI COUNTY,MIIRYA,ISIMBA,KISANJA P/S,681,8,1,4,90,405,508,30,538,0,O-25-124-04-02-03
MASINDI,BURULI COUNTY,MIIRYA,ISIMBA,KITOOKA T/C,611,4,2,5,58,381,450,31,481,0,O-25-124-04-02-04
MASINDI,BURULI COUNTY,MIIRYA,KIGUULYA,KIGEZI T/C,386,0,1,6,53,225,285,21,306,0,O-25-124-04-03-01
MASINDI,BURULI COUNTY,MIIRYA,KIGUULYA,KIGULYA COU,424,5,1,2,37,297,342,22,364,0,O-25-124-04-03-02
MASINDI,BURULI COUNTY,MIIRYA,KIGUULYA,KIJOGORO P/S (A-L),442,4,1,3,62,147,217,74,291,0,O-25-124-04-03-03
MASINDI,BURULI COUNTY,MIIRYA,KIGUULYA,KINUMI T/C,440,6,2,5,62,255,330,28,358,0,O-25-124-04-03-04
MASINDI,BURULI COUNTY,MIIRYA,KIGUULYA,KISUUGA,294,4,1,10,77,111,203,22,225,0,O-25-124-04-03-05
MASINDI,BURULI COUNTY,MIIRYA,KIGUULYA,MIIRYA SCTY HQRS,644,3,1,0,72,321,397,76,473,0,O-25-124-04-03-06
MASINDI,BURULI COUNTY,MIIRYA,KIGUULYA,NYAKALOGI CATH. CHURCH,465,4,1,3,50,317,375,17,392,0,O-25-124-04-03-07
MASINDI,BURULI COUNTY,MIIRYA,KIGUULYA,RWEMIGALI T.C,261,2,0,5,50,108,165,14,179,0,O-25-124-04-03-08
MASINDI,BURULI COUNTY,MIIRYA,KIGUULYA,KIJOGORO P/S (M-Z),436,4,1,6,86,170,267,29,296,0,O-25-124-04-03-09
MASINDI,BURULI COUNTY,NYANGAHYA,KIKWANANA/KIHAND,BIIZI,749,3,8,5,116,416,548,21,569,0,O-25-124-05-01-01
MASINDI,BURULI COUNTY,NYANGAHYA,KIKWANANA/KIHAND,KIKWANANA,828,3,0,2,119,476,600,16,616,0,O-25-124-05-01-02
MASINDI,BURULI COUNTY,NYANGAHYA,KIKWANANA/KIHAND,NYAKATOOKE,621,5,3,3,94,322,427,14,441,0,O-25-124-05-01-03
MASINDI,BURULI COUNTY,NYANGAHYA,KIRYANGA,KALYANGO T/C,742,2,1,2,82,464,551,65,616,0,O-25-124-05-02-01
MASINDI,BURULI COUNTY,NYANGAHYA,KIRYANGA,KATASENYWA P/S (A-J),482,2,1,1,69,270,343,28,371,0,O-25-124-05-02-02
MASINDI,BURULI COUNTY,NYANGAHYA,KIRYANGA,RWIJERE P/S (A-K),839,2,0,3,154,468,627,33,660,0,O-25-124-05-02-03
MASINDI,BURULI COUNTY,NYANGAHYA,KIRYANGA,KATASENYWA P/S (K-Z),502,3,0,1,60,305,369,4,373,0,O-25-124-05-02-04
MASINDI,BURULI COUNTY,NYANGAHYA,KIRYANGA,RWIJERE P/S (L-Z),308,3,2,1,52,169,227,11,238,0,O-25-124-05-02-05
MASINDI,BURULI COUNTY,PAKANYI,KIHAGUZI,HANGA (A - M),700,3,0,6,70,391,470,7,477,0,O-25-124-06-01-01
MASINDI,BURULI COUNTY,PAKANYI,KIHAGUZI,KASENYI BOKWE T/C (A - L),736,8,2,10,58,350,428,40,468,0,O-25-124-06-01-02
MASINDI,BURULI COUNTY,PAKANYI,KIHAGUZI,KIBAMBA P/S (A-L),840,14,3,7,135,378,537,36,573,0,O-25-124-06-01-03
MASINDI,BURULI COUNTY,PAKANYI,KIHAGUZI,KIBAMBA P/S (M-Z),418,8,3,4,61,205,281,8,289,0,O-25-124-06-01-04
MASINDI,BURULI COUNTY,PAKANYI,KIHAGUZI,HANGA (N - Z),450,2,0,5,38,224,269,20,289,0,O-25-124-06-01-05
MASINDI,BURULI COUNTY,PAKANYI,KIHAGUZI,KASENYI BOKWE T/C (M - Z),499,2,5,6,46,243,302,20,322,0,O-25-124-06-01-06
MASINDI,BURULI COUNTY,PAKANYI,KIRULI,KITENGULE MKT,894,15,7,17,92,406,537,26,563,0,O-25-124-06-02-01
MASINDI,BURULI COUNTY,PAKANYI,KIRULI,KITANYATA (A-L),903,13,3,6,96,336,454,44,498,0,O-25-124-06-02-02
MASINDI,BURULI COUNTY,PAKANYI,KIRULI,KIRULI T.C,596,4,0,4,52,316,376,13,389,0,O-25-124-06-02-03
MASINDI,BURULI COUNTY,PAKANYI,KIRULI,KITANYATA (M-Z),744,8,1,14,77,266,366,21,387,0,O-25-124-06-02-04
MASINDI,BURULI COUNTY,PAKANYI,KYAKAMESE,KIBAMBA(A-L),525,13,2,0,74,218,307,13,320,0,O-25-124-06-03-01
MASINDI,BURULI COUNTY,PAKANYI,KYAKAMESE,KIBAMBA (M-Z),585,3,0,8,71,278,360,14,374,0,O-25-124-06-03-02
MASINDI,BURULI COUNTY,PAKANYI,KYAKAMESE,KIYUYA,428,2,0,1,48,277,328,6,334,0,O-25-124-06-03-03
MASINDI,BURULI COUNTY,PAKANYI,KYAKAMESE,NYAKATOOGO,607,5,1,3,45,342,396,10,406,0,O-25-124-06-03-04
MASINDI,BURULI COUNTY,PAKANYI,KYAKAMESE,PAKANYI (A-L),660,1,2,4,69,350,426,13,439,0,O-25-124-06-03-05
MASINDI,BURULI COUNTY,PAKANYI,KYAKAMESE,WAIGA,913,11,4,15,42,426,498,42,540,0,O-25-124-06-03-06
MASINDI,BURULI COUNTY,PAKANYI,KYAKAMESE,PAKANYI (M-Z),438,5,3,1,36,205,250,17,267,0,O-25-124-06-03-07
MASINDI,BURULI COUNTY,PAKANYI,KYAKAMESE,KATUGO CATH. CHURCH,362,6,3,0,34,173,216,21,237,0,O-25-124-06-03-08
MASINDI,BURULI COUNTY,PAKANYI,KYAKAMESE,ALIMUGONZA (A-ON),770,6,1,1,94,280,382,16,398,0,O-25-124-06-03-09
MASINDI,BURULI COUNTY,PAKANYI,KYAKAMESE,ALIMUGONZA (OM-Z),356,2,0,1,55,119,177,10,187,0,O-25-124-06-03-10
MASINDI,BURULI COUNTY,PAKANYI,KYATIRI,KIBIBIRA,1126,11,8,28,226,485,758,32,790,0,O-25-124-06-04-01
MASINDI,BURULI COUNTY,PAKANYI,KYATIRI,KYATIRI 1,1067,13,6,10,230,328,587,44,631,0,O-25-124-06-04-02
MASINDI,BURULI COUNTY,PAKANYI,KYATIRI,KYATIRI 2,688,4,2,4,150,262,422,22,444,0,O-25-124-06-04-03
MASINDI,BURULI COUNTY,PAKANYI,KYATIRI,NYAKABALE,267,4,2,7,66,85,164,18,182,0,O-25-124-06-04-04
MASINDI,BURULI COUNTY,PAKANYI,KYATIRI,NYAMBINDO (A-L),735,6,4,8,112,347,477,23,500,0,O-25-124-06-04-05
MASINDI,BURULI COUNTY,PAKANYI,KYATIRI,NYAMBINDO (M-Z),353,5,1,9,61,144,220,17,237,0,O-25-124-06-04-06
MASINDI,BURULI COUNTY,PAKANYI,LABONGO,KIHONDA,597,1,1,0,72,376,450,15,465,0,O-25-124-06-05-01
MASINDI,BURULI COUNTY,PAKANYI,LABONGO,KILANYI AID POST,824,3,0,5,77,459,544,17,561,0,O-25-124-06-05-02
MASINDI,BURULI COUNTY,PAKANYI,LABONGO,KYAMUGWERA,552,2,2,3,53,348,408,10,418,0,O-25-124-06-05-03
MBARARA,KASHARI COUNTY,BIHARWE,BIHARWE,BIHARWE I,396,3,2,1,57,232,295,8,303,0,O-27-140-01-01-01
MBARARA,KASHARI COUNTY,BIHARWE,BIHARWE,BIHARWE T/C,491,1,1,0,122,169,293,4,297,0,O-27-140-01-01-02
MBARARA,KASHARI COUNTY,BIHARWE,BIHARWE,KAMATARISI P/S,318,2,1,0,41,185,229,7,236,0,O-27-140-01-01-03
MBARARA,KASHARI COUNTY,BIHARWE,KISHASHA,KISHASHA 1,539,3,0,0,77,299,379,3,382,0,O-27-140-01-02-01
MBARARA,KASHARI COUNTY,BIHARWE,KISHASHA,NYAKANENGO T/C,452,0,0,0,63,295,358,9,367,0,O-27-140-01-02-02
MBARARA,KASHARI COUNTY,BIHARWE,KISHASHA,KISHASHA 3,471,0,0,1,47,312,360,33,393,0,O-27-140-01-02-03
MBARARA,KASHARI COUNTY,BIHARWE,NYABUHAMA,KATOJO,454,0,0,1,79,235,315,18,333,0,O-27-140-01-03-01
MBARARA,KASHARI COUNTY,BIHARWE,NYABUHAMA,NYABUHAMA 2,478,1,0,1,167,217,386,8,394,0,O-27-140-01-03-02
MBARARA,KASHARI COUNTY,BIHARWE,NYABUHAMA,NYABUHAMA 3,230,0,0,0,82,113,195,4,199,0,O-27-140-01-03-03
MBARARA,KASHARI COUNTY,BIHARWE,NYABUHAMA,NYABUHAMA 4,429,3,1,3,88,219,314,10,324,0,O-27-140-01-03-04
MBARARA,KASHARI COUNTY,BIHARWE,NYAKINENGO,NYAKINENGO 1,465,0,0,1,34,310,345,5,350,0,O-27-140-01-04-01
MBARARA,KASHARI COUNTY,BIHARWE,NYAKINENGO,NYAKINENGO 2,557,2,0,0,110,257,369,4,373,0,O-27-140-01-04-02
MBARARA,KASHARI COUNTY,BIHARWE,NYAKINENGO,RWEMIKUNYU T/C,315,0,0,1,32,226,259,6,265,0,O-27-140-01-04-03
MBARARA,KASHARI COUNTY,BIHARWE,RWENJERU,RWENJERU 1,345,0,1,0,47,293,341,1,342,0,O-27-140-01-05-01
MBARARA,KASHARI COUNTY,BIHARWE,RWENJERU,RWENJERU 2,399,4,1,0,44,220,269,6,275,0,O-27-140-01-05-02
MBARARA,KASHARI COUNTY,BIHARWE,RWENJERU,RWENJERU C.O.U,412,1,0,1,39,298,339,8,347,0,O-27-140-01-05-03
MBARARA,KASHARI COUNTY,BISYA,KABARE,KABAARE S/COUNTY HQRS,985,1,0,0,158,384,543,8,551,0,O-27-140-02-01-01
MBARARA,KASHARI COUNTY,BISYA,KABARE,RUHUMBA,302,0,0,0,19,193,212,7,219,0,O-27-140-02-01-02
MBARARA,KASHARI COUNTY,BISYA,KABARE,AHANIKIRI,393,2,0,0,28,239,269,4,273,0,O-27-140-02-01-03
MBARARA,KASHARI COUNTY,BISYA,KABARE,ORUTEISIRE T/C,467,1,0,2,42,332,377,9,386,0,O-27-140-02-01-04
MBARARA,KASHARI COUNTY,BISYA,KABARE,RUBINDI /KABULA,241,0,1,0,21,152,174,4,178,0,O-27-140-02-01-05
MBARARA,KASHARI COUNTY,BISYA,KARIRO,BUREBERO T/C,288,0,0,0,22,216,238,8,246,0,O-27-140-02-02-01
MBARARA,KASHARI COUNTY,BISYA,KARIRO,KARIRO PARISH HQRS,509,4,0,2,59,340,405,8,413,0,O-27-140-02-02-02
MBARARA,KASHARI COUNTY,BISYA,KARIRO,AKABINGO T/C,598,0,2,1,60,404,467,0,467,0,O-27-140-02-02-03
MBARARA,KASHARI COUNTY,BISYA,KARWESANGA(RUGA,BISYA 1,749,2,3,5,88,496,594,4,598,0,O-27-140-02-03-01
MBARARA,KASHARI COUNTY,BISYA,KARWESANGA(RUGA,BISYA 3,624,0,0,2,65,429,496,4,500,0,O-27-140-02-03-02
MBARARA,KASHARI COUNTY,BISYA,NYAMIRIRO,RUKANJA PRI. SCHOOL,501,0,0,0,38,368,406,4,410,0,O-27-140-02-04-01
MBARARA,KASHARI COUNTY,BISYA,NYAMIRIRO,KURIKAYO T/C,367,0,0,1,16,295,312,4,316,0,O-27-140-02-04-02
MBARARA,KASHARI COUNTY,BISYA,NYAMIRIRO,NYAMIRIRO PARISH HQRS,452,3,0,0,59,287,349,3,352,0,O-27-140-02-04-03
MBARARA,KASHARI COUNTY,BISYA,RWAMUHIIGI,RWAMUHIGI 1,273,0,0,0,41,192,233,4,237,0,O-27-140-02-05-01
MBARARA,KASHARI COUNTY,BISYA,RWAMUHIIGI,RWAMUHIGI 2,536,1,0,4,48,387,440,12,452,0,O-27-140-02-05-02
MBARARA,KASHARI COUNTY,BISYA,RWAMUHIIGI,RWAMUHIGI 3,527,1,0,2,25,426,454,10,464,0,O-27-140-02-05-03
MBARARA,KASHARI COUNTY,BUBAARE,KAMUSHOKO,KAMUSHOKO 1,361,0,0,0,53,228,281,5,286,0,O-27-140-03-01-01
MBARARA,KASHARI COUNTY,BUBAARE,KAMUSHOKO,KAMUSHOKO 2,605,2,0,0,101,362,465,10,475,0,O-27-140-03-01-02
MBARARA,KASHARI COUNTY,BUBAARE,KAMUSHOKO,KYANTAMBA / RWEMPOGO,505,1,0,0,94,238,333,16,349,0,O-27-140-03-01-03
MBARARA,KASHARI COUNTY,BUBAARE,KASHAKA,KASHAKA 1,667,4,3,1,112,331,451,5,456,0,O-27-140-03-02-01
MBARARA,KASHARI COUNTY,BUBAARE,KASHAKA,KASHAKA 2,418,0,0,0,62,247,309,6,315,0,O-27-140-03-02-02
MBARARA,KASHARI COUNTY,BUBAARE,KASHAKA,NTURA PRI. SCHOOL,118,0,0,1,13,74,88,0,88,0,O-27-140-03-02-03
MBARARA,KASHARI COUNTY,BUBAARE,KATOJO,KATOJO 1,402,0,0,1,36,235,272,5,277,0,O-27-140-03-03-01
MBARARA,KASHARI COUNTY,BUBAARE,KATOJO,KATOJO 2,229,0,0,0,28,129,157,2,159,0,O-27-140-03-03-02
MBARARA,KASHARI COUNTY,BUBAARE,MUGARUTSYA,MUGARUTSYA PARISH HQRS,288,2,0,0,26,229,257,5,262,0,O-27-140-03-04-01
MBARARA,KASHARI COUNTY,BUBAARE,MUGARUTSYA,MUGARUTSYA I,653,3,0,1,77,390,471,29,500,0,O-27-140-03-04-02
MBARARA,KASHARI COUNTY,BUBAARE,MUGARUTSYA,MUGARUTSYA II,333,0,0,0,44,149,193,10,203,0,O-27-140-03-04-03
MBARARA,KASHARI COUNTY,BUBAARE,RUGARAMA,RUGARAMA 1,627,3,4,4,103,367,481,23,504,0,O-27-140-03-05-01
MBARARA,KASHARI COUNTY,BUBAARE,RUGARAMA,RUGARAMA 4,373,2,1,1,36,245,285,12,297,0,O-27-140-03-05-02
MBARARA,KASHARI COUNTY,BUBAARE,RUGARAMA,NKAKA,218,2,0,1,24,151,178,0,178,0,O-27-140-03-05-03
MBARARA,KASHARI COUNTY,BUBAARE,RWENSHANKU,RWENSHANKU 1,355,2,5,1,41,193,242,8,250,0,O-27-140-03-06-01
MBARARA,KASHARI COUNTY,BUBAARE,RWENSHANKU,RWENSHANKU 2,675,0,5,0,66,374,445,8,453,0,O-27-140-03-06-02
MBARARA,KASHARI COUNTY,BUBAARE,RWENSHANKU,RWANSHANKU / RUGONGI,292,1,3,0,22,187,213,0,213,0,O-27-140-03-06-03
MBARARA,KASHARI COUNTY,BUKIIRO,BUKIRO,BUKIRO 1,725,0,0,2,86,434,522,27,549,0,O-27-140-04-01-01
MBARARA,KASHARI COUNTY,BUKIIRO,BUKIRO,BUKIRO 2,707,4,1,1,102,417,525,3,528,0,O-27-140-04-01-02
MBARARA,KASHARI COUNTY,BUKIIRO,NYANJA,NYANZA I,638,0,0,0,73,420,493,6,499,0,O-27-140-04-02-01
MBARARA,KASHARI COUNTY,BUKIIRO,NYANJA,NYANZA II,692,1,0,2,128,407,538,11,549,0,O-27-140-04-02-02
MBARARA,KASHARI COUNTY,BUKIIRO,NYARUBUNGO,NYARUBUNGO 1,383,5,0,0,42,256,303,7,310,0,O-27-140-04-03-01
MBARARA,KASHARI COUNTY,BUKIIRO,NYARUBUNGO,NYARUBUNGO 2,243,0,0,0,20,164,184,8,192,0,O-27-140-04-03-02
MBARARA,KASHARI COUNTY,BUKIIRO,NYARUBUNGO,NYARUBUNGO 3,456,0,0,3,44,334,381,13,394,0,O-27-140-04-03-03
MBARARA,KASHARI COUNTY,BUKIIRO,NYARUBUNGO,NYARUBUNGO 4,834,1,0,0,117,539,657,7,664,0,O-27-140-04-03-04
MBARARA,KASHARI COUNTY,BUKIIRO,RUBINGO,RUBINGO 2,442,2,2,1,41,280,326,17,343,0,O-27-140-04-04-01
MBARARA,KASHARI COUNTY,BUKIIRO,RUBINGO,RUBINGO 3,695,0,1,2,72,458,533,19,552,0,O-27-140-04-04-02
MBARARA,KASHARI COUNTY,ITARA,RUBURARA,MUTONTO,347,2,0,2,46,243,293,2,295,0,O-27-140-05-01-01
MBARARA,KASHARI COUNTY,ITARA,RUBURARA,KAHOOMA,689,2,3,3,103,461,572,5,577,0,O-27-140-05-01-02
MBARARA,KASHARI COUNTY,ITARA,RUSHOZI,ITARA 1,607,1,0,0,102,329,432,0,432,0,O-27-140-05-02-01
MBARARA,KASHARI COUNTY,ITARA,RUSHOZI,ITARA 2,648,2,1,3,103,366,475,9,484,0,O-27-140-05-02-02
MBARARA,KASHARI COUNTY,KAGONGI,BWENGURE,BWENGURE 1,533,2,0,2,92,310,406,9,415,0,O-27-140-06-01-01
MBARARA,KASHARI COUNTY,KAGONGI,BWENGURE,BWENGURE 2,515,2,0,0,49,303,354,0,354,0,O-27-140-06-01-02
MBARARA,KASHARI COUNTY,KAGONGI,BWENGURE,BWENGURE 3,399,0,0,1,49,244,294,0,294,0,O-27-140-06-01-03
MBARARA,KASHARI COUNTY,KAGONGI,BWENGURE,RUGARAMA,362,3,0,1,26,252,282,5,287,0,O-27-140-06-01-04
MBARARA,KASHARI COUNTY,KAGONGI,KIBINGO,KIBINGO 1,285,0,0,1,23,208,232,5,237,0,O-27-140-06-02-01
MBARARA,KASHARI COUNTY,KAGONGI,KIBINGO,KIBINGO 2,402,0,2,0,16,325,343,7,350,0,O-27-140-06-02-02
MBARARA,KASHARI COUNTY,KAGONGI,KIBINGO,KIBINGO 3,340,0,1,1,13,276,291,8,299,0,O-27-140-06-02-03
MBARARA,KASHARI COUNTY,KAGONGI,KYANDAHI,KYENDAHI 1,558,2,1,0,49,369,421,6,427,0,O-27-140-06-03-01
MBARARA,KASHARI COUNTY,KAGONGI,KYANDAHI,KYENDAHI 2,168,0,0,0,4,136,140,3,143,0,O-27-140-06-03-02
MBARARA,KASHARI COUNTY,KAGONGI,KYANDAHI,KYENDAHI 3,293,1,1,1,14,222,239,5,244,0,O-27-140-06-03-03
MBARARA,KASHARI COUNTY,KAGONGI,NGANGO,NGANGO 1,396,0,1,0,27,271,299,11,310,0,O-27-140-06-04-01
MBARARA,KASHARI COUNTY,KAGONGI,NGANGO,NGANGO 2,333,0,1,1,30,227,259,5,264,0,O-27-140-06-04-02
MBARARA,KASHARI COUNTY,KAGONGI,NGANGO,NGANGO 3,387,1,2,1,18,282,304,15,319,0,O-27-140-06-04-03
MBARARA,KASHARI COUNTY,KAGONGI,NGANGO,NGANGO 4,456,0,0,1,15,362,378,11,389,0,O-27-140-06-04-04
MBARARA,KASHARI COUNTY,KAGONGI,NSIIKA,NSIIKA 1,173,0,0,0,36,92,128,8,136,0,O-27-140-06-05-01
MBARARA,KASHARI COUNTY,KAGONGI,NSIIKA,NSIIKA 2,259,0,0,0,34,183,217,1,218,0,O-27-140-06-05-02
MBARARA,KASHARI COUNTY,KAGONGI,NSIIKA,NSIIKA 3,641,0,1,1,57,459,518,9,527,0,O-27-140-06-05-03
MBARARA,KASHARI COUNTY,KAGONGI,NTUURA,NTUURA 1,472,1,1,1,49,309,361,8,369,0,O-27-140-06-06-01
MBARARA,KASHARI COUNTY,KAGONGI,NTUURA,NTUURA 2,203,0,0,0,10,156,166,5,171,0,O-27-140-06-06-02
MBARARA,KASHARI COUNTY,KAGONGI,NTUURA,NTUURA 3,426,0,0,1,32,299,332,6,338,0,O-27-140-06-06-03
MBARARA,KASHARI COUNTY,KAGONGI,NTUURA,NTUURA 4,629,1,0,0,42,452,495,9,504,0,O-27-140-06-06-04
MBARARA,KASHARI COUNTY,KAKIIKA,BUNUTSYA,BUNUTSYA I,585,0,0,2,42,421,465,12,477,0,O-27-140-07-01-01
MBARARA,KASHARI COUNTY,KAKIIKA,BUNUTSYA,BUNUTSYA II,195,0,0,1,11,150,162,6,168,0,O-27-140-07-01-02
MBARARA,KASHARI COUNTY,KAKIIKA,KAKIIKA,NYAKABUNGO,365,1,0,0,48,174,223,15,238,0,O-27-140-07-02-01
MBARARA,KASHARI COUNTY,KAKIIKA,KAKIIKA,KAKIIKA 1/MAKENKE 1,333,0,0,1,46,145,192,8,200,0,O-27-140-07-02-02
MBARARA,KASHARI COUNTY,KAKIIKA,KAKIIKA,KAKIIKA 2/MAKENKE 2,358,0,0,0,39,203,242,6,248,0,O-27-140-07-02-03
MBARARA,KASHARI COUNTY,KAKIIKA,KAKIIKA,KAKIIKA 3/MAKENKE 3,619,1,0,2,97,232,332,8,340,0,O-27-140-07-02-04
MBARARA,KASHARI COUNTY,KAKIIKA,KAKIIKA,KAKIIKA OUTSIDE Q.GUARD [A - J],581,2,3,0,87,168,260,4,264,0,O-27-140-07-02-05
MBARARA,KASHARI COUNTY,KAKIIKA,KAKIIKA,KAKIIKA OUTSIDE Q.GUARD [K - M,993,3,2,0,133,385,523,15,538,0,O-27-140-07-02-06
MBARARA,KASHARI COUNTY,KAKIIKA,KAKIIKA,KAKIIKA OUTSIDE Q.GUARD [N - Z],1175,2,3,0,140,322,467,4,471,0,O-27-140-07-02-07
MBARARA,KASHARI COUNTY,KAKIIKA,KAKOMA,KAKOMA,750,2,1,0,58,497,558,18,576,0,O-27-140-07-03-01
MBARARA,KASHARI COUNTY,KAKIIKA,KAKOMA,KAKOMA 2,278,0,0,0,22,201,223,6,229,0,O-27-140-07-03-02
MBARARA,KASHARI COUNTY,KAKIIKA,NYARUBANGA,NYARUBANGA,664,0,2,2,95,331,430,1,431,0,O-27-140-07-04-01
MBARARA,KASHARI COUNTY,KAKIIKA,RWEMIGYINA,RWEMIGINA 2,613,0,1,0,85,380,466,11,477,0,O-27-140-07-05-01
MBARARA,KASHARI COUNTY,KAKIIKA,RWEMIGYINA,RWEMIGINA 3,589,0,1,0,75,326,402,0,402,0,O-27-140-07-05-02
MBARARA,KASHARI COUNTY,KASHARE,MIRONGO,MIRONGO 1,465,0,0,3,61,331,395,9,404,0,O-27-140-08-01-01
MBARARA,KASHARI COUNTY,KASHARE,MIRONGO,MIRONGO 2,508,1,1,3,77,328,410,14,424,0,O-27-140-08-01-02
MBARARA,KASHARI COUNTY,KASHARE,MIRONGO,MIRONGO 3,390,0,0,0,36,277,313,8,321,0,O-27-140-08-01-03
MBARARA,KASHARI COUNTY,KASHARE,MIRONGO,MIRONGO 4,700,1,1,1,68,464,535,7,542,0,O-27-140-08-01-04
MBARARA,KASHARI COUNTY,KASHARE,MITOOZO,MITOOZO 1,512,0,3,0,46,314,363,20,383,0,O-27-140-08-02-01
MBARARA,KASHARI COUNTY,KASHARE,MITOOZO,MITOOZO 2,446,1,0,0,32,299,332,4,336,0,O-27-140-08-02-02
MBARARA,KASHARI COUNTY,KASHARE,MITOOZO,MITOOZO 3,669,0,0,1,61,427,489,10,499,0,O-27-140-08-02-03
MBARARA,KASHARI COUNTY,KASHARE,NCHUNE,NCHUNE 1,446,1,0,1,28,295,325,9,334,0,O-27-140-08-03-01
MBARARA,KASHARI COUNTY,KASHARE,NCHUNE,NCHUNE 2,329,1,1,1,38,227,268,7,275,0,O-27-140-08-03-02
MBARARA,KASHARI COUNTY,KASHARE,NCHUNE,NCHUNE 3,561,0,0,0,45,370,415,3,418,0,O-27-140-08-03-03
MBARARA,KASHARI COUNTY,KASHARE,NCHUNE,NCHUNE 4,564,0,0,0,40,361,401,7,408,0,O-27-140-08-03-04
MBARARA,KASHARI COUNTY,KASHARE,NYABISIRIRA,NYABISIRIRA 1,510,0,1,0,40,383,424,0,424,0,O-27-140-08-04-01
MBARARA,KASHARI COUNTY,KASHARE,NYABISIRIRA,NYABISIRIRA 2,373,0,4,0,27,262,293,2,295,0,O-27-140-08-04-02
MBARARA,KASHARI COUNTY,KASHARE,NYABISIRIRA,NYABISIRIRA 3,609,1,0,1,36,436,474,6,480,0,O-27-140-08-04-03
MBARARA,KASHARI COUNTY,KASHARE,NYABISIRIRA,NYABISIRIRA 4,573,0,0,5,72,353,430,8,438,0,O-27-140-08-04-04
MBARARA,KASHARI COUNTY,KASHARE,NYABISIRIRA,AKAIHAMBA,432,0,1,0,36,262,299,14,313,0,O-27-140-08-04-05
MBARARA,KASHARI COUNTY,RUBAYA,BUNENERO,BUNENERO 2,527,1,0,2,112,275,390,10,400,0,O-27-140-09-01-01
MBARARA,KASHARI COUNTY,RUBAYA,BUNENERO,BUNENERO 3,801,4,0,0,107,427,538,2,540,0,O-27-140-09-01-02
MBARARA,KASHARI COUNTY,RUBAYA,RUHUNGA,RUHUNGA 1,475,1,0,2,53,273,329,0,329,0,O-27-140-09-02-01
MBARARA,KASHARI COUNTY,RUBAYA,RUHUNGA,RUHUNGA 3,613,2,1,2,116,353,474,0,474,0,O-27-140-09-02-02
MBARARA,KASHARI COUNTY,RUBAYA,RUHUNGA,RUHUNGA 4,233,1,0,2,48,136,187,2,189,0,O-27-140-09-02-03
MBARARA,KASHARI COUNTY,RUBAYA,RUHUNGA,RUHUNGA 5,260,1,0,0,50,139,190,2,192,0,O-27-140-09-02-04
MBARARA,KASHARI COUNTY,RUBAYA,RUHUNGA,KAGUHANZYA/GEITEMBA,572,1,0,3,108,303,415,2,417,0,O-27-140-09-02-05
MBARARA,KASHARI COUNTY,RUBAYA,RUSHOZI,RUSHOZI 1,433,3,0,3,80,220,306,9,315,0,O-27-140-09-03-01
MBARARA,KASHARI COUNTY,RUBAYA,RUSHOZI,RUSHOZI 2,449,1,0,1,81,227,310,7,317,0,O-27-140-09-03-02
MBARARA,KASHARI COUNTY,RUBAYA,RUSHOZI,KOKUNDEKA PRI. SCHOOL,348,1,1,0,53,226,281,2,283,0,O-27-140-09-03-03
MBARARA,KASHARI COUNTY,RUBINDI,KARWESANGA(RUGA,KARWENSANGA 2,532,0,1,1,34,385,421,5,426,0,O-27-140-10-01-01
MBARARA,KASHARI COUNTY,RUBINDI,KARWESANGA(RUGA,KARWENSANGA 3,468,1,0,0,21,341,363,18,381,0,O-27-140-10-01-02
MBARARA,KASHARI COUNTY,RUBINDI,KARWESANGA(RUGA,KARWENSANGA 4,376,1,0,1,24,287,313,6,319,0,O-27-140-10-01-03
MBARARA,KASHARI COUNTY,RWANYAMAHEMBE,KAKYERERE,KAKYERERE 2,792,0,2,5,164,384,555,15,570,0,O-27-140-11-01-01
MBARARA,KASHARI COUNTY,RWANYAMAHEMBE,KAKYERERE,KAKYERERE 3,503,1,0,1,107,300,409,16,425,0,O-27-140-11-01-02
MBARARA,KASHARI COUNTY,RWANYAMAHEMBE,KAKYERERE,KAKYERERE 4,587,2,1,2,59,407,471,7,478,0,O-27-140-11-01-03
MBARARA,KASHARI COUNTY,RWANYAMAHEMBE,KAKYERERE,KAKYERERE 5,334,1,0,1,35,211,248,10,258,0,O-27-140-11-01-04
MBARARA,KASHARI COUNTY,RWANYAMAHEMBE,KATYAZO,KATYAZO 1,515,0,0,1,38,356,395,32,427,0,O-27-140-11-02-01
MBARARA,KASHARI COUNTY,RWANYAMAHEMBE,KATYAZO,KATYAZO 2,430,0,1,1,46,334,382,1,383,0,O-27-140-11-02-02
MBARARA,KASHARI COUNTY,RWANYAMAHEMBE,KATYAZO,KATYAZO 3,648,1,0,1,93,432,527,8,535,0,O-27-140-11-02-03
MBARARA,KASHARI COUNTY,RWANYAMAHEMBE,MABIRA,MABIRA 1,523,1,0,0,102,335,438,0,438,0,O-27-140-11-03-01
MBARARA,KASHARI COUNTY,RWANYAMAHEMBE,MABIRA,MABIRA 2,488,1,0,1,69,289,360,2,362,0,O-27-140-11-03-02
MBARARA,KASHARI COUNTY,RWANYAMAHEMBE,MABIRA,KITOOKYE P/S,531,0,0,2,59,375,436,0,436,0,O-27-140-11-03-03
MBARARA,KASHARI COUNTY,RWANYAMAHEMBE,RUTOMA,RUTOOMA 1,912,1,0,1,160,493,655,10,665,0,O-27-140-11-04-01
MBARARA,KASHARI COUNTY,RWANYAMAHEMBE,RUTOMA,RUTOOMA 2,582,3,0,0,121,316,440,7,447,0,O-27-140-11-04-02
MBARARA,KASHARI COUNTY,RWANYAMAHEMBE,RUTOMA,RUTOOMA 3,426,1,0,0,43,285,329,21,350,0,O-27-140-11-04-03
MBARARA,KASHARI COUNTY,RWANYAMAHEMBE,RUTOMA,RUTOOMA 4,172,0,0,0,37,109,146,2,148,0,O-27-140-11-04-04
MBARARA,KASHARI COUNTY,RWANYAMAHEMBE,RWEBISHEKYE,RWEBISHEKYE 1,629,0,1,0,98,396,495,4,499,0,O-27-140-11-05-01
MBARARA,KASHARI COUNTY,RWANYAMAHEMBE,RWEBISHEKYE,RWEBISHEKYE 2,496,1,1,2,89,293,386,0,386,0,O-27-140-11-05-02
MBARARA,KASHARI COUNTY,RWANYAMAHEMBE,RWEBISHEKYE,RWEBISHEKYE 3,1016,4,3,1,190,503,701,12,713,0,O-27-140-11-05-03
MBARARA,KASHARI COUNTY,RWANYAMAHEMBE,RWEBISHEKYE,RWEBISHEKYE 4,253,0,0,0,27,174,201,3,204,0,O-27-140-11-05-04
MBARARA,MBARARA MUNICIPALITY,KAKOBA,KAKOBA,KIHINDI,899,0,1,0,231,327,559,2,561,0,O-27-144-01-01-01
MBARARA,MBARARA MUNICIPALITY,KAKOBA,KAKOBA,KISHWAHILI [A - L],487,0,0,1,113,194,308,6,314,0,O-27-144-01-01-02
MBARARA,MBARARA MUNICIPALITY,KAKOBA,KAKOBA,KISHWAHILI [M - Z],648,1,0,1,161,229,392,4,396,0,O-27-144-01-01-03
MBARARA,MBARARA MUNICIPALITY,KAKOBA,KAKOBA,KAKOBA CENTRAL [A - K],834,0,1,0,196,232,429,79,508,0,O-27-144-01-01-04
MBARARA,MBARARA MUNICIPALITY,KAKOBA,KAKOBA,KAKOBA CENTRAL [L - M],334,2,0,0,87,96,185,16,201,0,O-27-144-01-01-05
MBARARA,MBARARA MUNICIPALITY,KAKOBA,KAKOBA,KAKOBA CENTRAL [N - Z],775,2,1,2,143,288,436,9,445,0,O-27-144-01-01-06
MBARARA,MBARARA MUNICIPALITY,KAKOBA,KAKOBA,KAKOBA QUARTERS,352,0,0,0,92,100,192,7,199,0,O-27-144-01-01-07
MBARARA,MBARARA MUNICIPALITY,KAKOBA,KAKOBA,POLICE / PRISONS P/S,497,0,0,0,124,107,231,3,234,0,O-27-144-01-01-08
MBARARA,MBARARA MUNICIPALITY,KAKOBA,KAKOBA,NYAKAIZI [A - L],402,0,0,0,106,124,230,3,233,0,O-27-144-01-01-09
MBARARA,MBARARA MUNICIPALITY,KAKOBA,KAKOBA,NYAKAIZI [M - Z],553,1,0,0,136,209,346,8,354,0,O-27-144-01-01-10
MBARARA,MBARARA MUNICIPALITY,KAKOBA,KAKOBA,KYAPOTANYI,647,1,0,0,160,278,439,11,450,0,O-27-144-01-01-11
MBARARA,MBARARA MUNICIPALITY,KAKOBA,KAKOBA,KAKOBA DEMO SCHOOL,365,0,0,0,44,176,220,30,250,0,O-27-144-01-01-12
MBARARA,MBARARA MUNICIPALITY,KAKOBA,KAKOBA,KISENYI [A - B],833,0,1,0,253,255,509,0,509,0,O-27-144-01-01-13
MBARARA,MBARARA MUNICIPALITY,KAKOBA,KAKOBA,KISENYI [C - K],977,0,0,0,254,315,569,8,577,0,O-27-144-01-01-14
MBARARA,MBARARA MUNICIPALITY,KAKOBA,KAKOBA,KISENYI [L - M],724,1,0,0,262,191,454,2,456,0,O-27-144-01-01-15
MBARARA,MBARARA MUNICIPALITY,KAKOBA,KAKOBA,KISENYI [N - R],869,1,3,1,202,260,467,4,471,0,O-27-144-01-01-16
MBARARA,MBARARA MUNICIPALITY,KAKOBA,KAKOBA,KISENYI [S - Z],834,1,1,2,283,191,478,4,482,0,O-27-144-01-01-17
MBARARA,MBARARA MUNICIPALITY,KAKOBA,KAKOBA,LUGAZI [A - K],769,1,0,0,198,260,459,3,462,0,O-27-144-01-01-18
MBARARA,MBARARA MUNICIPALITY,KAKOBA,KAKOBA,LUGAZI [L - M],733,0,0,0,196,255,451,9,460,0,O-27-144-01-01-19
MBARARA,MBARARA MUNICIPALITY,KAKOBA,KAKOBA,LUGAZI [N - Z],987,5,0,0,223,323,551,18,569,0,O-27-144-01-01-20
MBARARA,MBARARA MUNICIPALITY,KAKOBA,NYAMITYOBORA,KABATERAINE [A - L],446,0,0,0,123,140,263,0,263,0,O-27-144-01-02-01
MBARARA,MBARARA MUNICIPALITY,KAKOBA,NYAMITYOBORA,KABATERAINE [M - Z],521,0,0,0,120,160,280,0,280,0,O-27-144-01-02-02
MBARARA,MBARARA MUNICIPALITY,KAKOBA,NYAMITYOBORA,MUTI,457,2,0,1,109,146,258,5,263,0,O-27-144-01-02-03
MBARARA,MBARARA MUNICIPALITY,KAKOBA,NYAMITYOBORA,LUBIRI,438,1,0,0,64,160,225,7,232,0,O-27-144-01-02-04
MBARARA,MBARARA MUNICIPALITY,KAKOBA,NYAMITYOBORA,UPPER CELL,662,1,0,2,219,177,399,7,406,0,O-27-144-01-02-05
MBARARA,MBARARA MUNICIPALITY,KAKOBA,NYAMITYOBORA,LOWER CELL [A - L],624,3,0,0,165,171,339,8,347,0,O-27-144-01-02-06
MBARARA,MBARARA MUNICIPALITY,KAKOBA,NYAMITYOBORA,LOWER CELL [M - Z],763,1,1,1,240,231,474,8,482,0,O-27-144-01-02-07
MBARARA,MBARARA MUNICIPALITY,KAKOBA,NYAMITYOBORA,CENTRAL CELL [A - L],767,2,0,0,183,250,435,9,444,0,O-27-144-01-02-08
MBARARA,MBARARA MUNICIPALITY,KAKOBA,NYAMITYOBORA,CENTRAL CELL [M - Z],929,1,1,1,248,256,507,5,512,0,O-27-144-01-02-09
MBARARA,MBARARA MUNICIPALITY,KAKOBA,NYAMITYOBORA,MARKET [M - Z],1161,2,0,1,309,263,575,8,583,0,O-27-144-01-02-10
MBARARA,MBARARA MUNICIPALITY,KAKOBA,NYAMITYOBORA,KILEMBE,706,2,1,0,157,245,405,9,414,0,O-27-144-01-02-11
MBARARA,MBARARA MUNICIPALITY,KAKOBA,NYAMITYOBORA,AGIP,866,0,0,3,207,237,447,31,478,0,O-27-144-01-02-12
MBARARA,MBARARA MUNICIPALITY,KAKOBA,NYAMITYOBORA,SURVEY [A - L],678,3,0,0,150,274,427,3,430,0,O-27-144-01-02-13
MBARARA,MBARARA MUNICIPALITY,KAKOBA,NYAMITYOBORA,SURVEY [M - Z],488,1,0,2,125,176,304,7,311,0,O-27-144-01-02-14
MBARARA,MBARARA MUNICIPALITY,KAKOBA,NYAMITYOBORA,LUBIRI CELL I [A - A],560,1,1,1,91,235,329,3,332,0,O-27-144-01-02-15
MBARARA,MBARARA MUNICIPALITY,KAKOBA,NYAMITYOBORA,LUBIRI CELL I [B - J],495,2,1,2,114,258,377,5,382,0,O-27-144-01-02-16
MBARARA,MBARARA MUNICIPALITY,KAKOBA,NYAMITYOBORA,LUBIRI CELL I [K - L],389,2,0,0,66,205,273,6,279,0,O-27-144-01-02-17
MBARARA,MBARARA MUNICIPALITY,KAKOBA,NYAMITYOBORA,LUBIRI CELL I [M - N],513,0,0,1,67,143,211,3,214,0,O-27-144-01-02-18
MBARARA,MBARARA MUNICIPALITY,KAKOBA,NYAMITYOBORA,LUBIRI CELL I [O - O],356,2,1,0,62,63,128,3,131,0,O-27-144-01-02-19
MBARARA,MBARARA MUNICIPALITY,KAKOBA,NYAMITYOBORA,LUBIRI CELL I [P - Z],269,0,0,0,29,64,93,0,93,0,O-27-144-01-02-20
MBARARA,MBARARA MUNICIPALITY,KAMUKUZI,KAMUKUZI,KAMUKUZI [A - L],714,1,0,0,156,229,386,1,387,0,O-27-144-02-01-01
MBARARA,MBARARA MUNICIPALITY,KAMUKUZI,KAMUKUZI,KAMUKUZI [M - Z],662,1,1,0,135,205,342,6,348,0,O-27-144-02-01-02
MBARARA,MBARARA MUNICIPALITY,KAMUKUZI,KAMUKUZI,KAMUKUZI / RWEBIKONA [A - L],829,1,0,1,183,290,475,3,478,0,O-27-144-02-01-03
MBARARA,MBARARA MUNICIPALITY,KAMUKUZI,KAMUKUZI,KAMUKUZI / RWEBIKONA [M - Z],788,0,1,1,194,232,428,5,433,0,O-27-144-02-01-04
MBARARA,MBARARA MUNICIPALITY,KAMUKUZI,KAMUKUZI,KAMUKUZI /KASHANYARAZI,632,0,0,0,173,222,395,10,405,0,O-27-144-02-01-05
MBARARA,MBARARA MUNICIPALITY,KAMUKUZI,KAMUKUZI,MEDICAL /BOMA,1157,5,1,5,315,323,649,17,666,0,O-27-144-02-01-06
MBARARA,MBARARA MUNICIPALITY,KAMUKUZI,KAMUKUZI,BIAFRA [A - L],765,1,1,0,189,238,429,14,443,0,O-27-144-02-01-07
MBARARA,MBARARA MUNICIPALITY,KAMUKUZI,KAMUKUZI,BIAFRA [M - Z],717,0,0,1,176,235,412,5,417,0,O-27-144-02-01-08
MBARARA,MBARARA MUNICIPALITY,KAMUKUZI,KAMUKUZI,NTARE,384,1,0,0,91,146,238,3,241,0,O-27-144-02-01-09
MBARARA,MBARARA MUNICIPALITY,KAMUKUZI,KAMUKUZI,KAMUKUZI / KAKYEKA [A - L],738,4,0,0,142,240,386,4,390,0,O-27-144-02-01-10
MBARARA,MBARARA MUNICIPALITY,KAMUKUZI,KAMUKUZI,KAMUKUZI / KAKYEKA [M - Z],886,0,0,2,181,267,450,10,460,0,O-27-144-02-01-11
MBARARA,MBARARA MUNICIPALITY,KAMUKUZI,KAMUKUZI,KAMUKUZI / KAKIKA [A - J],480,0,1,0,122,149,272,4,276,0,O-27-144-02-01-12
MBARARA,MBARARA MUNICIPALITY,KAMUKUZI,KAMUKUZI,KAMUKUZI / KAKIKA [K - L],458,0,1,2,107,172,282,2,284,0,O-27-144-02-01-13
MBARARA,MBARARA MUNICIPALITY,KAMUKUZI,KAMUKUZI,KAMUKUZI / KAKIKA [M - N],665,1,0,1,156,203,361,2,363,0,O-27-144-02-01-14
MBARARA,MBARARA MUNICIPALITY,KAMUKUZI,KAMUKUZI,KAMUKUZI / KAKIKA [O - Z],409,0,1,1,127,112,241,6,247,0,O-27-144-02-01-15
MBARARA,MBARARA MUNICIPALITY,KAMUKUZI,RUHARO,RUHARO I,743,3,0,1,206,282,492,4,496,0,O-27-144-02-02-01
MBARARA,MBARARA MUNICIPALITY,KAMUKUZI,RUHARO,RUHARO [A - L],582,2,0,0,153,228,383,10,393,0,O-27-144-02-02-02
MBARARA,MBARARA MUNICIPALITY,KAMUKUZI,RUHARO,RUHARO [M - Z],382,1,0,3,94,149,247,9,256,0,O-27-144-02-02-03
MBARARA,MBARARA MUNICIPALITY,KAMUKUZI,RUHARO,NKOKONJERU [A - L],537,0,0,0,89,250,339,10,349,0,O-27-144-02-02-04
MBARARA,MBARARA MUNICIPALITY,KAMUKUZI,RUHARO,NKOKONJERU [M - Z],651,0,0,1,124,291,416,9,425,0,O-27-144-02-02-05
MBARARA,MBARARA MUNICIPALITY,KAMUKUZI,RUHARO,KIYANJA [A - L],708,4,1,1,159,268,433,7,440,0,O-27-144-02-02-06
MBARARA,MBARARA MUNICIPALITY,KAMUKUZI,RUHARO,KIYANJA [M - Z],755,1,0,0,206,221,428,18,446,0,O-27-144-02-02-07
MBARARA,MBARARA MUNICIPALITY,KAMUKUZI,RUHARO,RWIZI,577,2,0,0,128,258,388,1,389,0,O-27-144-02-02-08
MBARARA,MBARARA MUNICIPALITY,NYAMITANGA,KATETE,KATETE MARKET,737,0,1,0,188,308,497,15,512,0,O-27-144-03-01-01
MBARARA,MBARARA MUNICIPALITY,NYAMITANGA,KATETE,KITEBERO /KASENYI P/S,724,1,0,3,171,279,454,4,458,0,O-27-144-03-01-02
MBARARA,MBARARA MUNICIPALITY,NYAMITANGA,KATETE,NYAMITANGA DIVISION OFFICES,587,0,1,0,134,214,349,0,349,0,O-27-144-03-01-03
MBARARA,MBARARA MUNICIPALITY,NYAMITANGA,KATETE,ST. MARY'S PRI. SCHOOL,509,1,0,0,128,181,310,59,369,0,O-27-144-03-01-04
MBARARA,MBARARA MUNICIPALITY,NYAMITANGA,KATETE,KARUGANGAMA,337,1,0,1,109,142,253,10,263,0,O-27-144-03-01-05
MBARARA,MBARARA MUNICIPALITY,NYAMITANGA,KATETE,KASENYI PRI. SCHOOL / RWIZI,326,0,0,0,75,127,202,3,205,0,O-27-144-03-01-06
MBARARA,MBARARA MUNICIPALITY,NYAMITANGA,KATETE,NYAMITANGA MUSLIM PRI. SCHO,567,0,0,0,117,202,319,6,325,0,O-27-144-03-01-07
MBARARA,MBARARA MUNICIPALITY,NYAMITANGA,RUTI,ST. ALOYSIUS PRI. SCHOOL,902,2,1,1,185,391,580,4,584,0,O-27-144-03-02-01
MBARARA,MBARARA MUNICIPALITY,NYAMITANGA,RUTI,KIREHE / KAFUNDA,688,1,0,1,143,276,421,6,427,0,O-27-144-03-02-02
MBARARA,MBARARA MUNICIPALITY,NYAMITANGA,RUTI,RUTI HEALTH CENTRE,683,3,0,1,159,259,422,7,429,0,O-27-144-03-02-03
MBARARA,MBARARA MUNICIPALITY,NYAMITANGA,RUTI,RUTI MUSLIM PRI. SCHOOL,518,1,0,0,155,200,356,1,357,0,O-27-144-03-02-04
MBARARA,MBARARA MUNICIPALITY,NYAMITANGA,RUTI,VICTORY PRI. SCHOOL,655,0,0,0,119,244,363,38,401,0,O-27-144-03-02-05
NTUNGAMO,KAJARA COUNTY,BWONGERA,ITEREERO,ITERERO PARISH HQRS-,626,6,0,3,205,245,459,8,467,0,O-34-187-01-01-01
NTUNGAMO,KAJARA COUNTY,BWONGERA,ITEREERO,KIYENJE,617,2,0,3,200,238,443,21,464,0,O-34-187-01-01-02
NTUNGAMO,KAJARA COUNTY,BWONGERA,ITEREERO,MAHWA PRIMARY SCHOOL,616,1,1,1,198,250,451,10,461,0,O-34-187-01-01-03
NTUNGAMO,KAJARA COUNTY,BWONGERA,KAKIIKA,KAKIIKA HQRS,533,1,1,1,165,222,390,4,394,0,O-34-187-01-02-01
NTUNGAMO,KAJARA COUNTY,BWONGERA,KAKIIKA,NYAKAZINGA CLINIC,589,0,0,2,149,288,439,13,452,0,O-34-187-01-02-02
NTUNGAMO,KAJARA COUNTY,BWONGERA,KAKIIKA,NYAKIHANGA MOSQUE,554,1,1,0,197,267,466,7,473,0,O-34-187-01-02-03
NTUNGAMO,KAJARA COUNTY,BWONGERA,KATOMI,BWONGERA P/SCHOOL,607,2,0,0,251,205,458,11,469,0,O-34-187-01-03-01
NTUNGAMO,KAJARA COUNTY,BWONGERA,KATOMI,KISHARIRO P/SCHOOL,476,1,0,1,160,233,395,8,403,0,O-34-187-01-03-02
NTUNGAMO,KAJARA COUNTY,BWONGERA,KATOMI,NYAKABARE C. O. U,806,4,1,2,184,378,569,30,599,0,O-34-187-01-03-03
NTUNGAMO,KAJARA COUNTY,BWONGERA,KITOJO,BUCENCE,758,4,1,4,256,270,535,45,580,0,O-34-187-01-04-01
NTUNGAMO,KAJARA COUNTY,BWONGERA,KITOJO,KITOJO P/SCHOOL,826,1,2,2,223,388,616,10,626,0,O-34-187-01-04-02
NTUNGAMO,KAJARA COUNTY,BWONGERA,KYABASHENYI,KASOMORO,476,4,0,0,157,199,360,8,368,0,O-34-187-01-05-01
NTUNGAMO,KAJARA COUNTY,BWONGERA,KYABASHENYI,KYABASHENYI PARISH HQRS,687,1,1,1,138,387,528,11,539,0,O-34-187-01-05-02
NTUNGAMO,KAJARA COUNTY,BWONGERA,KYABASHENYI,KYABASHENYI PRIMARY SCHOOL,619,4,2,3,130,323,462,17,479,0,O-34-187-01-05-03
NTUNGAMO,KAJARA COUNTY,BWONGERA,KYARUHUGA,KEMISHEGO PRI. SCHOOL,662,0,0,1,216,234,451,24,475,0,O-34-187-01-06-01
NTUNGAMO,KAJARA COUNTY,BWONGERA,KYARUHUGA,KIINA PRI. SCHOOL,536,0,0,0,142,241,383,0,383,0,O-34-187-01-06-02
NTUNGAMO,KAJARA COUNTY,BWONGERA,KYARUHUGA,KISIMINTI,461,0,0,1,161,184,346,7,353,0,O-34-187-01-06-03
NTUNGAMO,KAJARA COUNTY,BWONGERA,KYARUHUGA,KYARUHUGA PARISH HQRS,524,2,0,0,119,283,404,11,415,0,O-34-187-01-06-04
NTUNGAMO,KAJARA COUNTY,BWONGERA,KYARUHUGA,KYARUHUGA PRI. SCHOOL,343,1,0,1,109,146,257,1,258,0,O-34-187-01-06-05
NTUNGAMO,KAJARA COUNTY,BWONGERA,NYABUBAARE,KATOMI P/SCHOOL,369,0,0,0,66,200,266,22,288,0,O-34-187-01-07-01
NTUNGAMO,KAJARA COUNTY,BWONGERA,NYABUBAARE,KITONJE TRADING CENTRE,523,3,1,2,116,279,401,6,407,0,O-34-187-01-07-02
NTUNGAMO,KAJARA COUNTY,BWONGERA,NYABUBAARE,NYABUBAARE PARISH HQRS,495,0,1,1,211,161,374,18,392,0,O-34-187-01-07-03
NTUNGAMO,KAJARA COUNTY,BWONGERA,RWANDA,KARAMA P/SCHOOL,656,2,0,1,116,393,512,14,526,0,O-34-187-01-08-01
NTUNGAMO,KAJARA COUNTY,BWONGERA,RWANDA,RWANDA P/SCHOOL,711,4,0,2,183,320,509,8,517,0,O-34-187-01-08-02
NTUNGAMO,KAJARA COUNTY,BWONGERA,RWANDA,RWANKORA P/SCHOOL,630,5,3,2,204,232,446,20,466,0,O-34-187-01-08-03
NTUNGAMO,KAJARA COUNTY,IHUNGA,BUTANDA,BUTANDA PRI. SCHOOL 1,426,0,0,1,107,207,315,10,325,0,O-34-187-02-01-01
NTUNGAMO,KAJARA COUNTY,IHUNGA,BUTANDA,BUTANDA PRI. SCHOOL 2,674,1,1,1,154,369,526,8,534,0,O-34-187-02-01-02
NTUNGAMO,KAJARA COUNTY,IHUNGA,BUTANDA,NAMIREMBE,553,1,1,1,171,269,443,15,458,0,O-34-187-02-01-03
NTUNGAMO,KAJARA COUNTY,IHUNGA,BUTANDA,KYAMAJUMBA P/S,482,2,0,1,115,257,375,0,375,0,O-34-187-02-01-04
NTUNGAMO,KAJARA COUNTY,IHUNGA,BUTANDA,KYENKUKU C.O.U,147,0,0,0,57,48,105,10,115,0,O-34-187-02-01-05
NTUNGAMO,KAJARA COUNTY,IHUNGA,KAGAMBA,KAGAMBA COU,590,2,0,0,158,314,474,8,482,0,O-34-187-02-02-01
NTUNGAMO,KAJARA COUNTY,IHUNGA,KAGAMBA,KAGAMBA PARISH HQRS,581,2,0,0,131,289,422,27,449,0,O-34-187-02-02-02
NTUNGAMO,KAJARA COUNTY,IHUNGA,KAGAMBA,KATENGA P/SCHOOL,510,3,0,2,139,250,394,18,412,0,O-34-187-02-02-03
NTUNGAMO,KAJARA COUNTY,IHUNGA,KAGAMBA,KATSYORO COU,615,2,0,1,209,278,490,14,504,0,O-34-187-02-02-04
NTUNGAMO,KAJARA COUNTY,IHUNGA,KITONDO,KANKWANZI COU,832,6,0,4,157,551,718,6,724,0,O-34-187-02-03-01
NTUNGAMO,KAJARA COUNTY,IHUNGA,KITONDO,KITONDO PARISH HEADQUARTER,773,6,0,3,274,316,599,17,616,0,O-34-187-02-03-02
NTUNGAMO,KAJARA COUNTY,IHUNGA,KITONDO,RUTOOMA,769,2,1,3,312,294,612,5,617,0,O-34-187-02-03-03
NTUNGAMO,KAJARA COUNTY,IHUNGA,NYAKIBIGI,KAKO P/SCHOOL 1,613,2,0,2,115,313,432,43,475,0,O-34-187-02-04-01
NTUNGAMO,KAJARA COUNTY,IHUNGA,NYAKIBIGI,KAKO P/SCHOOL 2,386,2,0,2,96,202,302,11,313,0,O-34-187-02-04-02
NTUNGAMO,KAJARA COUNTY,IHUNGA,NYAKIBIGI,NYAKIBIGI PARISH HQRS,718,2,0,0,182,352,536,19,555,0,O-34-187-02-04-03
NTUNGAMO,KAJARA COUNTY,IHUNGA,RUTUNGURU,IHUNGA SCTY HQRS 1,669,4,0,0,135,377,516,9,525,0,O-34-187-02-05-01
NTUNGAMO,KAJARA COUNTY,IHUNGA,RUTUNGURU,IHUNGA SCTY HQRS 2,784,0,0,3,146,428,577,21,598,0,O-34-187-02-05-02
NTUNGAMO,KAJARA COUNTY,IHUNGA,RUTUNGURU,RUTUNGURU PRIMARY SCHOOL,582,2,0,2,176,296,476,14,490,0,O-34-187-02-05-03
NTUNGAMO,KAJARA COUNTY,IHUNGA,RUTUNGURU,KANKWINURE TRADING CENTRE,430,3,1,0,82,266,352,2,354,0,O-34-187-02-05-04
NTUNGAMO,KAJARA COUNTY,KIBATSI,IBAARE,IBAARE 1,627,0,0,3,151,293,447,10,457,0,O-34-187-03-01-01
NTUNGAMO,KAJARA COUNTY,KIBATSI,IBAARE,IBAARE 2,673,1,0,3,137,354,495,20,515,0,O-34-187-03-01-02
NTUNGAMO,KAJARA COUNTY,KIBATSI,IBAARE,KIBATSI MODEL SCHOOL,398,1,0,2,115,129,247,22,269,0,O-34-187-03-01-03
NTUNGAMO,KAJARA COUNTY,KIBATSI,IBAARE,KIBATSI P/S II,444,2,0,2,117,215,336,6,342,0,O-34-187-03-01-04
NTUNGAMO,KAJARA COUNTY,KIBATSI,KIBARUKO,KAMURI PRI. SCHOOL,703,1,0,2,148,373,524,42,566,0,O-34-187-03-02-01
NTUNGAMO,KAJARA COUNTY,KIBATSI,KIBARUKO,KIBARUKO PARISH HQRS,720,1,1,3,137,400,542,20,562,0,O-34-187-03-02-02
NTUNGAMO,KAJARA COUNTY,KIBATSI,KIBARUKO,KIHUMURO PRI. SCHOOL,367,3,0,0,149,124,276,10,286,0,O-34-187-03-02-03
NTUNGAMO,KAJARA COUNTY,KIBATSI,KIBARUKO,KIHUMURO C.O.U,502,3,0,2,145,255,405,18,423,0,O-34-187-03-02-04
NTUNGAMO,KAJARA COUNTY,KIBATSI,NYAMUGOYE,KISHUNJURE P/SCHOOL A,642,0,0,4,140,318,462,0,462,0,O-34-187-03-03-01
NTUNGAMO,KAJARA COUNTY,KIBATSI,NYAMUGOYE,KISHUNJURE P/SCHOOL B,639,3,0,5,150,256,414,11,425,0,O-34-187-03-03-02
NTUNGAMO,KAJARA COUNTY,KIBATSI,RUKARANGO,RUBINGO P/SCHOOL,401,0,0,1,80,227,308,13,321,0,O-34-187-03-04-01
NTUNGAMO,KAJARA COUNTY,KIBATSI,RUKARANGO,RUKARANGO PARISH HQRS,475,1,0,0,124,232,357,16,373,0,O-34-187-03-04-02
NTUNGAMO,KAJARA COUNTY,KIBATSI,RUKARANGO,RUKARANGO P/SCHOOL,498,1,0,2,148,240,391,20,411,0,O-34-187-03-04-03
NTUNGAMO,KAJARA COUNTY,KIBATSI,RUKONI,RUKONI PARISH HQRS,388,3,0,1,139,126,269,6,275,0,O-34-187-03-05-01
NTUNGAMO,KAJARA COUNTY,KIBATSI,RUKONI,RWENSINGO PRIMARY SCHOOL 1,496,2,1,2,130,223,358,23,381,0,O-34-187-03-05-02
NTUNGAMO,KAJARA COUNTY,KIBATSI,RUKONI,RWENSINGO PRIMARY SCHOOL 2,747,3,1,5,242,299,550,32,582,0,O-34-187-03-05-03
NTUNGAMO,KAJARA COUNTY,NYABIHOKO,KINONI,KINONI PARISH HQRS,448,0,0,0,71,253,324,16,340,0,O-34-187-04-01-01
NTUNGAMO,KAJARA COUNTY,NYABIHOKO,KINONI,RWERE WEST,541,1,1,0,130,292,424,1,425,0,O-34-187-04-01-02
NTUNGAMO,KAJARA COUNTY,NYABIHOKO,KINONI,RUHANGA T/C,352,0,0,1,49,230,280,6,286,0,O-34-187-04-01-03
NTUNGAMO,KAJARA COUNTY,NYABIHOKO,KINONI,MUKINGA FULL GOSPEL CHURCH,338,1,0,0,87,173,261,11,272,0,O-34-187-04-01-04
NTUNGAMO,KAJARA COUNTY,NYABIHOKO,KIYAGA,BUSHAMBA,537,4,0,1,257,181,443,3,446,0,O-34-187-04-02-01
NTUNGAMO,KAJARA COUNTY,NYABIHOKO,KIYAGA,KIYAGA 1,545,2,1,1,126,251,381,19,400,0,O-34-187-04-02-02
NTUNGAMO,KAJARA COUNTY,NYABIHOKO,KIYAGA,KIYAGA 2,516,2,0,2,147,233,384,11,395,0,O-34-187-04-02-03
NTUNGAMO,KAJARA COUNTY,NYABIHOKO,NKONGORO,NKONGORO PARISH HQRS,189,0,0,1,58,75,134,8,142,0,O-34-187-04-03-01
NTUNGAMO,KAJARA COUNTY,NYABIHOKO,NKONGORO,NKONGORO P/SCHOOL 1,456,3,0,1,158,195,357,13,370,0,O-34-187-04-03-02
NTUNGAMO,KAJARA COUNTY,NYABIHOKO,NKONGORO,NKONGORO P/SCHOOL 2,529,2,0,1,140,247,390,1,391,0,O-34-187-04-03-03
NTUNGAMO,KAJARA COUNTY,NYABIHOKO,NKONGORO,NYABIHOKO SCTY HQRS,569,2,0,1,114,360,477,12,489,0,O-34-187-04-03-04
NTUNGAMO,KAJARA COUNTY,NYABIHOKO,NKONGORO,KAWYAMPUMO PLAY GROUND,135,2,0,0,30,72,104,0,104,0,O-34-187-04-03-05
NTUNGAMO,KAJARA COUNTY,NYABIHOKO,NKONGORO,KAMUSHIRINGIS / KACURAGYENYI,270,2,0,0,139,81,222,2,224,0,O-34-187-04-03-06
NTUNGAMO,KAJARA COUNTY,NYABIHOKO,NYABUSHENYI,IHEMA P/SCHOOL,656,3,2,1,175,385,566,16,582,0,O-34-187-04-04-01
NTUNGAMO,KAJARA COUNTY,NYABIHOKO,NYABUSHENYI,NYABUSHENYI 1,569,3,1,1,148,277,430,44,474,0,O-34-187-04-04-02
NTUNGAMO,KAJARA COUNTY,NYABIHOKO,NYABUSHENYI,NYABUSHENYI II,503,2,0,1,118,282,403,12,415,0,O-34-187-04-04-03
NTUNGAMO,KAJARA COUNTY,NYABIHOKO,RUKANGA,KABUMBA P/S [A - L],638,3,1,0,126,320,450,18,468,0,O-34-187-04-05-01
NTUNGAMO,KAJARA COUNTY,NYABIHOKO,RUKANGA,KABUMBA P/S M - Z],645,0,1,1,142,293,437,6,443,0,O-34-187-04-05-02
NTUNGAMO,KAJARA COUNTY,NYABIHOKO,RUKANGA,RUKANGA P/S,391,2,0,1,126,180,309,0,309,0,O-34-187-04-05-03
NTUNGAMO,KAJARA COUNTY,NYABIHOKO,RUKANGA,RWENSINGA P/S,345,2,0,0,81,172,255,7,262,0,O-34-187-04-05-04
NTUNGAMO,KAJARA COUNTY,NYABIHOKO,RWASHAMAIRE,KAJARA COUNTY HQRS,429,1,0,2,130,157,290,14,304,0,O-34-187-04-06-01
NTUNGAMO,KAJARA COUNTY,NYABIHOKO,RWASHAMAIRE,RWASHAMAIRE PARISH HQRS,520,1,0,1,201,181,384,12,396,0,O-34-187-04-06-02
NTUNGAMO,KAJARA COUNTY,NYABIHOKO,RWASHAMAIRE,RWASHAMAIRE PLAY GROUND,826,2,0,0,324,184,510,4,514,0,O-34-187-04-06-03
NTUNGAMO,RUHAAMA COUNTY,ITOJO,BUHANAMA,KASHENYI P/S,675,0,0,0,161,365,526,12,538,0,O-34-185-01-01-01
NTUNGAMO,RUHAAMA COUNTY,ITOJO,BUHANAMA,BUKORA P/S,432,1,0,2,85,265,353,7,360,0,O-34-185-01-01-02
NTUNGAMO,RUHAAMA COUNTY,ITOJO,BUHANAMA,BUHANAMA P/S,385,0,0,0,63,248,311,4,315,0,O-34-185-01-01-03
NTUNGAMO,RUHAAMA COUNTY,ITOJO,BUHANAMA,BUHANAMA PARISH HQRS,406,2,0,0,70,262,334,2,336,0,O-34-185-01-01-04
NTUNGAMO,RUHAAMA COUNTY,ITOJO,BUHANAMA,ITOJO 1,657,0,0,1,132,356,489,10,499,0,O-34-185-01-01-05
NTUNGAMO,RUHAAMA COUNTY,ITOJO,BUHANAMA,ITOJO 2,613,1,0,2,160,286,449,1,450,0,O-34-185-01-01-06
NTUNGAMO,RUHAAMA COUNTY,ITOJO,BUHANAMA,ITOJO 3,544,5,1,0,95,344,445,19,464,0,O-34-185-01-01-07
NTUNGAMO,RUHAAMA COUNTY,ITOJO,BUHANAMA,ITOJO 4,465,3,1,4,71,306,385,11,396,0,O-34-185-01-01-08
NTUNGAMO,RUHAAMA COUNTY,ITOJO,BUHANAMA,ITOJO CENTRAL PRI. SCHOOL,418,1,0,2,102,249,354,6,360,0,O-34-185-01-01-09
NTUNGAMO,RUHAAMA COUNTY,ITOJO,NYONGOZI,NYONGOZI 2,557,1,2,2,133,297,435,7,442,0,O-34-185-01-02-01
NTUNGAMO,RUHAAMA COUNTY,ITOJO,NYONGOZI,NYONGOZI 3,462,3,2,0,107,239,351,10,361,0,O-34-185-01-02-02
NTUNGAMO,RUHAAMA COUNTY,ITOJO,NYONGOZI,ISHUNGA-NKOMERO,555,2,0,3,97,330,432,9,441,0,O-34-185-01-02-03
NTUNGAMO,RUHAAMA COUNTY,ITOJO,NYONGOZI,NYONGOZI CATHOLIC CENTRE,341,0,0,0,84,198,282,5,287,0,O-34-185-01-02-04
NTUNGAMO,RUHAAMA COUNTY,ITOJO,RUHANGA,RUHANGA 1,718,1,2,4,230,330,567,14,581,0,O-34-185-01-03-01
NTUNGAMO,RUHAAMA COUNTY,ITOJO,RUHANGA,RUHANGA 2,698,0,0,3,197,259,459,15,474,0,O-34-185-01-03-02
NTUNGAMO,RUHAAMA COUNTY,ITOJO,RUHANGA,RUHANGA 3,316,7,1,2,92,141,243,9,252,0,O-34-185-01-03-03
NTUNGAMO,RUHAAMA COUNTY,NTUNGAMO,BUTARE,BUTARE 1,678,2,2,2,162,348,516,26,542,0,O-34-185-02-01-01
NTUNGAMO,RUHAAMA COUNTY,NTUNGAMO,BUTARE,BUTARE 2,453,0,1,1,113,222,337,5,342,0,O-34-185-02-01-02
NTUNGAMO,RUHAAMA COUNTY,NTUNGAMO,BUTARE,MUJWA P/S,324,2,1,1,97,144,245,8,253,0,O-34-185-02-01-03
NTUNGAMO,RUHAAMA COUNTY,NTUNGAMO,BUTARE,KITEMBE II P/S,321,0,0,0,69,181,250,6,256,0,O-34-185-02-01-04
NTUNGAMO,RUHAAMA COUNTY,NTUNGAMO,KAHUNGA,KAHUNGA,197,1,0,0,58,82,141,0,141,0,O-34-185-02-02-01
NTUNGAMO,RUHAAMA COUNTY,NTUNGAMO,KAHUNGA,NYAKIBIGI P/S,563,4,1,3,117,305,430,11,441,0,O-34-185-02-02-02
NTUNGAMO,RUHAAMA COUNTY,NTUNGAMO,KAHUNGA,KAHUNGA PRI. SCHOOL,620,0,1,0,246,229,476,1,477,0,O-34-185-02-02-03
NTUNGAMO,RUHAAMA COUNTY,NTUNGAMO,KIKONI,KAREGYEYA,623,0,0,1,98,408,507,7,514,0,O-34-185-02-03-01
NTUNGAMO,RUHAAMA COUNTY,NTUNGAMO,KIKONI,MUTANOGA P/SCHOOL,597,0,2,0,136,329,467,14,481,0,O-34-185-02-03-02
NTUNGAMO,RUHAAMA COUNTY,NTUNGAMO,KIZAARA,KIZAARA,809,3,1,2,183,468,657,7,664,0,O-34-185-02-04-01
NTUNGAMO,RUHAAMA COUNTY,NTUNGAMO,NYABUBAARE,KABAARE,731,2,0,4,181,375,562,15,577,0,O-34-185-02-05-01
NTUNGAMO,RUHAAMA COUNTY,NTUNGAMO,NYABUBAARE,KYANGARA,729,0,0,2,144,411,557,5,562,0,O-34-185-02-05-02
NTUNGAMO,RUHAAMA COUNTY,NTUNGAMO,NYABUBAARE,RUGARAMA,685,3,2,0,125,372,502,20,522,0,O-34-185-02-05-03
NTUNGAMO,RUHAAMA COUNTY,NTUNGAMO,NYABURIZA,KABUHOME,356,0,1,0,64,182,247,7,254,0,O-34-185-02-06-01
NTUNGAMO,RUHAAMA COUNTY,NTUNGAMO,NYABURIZA,KARAMBI,478,0,1,1,81,271,354,4,358,0,O-34-185-02-06-02
NTUNGAMO,RUHAAMA COUNTY,NTUNGAMO,NYABURIZA,NYABURIZA PARISH HQRS,630,1,0,5,112,344,462,6,468,0,O-34-185-02-06-03
NTUNGAMO,RUHAAMA COUNTY,NTUNGAMO,NYABURIZA,NYABUTOMA,320,1,0,0,59,173,233,1,234,0,O-34-185-02-06-04
NTUNGAMO,RUHAAMA COUNTY,NTUNGAMO,NYABURIZA,KABUHOME CHURCH SCH.,480,2,0,2,71,328,403,10,413,0,O-34-185-02-06-05
NTUNGAMO,RUHAAMA COUNTY,NTUNGAMO,RUHOKO,KYAMIGANGO TRADING CENTRE,288,1,1,2,54,166,224,17,241,0,O-34-185-02-07-01
NTUNGAMO,RUHAAMA COUNTY,NTUNGAMO,RUHOKO,NYAKASHOZI P/S,507,1,0,1,137,280,419,13,432,0,O-34-185-02-07-02
NTUNGAMO,RUHAAMA COUNTY,NTUNGAMO,RUHOKO,RUGOMA TRADING CENTRE,454,1,0,1,107,263,372,6,378,0,O-34-185-02-07-03
NTUNGAMO,RUHAAMA COUNTY,NTUNGAMO TOWN COUNCIL,CENTRAL WARD,CENTRAL WARD 1,485,0,0,0,140,123,263,4,267,0,O-34-185-03-01-01
NTUNGAMO,RUHAAMA COUNTY,NTUNGAMO TOWN COUNCIL,CENTRAL WARD,CENTRAL WARD 2,352,0,0,0,135,113,248,2,250,0,O-34-185-03-01-02
NTUNGAMO,RUHAAMA COUNTY,NTUNGAMO TOWN COUNCIL,CENTRAL WARD,CENTRAL WARD 3,219,0,0,0,58,55,113,3,116,0,O-34-185-03-01-03
NTUNGAMO,RUHAAMA COUNTY,NTUNGAMO TOWN COUNCIL,KAHUNGA WARD,NYAMISHA 1,370,0,0,1,89,165,255,0,255,0,O-34-185-03-02-01
NTUNGAMO,RUHAAMA COUNTY,NTUNGAMO TOWN COUNCIL,KAHUNGA WARD,NYAMISHA 2,324,1,0,0,70,152,223,10,233,0,O-34-185-03-02-02
NTUNGAMO,RUHAAMA COUNTY,NTUNGAMO TOWN COUNCIL,KAHUNGA WARD,NYAMISHA 3,382,1,0,0,97,183,281,6,287,0,O-34-185-03-02-03
NTUNGAMO,RUHAAMA COUNTY,NTUNGAMO TOWN COUNCIL,KIKONI WARD,KIKONI 1,816,0,1,1,241,359,602,9,611,0,O-34-185-03-03-01
NTUNGAMO,RUHAAMA COUNTY,NTUNGAMO TOWN COUNCIL,KIKONI WARD,KIKONI 2,709,2,1,3,253,278,537,5,542,0,O-34-185-03-03-02
NTUNGAMO,RUHAAMA COUNTY,NTUNGAMO TOWN COUNCIL,KYAMATE WARD,RUHOKO P/S 1,726,0,0,0,138,420,558,8,566,0,O-34-185-03-04-01
NTUNGAMO,RUHAAMA COUNTY,NTUNGAMO TOWN COUNCIL,KYAMATE WARD,KYAMATE P/S GROUND,854,2,0,1,167,344,514,7,521,0,O-34-185-03-04-02
NTUNGAMO,RUHAAMA COUNTY,NTUNGAMO TOWN COUNCIL,MUKO WARD,TOWN COUNCIL OFFICES,697,0,0,0,231,164,395,9,404,0,O-34-185-03-05-01
NTUNGAMO,RUHAAMA COUNTY,NTUNGAMO TOWN COUNCIL,MUKO WARD,ADMINISTRATION POLICE HQRS,387,1,0,0,145,97,243,1,244,0,O-34-185-03-05-02
NTUNGAMO,RUHAAMA COUNTY,NTUNGAMO TOWN COUNCIL,PARK WARD,PARK WARD 1,812,0,0,0,248,187,435,3,438,0,O-34-185-03-06-01
NTUNGAMO,RUHAAMA COUNTY,NTUNGAMO TOWN COUNCIL,PARK WARD,PARK WARD 2,199,1,0,0,66,47,114,1,115,0,O-34-185-03-06-02
NTUNGAMO,RUHAAMA COUNTY,NTUNGAMO TOWN COUNCIL,PARK WARD,PARK WARD 3,477,0,1,0,171,101,273,3,276,0,O-34-185-03-06-03
NTUNGAMO,RUHAAMA COUNTY,NYAKYERA,KAGORORA,RWENYONYOZI,397,1,0,4,83,251,339,7,346,0,O-34-185-04-01-01
NTUNGAMO,RUHAAMA COUNTY,NYAKYERA,KAGORORA,KABEKAKYE TRADING CENTRE,506,1,1,3,55,303,363,4,367,0,O-34-185-04-01-02
NTUNGAMO,RUHAAMA COUNTY,NYAKYERA,KAGORORA,OMUKIGANDO,211,0,1,0,44,120,165,7,172,0,O-34-185-04-01-03
NTUNGAMO,RUHAAMA COUNTY,NYAKYERA,KAGORORA,NYAKYERA P/SCHOOL,784,0,0,3,153,406,562,9,571,0,O-34-185-04-01-04
NTUNGAMO,RUHAAMA COUNTY,NYAKYERA,KAGORORA,NYAKYERA S/CTY HQRS,473,2,1,3,50,266,322,14,336,0,O-34-185-04-01-05
NTUNGAMO,RUHAAMA COUNTY,NYAKYERA,KATARAKA,KATARAKA PRI. SCHOOL [A - L],138,1,0,0,43,71,115,0,115,0,O-34-185-04-02-01
NTUNGAMO,RUHAAMA COUNTY,NYAKYERA,KATARAKA,KATARAKA PRI. SCHOOL [M - Z],356,3,0,0,79,169,251,10,261,0,O-34-185-04-02-02
NTUNGAMO,RUHAAMA COUNTY,NYAKYERA,KATARAKA,RUSA PRI. SCHOOL,735,1,0,3,150,395,549,16,565,0,O-34-185-04-02-03
NTUNGAMO,RUHAAMA COUNTY,NYAKYERA,KIBINGO,BUHIGA,693,2,0,0,85,436,523,5,528,0,O-34-185-04-03-01
NTUNGAMO,RUHAAMA COUNTY,NYAKYERA,KIBINGO,KAHIJA P/S,636,2,0,1,137,394,534,9,543,0,O-34-185-04-03-02
NTUNGAMO,RUHAAMA COUNTY,NYAKYERA,KIBINGO,KIBINGO P. SCHOOL,714,4,1,0,125,400,530,21,551,0,O-34-185-04-03-03
NTUNGAMO,RUHAAMA COUNTY,NYAKYERA,KIBINGO,KIBINGO T/CENTRE,586,4,1,2,135,376,518,23,541,0,O-34-185-04-03-04
NTUNGAMO,RUHAAMA COUNTY,NYAKYERA,KIYOORA,KIYOORA PARISH HQRS,668,3,2,2,117,418,542,5,547,0,O-34-185-04-04-01
NTUNGAMO,RUHAAMA COUNTY,NYAKYERA,KIYOORA,KIYOORA TTC,304,1,1,0,76,163,241,8,249,0,O-34-185-04-04-02
NTUNGAMO,RUHAAMA COUNTY,NYAKYERA,KIYOORA,NYAKASA P/SCHOOL,593,3,0,2,154,306,465,11,476,0,O-34-185-04-04-03
NTUNGAMO,RUHAAMA COUNTY,NYAKYERA,KIZIIBA,BITUNTU,448,1,0,2,33,303,339,3,342,0,O-34-185-04-05-01
NTUNGAMO,RUHAAMA COUNTY,NYAKYERA,KIZIIBA,IGORORA P/S,525,1,2,1,88,313,405,2,407,0,O-34-185-04-05-02
NTUNGAMO,RUHAAMA COUNTY,NYAKYERA,KIZIIBA,KAHENGYERE,454,1,1,0,86,272,360,6,366,0,O-34-185-04-05-03
NTUNGAMO,RUHAAMA COUNTY,NYAKYERA,KIZIIBA,KAYANGA P/SCHOOL,484,2,3,3,38,318,364,4,368,0,O-34-185-04-05-04
NTUNGAMO,RUHAAMA COUNTY,NYAKYERA,KIZIIBA,KAZIIBA P/S,438,0,0,1,51,301,353,7,360,0,O-34-185-04-05-05
NTUNGAMO,RUHAAMA COUNTY,NYAKYERA,NGOMA,NGOMA,730,4,0,4,232,307,547,14,561,0,O-34-185-04-06-01
NTUNGAMO,RUHAAMA COUNTY,NYAKYERA,NGOMA,RWEMBIRIZI,601,2,1,0,105,349,457,3,460,0,O-34-185-04-06-02
NTUNGAMO,RUHAAMA COUNTY,NYAKYERA,NGOMBA,KATOOMA T/C,528,2,2,2,66,322,394,17,411,0,O-34-185-04-07-01
NTUNGAMO,RUHAAMA COUNTY,NYAKYERA,NGOMBA,RUHONDWA T/C,539,0,0,2,65,333,400,8,408,0,O-34-185-04-07-02
NTUNGAMO,RUHAAMA COUNTY,NYAKYERA,NGOMBA,NGOMBA,638,2,0,2,149,372,525,7,532,0,O-34-185-04-07-03
NTUNGAMO,RUHAAMA COUNTY,NYAKYERA,NGOMBA,RUZINGA,477,2,2,1,67,308,380,2,382,0,O-34-185-04-07-04
NTUNGAMO,RUHAAMA COUNTY,RUHAAMA,KAFUNJO,KAFUNJO T/C I,579,0,0,0,88,310,398,23,421,0,O-34-185-05-01-01
NTUNGAMO,RUHAAMA COUNTY,RUHAAMA,KAFUNJO,KAFUNJO T/C 2,358,1,0,1,55,220,277,5,282,0,O-34-185-05-01-02
NTUNGAMO,RUHAAMA COUNTY,RUHAAMA,KAFUNJO,KAFUNJO T/C 3,773,2,1,4,124,438,569,23,592,0,O-34-185-05-01-03
NTUNGAMO,RUHAAMA COUNTY,RUHAAMA,KAFUNJO,KAFUNJO PARISH HQRS 1,340,2,1,0,56,185,244,9,253,0,O-34-185-05-01-04
NTUNGAMO,RUHAAMA COUNTY,RUHAAMA,KAFUNJO,KAFUNJO PARISH HQRS 2,526,2,0,2,73,302,379,19,398,0,O-34-185-05-01-05
NTUNGAMO,RUHAAMA COUNTY,RUHAAMA,KAFUNJO,KIGANDO,522,9,2,6,130,252,399,2,401,0,O-34-185-05-01-06
NTUNGAMO,RUHAAMA COUNTY,RUHAAMA,KAFUNJO,TWEMPALA P/S,289,1,2,0,14,211,228,6,234,0,O-34-185-05-01-07
NTUNGAMO,RUHAAMA COUNTY,RUHAAMA,KAFUNJO,MIRAAMA PRI. SCHOOL,527,0,0,1,82,334,417,7,424,0,O-34-185-05-01-08
NTUNGAMO,RUHAAMA COUNTY,RUHAAMA,KAFUNJO,KAGYEZI PRI. SCHOOL,303,1,0,0,56,71,128,3,131,0,O-34-185-05-01-09
NTUNGAMO,RUHAAMA COUNTY,RUHAAMA,KATOJO,KATOJO PARISH HQRS,532,1,1,2,135,291,430,4,434,0,O-34-185-05-02-01
NTUNGAMO,RUHAAMA COUNTY,RUHAAMA,KATOJO,MUSHASHA CHURCH SCHOOL,621,2,0,1,71,445,519,3,522,0,O-34-185-05-02-02
NTUNGAMO,RUHAAMA COUNTY,RUHAAMA,KATOJO,KEMIRONKO,165,0,0,1,35,103,139,3,142,0,O-34-185-05-02-03
NTUNGAMO,RUHAAMA COUNTY,RUHAAMA,KATOJO,KATOJO C.O.U,273,1,1,1,118,120,241,3,244,0,O-34-185-05-02-04
NTUNGAMO,RUHAAMA COUNTY,RUHAAMA,KISHAMI,KISHAMI 1,585,6,0,1,93,366,466,10,476,0,O-34-185-05-03-01
NTUNGAMO,RUHAAMA COUNTY,RUHAAMA,KISHAMI,KISHAMI 2,427,1,0,1,67,260,329,10,339,0,O-34-185-05-03-02
NTUNGAMO,RUHAAMA COUNTY,RUHAAMA,KISHAMI,KISHAMI 3,521,1,1,2,111,256,371,13,384,0,O-34-185-05-03-03
NTUNGAMO,RUHAAMA COUNTY,RUHAAMA,KISHAMI,MITOOMA 1,474,4,0,1,173,201,379,23,402,0,O-34-185-05-03-04
NTUNGAMO,RUHAAMA COUNTY,RUHAAMA,KISHAMI,MITOOMA 2,613,5,0,3,186,310,504,14,518,0,O-34-185-05-03-05
NTUNGAMO,RUHAAMA COUNTY,RUHAAMA,KISHAMI,MITOOMA 3,498,3,0,5,75,311,394,9,403,0,O-34-185-05-03-06
NTUNGAMO,RUHAAMA COUNTY,RUHAAMA,KISHAMI,KYAKASHAMBARA C.O.U,505,3,3,9,135,225,375,16,391,0,O-34-185-05-03-07
NTUNGAMO,RUHAAMA COUNTY,RUHAAMA,KISHAMI,KYABAKONJO TC,481,2,0,5,114,246,367,19,386,0,O-34-185-05-03-08
NTUNGAMO,RUHAAMA COUNTY,RUHAAMA,RUHAAMA,NYAKIIKA P/SCHOOL 1,636,1,2,0,99,428,530,1,531,0,O-34-185-05-04-01
NTUNGAMO,RUHAAMA COUNTY,RUHAAMA,RUHAAMA,NYAKIIKA P/SCHOOL 2,318,0,0,0,40,213,253,2,255,0,O-34-185-05-04-02
NTUNGAMO,RUHAAMA COUNTY,RUHAAMA,RUHAAMA,NYAKIIKA P/SCHOOL 3,751,0,0,1,199,361,561,9,570,0,O-34-185-05-04-03
NTUNGAMO,RUHAAMA COUNTY,RUHAAMA,RUHAAMA,KEMIRONKO PLAYGROUND,419,1,0,4,84,264,353,11,364,0,O-34-185-05-04-04
NTUNGAMO,RUHAAMA COUNTY,RUHAAMA,RUHAAMA,NYAKAGANDO MOSLEM PRI. SCH,565,4,0,3,78,366,451,6,457,0,O-34-185-05-04-05
NTUNGAMO,RUHAAMA COUNTY,RUHAAMA,RWAMWIRE,KASHARIRA,635,2,1,1,84,425,513,10,523,0,O-34-185-05-05-01
NTUNGAMO,RUHAAMA COUNTY,RUHAAMA,RWAMWIRE,MWERASANDU,768,2,0,2,67,493,564,7,571,0,O-34-185-05-05-02
NTUNGAMO,RUHAAMA COUNTY,RUHAAMA,RWENGOMA,NYAKAHITA PRI. SCHOOL,440,1,0,1,40,294,336,4,340,0,O-34-185-05-06-01
NTUNGAMO,RUHAAMA COUNTY,RUHAAMA,RWENGOMA,RWENGOMA PARISH HQRS,672,1,1,0,125,408,535,7,542,0,O-34-185-05-06-02
NTUNGAMO,RUHAAMA COUNTY,RUHAAMA,RWENGOMA,KAHUNGYE PRI. SCHOOL,596,2,0,2,109,363,476,1,477,0,O-34-185-05-06-03
NTUNGAMO,RUHAAMA COUNTY,RUKONI,KIHANGA,KIHANGA P/S 1,703,0,1,2,237,304,544,20,564,0,O-34-185-06-01-01
NTUNGAMO,RUHAAMA COUNTY,RUKONI,KIHANGA,KIHANGA P/S 2,378,3,1,1,126,158,289,9,298,0,O-34-185-06-01-02
NTUNGAMO,RUHAAMA COUNTY,RUKONI,KIHANGA,NYAKIBARE P/SCH 1,746,0,0,3,161,460,624,16,640,0,O-34-185-06-01-03
NTUNGAMO,RUHAAMA COUNTY,RUKONI,KIHANGA,KABUTONDO PRI. SCH,443,1,0,3,98,222,324,20,344,0,O-34-185-06-01-04
NTUNGAMO,RUHAAMA COUNTY,RUKONI,KIRUNGU,KIRUNGI P/S,772,1,1,10,95,564,671,5,676,0,O-34-185-06-02-01
NTUNGAMO,RUHAAMA COUNTY,RUKONI,KITOJO,MUSHASHA,565,1,0,1,158,317,477,11,488,0,O-34-185-06-03-01
NTUNGAMO,RUHAAMA COUNTY,RUKONI,KITOJO,KYABWATO PRI. SCHOOL,755,3,0,3,199,317,522,18,540,0,O-34-185-06-03-02
NTUNGAMO,RUHAAMA COUNTY,RUKONI,KITOJO,KICWAMBA TC,257,0,1,1,40,180,222,11,233,0,O-34-185-06-03-03
NTUNGAMO,RUHAAMA COUNTY,RUKONI,KITWE,KABOBO PRI. SCHOOL,352,0,0,0,71,205,276,12,288,0,O-34-185-06-04-01
NTUNGAMO,RUHAAMA COUNTY,RUKONI,KITWE,KITWE MIXED PRI. SCHOOL,283,1,0,0,42,171,214,3,217,0,O-34-185-06-04-02
NTUNGAMO,RUHAAMA COUNTY,RUKONI,KITWE,KITWE,1024,0,0,3,178,452,633,10,643,0,O-34-185-06-04-03
NTUNGAMO,RUHAAMA COUNTY,RUKONI,KITWE,KOOJO P/S,797,0,0,1,129,403,533,9,542,0,O-34-185-06-04-04
NTUNGAMO,RUHAAMA COUNTY,RUKONI,KYAMWASHA,KAHOKO T/CENTRE,676,4,0,2,190,330,526,17,543,0,O-34-185-06-05-01
NTUNGAMO,RUHAAMA COUNTY,RUKONI,KYAMWASHA,MUSHUNGA PRI. SCHOOL,328,0,0,0,117,138,255,15,270,0,O-34-185-06-05-02
NTUNGAMO,RUHAAMA COUNTY,RUKONI,KYAMWASHA,KYAMWASHA PRI. SCHOOL 1,586,0,0,4,166,282,452,15,467,0,O-34-185-06-05-03
NTUNGAMO,RUHAAMA COUNTY,RUKONI,KYAMWASHA,KYAMWASHA PRI. SCHOOL 2 B,717,1,0,2,185,318,506,19,525,0,O-34-185-06-05-04
NTUNGAMO,RUHAAMA COUNTY,RUKONI,KYAMWASHA,RUKONI PRI. SCHOOL 1,293,0,1,0,54,156,211,8,219,0,O-34-185-06-05-05
NTUNGAMO,RUHAAMA COUNTY,RUKONI,KYAMWASHA,KYAMWASHA PRI. SCHOOL 2 C,634,1,0,4,176,301,482,14,496,0,O-34-185-06-05-06
NTUNGAMO,RUHAAMA COUNTY,RUKONI,NSHENYI,BAKIHARAIRE P/S,581,0,0,2,103,330,435,12,447,0,O-34-185-06-06-01
NTUNGAMO,RUHAAMA COUNTY,RUKONI,NSHENYI,AHAMUKUKURU T/C 1,544,2,2,0,152,281,437,15,452,0,O-34-185-06-06-02
NTUNGAMO,RUHAAMA COUNTY,RUKONI,NSHENYI,AHAMUKUKURU T/C 2,653,1,0,1,188,350,540,16,556,0,O-34-185-06-06-03
NTUNGAMO,RUHAAMA COUNTY,RUKONI,NSHENYI,NSHENYI PARISH HQRS,784,0,1,0,143,407,551,10,561,0,O-34-185-06-06-04
NTUNGAMO,RUHAAMA COUNTY,RUKONI,NSHENYI,KABAHIKWE CHURCH,805,3,1,3,278,314,599,45,644,0,O-34-185-06-06-05
NTUNGAMO,RUHAAMA COUNTY,RUKONI,NYAKABAARE,KABEREBERE T/CENTRE,401,0,1,1,116,200,318,5,323,0,O-34-185-06-07-01
NTUNGAMO,RUHAAMA COUNTY,RUKONI,NYAKABAARE,KANONKO PRIMARY SCHOOL,773,1,0,3,151,455,610,10,620,0,O-34-185-06-07-02
NTUNGAMO,RUHAAMA COUNTY,RUKONI,NYAKABAARE,KIGOMERO P/SCHOOL 1,574,1,1,1,65,357,425,5,430,0,O-34-185-06-07-03
NTUNGAMO,RUHAAMA COUNTY,RUKONI,NYAKABAARE,KIGOMERO P/SCHOOL 2,486,2,1,0,65,312,380,5,385,0,O-34-185-06-07-04
NTUNGAMO,RUHAAMA COUNTY,RUKONI,NYAKABAARE,NYAKABAARE PARISH HQRS 2,692,0,0,2,93,413,508,3,511,0,O-34-185-06-07-05
NTUNGAMO,RUHAAMA COUNTY,RUKONI,NYAKABAARE,NYAKABAARE PARISH HQRS 3,661,3,1,2,113,344,463,14,477,0,O-34-185-06-07-06
NTUNGAMO,RUHAAMA COUNTY,RUKONI,RUKONI,RUKIRI CELL A,958,1,0,1,116,593,711,21,732,0,O-34-185-06-08-01
NTUNGAMO,RUHAAMA COUNTY,RUKONI,RUKONI,NYAMIYAGA,593,0,0,2,68,387,457,6,463,0,O-34-185-06-08-02
NTUNGAMO,RUHAAMA COUNTY,RUKONI,RUKONI,RUKONI SUBCOUNTY HQRS,649,0,0,1,172,314,487,7,494,0,O-34-185-06-08-03
NTUNGAMO,RUHAAMA COUNTY,RUKONI,RUKONI,KYENTAMA C.O.U,636,2,2,1,90,400,495,19,514,0,O-34-185-06-08-04
NTUNGAMO,RUHAAMA COUNTY,RUKONI,RUKONI,KATEMBATEMBE C.O.U,296,0,0,1,87,124,212,5,217,0,O-34-185-06-08-05
NTUNGAMO,RUHAAMA COUNTY,RUKONI,RWOHO,KIRERA,615,5,2,3,90,406,506,15,521,0,O-34-185-06-09-01
NTUNGAMO,RUHAAMA COUNTY,RUKONI,RWOHO,NYAMATEETE P/S,645,4,2,1,125,413,545,5,550,0,O-34-185-06-09-02
NTUNGAMO,RUHAAMA COUNTY,RUKONI,RWOHO,RWOHO,735,1,1,1,114,474,591,11,602,0,O-34-185-06-09-03
NTUNGAMO,RUHAAMA COUNTY,RUKONI,RWOHO,RURAMA TC,327,0,0,1,66,185,252,11,263,0,O-34-185-06-09-04
NTUNGAMO,RUHAAMA COUNTY,RWEIKINIRO,KABUNGO,KABUNGO PARISH HQRS,610,1,0,0,79,404,484,5,489,0,O-34-185-07-01-01
NTUNGAMO,RUHAAMA COUNTY,RWEIKINIRO,KABUNGO,KABUNGO PS 1,723,2,5,5,97,416,525,17,542,0,O-34-185-07-01-02
NTUNGAMO,RUHAAMA COUNTY,RWEIKINIRO,KABUNGO,KABUNGO PS 2,478,0,1,0,120,274,395,10,405,0,O-34-185-07-01-03
NTUNGAMO,RUHAAMA COUNTY,RWEIKINIRO,KABUNGO,KABUNGO PS 3,473,3,0,0,85,271,359,2,361,0,O-34-185-07-01-04
NTUNGAMO,RUHAAMA COUNTY,RWEIKINIRO,KABUNGO,KYAMUGASHE C.O.U COMPOUND,504,3,1,0,59,310,373,7,380,0,O-34-185-07-01-05
NTUNGAMO,RUHAAMA COUNTY,RWEIKINIRO,KABUNGO,RWEMIYAGA MOSQUE,327,0,0,1,32,209,242,2,244,0,O-34-185-07-01-06
NTUNGAMO,RUHAAMA COUNTY,RWEIKINIRO,KABUNGO,OUTSIDE Q.GUARD,665,0,0,2,16,523,541,3,544,0,O-34-185-07-01-07
NTUNGAMO,RUHAAMA COUNTY,RWEIKINIRO,KAYENJE,KAGONGI,491,3,2,1,132,251,389,4,393,0,O-34-185-07-02-01
NTUNGAMO,RUHAAMA COUNTY,RWEIKINIRO,KAYENJE,KAYENJE P/S,351,3,0,7,40,207,257,9,266,0,O-34-185-07-02-02
NTUNGAMO,RUHAAMA COUNTY,RWEIKINIRO,KAYENJE,RURAMA,500,1,1,3,47,390,442,3,445,0,O-34-185-07-02-03
NTUNGAMO,RUHAAMA COUNTY,RWEIKINIRO,KAYENJE,RWABARATA MARKET,594,3,0,0,74,394,471,22,493,0,O-34-185-07-02-04
NTUNGAMO,RUHAAMA COUNTY,RWEIKINIRO,KAYENJE,RWABASHARE PRI. SCHOOL,369,0,0,2,5,237,244,3,247,0,O-34-185-07-02-05
NTUNGAMO,RUHAAMA COUNTY,RWEIKINIRO,KITASHEKWA,KAKUKURU,570,0,0,0,67,356,423,4,427,0,O-34-185-07-03-01
NTUNGAMO,RUHAAMA COUNTY,RWEIKINIRO,KITASHEKWA,RWENANURA,569,1,1,4,125,311,442,3,445,0,O-34-185-07-03-02
NTUNGAMO,RUHAAMA COUNTY,RWEIKINIRO,KITASHEKWA,RWERA P/SCHOOL,173,0,1,1,31,106,139,6,145,0,O-34-185-07-03-03
NTUNGAMO,RUHAAMA COUNTY,RWEIKINIRO,KITASHEKWA,KITEMBE P/S,524,1,0,1,84,340,426,2,428,0,O-34-185-07-03-04
NTUNGAMO,RUHAAMA COUNTY,RWEIKINIRO,KITASHEKWA,MIGYERA P/S,249,0,1,1,28,171,201,1,202,0,O-34-185-07-03-05
NTUNGAMO,RUHAAMA COUNTY,RWEIKINIRO,KITASHEKWA,KITASHEKWA PARISH HQRS,218,1,0,0,31,150,182,3,185,0,O-34-185-07-03-06
NTUNGAMO,RUHAAMA COUNTY,RWEIKINIRO,MURAMBI,KIBEHO 1 [A - K],399,3,0,1,102,208,314,21,335,0,O-34-185-07-04-01
NTUNGAMO,RUHAAMA COUNTY,RWEIKINIRO,MURAMBI,MURAMBI 2,487,0,0,4,36,365,405,7,412,0,O-34-185-07-04-02
NTUNGAMO,RUHAAMA COUNTY,RWEIKINIRO,MURAMBI,MURAMBI 3,512,0,1,1,61,335,398,13,411,0,O-34-185-07-04-03
NTUNGAMO,RUHAAMA COUNTY,RWEIKINIRO,MURAMBI,RWENTOBO C.O.U,772,4,1,9,120,450,584,13,597,0,O-34-185-07-04-04
NTUNGAMO,RUHAAMA COUNTY,RWEIKINIRO,MURAMBI,ISHANJE C.O.U,583,1,0,1,54,404,460,13,473,0,O-34-185-07-04-05
NTUNGAMO,RUHAAMA COUNTY,RWEIKINIRO,MURAMBI,KIBEHO 1 [L - Z],365,3,0,1,87,192,283,3,286,0,O-34-185-07-04-06
NTUNGAMO,RUHAAMA COUNTY,RWEIKINIRO,MURAMBI,KIGARAMA C.O.U,389,2,0,2,52,231,287,17,304,0,O-34-185-07-04-07
NTUNGAMO,RUHAAMA COUNTY,RWEIKINIRO,MURAMBI,NYABUKYERE CHURCH,262,0,0,0,2,159,161,7,168,0,O-34-185-07-04-08
NTUNGAMO,RUHAAMA COUNTY,RWEIKINIRO,RUSHEBEYA,KICECE P/S,566,4,0,0,93,329,426,8,434,0,O-34-185-07-05-01
NTUNGAMO,RUHAAMA COUNTY,RWEIKINIRO,RUSHEBEYA,NYAMIKO,200,1,0,0,29,124,154,3,157,0,O-34-185-07-05-02
NTUNGAMO,RUHAAMA COUNTY,RWEIKINIRO,RUSHEBEYA,RUSHEBEYA 1,416,0,1,1,29,268,299,7,306,0,O-34-185-07-05-03
NTUNGAMO,RUHAAMA COUNTY,RWEIKINIRO,RUSHEBEYA,RUSHEBEYA 2,500,1,1,0,96,303,401,1,402,0,O-34-185-07-05-04
NTUNGAMO,RUHAAMA COUNTY,RWEIKINIRO,RUSHEBEYA,KYENJOJO P/S,409,0,0,2,131,163,296,21,317,0,O-34-185-07-05-05
NTUNGAMO,RUSHENYI COUNTY,KAINA,KABASHESHE,KAINA PARISH HQRS,604,0,0,1,119,350,470,19,489,0,O-34-186-01-01-01
NTUNGAMO,RUSHENYI COUNTY,KAINA,KABASHESHE,KAINA P/S,768,3,0,2,114,498,617,9,626,0,O-34-186-01-01-02
NTUNGAMO,RUSHENYI COUNTY,KAINA,KABASHESHE,KYORUHEGA P/S,498,2,0,0,131,253,386,8,394,0,O-34-186-01-01-03
NTUNGAMO,RUSHENYI COUNTY,KAINA,KABASHESHE,KACWAMPARE TRAD. CENTRE,235,1,0,1,58,137,197,3,200,0,O-34-186-01-01-04
NTUNGAMO,RUSHENYI COUNTY,KAINA,KABASHESHE,RUKOMA P/S,294,0,0,0,22,212,234,2,236,0,O-34-186-01-01-05
NTUNGAMO,RUSHENYI COUNTY,KAINA,KATOOMA,KATOMA PARISH HQRS,544,3,1,1,92,315,412,32,444,0,O-34-186-01-02-01
NTUNGAMO,RUSHENYI COUNTY,KAINA,KATOOMA,RWAHI I,786,2,1,3,223,344,573,4,577,0,O-34-186-01-02-02
NTUNGAMO,RUSHENYI COUNTY,KAINA,KATOOMA,RWAHI II,739,3,2,3,120,444,572,31,603,0,O-34-186-01-02-03
NTUNGAMO,RUSHENYI COUNTY,KAINA,KIJUBWE,KIJUBWE,433,1,0,1,34,294,330,17,347,0,O-34-186-01-03-01
NTUNGAMO,RUSHENYI COUNTY,KAINA,KIJUBWE,MUTAKA I,392,0,0,0,39,247,286,14,300,0,O-34-186-01-03-02
NTUNGAMO,RUSHENYI COUNTY,KAINA,KIJUBWE,RWEMISHURE TRAD. CENTRE,383,0,0,2,20,283,305,9,314,0,O-34-186-01-03-03
NTUNGAMO,RUSHENYI COUNTY,KAINA,KIJUBWE,RWENKONA NURSERY SCHOOL,447,1,1,1,73,272,348,8,356,0,O-34-186-01-03-04
NTUNGAMO,RUSHENYI COUNTY,KAINA,KYOBWE,KIBAARE P/SCHOOL,535,3,2,0,64,333,402,9,411,0,O-34-186-01-04-01
NTUNGAMO,RUSHENYI COUNTY,KAINA,KYOBWE,KYOBWE PARISH HQRS,535,1,0,2,62,380,445,13,458,0,O-34-186-01-04-02
NTUNGAMO,RUSHENYI COUNTY,KAINA,KYOBWE,NYABUGANDO P/SCHOOL,595,1,1,0,69,391,462,14,476,0,O-34-186-01-04-03
NTUNGAMO,RUSHENYI COUNTY,KAINA,RUHEGA,RUHEGA I,662,1,0,0,88,436,525,19,544,0,O-34-186-01-05-01
NTUNGAMO,RUSHENYI COUNTY,KAINA,RUHEGA,RUHEGA II,589,4,1,1,113,345,464,20,484,0,O-34-186-01-05-02
NTUNGAMO,RUSHENYI COUNTY,KAINA,RUHEGA,RUHEGA III,356,1,0,0,77,200,278,3,281,0,O-34-186-01-05-03
NTUNGAMO,RUSHENYI COUNTY,KAYONZA,KABASHESHE,KABASHESHE 1,741,0,0,2,84,501,587,3,590,0,O-34-186-02-01-01
NTUNGAMO,RUSHENYI COUNTY,KAYONZA,KABASHESHE,KABASHESHE 2,696,1,2,1,87,437,528,11,539,0,O-34-186-02-01-02
NTUNGAMO,RUSHENYI COUNTY,NGOMA,KASHENYI,BUGONA 2,651,1,1,0,47,567,616,7,623,0,O-34-186-03-01-01
NTUNGAMO,RUSHENYI COUNTY,NGOMA,KASHENYI,KASHENYI PARISH HQRS [A - L],873,0,0,0,6,627,633,31,664,0,O-34-186-03-01-02
NTUNGAMO,RUSHENYI COUNTY,NGOMA,KASHENYI,KASHENYI PARISH HQRS [M - Z],495,1,0,2,39,445,487,4,491,0,O-34-186-03-01-03
NTUNGAMO,RUSHENYI COUNTY,NGOMA,KIYANJA,KASHATE,684,3,0,5,62,450,520,14,534,0,O-34-186-03-02-01
NTUNGAMO,RUSHENYI COUNTY,NGOMA,KIYANJA,KIYANJA 1,764,0,2,3,146,346,497,18,515,0,O-34-186-03-02-02
NTUNGAMO,RUSHENYI COUNTY,NGOMA,KIYANJA,KIYANJA MOSQUE,371,2,0,3,98,182,285,11,296,0,O-34-186-03-02-03
NTUNGAMO,RUSHENYI COUNTY,NGOMA,KIZINGA,BUTERERE KAKURA CATHOLIC C,731,6,0,3,101,464,574,20,594,0,O-34-186-03-03-01
NTUNGAMO,RUSHENYI COUNTY,NGOMA,KIZINGA,KIZINGA PARISH HQRS,288,2,1,2,43,151,199,15,214,0,O-34-186-03-03-02
NTUNGAMO,RUSHENYI COUNTY,NGOMA,KIZINGA,KIZINGA PRI. SCHOOL,648,2,0,1,73,359,435,36,471,0,O-34-186-03-03-03
NTUNGAMO,RUSHENYI COUNTY,NGOMA,MUGYERA,BURAMA P/SCHOOL,486,1,0,1,135,250,387,6,393,0,O-34-186-03-04-01
NTUNGAMO,RUSHENYI COUNTY,NGOMA,MUGYERA,KAKIIRI COU,474,0,0,2,55,360,417,5,422,0,O-34-186-03-04-02
NTUNGAMO,RUSHENYI COUNTY,NGOMA,MUGYERA,MUGYERA PARISH HQRS,756,3,1,1,136,483,624,6,630,0,O-34-186-03-04-03
NTUNGAMO,RUSHENYI COUNTY,NGOMA,MUGYERA,KABINGOZA CHURCH,377,3,2,0,132,184,321,7,328,0,O-34-186-03-04-04
NTUNGAMO,RUSHENYI COUNTY,NGOMA,MUKONI,BUTARE COU,375,0,0,22,29,274,325,2,327,0,O-34-186-03-05-01
NTUNGAMO,RUSHENYI COUNTY,NGOMA,MUKONI,MUKONI PARISH HQRS,533,2,0,3,73,302,380,22,402,0,O-34-186-03-05-02
NTUNGAMO,RUSHENYI COUNTY,NGOMA,NYAKARIRO,KIGAGA P/S,554,1,0,1,64,286,352,6,358,0,O-34-186-03-06-01
NTUNGAMO,RUSHENYI COUNTY,NGOMA,NYAKARIRO,NYAKARIRO 1,546,0,0,0,2,516,518,4,522,0,O-34-186-03-06-02
NTUNGAMO,RUSHENYI COUNTY,NGOMA,NYAKARIRO,NYAKARIRO 2,487,1,0,0,5,428,434,6,440,0,O-34-186-03-06-03
NTUNGAMO,RUSHENYI COUNTY,NGOMA,RUHARA,AHAKABUGA,674,1,4,3,37,490,535,6,541,0,O-34-186-03-07-01
NTUNGAMO,RUSHENYI COUNTY,NGOMA,RUHARA,RUHARA,539,1,0,1,170,204,376,4,380,0,O-34-186-03-07-02
NTUNGAMO,RUSHENYI COUNTY,NGOMA,RUHARA,ADVENTIST CHURCH,575,0,0,0,27,449,476,0,476,0,O-34-186-03-07-03
NTUNGAMO,RUSHENYI COUNTY,RUBAARE,KAGUGU,BWITTA,464,0,0,1,23,285,309,7,316,0,O-34-186-04-01-01
NTUNGAMO,RUSHENYI COUNTY,RUBAARE,KAGUGU,KAGUGU PARISH HQRS,675,2,0,1,224,272,499,2,501,0,O-34-186-04-01-02
NTUNGAMO,RUSHENYI COUNTY,RUBAARE,KAGUGU,KASHANDA P/S,522,2,0,0,139,248,389,9,398,0,O-34-186-04-01-03
NTUNGAMO,RUSHENYI COUNTY,RUBAARE,KAGUGU,KAGUGU MARKET,370,2,0,0,30,240,272,7,279,0,O-34-186-04-01-04
NTUNGAMO,RUSHENYI COUNTY,RUBAARE,MUTOJO,MUTOJO PARISH HQRS I,600,2,2,1,96,390,491,12,503,0,O-34-186-04-02-01
NTUNGAMO,RUSHENYI COUNTY,RUBAARE,MUTOJO,MUTOJO P/SCHOOL,564,2,1,0,134,288,425,12,437,0,O-34-186-04-02-02
NTUNGAMO,RUSHENYI COUNTY,RUBAARE,MUTOJO,NYAMURINDIRA,601,2,0,3,140,337,482,25,507,0,O-34-186-04-02-03
NTUNGAMO,RUSHENYI COUNTY,RUBAARE,MUTOJO,RUBAARE T/CENTRE A,679,2,2,2,155,257,418,10,428,0,O-34-186-04-02-04
NTUNGAMO,RUSHENYI COUNTY,RUBAARE,MUTOJO,RUBAARE T/CENTRE B,500,0,1,1,104,195,301,14,315,0,O-34-186-04-02-05
NTUNGAMO,RUSHENYI COUNTY,RUBAARE,MUTOJO,RUBAARE MOSLEM P/S PLAYGRO,614,1,0,0,171,190,362,15,377,0,O-34-186-04-02-06
NTUNGAMO,RUSHENYI COUNTY,RUBAARE,NYANGA,NYANGA PARISH HQRS,517,2,1,1,98,343,445,9,454,0,O-34-186-04-03-01
NTUNGAMO,RUSHENYI COUNTY,RUBAARE,NYANGA,NYANGA P/SCHOOL,703,1,0,4,183,386,574,12,586,0,O-34-186-04-03-02
NTUNGAMO,RUSHENYI COUNTY,RUBAARE,NYANGA,RUYONZA PRIMARY SCHOOL,793,1,0,2,266,396,665,5,670,0,O-34-186-04-03-03
NTUNGAMO,RUSHENYI COUNTY,RUBAARE,NYARWANYA,KACERERE,481,4,0,0,125,219,348,11,359,0,O-34-186-04-04-01
NTUNGAMO,RUSHENYI COUNTY,RUBAARE,NYARWANYA,NYARWANYA,651,2,0,3,141,368,514,12,526,0,O-34-186-04-04-02
NTUNGAMO,RUSHENYI COUNTY,RUBAARE,NYARWANYA,BIKONOKA CATHOLIC CHURCH,328,0,0,1,106,140,247,12,259,0,O-34-186-04-04-03
NTUNGAMO,RUSHENYI COUNTY,RUBAARE,NYARWANYA,KYAMUHAMYA C.O.U,272,2,0,2,71,145,220,5,225,0,O-34-186-04-04-04
NTUNGAMO,RUSHENYI COUNTY,RUBAARE,OMUNGYENYI,OMUNGYENYI A,451,1,0,0,75,253,329,12,341,0,O-34-186-04-05-01
NTUNGAMO,RUSHENYI COUNTY,RUBAARE,OMUNGYENYI,RWABARAMIRA,646,1,0,1,88,394,484,12,496,0,O-34-186-04-05-02
NTUNGAMO,RUSHENYI COUNTY,RUBAARE,OMUNGYENYI,OMUNGYENYI B,346,4,0,1,140,128,273,6,279,0,O-34-186-04-05-03
NTUNGAMO,RUSHENYI COUNTY,RUBAARE,RUKIIRI,KIBONWA,761,5,0,3,218,319,545,14,559,0,O-34-186-04-06-01
NTUNGAMO,RUSHENYI COUNTY,RUBAARE,RUKIIRI,RUKIRI,498,5,0,2,73,276,356,9,365,0,O-34-186-04-06-02
NTUNGAMO,RUSHENYI COUNTY,RUBAARE,RUKIIRI,RUBANGA,533,0,0,1,8,337,346,7,353,0,O-34-186-04-06-03
NTUNGAMO,RUSHENYI COUNTY,RUGARAMA,KAGONGI,KAGONGI P/S,681,3,1,2,203,304,513,22,535,0,O-34-186-05-01-01
NTUNGAMO,RUSHENYI COUNTY,RUGARAMA,KAGONGI,KAGYEYO P/S,627,0,1,2,104,385,492,8,500,0,O-34-186-05-01-02
NTUNGAMO,RUSHENYI COUNTY,RUGARAMA,KAGONGI,RUGARAMA SCTY HQTRS,792,3,2,4,211,354,574,29,603,0,O-34-186-05-01-03
NTUNGAMO,RUSHENYI COUNTY,RUGARAMA,KAKANENA,KANANENA MARKET PLACE,740,6,0,0,239,358,603,14,617,0,O-34-186-05-02-01
NTUNGAMO,RUSHENYI COUNTY,RUGARAMA,KAKANENA,KAKANENA PARISH HQRS,770,2,3,6,269,304,584,21,605,0,O-34-186-05-02-02
NTUNGAMO,RUSHENYI COUNTY,RUGARAMA,KAKANENA,NYAKITABIRE P/S,651,5,0,1,91,403,500,18,518,0,O-34-186-05-02-03
NTUNGAMO,RUSHENYI COUNTY,RUGARAMA,KAKANENA,RUHEGA P/S,310,0,0,2,50,197,249,9,258,0,O-34-186-05-02-04
NTUNGAMO,RUSHENYI COUNTY,RUGARAMA,KATUNGAMO,KATUNGAMO HQTRS,405,0,0,1,60,264,325,11,336,0,O-34-186-05-03-01
NTUNGAMO,RUSHENYI COUNTY,RUGARAMA,KATUNGAMO,KISHENGA,652,1,0,2,117,413,533,12,545,0,O-34-186-05-03-02
NTUNGAMO,RUSHENYI COUNTY,RUGARAMA,KATUNGAMO,RUHOKO,574,0,0,1,212,227,440,0,440,0,O-34-186-05-03-03
NTUNGAMO,RUSHENYI COUNTY,RUGARAMA,KATUNGAMO,MURAMBI P/S,400,0,0,1,90,228,319,6,325,0,O-34-186-05-03-04
NTUNGAMO,RUSHENYI COUNTY,RUGARAMA,KYAFOORA,KAJUMBAJUMBA,459,1,0,2,90,274,367,28,395,0,O-34-186-05-04-01
NTUNGAMO,RUSHENYI COUNTY,RUGARAMA,KYAFOORA,KYAFOORA PARISH HQRS,784,1,0,2,181,412,596,8,604,0,O-34-186-05-04-02
NTUNGAMO,RUSHENYI COUNTY,RUGARAMA,NGOMBA,NGOMBA PARISH HQRS,745,0,1,1,219,370,591,21,612,0,O-34-186-05-05-01
NTUNGAMO,RUSHENYI COUNTY,RUGARAMA,NGOMBA,NGOMBA P/S,641,7,0,2,222,305,536,12,548,0,O-34-186-05-05-02
NTUNGAMO,RUSHENYI COUNTY,RUGARAMA,NGOMBA,NYAKARAMBI P/S,656,1,0,4,95,479,579,11,590,0,O-34-186-05-05-03
NTUNGAMO,RUSHENYI COUNTY,RUGARAMA,NYAKABUNGO,KABUYE,404,0,0,0,75,217,292,48,340,0,O-34-186-05-06-01
NTUNGAMO,RUSHENYI COUNTY,RUGARAMA,NYAKABUNGO,NYAKABUNGO,847,7,2,6,259,404,678,7,685,0,O-34-186-05-06-02
NTUNGAMO,RUSHENYI COUNTY,RUGARAMA,NYAKABUNGO,NYAMAFURO,528,2,3,3,141,254,403,38,441,0,O-34-186-05-06-03
NTUNGAMO,RUSHENYI COUNTY,RUGARAMA,NYAKABUNGO,AHAKATUTSI,451,1,0,1,92,274,368,5,373,0,O-34-186-05-06-04
RUKUNGIRI,RUBABO COUNTY,BUYANJA,BUGYERA,KITOJO P/S,903,1,1,3,285,380,670,17,687,0,O-37-197-01-01-01
RUKUNGIRI,RUBABO COUNTY,BUYANJA,BUGYERA,NYAKIJU C.O.U,219,0,0,1,48,105,154,9,163,0,O-37-197-01-01-02
RUKUNGIRI,RUBABO COUNTY,BUYANJA,BUGYERA,RUGARAMA C.O.U,295,1,0,0,116,124,241,4,245,0,O-37-197-01-01-03
RUKUNGIRI,RUBABO COUNTY,BUYANJA,BUYANJA TOWN,KYAMAKANDA PLAY GROUND,1034,3,0,0,452,229,684,9,693,0,O-37-197-01-02-01
RUKUNGIRI,RUBABO COUNTY,BUYANJA,BUYANJA TOWN,BUYANJA SUBCOUNTY HQTRS,1051,1,1,1,352,267,622,17,639,0,O-37-197-01-02-02
RUKUNGIRI,RUBABO COUNTY,BUYANJA,KASHEESHE,KASHESHE P/S,504,1,0,1,193,212,407,5,412,0,O-37-197-01-03-01
RUKUNGIRI,RUBABO COUNTY,BUYANJA,KASHEESHE,KASHEHSE BISHOP'S P/S,464,1,0,1,201,158,361,10,371,0,O-37-197-01-03-02
RUKUNGIRI,RUBABO COUNTY,BUYANJA,KYAMAKANDA,KIHUMURO P/S,565,4,0,2,180,267,453,10,463,0,O-37-197-01-04-01
RUKUNGIRI,RUBABO COUNTY,BUYANJA,KYAMAKANDA,RWAMUHIMA P/S,456,0,0,1,123,249,373,10,383,0,O-37-197-01-04-02
RUKUNGIRI,RUBABO COUNTY,BUYANJA,KYAMAKANDA,KYAMAKANDA PARISH HQRS,489,1,1,1,193,179,375,3,378,0,O-37-197-01-04-03
RUKUNGIRI,RUBABO COUNTY,BUYANJA,NYABITEETE,NABITEETE P/S,488,0,0,1,184,186,371,6,377,0,O-37-197-01-05-01
RUKUNGIRI,RUBABO COUNTY,BUYANJA,NYABITEETE,BUHANDAGAZI C.O.U,375,0,0,1,105,177,283,4,287,0,O-37-197-01-05-02
RUKUNGIRI,RUBABO COUNTY,BUYANJA,NYABITEETE,KANOMBE P/S,607,1,0,2,176,307,486,3,489,0,O-37-197-01-05-03
RUKUNGIRI,RUBABO COUNTY,BUYANJA,NYAKABUNGO,KATUNGU P/S,488,0,0,0,187,184,371,5,376,0,O-37-197-01-06-01
RUKUNGIRI,RUBABO COUNTY,BUYANJA,NYAKABUNGO,RURENGYE CATHOLIC CHURCH,465,2,0,2,136,228,368,8,376,0,O-37-197-01-06-02
RUKUNGIRI,RUBABO COUNTY,BUYANJA,NYAKABUNGO,RUSHOROZA CATHOLIC CHURCH,289,0,0,1,87,140,228,7,235,0,O-37-197-01-06-03
RUKUNGIRI,RUBABO COUNTY,BUYANJA,NYAKAINA,RWENKURIJO P/S,558,2,0,0,206,237,445,13,458,0,O-37-197-01-07-01
RUKUNGIRI,RUBABO COUNTY,BUYANJA,NYAKAINA,KAGATI C.O.U,760,5,0,3,318,275,601,3,604,0,O-37-197-01-07-02
RUKUNGIRI,RUBABO COUNTY,BUYANJA,NYAKAINA,KYANAMIRA CATHOLIC CHURCH,316,2,1,1,125,110,239,3,242,0,O-37-197-01-07-03
RUKUNGIRI,RUBABO COUNTY,BUYANJA,RUBANGA,IBUMBA P/S,911,3,0,3,195,457,658,13,671,0,O-37-197-01-08-01
RUKUNGIRI,RUBABO COUNTY,BUYANJA,RUBANGA,KISHONGA P/S,688,1,0,0,182,287,470,16,486,0,O-37-197-01-08-02
RUKUNGIRI,RUBABO COUNTY,BUYANJA,RUBANGA,RUBANGA P/S,585,2,2,2,134,263,403,6,409,0,O-37-197-01-08-03
RUKUNGIRI,RUBABO COUNTY,BUYANJA,RWAKIRUNGURA,RWENTUHA P/S,820,4,0,0,263,325,592,25,617,0,O-37-197-01-09-01
RUKUNGIRI,RUBABO COUNTY,BUYANJA,RWAKIRUNGURA,RWAKIRUMIRA C.O.U,438,0,1,0,147,174,322,16,338,0,O-37-197-01-09-02
RUKUNGIRI,RUBABO COUNTY,KEBISONI,GARUBANDA,PARENTS P/S,427,2,0,0,117,216,335,12,347,0,O-37-197-02-01-01
RUKUNGIRI,RUBABO COUNTY,KEBISONI,GARUBANDA,IBIRI T. CENTRE,841,2,1,2,178,434,617,18,635,0,O-37-197-02-01-02
RUKUNGIRI,RUBABO COUNTY,KEBISONI,KABINGO,KARIRE P/S,427,1,0,0,124,196,321,10,331,0,O-37-197-02-02-01
RUKUNGIRI,RUBABO COUNTY,KEBISONI,KABINGO,KABINGO P/S,685,1,1,2,209,273,486,16,502,0,O-37-197-02-02-02
RUKUNGIRI,RUBABO COUNTY,KEBISONI,KABINGO,RWEMIRAMA R.C. CHURCH,310,1,0,2,65,168,236,5,241,0,O-37-197-02-02-03
RUKUNGIRI,RUBABO COUNTY,KEBISONI,KAKIINGA,MUTOJO,483,2,0,0,93,229,324,0,324,0,O-37-197-02-03-01
RUKUNGIRI,RUBABO COUNTY,KEBISONI,KAKIINGA,KAKIBAYA P/S,435,1,0,0,109,199,309,8,317,0,O-37-197-02-03-02
RUKUNGIRI,RUBABO COUNTY,KEBISONI,KARUHEMBE,KARUHEMBE PR. SCHOOL,433,1,0,3,116,198,318,7,325,0,O-37-197-02-04-01
RUKUNGIRI,RUBABO COUNTY,KEBISONI,KARUHEMBE,NYAKAZINGA STAGE,498,1,0,1,128,226,356,12,368,0,O-37-197-02-04-02
RUKUNGIRI,RUBABO COUNTY,KEBISONI,KARUHEMBE,KARUHEMBE C.O.U,439,1,0,0,76,240,317,7,324,0,O-37-197-02-04-03
RUKUNGIRI,RUBABO COUNTY,KEBISONI,KEBISONI TOWN,KEBISONI SUB-COUNTY HQRS,898,2,0,2,241,399,644,7,651,0,O-37-197-02-05-01
RUKUNGIRI,RUBABO COUNTY,KEBISONI,KEBISONI TOWN,RUMBUGU P/S,637,2,0,0,129,316,447,5,452,0,O-37-197-02-05-02
RUKUNGIRI,RUBABO COUNTY,KEBISONI,KIIGIRO,KIIGIRO P/S,471,0,1,1,118,249,369,10,379,0,O-37-197-02-06-01
RUKUNGIRI,RUBABO COUNTY,KEBISONI,KIIGIRO,NDAMA PS,402,3,0,3,139,172,317,4,321,0,O-37-197-02-06-02
RUKUNGIRI,RUBABO COUNTY,KEBISONI,MABANGA,MABANGA P/S,626,1,2,1,132,313,449,14,463,0,O-37-197-02-07-01
RUKUNGIRI,RUBABO COUNTY,KEBISONI,MABANGA,NYARUNYINYA C.O.U,615,0,1,2,157,330,490,12,502,0,O-37-197-02-07-02
RUKUNGIRI,RUBABO COUNTY,KEBISONI,NYEIBINGO,NYEIBINGO C.O.U,622,1,0,0,169,293,463,17,480,0,O-37-197-02-08-01
RUKUNGIRI,RUBABO COUNTY,KEBISONI,NYEIBINGO,KYAMUTARANGA,626,1,0,0,161,325,487,8,495,0,O-37-197-02-08-02
RUKUNGIRI,RUBABO COUNTY,KEBISONI,NYEIBINGO,BIKUNGU P/S,320,0,0,1,132,147,280,2,282,0,O-37-197-02-08-03
RUKUNGIRI,RUBABO COUNTY,NYAKISHENYI,BIKONGOZO,BIKONGOZO PRI.SCHOOL,500,2,0,1,41,340,384,1,385,0,O-37-197-03-01-01
RUKUNGIRI,RUBABO COUNTY,NYAKISHENYI,BIKONGOZO,KEBIHIMBA T/C,364,0,0,0,51,242,293,4,297,0,O-37-197-03-01-02
RUKUNGIRI,RUBABO COUNTY,NYAKISHENYI,KACENCE,NYAKISOROZA H/C III,555,0,0,3,89,348,440,9,449,0,O-37-197-03-02-01
RUKUNGIRI,RUBABO COUNTY,NYAKISHENYI,KACENCE,NYAKISHENYI S/CTY HQRS,979,3,1,1,100,639,744,8,752,0,O-37-197-03-02-02
RUKUNGIRI,RUBABO COUNTY,NYAKISHENYI,KAFUNJO,KAFUNJO PRI. SCH.,532,1,0,1,42,342,386,4,390,0,O-37-197-03-03-01
RUKUNGIRI,RUBABO COUNTY,NYAKISHENYI,KAFUNJO,KIRIMBE PRI. SCH.,875,3,4,5,91,519,622,12,634,0,O-37-197-03-03-02
RUKUNGIRI,RUBABO COUNTY,NYAKISHENYI,KAHOKO,RUSHESHE PRI. SCHOOL,767,2,4,2,124,439,571,6,577,0,O-37-197-03-04-01
RUKUNGIRI,RUBABO COUNTY,NYAKISHENYI,KAHOKO,KIBARE PRI. SCHOOL,720,2,2,3,67,477,551,2,553,0,O-37-197-03-04-02
RUKUNGIRI,RUBABO COUNTY,NYAKISHENYI,KAHOKO,OMURUTOOMA PRI. SCHOOL,565,4,1,3,59,383,450,12,462,0,O-37-197-03-04-03
RUKUNGIRI,RUBABO COUNTY,NYAKISHENYI,KATONYA,KATONYA PRI. SCHOOL,679,1,1,2,55,546,605,3,608,0,O-37-197-03-05-01
RUKUNGIRI,RUBABO COUNTY,NYAKISHENYI,KATONYA,MUSHUNGA T/C,391,1,1,0,74,234,310,3,313,0,O-37-197-03-05-02
RUKUNGIRI,RUBABO COUNTY,NYAKISHENYI,KATONYA,BUGARAMA PRI. SCHOOL,656,4,0,0,104,423,531,6,537,0,O-37-197-03-05-03
RUKUNGIRI,RUBABO COUNTY,NYAKISHENYI,MURAMA,MURAMA P/S,666,1,0,0,117,427,545,7,552,0,O-37-197-03-06-01
RUKUNGIRI,RUBABO COUNTY,NYAKISHENYI,MURAMA,KIGANDA C.OU,450,1,0,1,107,255,364,14,378,0,O-37-197-03-06-02
RUKUNGIRI,RUBABO COUNTY,NYAKISHENYI,MURAMA,MULAGO PR. SCHOOL,368,1,0,0,77,252,330,3,333,0,O-37-197-03-06-03
RUKUNGIRI,RUBABO COUNTY,NYAKISHENYI,NGOMA,KIGARAMA PRI. SCHOOL,361,1,0,0,37,256,294,2,296,0,O-37-197-03-07-01
RUKUNGIRI,RUBABO COUNTY,NYAKISHENYI,NGOMA,RURINDO P/S,669,2,1,2,94,443,542,7,549,0,O-37-197-03-07-02
RUKUNGIRI,RUBABO COUNTY,NYAKISHENYI,NYARUGANDO,NYABUBARE P/S,493,3,0,1,74,314,392,8,400,0,O-37-197-03-08-01
RUKUNGIRI,RUBABO COUNTY,NYAKISHENYI,NYARUGANDO,MARASHANIRO PRI. SCHOOL,404,0,0,0,62,282,344,3,347,0,O-37-197-03-08-02
RUKUNGIRI,RUBABO COUNTY,NYAKISHENYI,RWANYUNDO,KIBOROGOTA T/C,386,0,2,0,21,278,301,3,304,0,O-37-197-03-09-01
RUKUNGIRI,RUBABO COUNTY,NYAKISHENYI,RWANYUNDO,RWANYUNDO P/S,991,2,0,7,114,655,778,13,791,0,O-37-197-03-09-02
RUKUNGIRI,RUBABO COUNTY,NYARUSHANJE,BUNONO,MUGYERA PRI. SCHOOL,780,2,2,2,110,519,635,4,639,0,O-37-197-04-01-01
RUKUNGIRI,RUBABO COUNTY,NYARUSHANJE,BUNONO,KARUKATA VOC.S. SCHOOL,414,1,1,1,70,251,324,6,330,0,O-37-197-04-01-02
RUKUNGIRI,RUBABO COUNTY,NYARUSHANJE,BUNONO,IHAMBIRO T. CENTRE,447,0,0,2,52,284,338,4,342,0,O-37-197-04-01-03
RUKUNGIRI,RUBABO COUNTY,NYARUSHANJE,BURORA,NYAKATUNGA T.CENTRE,600,1,1,1,122,366,491,14,505,0,O-37-197-04-02-01
RUKUNGIRI,RUBABO COUNTY,NYARUSHANJE,BURORA,NYAMAKUKURU PRI. SCHOOL,749,3,5,1,95,440,544,4,548,0,O-37-197-04-02-02
RUKUNGIRI,RUBABO COUNTY,NYARUSHANJE,BURORA,BURORA PARISH HQRS,857,4,0,0,134,478,616,15,631,0,O-37-197-04-02-03
RUKUNGIRI,RUBABO COUNTY,NYARUSHANJE,BWANGA,BWANGA MULUKA HQRS,689,1,1,0,147,345,494,30,524,0,O-37-197-04-03-01
RUKUNGIRI,RUBABO COUNTY,NYARUSHANJE,BWANGA,KIHUNGYE PRI. SCHOOL,686,3,0,1,126,364,494,8,502,0,O-37-197-04-03-02
RUKUNGIRI,RUBABO COUNTY,NYARUSHANJE,IBANDA,IBANDA P/S,608,1,1,1,115,368,486,16,502,0,O-37-197-04-04-01
RUKUNGIRI,RUBABO COUNTY,NYARUSHANJE,IBANDA,NYARUSHANGYE UPPER P/S,709,2,1,2,163,354,522,12,534,0,O-37-197-04-04-02
RUKUNGIRI,RUBABO COUNTY,NYARUSHANJE,IBANDA,RUBIRIIZI P/S,561,3,3,0,110,332,448,9,457,0,O-37-197-04-04-03
RUKUNGIRI,RUBABO COUNTY,NYARUSHANJE,IBANDA,KABUGA HEALTH CENTRE,524,2,3,2,37,329,373,3,376,0,O-37-197-04-04-04
RUKUNGIRI,RUBABO COUNTY,NYARUSHANJE,IHUNGA,KARUKAATA P. SCHOOL,555,0,0,0,73,369,442,11,453,0,O-37-197-04-05-01
RUKUNGIRI,RUBABO COUNTY,NYARUSHANJE,IHUNGA,KIBIZI P. SCHOOL,700,2,1,1,81,492,577,6,583,0,O-37-197-04-05-02
RUKUNGIRI,RUBABO COUNTY,NYARUSHANJE,KISIIZI,KAYANGA P. SCHOOL,596,2,0,0,104,367,473,12,485,0,O-37-197-04-06-01
RUKUNGIRI,RUBABO COUNTY,NYARUSHANJE,KISIIZI,OMUKASHENYI CATHOLIC CHURC,326,0,0,0,82,176,258,3,261,0,O-37-197-04-06-02
RUKUNGIRI,RUBABO COUNTY,NYARUSHANJE,KISIIZI,KISIIZI HOSPITAL P. SCHOOL,467,2,1,2,85,264,354,9,363,0,O-37-197-04-06-03
RUKUNGIRI,RUBABO COUNTY,NYARUSHANJE,KISIIZI,KISIIZI UPPER PRI. SCHOOL,474,0,1,2,55,316,374,8,382,0,O-37-197-04-06-04
RUKUNGIRI,RUBABO COUNTY,NYARUSHANJE,KISIIZI,KITAGATA CATHOLIC CHURCH,390,0,0,0,67,259,326,9,335,0,O-37-197-04-06-05
RUKUNGIRI,RUBABO COUNTY,NYARUSHANJE,NDAGO,BWEYO CATHOLIC CHURCH,788,3,0,0,137,492,632,23,655,0,O-37-197-04-07-01
RUKUNGIRI,RUBABO COUNTY,NYARUSHANJE,NDAGO,NDAGO PRI. SCHOOL,744,4,1,1,137,467,610,21,631,0,O-37-197-04-07-02
RUKUNGIRI,RUBABO COUNTY,NYARUSHANJE,NYABUSHENYI,NYABUSHENYI UPPER PRI. SCHO,695,2,1,2,151,349,505,8,513,0,O-37-197-04-08-01
RUKUNGIRI,RUBABO COUNTY,NYARUSHANJE,NYABUSHENYI,NYABUSHENYI LOWER PRI. SCHO,703,0,0,1,164,391,556,11,567,0,O-37-197-04-08-02
RUKUNGIRI,RUBABO COUNTY,NYARUSHANJE,NYABUSHENYI,KIGANGA PRI. SCHOOL,596,2,0,1,95,380,478,11,489,0,O-37-197-04-08-03
RUKUNGIRI,RUBABO COUNTY,NYARUSHANJE,RUYONZA,MUSYANA PRI. SCHOOL,995,3,1,4,214,552,774,22,796,0,O-37-197-04-09-01
RUKUNGIRI,RUBABO COUNTY,NYARUSHANJE,RUYONZA,RUYONZA/NDAGO PENTECOSTAL,731,3,1,2,156,381,543,11,554,0,O-37-197-04-09-02
RUKUNGIRI,RUJUMBURA COUNTY,BUGANGARI,BUGANGARI,KATABUSHERA,661,5,1,0,242,264,512,13,525,0,O-37-198-01-01-01
RUKUNGIRI,RUJUMBURA COUNTY,BUGANGARI,BUGANGARI,BUGANGARI S/CTY HQRS,594,1,2,0,167,250,420,16,436,0,O-37-198-01-01-02
RUKUNGIRI,RUJUMBURA COUNTY,BUGANGARI,BUGANGARI,RUNYAMUNYU,344,0,0,1,78,165,244,37,281,0,O-37-198-01-01-03
RUKUNGIRI,RUJUMBURA COUNTY,BUGANGARI,BUGANGARI,KAKIRAGIRO,636,3,0,1,163,273,440,74,514,0,O-37-198-01-01-04
RUKUNGIRI,RUJUMBURA COUNTY,BUGANGARI,BURAMA,KIBARAMA,941,9,0,6,202,386,603,18,621,0,O-37-198-01-02-01
RUKUNGIRI,RUJUMBURA COUNTY,BUGANGARI,BURAMA,OMUKOBUSINGYE,534,2,2,0,121,297,422,14,436,0,O-37-198-01-02-02
RUKUNGIRI,RUJUMBURA COUNTY,BUGANGARI,KAKINDO,NYARUBARE,351,5,0,1,64,225,295,9,304,0,O-37-198-01-03-01
RUKUNGIRI,RUJUMBURA COUNTY,BUGANGARI,KAKINDO,KAKINDO PRI. SCHOOL,799,1,0,3,267,347,618,14,632,0,O-37-198-01-03-02
RUKUNGIRI,RUJUMBURA COUNTY,BUGANGARI,KASHAYO,NYAKARIRO PRI. SCHOOL,749,1,0,2,167,427,597,12,609,0,O-37-198-01-04-01
RUKUNGIRI,RUJUMBURA COUNTY,BUGANGARI,KASHAYO,MURAMBO T/C,541,1,0,3,136,303,443,7,450,0,O-37-198-01-04-02
RUKUNGIRI,RUJUMBURA COUNTY,BUGANGARI,KAZINDIRO,KAZINDIRO HQRS,679,2,1,0,143,323,469,55,524,0,O-37-198-01-05-01
RUKUNGIRI,RUJUMBURA COUNTY,BUGANGARI,KAZINDIRO,NYAMIHANGA T/C,730,2,0,1,149,359,511,74,585,0,O-37-198-01-05-02
RUKUNGIRI,RUJUMBURA COUNTY,BUGANGARI,KAZINDIRO,NYANGANJARA P/S,591,2,1,1,151,284,439,18,457,0,O-37-198-01-05-03
RUKUNGIRI,RUJUMBURA COUNTY,BUGANGARI,KYABUREERE,KATERAMPUNGU PRI. SCHOOL,734,4,0,0,184,396,584,13,597,0,O-37-198-01-06-01
RUKUNGIRI,RUJUMBURA COUNTY,BUGANGARI,KYABUREERE,BUREMBO PARISH HQRS,621,3,0,3,159,314,479,21,500,0,O-37-198-01-06-02
RUKUNGIRI,RUJUMBURA COUNTY,BUGANGARI,NYABITEETE,KANYANKYENDE P/S,794,3,2,4,205,402,616,25,641,0,O-37-198-01-07-01
RUKUNGIRI,RUJUMBURA COUNTY,BUGANGARI,NYABITEETE,BUREMBO P/S,751,4,0,0,174,420,598,24,622,0,O-37-198-01-07-02
RUKUNGIRI,RUJUMBURA COUNTY,BUGANGARI,NYABITEETE,NYABITEETE PARISH HQRS,766,2,1,3,98,386,490,113,603,0,O-37-198-01-07-03
RUKUNGIRI,RUJUMBURA COUNTY,BUHUNGA,BUHUNGA,KARUZIGYE P/S,490,2,0,0,147,217,366,19,385,0,O-37-198-02-01-01
RUKUNGIRI,RUJUMBURA COUNTY,BUHUNGA,BUHUNGA,KATURIKA S.S.S,877,5,1,1,257,412,676,22,698,0,O-37-198-02-01-02
RUKUNGIRI,RUJUMBURA COUNTY,BUHUNGA,BUHUNGA,BUHUNGA P/S,390,4,0,1,89,230,324,8,332,0,O-37-198-02-01-03
RUKUNGIRI,RUJUMBURA COUNTY,BUHUNGA,BUHUNGA,RUSHESHE T/C,525,1,0,4,103,313,421,5,426,0,O-37-198-02-01-04
RUKUNGIRI,RUJUMBURA COUNTY,BUHUNGA,BWANDA,RUMBUGU C.O.U,516,2,0,1,107,276,386,5,391,0,O-37-198-02-02-01
RUKUNGIRI,RUJUMBURA COUNTY,BUHUNGA,BWANDA,KEIHUMURE PRI. SCHOOL,452,2,1,0,87,271,361,4,365,0,O-37-198-02-02-02
RUKUNGIRI,RUJUMBURA COUNTY,BUHUNGA,BWANDA,BWANDA C.O.U,486,0,1,1,131,255,388,10,398,0,O-37-198-02-02-03
RUKUNGIRI,RUJUMBURA COUNTY,BUHUNGA,KABINGO,KABINGO PARISH HQRS,745,0,0,5,199,359,563,19,582,0,O-37-198-02-03-01
RUKUNGIRI,RUJUMBURA COUNTY,BUHUNGA,KABINGO,IKUNIRO PRI. SCHOOL,616,1,0,3,122,358,484,13,497,0,O-37-198-02-03-02
RUKUNGIRI,RUJUMBURA COUNTY,BUHUNGA,KIBIRIZI,RUTOOMA P/S,680,4,0,1,151,358,514,11,525,0,O-37-198-02-04-01
RUKUNGIRI,RUJUMBURA COUNTY,BUHUNGA,KIBIRIZI,KAGOROGORO P/S,489,1,0,0,63,300,364,6,370,0,O-37-198-02-04-02
RUKUNGIRI,RUJUMBURA COUNTY,BUHUNGA,KIHANGA,KACENCE,515,2,0,1,123,248,374,16,390,0,O-37-198-02-05-01
RUKUNGIRI,RUJUMBURA COUNTY,BUHUNGA,KIHANGA,NYARUBARE FULL GOSPEL CHUR,513,2,0,1,119,277,399,0,399,0,O-37-198-02-05-02
RUKUNGIRI,RUJUMBURA COUNTY,BUHUNGA,KYARUYENJE,KYARUYENJE PARISH HQRS,797,2,0,3,213,416,634,8,642,0,O-37-198-02-06-01
RUKUNGIRI,RUJUMBURA COUNTY,BUHUNGA,KYARUYENJE,KAKAMBA P/S,639,1,0,0,170,359,530,10,540,0,O-37-198-02-06-02
RUKUNGIRI,RUJUMBURA COUNTY,BWAMBARA,BIKURUNGU,NYAMITOOMA C.O.U,500,2,1,1,137,213,354,33,387,0,O-37-198-03-01-01
RUKUNGIRI,RUJUMBURA COUNTY,BWAMBARA,BIKURUNGU,BIKURUNGU T/C,704,0,0,2,189,316,507,10,517,0,O-37-198-03-01-02
RUKUNGIRI,RUJUMBURA COUNTY,BWAMBARA,BIKURUNGU,OMUBURAMA PRI. SCHOOL,479,2,0,0,110,180,292,61,353,0,O-37-198-03-01-03
RUKUNGIRI,RUJUMBURA COUNTY,BWAMBARA,BWAMBARA,BWAMBARA S/CTY HQRS,720,1,1,2,154,332,490,18,508,0,O-37-198-03-02-01
RUKUNGIRI,RUJUMBURA COUNTY,BWAMBARA,BWAMBARA,BWAMBARA PRI. SCHOOL,567,2,1,2,161,244,410,5,415,0,O-37-198-03-02-02
RUKUNGIRI,RUJUMBURA COUNTY,BWAMBARA,BWAMBARA,BWAMBARA SEC. SCHOOL,587,1,0,0,141,231,373,88,461,0,O-37-198-03-02-03
RUKUNGIRI,RUJUMBURA COUNTY,BWAMBARA,BWAMBARA,KAYAGA T/C,455,4,0,1,146,205,356,21,377,0,O-37-198-03-02-04
RUKUNGIRI,RUJUMBURA COUNTY,BWAMBARA,BWAMBARA,BUFUNDA PRI. SCHOOL,488,3,0,2,131,248,384,7,391,0,O-37-198-03-02-05
RUKUNGIRI,RUJUMBURA COUNTY,BWAMBARA,KIKARARA,KIKARARA PRI. SCHOOL,599,5,2,7,117,306,437,12,449,0,O-37-198-03-03-01
RUKUNGIRI,RUJUMBURA COUNTY,BWAMBARA,KIKARARA,NYAKATEMBE C.O.U,948,2,2,6,125,437,572,37,609,0,O-37-198-03-03-02
RUKUNGIRI,RUJUMBURA COUNTY,BWAMBARA,KIKARARA,RWESIGIRO MARKET PLACE,742,5,0,3,121,331,460,6,466,0,O-37-198-03-03-03
RUKUNGIRI,RUJUMBURA COUNTY,BWAMBARA,KIKONGI,KIKONGI T/C,759,1,1,6,176,353,537,16,553,0,O-37-198-03-04-01
RUKUNGIRI,RUJUMBURA COUNTY,BWAMBARA,KIKONGI,IHIMBO PRI. SCHOOL,1086,9,2,2,236,491,740,10,750,0,O-37-198-03-04-02
RUKUNGIRI,RUJUMBURA COUNTY,BWAMBARA,KIKONGI,RUSHARAZI P/S,335,0,0,0,44,146,190,32,222,0,O-37-198-03-04-03
RUKUNGIRI,RUJUMBURA COUNTY,BWAMBARA,NYABUBARE,NYAMIHUKU P/S,467,3,0,0,116,202,321,8,329,0,O-37-198-03-05-01
RUKUNGIRI,RUJUMBURA COUNTY,BWAMBARA,NYABUBARE,NYABUBARE CHURCH SCHOOL,502,1,0,0,86,262,349,12,361,0,O-37-198-03-05-02
RUKUNGIRI,RUJUMBURA COUNTY,BWAMBARA,NYABUBARE,KAKONI P/S,637,1,0,1,124,361,487,2,489,0,O-37-198-03-05-03
RUKUNGIRI,RUJUMBURA COUNTY,BWAMBARA,NYABUBARE,NYABUBARE T/C,748,5,0,1,94,321,421,96,517,0,O-37-198-03-05-04
RUKUNGIRI,RUJUMBURA COUNTY,BWAMBARA,RWENSHAMA,RWENSHAMA,530,2,0,1,118,178,299,6,305,0,O-37-198-03-06-01
RUKUNGIRI,RUJUMBURA COUNTY,BWAMBARA,RWENSHAMA,RWEBINYONYI,526,5,0,1,159,155,320,9,329,0,O-37-198-03-06-02
RUKUNGIRI,RUJUMBURA COUNTY,BWAMBARA,RWENSHAMA,NCWERA,267,0,0,1,39,115,155,16,171,0,O-37-198-03-06-03
RUKUNGIRI,RUJUMBURA COUNTY,KAGUNGA,KANYINYA,KITAZIGURUKWA P/S,470,0,1,0,221,145,367,15,382,0,O-37-198-04-01-01
RUKUNGIRI,RUJUMBURA COUNTY,KAGUNGA,KANYINYA,MARUMBA,575,0,1,0,250,217,468,5,473,0,O-37-198-04-01-02
RUKUNGIRI,RUJUMBURA COUNTY,KAGUNGA,KARANGARO,RUKONDO PRI. SCHOOL,905,4,0,2,336,413,755,3,758,0,O-37-198-04-02-01
RUKUNGIRI,RUJUMBURA COUNTY,KAGUNGA,KARANGARO,KAHORORO P/S,708,2,1,5,177,393,578,14,592,0,O-37-198-04-02-02
RUKUNGIRI,RUJUMBURA COUNTY,KAGUNGA,KYATOKO,KYATOKO P/S,785,1,0,1,326,305,633,27,660,0,O-37-198-04-03-01
RUKUNGIRI,RUJUMBURA COUNTY,KAGUNGA,KYATOKO,NYAMIZI C.O.U,513,1,0,3,190,230,424,13,437,0,O-37-198-04-03-02
RUKUNGIRI,RUJUMBURA COUNTY,KAGUNGA,NDORERO,CHURCH OF GOD,370,1,0,0,123,159,283,20,303,0,O-37-198-04-04-01
RUKUNGIRI,RUJUMBURA COUNTY,KAGUNGA,NDORERO,NAMAYENJE MARKET,428,2,0,1,168,193,364,4,368,0,O-37-198-04-04-02
RUKUNGIRI,RUJUMBURA COUNTY,KAGUNGA,RWENTONDO,KATWEKAMWE P/S,645,1,1,0,194,334,530,5,535,0,O-37-198-04-05-01
RUKUNGIRI,RUJUMBURA COUNTY,KAGUNGA,RWENTONDO,RWENTONDO PARISH HQRS,548,1,1,2,140,303,447,12,459,0,O-37-198-04-05-02
RUKUNGIRI,RUJUMBURA COUNTY,KAGUNGA,RWENTONDO,KASHOZI P/S,522,1,0,1,106,260,368,45,413,0,O-37-198-04-05-03
RUKUNGIRI,RUJUMBURA COUNTY,NYAKAGYEME,KABWOMA,RUTEETE P/S,567,2,0,0,158,291,451,10,461,0,O-37-198-05-01-01
RUKUNGIRI,RUJUMBURA COUNTY,NYAKAGYEME,KABWOMA,NYAMIFURA P/S,800,6,1,1,239,386,633,15,648,0,O-37-198-05-01-02
RUKUNGIRI,RUJUMBURA COUNTY,NYAKAGYEME,KAHOKO,MITOOMA C.O.U,625,2,3,0,151,367,523,19,542,0,O-37-198-05-02-01
RUKUNGIRI,RUJUMBURA COUNTY,NYAKAGYEME,KAHOKO,KAHOKO P/S,545,1,0,0,155,309,465,6,471,0,O-37-198-05-02-02
RUKUNGIRI,RUJUMBURA COUNTY,NYAKAGYEME,KAHOKO,NYAKAGYEME C.O.U,617,4,0,1,251,250,506,8,514,0,O-37-198-05-02-03
RUKUNGIRI,RUJUMBURA COUNTY,NYAKAGYEME,KAHOKO,KINYAMAHWA T/C,472,0,0,0,136,246,382,16,398,0,O-37-198-05-02-04
RUKUNGIRI,RUJUMBURA COUNTY,NYAKAGYEME,KAHOKO,AKATERERO T/C,325,4,0,0,116,154,274,3,277,0,O-37-198-05-02-05
RUKUNGIRI,RUJUMBURA COUNTY,NYAKAGYEME,KIGAAGA,KYAMURARI P/S,662,2,0,1,202,323,528,7,535,0,O-37-198-05-03-01
RUKUNGIRI,RUJUMBURA COUNTY,NYAKAGYEME,KIGAAGA,BUCENCE P/S,429,1,0,1,155,193,350,1,351,0,O-37-198-05-03-02
RUKUNGIRI,RUJUMBURA COUNTY,NYAKAGYEME,KIGAAGA,KAKONKOMA P/S,472,5,0,3,193,192,393,2,395,0,O-37-198-05-03-03
RUKUNGIRI,RUJUMBURA COUNTY,NYAKAGYEME,KITIMBA,NYABURONDO C.O.U,925,2,2,0,303,398,705,17,722,0,O-37-198-05-04-01
RUKUNGIRI,RUJUMBURA COUNTY,NYAKAGYEME,KITIMBA,KITIMBA P/S,656,2,1,1,272,252,528,5,533,0,O-37-198-05-04-02
RUKUNGIRI,RUJUMBURA COUNTY,NYAKAGYEME,MASYA,BUSHORERO P CHURCH,452,1,1,0,169,187,358,17,375,0,O-37-198-05-05-01
RUKUNGIRI,RUJUMBURA COUNTY,NYAKAGYEME,MASYA,MASYA P/S,359,2,0,2,115,177,296,5,301,0,O-37-198-05-05-02
RUKUNGIRI,RUJUMBURA COUNTY,NYAKAGYEME,MASYA,MUNYEGANYEGYE PRI. SCHOOL,453,1,1,1,135,235,373,5,378,0,O-37-198-05-05-03
RUKUNGIRI,RUJUMBURA COUNTY,NYAKAGYEME,MASYA,KAGASHE T.C,318,2,0,0,78,167,247,4,251,0,O-37-198-05-05-04
RUKUNGIRI,RUJUMBURA COUNTY,NYAKAGYEME,NYAKINENGO,RUGANDO C.O.U,650,5,1,0,201,316,523,7,530,0,O-37-198-05-06-01
RUKUNGIRI,RUJUMBURA COUNTY,NYAKAGYEME,NYAKINENGO,KATOMA P/S,582,1,0,1,153,335,490,5,495,0,O-37-198-05-06-02
RUKUNGIRI,RUJUMBURA COUNTY,NYAKAGYEME,NYAKINENGO,NYAKINENGO P/S,514,2,0,1,149,253,405,2,407,0,O-37-198-05-06-03
RUKUNGIRI,RUJUMBURA COUNTY,NYAKAGYEME,RUSHASHA,MASHONGORA P/S,601,3,1,1,188,261,454,9,463,0,O-37-198-05-07-01
RUKUNGIRI,RUJUMBURA COUNTY,NYAKAGYEME,RUSHASHA,KABUGASHE P/S,600,3,0,1,199,248,451,7,458,0,O-37-198-05-07-02
RUKUNGIRI,RUJUMBURA COUNTY,NYAKAGYEME,RUSHASHA,RUSHASHA P/S,406,5,0,0,109,201,315,6,321,0,O-37-198-05-07-03
RUKUNGIRI,RUJUMBURA COUNTY,NYAKAGYEME,RWERERE,RWERERE MARKET,393,1,0,1,141,157,300,8,308,0,O-37-198-05-08-01
RUKUNGIRI,RUJUMBURA COUNTY,NYAKAGYEME,RWERERE,RWERERE P/S,709,2,0,1,191,393,587,9,596,0,O-37-198-05-08-02
RUKUNGIRI,RUJUMBURA COUNTY,NYAKAGYEME,RWERERE,BIGAAGA CATHOLIC CHURCH,378,0,0,1,89,231,321,2,323,0,O-37-198-05-08-03
RUKUNGIRI,RUJUMBURA COUNTY,RUHINDA,BUROMBE,RUHINDA S/CTY HQRS,602,3,0,0,146,273,422,12,434,0,O-37-198-06-01-01
RUKUNGIRI,RUJUMBURA COUNTY,RUHINDA,BUROMBE,KATOKYE C.O.U,466,1,1,2,118,222,344,11,355,0,O-37-198-06-01-02
RUKUNGIRI,RUJUMBURA COUNTY,RUHINDA,BUROMBE,BUROMBE P/S,638,3,2,8,140,293,446,10,456,0,O-37-198-06-01-03
RUKUNGIRI,RUJUMBURA COUNTY,RUHINDA,KICWAMBA,KAJWAMUSHANAP/S,662,1,0,3,138,362,504,5,509,0,O-37-198-06-02-01
RUKUNGIRI,RUJUMBURA COUNTY,RUHINDA,KICWAMBA,RWABUKOBA P/S,615,1,0,0,209,247,457,13,470,0,O-37-198-06-02-02
RUKUNGIRI,RUJUMBURA COUNTY,RUHINDA,KICWAMBA,KICWAMBA P/S,523,0,0,1,182,255,438,8,446,0,O-37-198-06-02-03
RUKUNGIRI,RUJUMBURA COUNTY,RUHINDA,NDERE,KABAGYERWA P/S,618,1,0,1,195,290,487,10,497,0,O-37-198-06-03-01
RUKUNGIRI,RUJUMBURA COUNTY,RUHINDA,NDERE,RWOYA  P/S,603,3,0,3,151,282,439,18,457,0,O-37-198-06-03-02
RUKUNGIRI,RUJUMBURA COUNTY,RUHINDA,NDERE,RWABUKOBA P/S,369,1,1,0,69,211,282,9,291,0,O-37-198-06-03-03
RUKUNGIRI,RUJUMBURA COUNTY,RUHINDA,NDERE,KAJUNJU P/S,318,1,0,3,59,186,249,4,253,0,O-37-198-06-03-04
RUKUNGIRI,RUJUMBURA COUNTY,RUHINDA,NYAKITABIRE,RUKAREKARE P/S,434,3,0,0,122,212,337,8,345,0,O-37-198-06-04-01
RUKUNGIRI,RUJUMBURA COUNTY,RUHINDA,NYAKITABIRE,KIGARIGARI P/S,539,2,1,3,105,301,412,13,425,0,O-37-198-06-04-02
RUKUNGIRI,RUJUMBURA COUNTY,RUHINDA,NYAKITABIRE,RWENSHAMA P/S,560,7,0,7,174,238,426,14,440,0,O-37-198-06-04-03
RUKUNGIRI,RUJUMBURA COUNTY,RUHINDA,NYARWIMUKA,IHINDIRO C.O.U,398,2,0,1,120,193,316,7,323,0,O-37-198-06-05-01
RUKUNGIRI,RUJUMBURA COUNTY,RUHINDA,NYARWIMUKA,RWERA P/S,689,6,3,9,145,383,546,27,573,0,O-37-198-06-05-02
RUKUNGIRI,RUJUMBURA COUNTY,RUHINDA,RWAMUGOMA,NYAKANYINYA P/S,805,1,0,2,164,442,609,20,629,0,O-37-198-06-06-01
RUKUNGIRI,RUJUMBURA COUNTY,RUHINDA,RWAMUGOMA,RWAMARENGYE C.O.U,530,1,1,0,153,270,425,15,440,0,O-37-198-06-06-02
RUKUNGIRI,RUJUMBURA COUNTY,RUKUNGIRI T.C.,EASTERN WARD,ST. GERALD S.S.S,335,0,0,0,117,105,222,2,224,0,O-37-198-07-01-01
RUKUNGIRI,RUJUMBURA COUNTY,RUKUNGIRI T.C.,EASTERN WARD,KAGASHE PLAYGROUND,467,0,0,0,179,181,360,0,360,0,O-37-198-07-01-02
RUKUNGIRI,RUJUMBURA COUNTY,RUKUNGIRI T.C.,NORTHERN WARD,RWAMAHWA H.C,513,0,0,0,209,115,324,5,329,0,O-37-198-07-02-01
RUKUNGIRI,RUJUMBURA COUNTY,RUKUNGIRI T.C.,NORTHERN WARD,KAGUNGA S/CTY HQRS,661,3,0,1,253,240,497,22,519,0,O-37-198-07-02-02
RUKUNGIRI,RUJUMBURA COUNTY,RUKUNGIRI T.C.,NORTHERN WARD,KIYAGA PRI. SCHOOL,698,2,0,1,290,218,511,11,522,0,O-37-198-07-02-03
RUKUNGIRI,RUJUMBURA COUNTY,RUKUNGIRI T.C.,SOUTHERN WARD,RUKUNGIRI STADIUM,918,0,0,2,461,143,606,4,610,0,O-37-198-07-03-01
RUKUNGIRI,RUJUMBURA COUNTY,RUKUNGIRI T.C.,SOUTHERN WARD,ST. PAUL COMMUNITY SCHOOL,792,4,0,0,431,105,540,9,549,0,O-37-198-07-03-02
RUKUNGIRI,RUJUMBURA COUNTY,RUKUNGIRI T.C.,WESTERN WARD,RUKUNGIRI BUS PARK,531,1,0,0,233,75,309,2,311,0,O-37-198-07-04-01
RUKUNGIRI,RUJUMBURA COUNTY,RUKUNGIRI T.C.,WESTERN WARD,KINDERGARTEN PRI. SCHOOL,1290,0,0,0,490,227,717,22,739,0,O-37-198-07-04-02
RUKUNGIRI,RUJUMBURA COUNTY,RUKUNGIRI T.C.,WESTERN WARD,CATHOLIC SOCIAL CENTRE,380,0,0,0,155,54,209,2,211,0,O-37-198-07-04-03
RUKUNGIRI,RUJUMBURA COUNTY,RUKUNGIRI T.C.,WESTERN WARD,RUKUNGIRI T.C PRI SCHOOL,406,0,0,0,119,78,197,6,203,0,O-37-198-07-04-04
RUKUNGIRI,RUJUMBURA COUNTY,RUKUNGIRI T.C.,WESTERN WARD,DISTRICT HQRS,462,1,0,0,198,91,290,7,297,0,O-37-198-07-04-05
KAMWENGE,KIBALE COUNTY,BWIZI,BIGULI,BIGULI (A-KW),948,6,0,5,52,446,509,8,517,0,O-46-53-01-01-01
KAMWENGE,KIBALE COUNTY,BWIZI,BIGULI,BITOJO,575,1,0,1,37,393,432,1,433,0,O-46-53-01-01-02
KAMWENGE,KIBALE COUNTY,BWIZI,BIGULI,BUSINGE T/C,323,1,0,2,36,151,190,8,198,0,O-46-53-01-01-03
KAMWENGE,KIBALE COUNTY,BWIZI,BIGULI,BIGULI (KY-Z),735,4,0,2,68,333,407,3,410,0,O-46-53-01-01-04
KAMWENGE,KIBALE COUNTY,BWIZI,BIGULI,KABUYE A,866,2,0,1,30,387,420,11,431,0,O-46-53-01-01-05
KAMWENGE,KIBALE COUNTY,BWIZI,BIGULI,KAMPALA,527,2,0,5,35,302,344,20,364,0,O-46-53-01-01-06
KAMWENGE,KIBALE COUNTY,BWIZI,BIGULI,KABUYE B,400,3,0,0,14,172,189,4,193,0,O-46-53-01-01-07
KAMWENGE,KIBALE COUNTY,BWIZI,BIGULI,MUKUKURU T/C,297,3,0,0,9,221,233,1,234,0,O-46-53-01-01-08
KAMWENGE,KIBALE COUNTY,BWIZI,BIGULI,KASESE T/C,457,0,0,1,17,139,157,3,160,0,O-46-53-01-01-09
KAMWENGE,KIBALE COUNTY,BWIZI,BWIZI,KAMUSENENE,848,5,0,6,77,494,582,12,594,0,O-46-53-01-02-01
KAMWENGE,KIBALE COUNTY,BWIZI,BWIZI,BWIZI,841,3,0,2,42,515,562,9,571,0,O-46-53-01-02-02
KAMWENGE,KIBALE COUNTY,BWIZI,BWIZI,KABARANGA,740,3,0,3,41,438,485,22,507,0,O-46-53-01-02-03
KAMWENGE,KIBALE COUNTY,BWIZI,BWIZI,KAMPALA,496,3,1,0,45,313,362,10,372,0,O-46-53-01-02-04
KAMWENGE,KIBALE COUNTY,BWIZI,BWIZI,NKONI P/S,507,2,0,1,37,284,324,10,334,0,O-46-53-01-02-05
KAMWENGE,KIBALE COUNTY,BWIZI,MARELE,MARELE P. SCHOOL A,531,2,0,1,45,289,337,9,346,0,O-46-53-01-03-01
KAMWENGE,KIBALE COUNTY,BWIZI,MARELE,MARELE P. SCHOOL B,687,1,0,1,63,396,461,5,466,0,O-46-53-01-03-02
KAMWENGE,KIBALE COUNTY,BWIZI,MARELE,BENGA T.C,1003,4,1,3,93,458,559,0,559,0,O-46-53-01-03-03
KAMWENGE,KIBALE COUNTY,BWIZI,NTONWA,NTONWA T. C.,827,2,0,6,31,493,532,11,543,0,O-46-53-01-04-01
KAMWENGE,KIBALE COUNTY,BWIZI,NTONWA,NYABUBALE 'A',559,1,0,2,40,346,389,12,401,0,O-46-53-01-04-02
KAMWENGE,KIBALE COUNTY,BWIZI,NTONWA,NYABUBALE 'B',949,1,0,0,40,508,549,12,561,0,O-46-53-01-04-03
KAMWENGE,KIBALE COUNTY,BWIZI,NTONWA,KIKIRI TC,257,0,0,0,12,165,177,4,181,0,O-46-53-01-04-04
KAMWENGE,KIBALE COUNTY,BWIZI,NTONWA,KASORORO C.O.U,243,0,0,2,1,208,211,5,216,0,O-46-53-01-04-05
KAMWENGE,KIBALE COUNTY,BWIZI,NTONWA,KYEHEMBA P/S,272,0,0,1,38,154,193,4,197,0,O-46-53-01-04-06
KAMWENGE,KIBALE COUNTY,KAHUNGE,BIGODI,BIGODI HEALTH CENTRE,665,0,1,1,49,420,471,18,489,0,O-46-53-02-01-01
KAMWENGE,KIBALE COUNTY,KAHUNGE,BIGODI,BUSIMBA,464,2,0,1,23,345,371,11,382,0,O-46-53-02-01-02
KAMWENGE,KIBALE COUNTY,KAHUNGE,BIGODI,BUJONGOBE,606,1,0,0,75,387,463,23,486,0,O-46-53-02-01-03
KAMWENGE,KIBALE COUNTY,KAHUNGE,BIGODI,MAHANGWE,370,3,0,1,34,271,309,5,314,0,O-46-53-02-01-04
KAMWENGE,KIBALE COUNTY,KAHUNGE,BIGODI,NKINGO,738,1,0,6,44,503,554,10,564,0,O-46-53-02-01-05
KAMWENGE,KIBALE COUNTY,KAHUNGE,BUSIRIBA,KIPUCU,633,1,0,4,39,435,479,13,492,0,O-46-53-02-02-01
KAMWENGE,KIBALE COUNTY,KAHUNGE,BUSIRIBA,BUSIRIBA,643,3,0,4,41,446,494,10,504,0,O-46-53-02-02-02
KAMWENGE,KIBALE COUNTY,KAHUNGE,BUSIRIBA,BUSABURA B,608,4,0,2,54,357,417,19,436,0,O-46-53-02-02-03
KAMWENGE,KIBALE COUNTY,KAHUNGE,BUSIRIBA,MURUGANDO,469,2,0,3,53,296,354,7,361,0,O-46-53-02-02-04
KAMWENGE,KIBALE COUNTY,KAHUNGE,BUSIRIBA,KIHOIMA,300,0,1,4,29,224,258,4,262,0,O-46-53-02-02-05
KAMWENGE,KIBALE COUNTY,KAHUNGE,KINONI,KANIMI PRIMARY SCHOOL,530,3,1,6,33,339,382,15,397,0,O-46-53-02-03-01
KAMWENGE,KIBALE COUNTY,KAHUNGE,KINONI,RWANJALE P. SCHOOL,560,2,0,1,9,364,376,9,385,0,O-46-53-02-03-02
KAMWENGE,KIBALE COUNTY,KAHUNGE,KINONI,BUNOGA P. SCHOOL,828,1,0,4,24,487,516,9,525,0,O-46-53-02-03-03
KAMWENGE,KIBALE COUNTY,KAHUNGE,KINONI,KANIMI,541,4,0,3,16,346,369,10,379,0,O-46-53-02-03-04
KAMWENGE,KIBALE COUNTY,KAHUNGE,KINONI,NYARWEYA P/S,299,1,0,1,18,211,231,3,234,0,O-46-53-02-03-05
KAMWENGE,KIBALE COUNTY,KAHUNGE,KIYAGAARA,KASOJO TRADING CENTRE,714,0,0,3,24,485,512,14,526,0,O-46-53-02-04-01
KAMWENGE,KIBALE COUNTY,KAHUNGE,KIYAGAARA,KAKINDO C. O. U.,418,3,0,0,10,278,291,11,302,0,O-46-53-02-04-02
KAMWENGE,KIBALE COUNTY,KAHUNGE,KIYAGAARA,KIYAGARA PARISH HQRS,539,1,1,0,35,316,353,4,357,0,O-46-53-02-04-03
KAMWENGE,KIBALE COUNTY,KAHUNGE,KIYAGAARA,RWEBIKWATO T.C,497,0,0,5,29,308,342,10,352,0,O-46-53-02-04-04
KAMWENGE,KIBALE COUNTY,KAHUNGE,KIYAGAARA,KICWAMPALI CHURCH,431,2,0,4,18,281,305,9,314,0,O-46-53-02-04-05
KAMWENGE,KIBALE COUNTY,KAHUNGE,KIYAGAARA,MIYORA CHURCH,366,1,0,0,24,248,273,7,280,0,O-46-53-02-04-06
KAMWENGE,KIBALE COUNTY,KAHUNGE,KYAKANYEMERA,RUKUNYU P. SCHOOL,593,2,0,2,46,362,412,12,424,0,O-46-53-02-05-01
KAMWENGE,KIBALE COUNTY,KAHUNGE,KYAKANYEMERA,KYAKANYEMERA,762,1,0,1,86,454,542,7,549,0,O-46-53-02-05-02
KAMWENGE,KIBALE COUNTY,KAHUNGE,KYAKANYEMERA,RWENGORO P/S. A,545,1,0,0,26,338,365,13,378,0,O-46-53-02-05-03
KAMWENGE,KIBALE COUNTY,KAHUNGE,KYAKANYEMERA,RWENGORO P/ S,574,2,1,1,38,354,396,6,402,0,O-46-53-02-05-04
KAMWENGE,KIBALE COUNTY,KAHUNGE,KYAKANYEMERA,KYERIMA,273,0,0,0,11,199,210,12,222,0,O-46-53-02-05-05
KAMWENGE,KIBALE COUNTY,KAHUNGE,KYAKANYEMERA,RWEMPIKYE I CHURCH OF GOD,282,0,0,0,13,197,210,4,214,0,O-46-53-02-05-06
KAMWENGE,KIBALE COUNTY,KAHUNGE,KYAKARAFA,BULEMBO P. SCHOOL,411,1,0,3,41,303,348,2,350,0,O-46-53-02-06-01
KAMWENGE,KIBALE COUNTY,KAHUNGE,KYAKARAFA,IRUBATA/ KYAKARAFA T. C.,640,4,1,2,52,337,396,20,416,0,O-46-53-02-06-02
KAMWENGE,KIBALE COUNTY,KAHUNGE,KYAKARAFA,KASOJO MARKET,470,0,0,0,10,297,307,0,307,0,O-46-53-02-06-03
KAMWENGE,KIBALE COUNTY,KAHUNGE,MPANGA,KAMWOKYA T. C. NYAKAHAMA,655,2,0,4,32,486,524,9,533,0,O-46-53-02-07-01
KAMWENGE,KIBALE COUNTY,KAHUNGE,MPANGA,KANYEGARAMIRE,635,0,1,5,64,394,464,4,468,0,O-46-53-02-07-02
KAMWENGE,KIBALE COUNTY,KAHUNGE,MPANGA,MPANGA TECHNICAL KINONI (A-M,586,0,0,5,23,386,414,20,434,0,O-46-53-02-07-03
KAMWENGE,KIBALE COUNTY,KAHUNGE,MPANGA,MPANGA TECHNICAL KINONI (N-Z),506,1,0,1,13,356,371,7,378,0,O-46-53-02-07-04
KAMWENGE,KIBALE COUNTY,KAHUNGE,MPANGA,KARAMBI P/S,246,1,0,4,9,189,203,4,207,0,O-46-53-02-07-05
KAMWENGE,KIBALE COUNTY,KAHUNGE,MPANGA,MPANGA SOCIAL HALL,459,0,0,1,40,339,380,3,383,0,O-46-53-02-07-06
KAMWENGE,KIBALE COUNTY,KAHUNGE,RWENKUBA,KAHUNGE S/C HQRS,618,2,0,4,55,357,418,9,427,0,O-46-53-02-08-01
KAMWENGE,KIBALE COUNTY,KAHUNGE,RWENKUBA,RUBABA C.O.U,635,4,0,5,62,339,410,0,410,0,O-46-53-02-08-02
KAMWENGE,KIBALE COUNTY,KAHUNGE,RWENKUBA,KYABENDA S.S.S,660,1,0,2,28,412,443,15,458,0,O-46-53-02-08-03
KAMWENGE,KIBALE COUNTY,KAHUNGE,RWENKUBA,NKARARA P. S.,494,0,0,1,37,346,384,3,387,0,O-46-53-02-08-04
KAMWENGE,KIBALE COUNTY,KAHUNGE,RWENKUBA,RUGONJO REST HOUSE A,541,2,0,6,72,288,368,6,374,0,O-46-53-02-08-05
KAMWENGE,KIBALE COUNTY,KAHUNGE,RWENKUBA,RUGONJO P/S,583,1,0,4,61,357,423,1,424,0,O-46-53-02-08-06
KAMWENGE,KIBALE COUNTY,KAHUNGE,RWENKUBA,KAHUNGE P/S,274,0,1,0,26,166,193,1,194,0,O-46-53-02-08-07
KAMWENGE,KIBALE COUNTY,KAMWENGE,BUSINGE,BUSINGE TRADING CENTRE,811,1,0,6,60,595,662,15,677,0,O-46-53-03-01-01
KAMWENGE,KIBALE COUNTY,KAMWENGE,BUSINGE,NYABITUSI T. C.,874,4,0,5,43,629,681,16,697,0,O-46-53-03-01-02
KAMWENGE,KIBALE COUNTY,KAMWENGE,GANYENDA,GAYENDA T. CENTRE,674,1,1,5,25,461,493,10,503,0,O-46-53-03-02-01
KAMWENGE,KIBALE COUNTY,KAMWENGE,GANYENDA,MACHIRO C. O. U.,675,4,0,2,50,490,546,10,556,0,O-46-53-03-02-02
KAMWENGE,KIBALE COUNTY,KAMWENGE,KABAMBIRO,BWERANNYANGI P. S.,405,0,0,2,11,313,326,8,334,0,O-46-53-03-03-01
KAMWENGE,KIBALE COUNTY,KAMWENGE,KABAMBIRO,KABAMBIRO TRADING CENTRE,457,0,0,3,7,375,385,7,392,0,O-46-53-03-03-02
KAMWENGE,KIBALE COUNTY,KAMWENGE,KABAMBIRO,BUBANDIZO CATHOLIC CHURCH A,486,3,0,7,39,250,299,7,306,0,O-46-53-03-03-03
KAMWENGE,KIBALE COUNTY,KAMWENGE,KABAMBIRO,KABAMBIRO CHURCH SCHOOL,489,0,0,1,16,370,387,17,404,0,O-46-53-03-03-04
KAMWENGE,KIBALE COUNTY,KAMWENGE,KABAMBIRO,BUBANDIZO CATHOLIC CHURCH B,612,8,1,4,46,403,462,4,466,0,O-46-53-03-03-05
KAMWENGE,KIBALE COUNTY,KAMWENGE,KABAMBIRO,RUSHANGO CATHOLIC CHURCH,336,1,0,2,8,323,334,2,336,0,O-46-53-03-03-06
KAMWENGE,KIBALE COUNTY,KAMWENGE,KABAMBIRO,DAMASIKO C.O.U,546,0,1,3,21,382,407,1,408,0,O-46-53-03-03-07
KAMWENGE,KIBALE COUNTY,KAMWENGE,KAKINGA,KABUGA (A-KA),464,1,0,1,40,382,424,9,433,0,O-46-53-03-04-01
KAMWENGE,KIBALE COUNTY,KAMWENGE,KAKINGA,KABUGA (KE-NS),734,2,2,7,58,626,695,14,709,0,O-46-53-03-04-02
KAMWENGE,KIBALE COUNTY,KAMWENGE,KAKINGA,KABUGA (NT-Z),520,1,0,4,26,236,267,9,276,0,O-46-53-03-04-03
KAMWENGE,KIBALE COUNTY,KAMWENGE,KAKINGA,NYAKAHAMA T.C,292,0,0,2,17,218,237,4,241,0,O-46-53-03-04-04
KAMWENGE,KIBALE COUNTY,KAMWENGE,KAKINGA,NYAKISHENYI CHURCH SCHOOL,906,3,0,5,78,537,623,19,642,0,O-46-53-03-04-05
KAMWENGE,KIBALE COUNTY,KAMWENGE,KIZIBA,BUTEMBA CATHOLIC CHURCH,552,1,1,5,13,418,438,10,448,0,O-46-53-03-05-01
KAMWENGE,KIBALE COUNTY,KAMWENGE,KIZIBA,BUTEMBA P. SCHOOL,439,2,0,2,49,305,358,5,363,0,O-46-53-03-05-02
KAMWENGE,KIBALE COUNTY,KAMWENGE,KIZIBA,KENTOMI,495,0,0,1,21,388,410,9,419,0,O-46-53-03-05-03
KAMWENGE,KIBALE COUNTY,KAMWENGE,KYABANDARA,KYABANDARA I,390,1,0,2,34,322,359,3,362,0,O-46-53-03-06-01
KAMWENGE,KIBALE COUNTY,KAMWENGE,KYABANDARA,KYABANDARA II A,505,0,0,0,23,393,416,4,420,0,O-46-53-03-06-02
KAMWENGE,KIBALE COUNTY,KAMWENGE,KYABANDARA,KYABANDARA II B,520,0,1,3,29,335,368,5,373,0,O-46-53-03-06-03
KAMWENGE,KIBALE COUNTY,KAMWENGE,KYABANDARA,RUBONA C. O. U,212,1,0,0,20,148,169,4,173,0,O-46-53-03-06-04
KAMWENGE,KIBALE COUNTY,KAMWENGE,NKONGORO,MBONGERA,523,1,1,2,37,311,352,10,362,0,O-46-53-03-07-01
KAMWENGE,KIBALE COUNTY,KAMWENGE,NKONGORO,NKONGORO PRIMARY SCHOOL,394,0,0,2,24,251,277,6,283,0,O-46-53-03-07-02
KAMWENGE,KIBALE COUNTY,KAMWENGE,NKONGORO,KASOGA CHURCH SCHOOL,308,0,1,1,13,133,148,5,153,0,O-46-53-03-07-03
KAMWENGE,KIBALE COUNTY,KAMWENGE,NKONGORO,NYAKASHARARA CATHOLIC SCHO,500,3,0,1,38,288,330,10,340,0,O-46-53-03-07-04
KAMWENGE,KIBALE COUNTY,KAMWENGE,NYAMASHEGWE,MIRAMBI TRADING CENTRE,691,0,0,2,34,448,484,19,503,0,O-46-53-03-08-01
KAMWENGE,KIBALE COUNTY,KAMWENGE,NYAMASHEGWE,NYAMASHEGWA II TRADING CENT,554,0,0,3,43,387,433,10,443,0,O-46-53-03-08-02
KAMWENGE,KIBALE COUNTY,KAMWENGE,NYAMASHEGWE,NYAMASHEGWA I TRADING CENT,594,0,0,1,16,548,565,7,572,0,O-46-53-03-08-03
KAMWENGE,KIBALE COUNTY,KAMWENGE,NYAMASHEGWE,KANARA (A-M),687,2,1,0,41,605,649,8,657,0,O-46-53-03-08-04
KAMWENGE,KIBALE COUNTY,KAMWENGE,NYAMASHEGWE,KENGOMA I T.C,423,1,1,1,15,394,412,7,419,0,O-46-53-03-08-05
KAMWENGE,KIBALE COUNTY,KAMWENGE,NYAMASHEGWE,KANARA (L-Z),402,0,1,0,19,356,376,7,383,0,O-46-53-03-08-06
KAMWENGE,KIBALE COUNTY,KAMWENGE T. C.,KABURIKOSE WARD,MIRAMBI (A-L),601,1,1,1,61,287,351,6,357,0,O-46-53-04-01-01
KAMWENGE,KIBALE COUNTY,KAMWENGE T. C.,KABURIKOSE WARD,KANYAGARAMIRE,592,2,0,5,80,355,442,8,450,0,O-46-53-04-01-02
KAMWENGE,KIBALE COUNTY,KAMWENGE T. C.,KABURIKOSE WARD,KITIBANI T. C.,499,0,0,5,37,307,349,16,365,0,O-46-53-04-01-03
KAMWENGE,KIBALE COUNTY,KAMWENGE T. C.,KABURIKOSE WARD,KIMULI-KIDONGO P.7 SCH,588,3,1,7,45,409,465,7,472,0,O-46-53-04-01-04
KAMWENGE,KIBALE COUNTY,KAMWENGE T. C.,KABURIKOSE WARD,MIRAMBI (M-Z),408,2,2,1,36,232,273,10,283,0,O-46-53-04-01-05
KAMWENGE,KIBALE COUNTY,KAMWENGE T. C.,KAMWENGE WARD,SAZA HQRS,471,3,0,0,23,303,329,9,338,0,O-46-53-04-02-01
KAMWENGE,KIBALE COUNTY,KAMWENGE T. C.,KAMWENGE WARD,KAMWENGE CATHOLIC CHURCH (,598,0,2,1,82,265,350,1,351,0,O-46-53-04-02-02
KAMWENGE,KIBALE COUNTY,KAMWENGE T. C.,KAMWENGE WARD,KABINGO,600,1,0,2,55,369,427,12,439,0,O-46-53-04-02-03
KAMWENGE,KIBALE COUNTY,KAMWENGE T. C.,KAMWENGE WARD,KAMWENGE RAILWAYS,778,2,1,3,73,531,610,16,626,0,O-46-53-04-02-04
KAMWENGE,KIBALE COUNTY,KAMWENGE T. C.,KAMWENGE WARD,KARAMBI C. O. U.,263,0,0,2,12,178,192,8,200,0,O-46-53-04-02-05
KAMWENGE,KIBALE COUNTY,KAMWENGE T. C.,KAMWENGE WARD,KAMWENGE PRIMARY SCHOOL B,539,0,0,0,81,206,287,0,287,0,O-46-53-04-02-06
KAMWENGE,KIBALE COUNTY,KAMWENGE T. C.,KAMWENGE WARD,KAMWENGE CATHOLIC CHURCH (,409,0,0,0,49,194,243,5,248,0,O-46-53-04-02-07
KAMWENGE,KIBALE COUNTY,KAMWENGE T. C.,KITONZI WARD,KITONZI,311,0,0,4,9,206,219,7,226,0,O-46-53-04-03-01
KAMWENGE,KIBALE COUNTY,KAMWENGE T. C.,KITONZI WARD,BUSINGE CATHOLIC CHURCH,207,0,0,3,7,133,143,5,148,0,O-46-53-04-03-02
KAMWENGE,KIBALE COUNTY,KAMWENGE T. C.,KITONZI WARD,KYABYOOMA TRADING CENTRE,542,0,2,2,40,372,416,5,421,0,O-46-53-04-03-03
KAMWENGE,KIBALE COUNTY,NKOMA,BIHANGA,KANARA,385,1,0,0,21,352,374,0,374,0,O-46-53-05-01-01
KAMWENGE,KIBALE COUNTY,NKOMA,BIHANGA,BIHANGA,879,2,0,6,62,476,546,15,561,0,O-46-53-05-01-02
KAMWENGE,KIBALE COUNTY,NKOMA,BIHANGA,LYAKAHUNGA A,763,3,0,2,66,390,461,8,469,0,O-46-53-05-01-03
KAMWENGE,KIBALE COUNTY,NKOMA,BIHANGA,BIHANGA P/S,667,3,0,3,136,372,514,10,524,0,O-46-53-05-01-04
KAMWENGE,KIBALE COUNTY,NKOMA,BISOZI,BISOZI P. S. (A-L),426,0,0,1,27,331,359,3,362,0,O-46-53-05-02-01
KAMWENGE,KIBALE COUNTY,NKOMA,BISOZI,BWITANKANJA,767,1,0,6,34,438,479,14,493,0,O-46-53-05-02-02
KAMWENGE,KIBALE COUNTY,NKOMA,BISOZI,KABEREBERE T/C,690,2,0,6,71,431,510,7,517,0,O-46-53-05-02-03
KAMWENGE,KIBALE COUNTY,NKOMA,BISOZI,KANTEMBWE PENTECOSTAL CHU,363,0,1,1,27,161,190,5,195,0,O-46-53-05-02-04
KAMWENGE,KIBALE COUNTY,NKOMA,BISOZI,BISOZI P. S. (M-Z),410,1,0,1,17,252,271,6,277,0,O-46-53-05-02-05
KAMWENGE,KIBALE COUNTY,NKOMA,BISOZI,MUKOLE C.O.U,359,0,0,1,29,269,299,1,300,0,O-46-53-05-02-06
KAMWENGE,KIBALE COUNTY,NKOMA,BISOZI,BIGORO C.O.U,382,3,0,1,18,238,260,4,264,0,O-46-53-05-02-07
KAMWENGE,KIBALE COUNTY,NKOMA,KABINGO,RWENSIKIZA,547,1,0,3,39,401,444,16,460,0,O-46-53-05-03-01
KAMWENGE,KIBALE COUNTY,NKOMA,KABINGO,KATEBE (A-M),498,1,0,3,22,364,390,17,407,0,O-46-53-05-03-02
KAMWENGE,KIBALE COUNTY,NKOMA,KABINGO,KABINGO,811,2,0,6,42,494,544,12,556,0,O-46-53-05-03-03
KAMWENGE,KIBALE COUNTY,NKOMA,KABINGO,BWIRUKIRO CHURCH,218,0,0,0,9,186,195,1,196,0,O-46-53-05-03-04
KAMWENGE,KIBALE COUNTY,NKOMA,KABINGO,KATEBE(N-Z),467,0,0,2,12,369,383,12,395,0,O-46-53-05-03-05
KAMWENGE,KIBALE COUNTY,NKOMA,KABINGO,KITASHENYA FULL GOSPEL CHUR,317,0,0,0,22,247,269,6,275,0,O-46-53-05-03-06
KAMWENGE,KIBALE COUNTY,NKOMA,MABALE,MABALE P. SCHOOL,598,1,0,3,55,383,442,8,450,0,O-46-53-05-04-01
KAMWENGE,KIBALE COUNTY,NKOMA,MABALE,MPANGA C. O. U.,711,3,0,4,44,498,549,7,556,0,O-46-53-05-04-02
KAMWENGE,KIBALE COUNTY,NKOMA,MABALE,MIKAMBA R. C. CHURCH,701,2,0,6,15,534,557,5,562,0,O-46-53-05-04-03
KAMWENGE,KIBALE COUNTY,NKOMA,MABALE,KANANI P. SCHOOL,601,6,0,6,35,390,437,15,452,0,O-46-53-05-04-04
KAMWENGE,KIBALE COUNTY,NKOMA,MABALE,RWENGORO ROMAN CATHOLIC C,318,0,0,2,29,166,197,7,204,0,O-46-53-05-04-05
KAMWENGE,KIBALE COUNTY,NKOMA,MABALE,KAHARA ROOMA CATHOLIC CHUR,276,1,0,3,28,173,205,8,213,0,O-46-53-05-04-06
KAMWENGE,KIBALE COUNTY,NKOMA,MABALE,ISONOSYA MUSAVE,349,1,0,1,17,262,281,5,286,0,O-46-53-05-04-07
KAMWENGE,KIBALE COUNTY,NKOMA,NKOMA,NKOMA PARISH HQRS,539,2,0,1,40,258,301,9,310,0,O-46-53-05-05-01
KAMWENGE,KIBALE COUNTY,NKOMA,NKOMA,KINYONZA T. C.,741,0,1,2,97,416,516,4,520,0,O-46-53-05-05-02
KAMWENGE,KIBALE COUNTY,NKOMA,NKOMA,MAHANI T. C.,350,0,0,3,21,231,255,6,261,0,O-46-53-05-05-03
KAMWENGE,KIBALE COUNTY,NKOMA,NKOMA,BULEGEYA,340,0,0,2,36,185,223,5,228,0,O-46-53-05-05-04
KAMWENGE,KIBALE COUNTY,NKOMA,NKOMA,ST MICHEAL P/S,506,2,0,1,9,298,310,6,316,0,O-46-53-05-05-05
KAMWENGE,KIBALE COUNTY,NKOMA,NKOMA,RWENCWERA C.O.U,234,0,0,1,22,120,143,5,148,0,O-46-53-05-05-06
KYENJOJO,MWENGE COUNTY NORTH,BUFUNJO,BIGANDO,BIGANDO P/S,456,2,0,2,16,312,332,20,352,0,O-48-56-01-01-01
KYENJOJO,MWENGE COUNTY NORTH,BUFUNJO,BIGANDO,BATARIKA,408,2,0,5,50,265,322,10,332,0,O-48-56-01-01-02
KYENJOJO,MWENGE COUNTY NORTH,BUFUNJO,BIGANDO,KATARAZA,394,5,2,0,18,293,318,7,325,0,O-48-56-01-01-03
KYENJOJO,MWENGE COUNTY NORTH,BUFUNJO,BIGANDO,BIGANDO C.O.U,377,0,0,1,26,284,311,6,317,0,O-48-56-01-01-04
KYENJOJO,MWENGE COUNTY NORTH,BUFUNJO,KISANGI,NYANTOZI PARISH HQRS,685,4,2,9,21,392,428,1,429,0,O-48-56-01-02-01
KYENJOJO,MWENGE COUNTY NORTH,BUFUNJO,KISANGI,KYENTAMA P/S,357,4,1,3,19,232,259,8,267,0,O-48-56-01-02-02
KYENJOJO,MWENGE COUNTY NORTH,BUFUNJO,KITEGA,KITEGA,645,2,0,3,12,451,468,9,477,0,O-48-56-01-03-01
KYENJOJO,MWENGE COUNTY NORTH,BUFUNJO,KITEGA,NYAMICU,510,1,5,6,40,325,377,15,392,0,O-48-56-01-03-02
KYENJOJO,MWENGE COUNTY NORTH,BUFUNJO,KITEGA,KYAKAHIGWA,701,2,1,7,44,498,552,3,555,0,O-48-56-01-03-03
KYENJOJO,MWENGE COUNTY NORTH,BUFUNJO,MBALE,KITABONA/MBALE A,562,4,1,6,24,387,422,22,444,0,O-48-56-01-04-01
KYENJOJO,MWENGE COUNTY NORTH,BUFUNJO,MBALE,RWENJAZA P/S,527,6,4,5,35,341,391,15,406,0,O-48-56-01-04-02
KYENJOJO,MWENGE COUNTY NORTH,BUFUNJO,MBALE,KITABONA/MBALE B,749,5,5,8,19,532,569,5,574,0,O-48-56-01-04-03
KYENJOJO,MWENGE COUNTY NORTH,BUFUNJO,MBALE,KATEGERE,292,4,0,5,14,197,220,10,230,0,O-48-56-01-04-04
KYENJOJO,MWENGE COUNTY NORTH,BUFUNJO,NYABIRONGO,NYABIRONGO PRIMARY SCHOOL,783,4,3,5,25,538,575,25,600,0,O-48-56-01-05-01
KYENJOJO,MWENGE COUNTY NORTH,BUFUNJO,NYABIRONGO,NSANJA TRADING CENTRE,451,3,0,3,30,301,337,6,343,0,O-48-56-01-05-02
KYENJOJO,MWENGE COUNTY NORTH,BUFUNJO,NYAMANGA,KAGOMA P/SCHOOL NYAMANGA,601,0,0,5,15,437,457,5,462,0,O-48-56-01-06-01
KYENJOJO,MWENGE COUNTY NORTH,BUFUNJO,NYAMANGA,BUFUNJO S.S.S,617,8,2,12,31,307,360,13,373,0,O-48-56-01-06-02
KYENJOJO,MWENGE COUNTY NORTH,BUFUNJO,NYAMANGA,BUKONGWA P/S,282,3,0,2,14,179,198,0,198,0,O-48-56-01-06-03
KYENJOJO,MWENGE COUNTY NORTH,BUGAAKI,HIIMA,RWAKAZOOBA C.O.U,725,0,0,5,62,322,389,4,393,0,O-48-56-02-01-01
KYENJOJO,MWENGE COUNTY NORTH,BUGAAKI,HIIMA,KASOZI C.O.U,945,2,0,6,46,430,484,36,520,0,O-48-56-02-01-02
KYENJOJO,MWENGE COUNTY NORTH,BUGAAKI,HIIMA,KAGOROGORO,483,2,2,2,23,340,369,6,375,0,O-48-56-02-01-03
KYENJOJO,MWENGE COUNTY NORTH,BUGAAKI,HIIMA,KYAKATARA,331,0,3,2,28,127,160,2,162,0,O-48-56-02-01-04
KYENJOJO,MWENGE COUNTY NORTH,BUGAAKI,KASENYI,KASENYI P. SCHOOL,406,3,0,2,18,261,284,8,292,0,O-48-56-02-02-01
KYENJOJO,MWENGE COUNTY NORTH,BUGAAKI,KASENYI,MABALE,169,1,0,1,3,129,134,6,140,0,O-48-56-02-02-02
KYENJOJO,MWENGE COUNTY NORTH,BUGAAKI,KASENYI,TIWEMARRA,422,2,1,7,20,285,315,2,317,0,O-48-56-02-02-03
KYENJOJO,MWENGE COUNTY NORTH,BUGAAKI,KYABARANGA,KYABARANGA P/S,646,4,1,2,60,335,402,17,419,0,O-48-56-02-03-01
KYENJOJO,MWENGE COUNTY NORTH,BUGAAKI,KYABARANGA,MABALE,315,0,1,0,27,197,225,4,229,0,O-48-56-02-03-02
KYENJOJO,MWENGE COUNTY NORTH,BUGAAKI,KYABARANGA,BUSASA T. C.,329,4,1,6,23,215,249,11,260,0,O-48-56-02-03-03
KYENJOJO,MWENGE COUNTY NORTH,BUGAAKI,KYABARANGA,KATIBA CATHOLIC CHURCH,565,2,2,4,45,370,423,9,432,0,O-48-56-02-03-04
KYENJOJO,MWENGE COUNTY NORTH,BUGAAKI,MITOMA,KASAMBA,541,0,4,2,17,376,399,0,399,0,O-48-56-02-04-01
KYENJOJO,MWENGE COUNTY NORTH,BUGAAKI,MITOMA,MIHONDO,538,1,1,5,21,389,417,8,425,0,O-48-56-02-04-02
KYENJOJO,MWENGE COUNTY NORTH,BUGAAKI,MITOMA,NYANJETAGERA,650,1,1,4,32,428,466,11,477,0,O-48-56-02-04-03
KYENJOJO,MWENGE COUNTY NORTH,BUGAAKI,MITOMA,MITOMA,580,3,0,5,10,420,438,6,444,0,O-48-56-02-04-04
KYENJOJO,MWENGE COUNTY NORTH,BUGAAKI,NYAMABUGA,RUGOMBE TRADING CENTRE,710,1,1,1,44,483,530,14,544,0,O-48-56-02-05-01
KYENJOJO,MWENGE COUNTY NORTH,BUGAAKI,NYAMABUGA,BUTARA CHURCH,625,1,2,3,24,425,455,8,463,0,O-48-56-02-05-02
KYENJOJO,MWENGE COUNTY NORTH,BUGAAKI,NYAMABUGA,NYAMABUGA PARISH HQRS,638,3,1,6,31,465,506,5,511,0,O-48-56-02-05-03
KYENJOJO,MWENGE COUNTY NORTH,BUGAAKI,NYAMABUGA,KISANGI P/S,586,0,1,3,33,388,425,18,443,0,O-48-56-02-05-04
KYENJOJO,MWENGE COUNTY NORTH,BUGAAKI,NYAMABUGA,ISUNGA NURSERY SCHOOL,317,0,0,4,15,235,254,8,262,0,O-48-56-02-05-05
KYENJOJO,MWENGE COUNTY NORTH,KATOOKE,KINOGERO,IRAARA,698,0,3,4,52,437,496,3,499,0,O-48-56-03-01-01
KYENJOJO,MWENGE COUNTY NORTH,KATOOKE,KINOGERO,RUKIIZI,492,3,4,11,4,327,349,16,365,0,O-48-56-03-01-02
KYENJOJO,MWENGE COUNTY NORTH,KATOOKE,KINOGERO,MAGUNDA,402,1,1,2,6,305,315,5,320,0,O-48-56-03-01-03
KYENJOJO,MWENGE COUNTY NORTH,KATOOKE,MWAARO,KATARA T. C.,647,2,0,2,26,465,495,8,503,0,O-48-56-03-02-01
KYENJOJO,MWENGE COUNTY NORTH,KATOOKE,MWAARO,KYANGABUKAMA MUKOLE,461,1,0,3,28,294,326,14,340,0,O-48-56-03-02-02
KYENJOJO,MWENGE COUNTY NORTH,KATOOKE,MWAARO,KATOOKE HEALTH CENTRE,985,4,4,2,112,459,581,17,598,0,O-48-56-03-02-03
KYENJOJO,MWENGE COUNTY NORTH,KATOOKE,MWAARO,NYABUHOMA GROUND,441,0,0,0,33,334,367,17,384,0,O-48-56-03-02-04
KYENJOJO,MWENGE COUNTY NORTH,KATOOKE,MWAARO,KAHANDA MARKET,622,4,2,4,30,377,417,30,447,0,O-48-56-03-02-05
KYENJOJO,MWENGE COUNTY NORTH,KATOOKE,MWAARO,KITEMBE P/S,427,1,2,5,25,294,327,17,344,0,O-48-56-03-02-06
KYENJOJO,MWENGE COUNTY NORTH,KATOOKE,MWAARO,MUKOLE P/S,391,2,2,1,38,291,334,7,341,0,O-48-56-03-02-07
KYENJOJO,MWENGE COUNTY NORTH,KATOOKE,MYERI,KIJWIGA T. C.,565,4,1,4,24,424,457,10,467,0,O-48-56-03-03-01
KYENJOJO,MWENGE COUNTY NORTH,KATOOKE,MYERI,MYERI MURUUKA HQRS,714,4,3,12,8,496,523,21,544,0,O-48-56-03-03-02
KYENJOJO,MWENGE COUNTY NORTH,KATOOKE,MYERI,MIRANGA CHURCH,693,1,1,10,12,494,518,9,527,0,O-48-56-03-03-03
KYENJOJO,MWENGE COUNTY NORTH,KATOOKE,NYAKISI,NYAKISI P. S.,646,3,2,1,55,429,490,18,508,0,O-48-56-03-04-01
KYENJOJO,MWENGE COUNTY NORTH,KATOOKE,NYAKISI,BUHURA P. S.,652,5,2,3,45,437,492,10,502,0,O-48-56-03-04-02
KYENJOJO,MWENGE COUNTY NORTH,KATOOKE,NYAKISI,KISOJO T. C.,714,7,2,16,25,507,557,20,577,0,O-48-56-03-04-03
KYENJOJO,MWENGE COUNTY NORTH,KATOOKE,RUBANGO,RUBANGO T. C.,770,6,2,12,28,500,548,27,575,0,O-48-56-03-05-01
KYENJOJO,MWENGE COUNTY NORTH,KATOOKE,RUBANGO,KAKONI C. O. U.,602,9,0,3,41,406,459,5,464,0,O-48-56-03-05-02
KYENJOJO,MWENGE COUNTY NORTH,KATOOKE,RUBANGO,KAGORRA ITAMBIRO,387,0,1,4,18,266,289,6,295,0,O-48-56-03-05-03
KYENJOJO,MWENGE COUNTY NORTH,KATOOKE,RWAMUKORA,RWAMUKOORA P/S,669,3,1,0,59,438,501,4,505,0,O-48-56-03-06-01
KYENJOJO,MWENGE COUNTY NORTH,KATOOKE,RWAMUKORA,TIMBICUMBE MARKET,507,4,4,5,26,372,411,5,416,0,O-48-56-03-06-02
KYENJOJO,MWENGE COUNTY NORTH,KATOOKE,RWAMUKORA,BWAHURO P.S.,852,0,0,5,51,547,603,11,614,0,O-48-56-03-06-03
KYENJOJO,MWENGE COUNTY NORTH,KATOOKE,RWAMUKORA,ENJERU,559,3,0,2,28,393,426,8,434,0,O-48-56-03-06-04
KYENJOJO,MWENGE COUNTY NORTH,KATOOKE,RWAMUKORA,NYAMWANDARA ITAMBIRO,178,0,0,0,10,125,135,3,138,0,O-48-56-03-06-05
KYENJOJO,MWENGE COUNTY NORTH,KATOOKE,RWAMUKORA,NTUUNTU C.O.U,155,1,0,0,5,120,126,3,129,0,O-48-56-03-06-06
KYENJOJO,MWENGE COUNTY NORTH,KYARUSOZI,BARAHIIJA,BARAHIJA P. S.,433,2,0,0,26,296,324,6,330,0,O-48-56-04-01-01
KYENJOJO,MWENGE COUNTY NORTH,KYARUSOZI,BARAHIIJA,KYANYINAIBALE T. C.,562,1,1,2,31,409,444,0,444,0,O-48-56-04-01-02
KYENJOJO,MWENGE COUNTY NORTH,KYARUSOZI,BARAHIIJA,KIKUMIRO ITAMBIRO,377,0,0,0,9,321,330,3,333,0,O-48-56-04-01-03
KYENJOJO,MWENGE COUNTY NORTH,KYARUSOZI,BINUNDA,NSINDE P. S.,672,3,1,4,32,447,487,9,496,0,O-48-56-04-02-01
KYENJOJO,MWENGE COUNTY NORTH,KYARUSOZI,BINUNDA,KYARUSOZI S.S.S,659,1,0,3,71,315,390,13,403,0,O-48-56-04-02-02
KYENJOJO,MWENGE COUNTY NORTH,KYARUSOZI,BINUNDA,KYARUSOZI P. S.,414,1,1,4,40,246,292,3,295,0,O-48-56-04-02-03
KYENJOJO,MWENGE COUNTY NORTH,KYARUSOZI,BINUNDA,KYARUSOZI SUBCOUNTY HQRS,407,1,1,0,35,234,271,0,271,0,O-48-56-04-02-04
KYENJOJO,MWENGE COUNTY NORTH,KYARUSOZI,BINUNDA,HAMUKUKU C.O.U,388,1,1,2,41,150,195,2,197,0,O-48-56-04-02-05
KYENJOJO,MWENGE COUNTY NORTH,KYARUSOZI,KASABA,KASABA C. O. U.,575,3,3,4,30,421,461,19,480,0,O-48-56-04-03-01
KYENJOJO,MWENGE COUNTY NORTH,KYARUSOZI,KASABA,MPARO P. S.,752,2,1,11,13,571,598,27,625,0,O-48-56-04-03-02
KYENJOJO,MWENGE COUNTY NORTH,KYARUSOZI,KASABA,NYARUZIGATI,348,3,2,3,20,252,280,20,300,0,O-48-56-04-03-03
KYENJOJO,MWENGE COUNTY NORTH,KYARUSOZI,KASABA,KASABA 'A',810,9,2,11,46,553,621,26,647,0,O-48-56-04-03-04
KYENJOJO,MWENGE COUNTY NORTH,KYARUSOZI,KATAMBALE,KATAMBALE PARISH HQRS,722,2,0,2,34,493,531,19,550,0,O-48-56-04-04-01
KYENJOJO,MWENGE COUNTY NORTH,KYARUSOZI,KATAMBALE,KIBALE T. C.,503,4,1,6,26,304,341,9,350,0,O-48-56-04-04-02
KYENJOJO,MWENGE COUNTY NORTH,KYARUSOZI,KATAMBALE,IGOBA P/S,727,1,1,6,28,529,565,15,580,0,O-48-56-04-04-03
KYENJOJO,MWENGE COUNTY NORTH,KYARUSOZI,KATAMBALE,KATAMBALE P/S,291,2,2,1,8,175,188,1,189,0,O-48-56-04-04-04
KYENJOJO,MWENGE COUNTY NORTH,KYARUSOZI,KIGOYERA,KIGOYERA PARISH HALL,950,6,2,7,19,743,777,13,790,0,O-48-56-04-05-01
KYENJOJO,MWENGE COUNTY NORTH,KYARUSOZI,KIGOYERA,KIGOYERA T. C. A,493,1,0,2,13,365,381,7,388,0,O-48-56-04-05-02
KYENJOJO,MWENGE COUNTY NORTH,KYARUSOZI,KIGOYERA,KIGOYERA T. C. B,396,2,2,3,10,255,272,10,282,0,O-48-56-04-05-03
KYENJOJO,MWENGE COUNTY NORTH,KYARUSOZI,KIGOYERA,KAJUMA CATHOLIC CHURCH,485,5,0,3,8,386,402,5,407,0,O-48-56-04-05-04
KYENJOJO,MWENGE COUNTY NORTH,KYARUSOZI,KYAMUGENYI,KYARUSOZI SUBCOUNTY HQRS,428,1,0,1,29,292,323,0,323,0,O-48-56-04-06-01
KYENJOJO,MWENGE COUNTY NORTH,KYARUSOZI,KYAMUGENYI,NCUMBI P/S,815,2,2,2,22,611,639,32,671,0,O-48-56-04-06-02
KYENJOJO,MWENGE COUNTY NORTH,KYARUSOZI,KYAMUGENYI,KYABAGANDA CATHOLIC CHURC,406,2,0,1,14,294,311,10,321,0,O-48-56-04-06-03
KYENJOJO,MWENGE COUNTY NORTH,KYARUSOZI,KYONGERA,KYONGERA PARISH HQRS,687,3,1,9,41,481,535,17,552,0,O-48-56-04-07-01
KYENJOJO,MWENGE COUNTY NORTH,KYARUSOZI,KYONGERA,KAISAMBA P. S.,501,0,0,5,16,382,403,9,412,0,O-48-56-04-07-02
KYENJOJO,MWENGE COUNTY NORTH,KYARUSOZI,MIRAMBI,KIHUMURO P. S.,492,1,0,2,22,384,409,16,425,0,O-48-56-04-08-01
KYENJOJO,MWENGE COUNTY NORTH,KYARUSOZI,MIRAMBI,KYEMBOGO P. S.,634,1,1,0,28,490,520,7,527,0,O-48-56-04-08-02
KYENJOJO,MWENGE COUNTY NORTH,KYARUSOZI,MIRAMBI,NYABURARA P. S.,675,6,3,7,20,495,531,13,544,0,O-48-56-04-08-03
KYENJOJO,MWENGE COUNTY NORTH,KYARUSOZI,MIRAMBI,MASOZI CATHOLIC CHURCH,265,0,0,1,1,226,228,3,231,0,O-48-56-04-08-04
KYENJOJO,MWENGE COUNTY NORTH,NYANKWANZI,HAKONA,RWENSAMBYA PRI.SCH.,619,3,1,3,27,456,490,9,499,0,O-48-56-05-01-01
KYENJOJO,MWENGE COUNTY NORTH,NYANKWANZI,HAKONA,NYANKWANZI P/S,783,4,2,6,35,529,576,7,583,0,O-48-56-05-01-02
KYENJOJO,MWENGE COUNTY NORTH,NYANKWANZI,HAKONA,HANSANJU T. C.,629,1,5,3,33,442,484,6,490,0,O-48-56-05-01-03
KYENJOJO,MWENGE COUNTY NORTH,NYANKWANZI,KITAIHUKA,KISANSA T.C,683,0,2,3,56,462,523,15,538,0,O-48-56-05-02-01
KYENJOJO,MWENGE COUNTY NORTH,NYANKWANZI,KITAIHUKA,KYANSIGIREKI,656,2,1,1,31,450,485,7,492,0,O-48-56-05-02-02
KYENJOJO,MWENGE COUNTY NORTH,NYANKWANZI,KITAIHUKA,MABIRA P/S,596,2,0,1,20,397,420,32,452,0,O-48-56-05-02-03
KYENJOJO,MWENGE COUNTY NORTH,NYANKWANZI,KITAIHUKA,MABIRA T.C,610,1,1,3,15,437,457,1,458,0,O-48-56-05-02-04
KYENJOJO,MWENGE COUNTY NORTH,NYANKWANZI,KYAMUTUNZI,KYARUGANGAMA P/S,759,4,2,5,41,504,556,17,573,0,O-48-56-05-03-01
KYENJOJO,MWENGE COUNTY NORTH,NYANKWANZI,KYAMUTUNZI,RWENSAMBYA P.S.,88,0,0,0,4,65,69,2,71,0,O-48-56-05-03-02
KYENJOJO,MWENGE COUNTY NORTH,NYANKWANZI,KYAMUTUNZI,KYAMUTUNZI T. C.,1230,6,1,8,118,660,793,11,804,0,O-48-56-05-03-03
KYENJOJO,MWENGE COUNTY NORTH,NYANKWANZI,KYAMUTUNZI,RUKUKURU C. O. U.,330,1,0,4,24,233,262,11,273,0,O-48-56-05-03-04
KYENJOJO,MWENGE COUNTY NORTH,NYANKWANZI,KYAMUTUNZI,KAITABIGERE CATHOLIC CHURCH,635,2,0,2,57,434,495,19,514,0,O-48-56-05-03-05
KYENJOJO,MWENGE COUNTY SOUTH,BUTIITI,BUTIITI,BIRENGA,584,0,2,2,26,426,456,9,465,0,O-48-57-01-01-01
KYENJOJO,MWENGE COUNTY SOUTH,BUTIITI,BUTIITI,BUTTITI S/C HQRS,386,0,7,0,16,244,267,13,280,0,O-48-57-01-01-02
KYENJOJO,MWENGE COUNTY SOUTH,BUTIITI,BUTIITI,NYOMBYA RC I,281,0,0,1,27,165,193,5,198,0,O-48-57-01-01-03
KYENJOJO,MWENGE COUNTY SOUTH,BUTIITI,BUTIITI,RUBONA,487,2,0,1,15,358,376,6,382,0,O-48-57-01-01-04
KYENJOJO,MWENGE COUNTY SOUTH,BUTIITI,KABIRIZI,KINYANTALE B,622,4,1,3,20,422,450,12,462,0,O-48-57-01-02-01
KYENJOJO,MWENGE COUNTY SOUTH,BUTIITI,KABIRIZI,KABIRIZI,740,1,0,4,26,520,551,9,560,0,O-48-57-01-02-02
KYENJOJO,MWENGE COUNTY SOUTH,BUTIITI,KABIRIZI,MUHANGI A,382,3,1,6,24,283,317,2,319,0,O-48-57-01-02-03
KYENJOJO,MWENGE COUNTY SOUTH,BUTIITI,KAIHURA,KAIHURA,551,0,0,4,33,312,349,3,352,0,O-48-57-01-03-01
KYENJOJO,MWENGE COUNTY SOUTH,BUTIITI,KAIHURA,ISANDARA,529,2,5,4,20,370,401,11,412,0,O-48-57-01-03-02
KYENJOJO,MWENGE COUNTY SOUTH,BUTIITI,KAIHURA,NYARUBINGO,521,2,1,4,9,354,370,26,396,0,O-48-57-01-03-03
KYENJOJO,MWENGE COUNTY SOUTH,BUTIITI,KAIHURA,BWENZI,439,1,0,1,18,316,336,14,350,0,O-48-57-01-03-04
KYENJOJO,MWENGE COUNTY SOUTH,BUTIITI,MBALE,KAIGORO,469,2,0,3,30,322,357,5,362,0,O-48-57-01-04-01
KYENJOJO,MWENGE COUNTY SOUTH,BUTIITI,MBALE,BUSORO,316,0,1,4,9,232,246,4,250,0,O-48-57-01-04-02
KYENJOJO,MWENGE COUNTY SOUTH,BUTIITI,MBALE,BUYABUNGA,498,1,3,7,17,360,388,8,396,0,O-48-57-01-04-03
KYENJOJO,MWENGE COUNTY SOUTH,BUTIITI,MBALE,MIHIKIRO,561,3,3,5,25,389,425,13,438,0,O-48-57-01-04-04
KYENJOJO,MWENGE COUNTY SOUTH,BUTIITI,MBALE,MUGOMA,508,0,0,9,29,383,421,10,431,0,O-48-57-01-04-05
KYENJOJO,MWENGE COUNTY SOUTH,BUTIITI,MUKUNYU,MUKUNYU,541,1,1,3,39,361,405,13,418,0,O-48-57-01-05-01
KYENJOJO,MWENGE COUNTY SOUTH,BUTIITI,MUKUNYU,MIRANGA,433,2,1,4,21,301,329,5,334,0,O-48-57-01-05-02
KYENJOJO,MWENGE COUNTY SOUTH,BUTIITI,MUKUNYU,BUSANZA,493,5,2,4,45,331,387,13,400,0,O-48-57-01-05-03
KYENJOJO,MWENGE COUNTY SOUTH,BUTIITI,MUKUNYU,MUKONOMURA,300,2,1,5,7,235,250,10,260,0,O-48-57-01-05-04
KYENJOJO,MWENGE COUNTY SOUTH,BUTIITI,NYAKARONGO,NYABUHARWA,636,1,1,2,52,404,460,25,485,0,O-48-57-01-06-01
KYENJOJO,MWENGE COUNTY SOUTH,BUTIITI,NYAKARONGO,KASWA,483,1,2,5,16,370,394,9,403,0,O-48-57-01-06-02
KYENJOJO,MWENGE COUNTY SOUTH,BUTIITI,NYAKARONGO,KIGANDO,471,4,1,4,26,335,370,11,381,0,O-48-57-01-06-03
KYENJOJO,MWENGE COUNTY SOUTH,BUTIITI,NYAKARONGO,NKINGA II,266,0,0,1,10,218,229,3,232,0,O-48-57-01-06-04
KYENJOJO,MWENGE COUNTY SOUTH,KIHUURA,KANYINYA,KANYINYA,558,2,2,2,18,337,361,27,388,0,O-48-57-02-01-01
KYENJOJO,MWENGE COUNTY SOUTH,KIHUURA,KANYINYA,NAME_MISSING,594,4,0,6,20,341,371,25,396,0,O-48-57-02-01-02
KYENJOJO,MWENGE COUNTY SOUTH,KIHUURA,KANYINYA,RUGORRA CENTRAL,697,5,2,8,38,457,510,22,532,0,O-48-57-02-01-03
KYENJOJO,MWENGE COUNTY SOUTH,KIHUURA,KANYINYA,NYAKATOMA C.O.U,472,2,0,4,18,355,379,0,379,0,O-48-57-02-01-04
KYENJOJO,MWENGE COUNTY SOUTH,KIHUURA,KIGUNDA,KIGUNDA,693,2,1,8,15,429,455,18,473,0,O-48-57-02-02-01
KYENJOJO,MWENGE COUNTY SOUTH,KIHUURA,KIGUNDA,KYAKAPECHE,555,1,2,2,32,389,426,12,438,0,O-48-57-02-02-02
KYENJOJO,MWENGE COUNTY SOUTH,KIHUURA,KIHUURA,KIHURA,668,0,1,2,49,389,441,9,450,0,O-48-57-02-03-01
KYENJOJO,MWENGE COUNTY SOUTH,KIHUURA,KIHUURA,BUKORA P. S.,668,6,2,10,26,452,496,15,511,0,O-48-57-02-03-02
KYENJOJO,MWENGE COUNTY SOUTH,KIHUURA,KIHUURA,KIREGESA,503,2,2,5,25,348,382,14,396,0,O-48-57-02-03-03
KYENJOJO,MWENGE COUNTY SOUTH,KIHUURA,KIKODA,KIKODA A,444,1,2,1,12,325,341,6,347,0,O-48-57-02-04-01
KYENJOJO,MWENGE COUNTY SOUTH,KIHUURA,KIKODA,KIKODA B,293,0,1,3,10,215,229,11,240,0,O-48-57-02-04-02
KYENJOJO,MWENGE COUNTY SOUTH,KIHUURA,KISOJO,KITABONA,415,3,1,2,24,295,325,10,335,0,O-48-57-02-05-01
KYENJOJO,MWENGE COUNTY SOUTH,KIHUURA,KISOJO,KYAMITARA,400,1,4,2,8,298,313,10,323,0,O-48-57-02-05-02
KYENJOJO,MWENGE COUNTY SOUTH,KIHUURA,KISOJO,KISOJO,512,3,1,6,43,326,379,5,384,0,O-48-57-02-05-03
KYENJOJO,MWENGE COUNTY SOUTH,KIHUURA,KYANKARAMATA,KYANKARAMATA,696,2,3,4,32,498,539,11,550,0,O-48-57-02-06-01
KYENJOJO,MWENGE COUNTY SOUTH,KIHUURA,KYANKARAMATA,HARUTOMA,653,3,3,3,50,390,449,20,469,0,O-48-57-02-06-02
KYENJOJO,MWENGE COUNTY SOUTH,KIHUURA,KYANKARAMATA,KYABULYEZIBWA,342,1,1,3,16,246,267,11,278,0,O-48-57-02-06-03
KYENJOJO,MWENGE COUNTY SOUTH,KIHUURA,MATIRI,MATIRI T. C.,870,8,6,6,68,550,638,13,651,0,O-48-57-02-07-01
KYENJOJO,MWENGE COUNTY SOUTH,KIHUURA,MATIRI,MAHASA,875,1,1,8,35,603,648,8,656,0,O-48-57-02-07-02
KYENJOJO,MWENGE COUNTY SOUTH,KIHUURA,MATIRI,KISEGENYU,455,5,0,1,24,322,352,11,363,0,O-48-57-02-07-03
KYENJOJO,MWENGE COUNTY SOUTH,KIHUURA,MATIRI,BIBUYE,322,1,0,2,14,233,250,4,254,0,O-48-57-02-07-04
KYENJOJO,MWENGE COUNTY SOUTH,KIHUURA,RWEITENGYA,RWAITENGYA,712,0,2,4,28,521,555,6,561,0,O-48-57-02-08-01
KYENJOJO,MWENGE COUNTY SOUTH,KIHUURA,RWEITENGYA,KISWARRA,564,0,0,3,9,416,428,8,436,0,O-48-57-02-08-02
KYENJOJO,MWENGE COUNTY SOUTH,KIHUURA,RWIBALE,NYAKABUNGO C.O.U,329,0,1,4,18,188,211,12,223,0,O-48-57-02-09-01
KYENJOJO,MWENGE COUNTY SOUTH,KIHUURA,RWIBALE,RWIBALE,599,1,1,9,48,374,433,7,440,0,O-48-57-02-09-02
KYENJOJO,MWENGE COUNTY SOUTH,KIHUURA,RWIBALE,BUTUBIRI,613,2,3,9,26,376,416,13,429,0,O-48-57-02-09-03
KYENJOJO,MWENGE COUNTY SOUTH,KIHUURA,RWIBALE,BUTUNDUZI CATHOLIC CHURCH,456,0,0,3,29,365,397,21,418,0,O-48-57-02-09-04
KYENJOJO,MWENGE COUNTY SOUTH,KYENJOJO TOWN COUNCIL,KASIINA,KASIINA PARISH HQRS,1102,3,0,4,130,424,561,6,567,0,O-48-57-03-01-01
KYENJOJO,MWENGE COUNTY SOUTH,KYENJOJO TOWN COUNCIL,KASIINA,HAKATOMA,804,3,3,4,29,486,525,12,537,0,O-48-57-03-01-02
KYENJOJO,MWENGE COUNTY SOUTH,KYENJOJO TOWN COUNCIL,KASIINA,NGEZI,750,1,3,1,44,439,488,3,491,0,O-48-57-03-01-03
KYENJOJO,MWENGE COUNTY SOUTH,KYENJOJO TOWN COUNCIL,KASIINA,KYENJOJO P/S,350,0,0,0,35,184,219,3,222,0,O-48-57-03-01-04
KYENJOJO,MWENGE COUNTY SOUTH,KYENJOJO TOWN COUNCIL,KIRONGO,KISERUKA,825,2,0,4,49,525,580,6,586,0,O-48-57-03-02-01
KYENJOJO,MWENGE COUNTY SOUTH,KYENJOJO TOWN COUNCIL,KIRONGO,KIRONGO,712,0,0,6,22,418,446,3,449,0,O-48-57-03-02-02
KYENJOJO,MWENGE COUNTY SOUTH,KYENJOJO TOWN COUNCIL,KIRONGO,BUCUNI,747,4,3,4,51,538,600,32,632,0,O-48-57-03-02-03
KYENJOJO,MWENGE COUNTY SOUTH,KYENJOJO TOWN COUNCIL,KYAMUTASA B,NYANTUNGO A,669,2,3,2,35,408,450,12,462,0,O-48-57-03-03-01
KYENJOJO,MWENGE COUNTY SOUTH,KYENJOJO TOWN COUNCIL,KYAMUTASA B,RWETEIKE P/S,755,4,3,4,25,503,539,7,546,0,O-48-57-03-03-02
KYENJOJO,MWENGE COUNTY SOUTH,NYANTUNGO,BURARO,BURARO B,619,3,3,4,20,461,491,6,497,0,O-48-57-04-01-01
KYENJOJO,MWENGE COUNTY SOUTH,NYANTUNGO,BURARO,IHAMBA,509,0,0,0,20,378,398,3,401,0,O-48-57-04-01-02
KYENJOJO,MWENGE COUNTY SOUTH,NYANTUNGO,BURARO,NYARUKOMA,766,3,1,0,28,506,538,10,548,0,O-48-57-04-01-03
KYENJOJO,MWENGE COUNTY SOUTH,NYANTUNGO,BURARO,KYANYAMITALE,384,2,2,2,14,262,282,7,289,0,O-48-57-04-01-04
KYENJOJO,MWENGE COUNTY SOUTH,NYANTUNGO,KIBIRA,KATUNGURU,697,2,1,16,31,483,533,14,547,0,O-48-57-04-02-01
KYENJOJO,MWENGE COUNTY SOUTH,NYANTUNGO,KIBIRA,KIBIRA,651,4,1,4,6,466,481,14,495,0,O-48-57-04-02-02
KYENJOJO,MWENGE COUNTY SOUTH,NYANTUNGO,KIBIRA,MABONWA,450,4,0,8,10,320,342,14,356,0,O-48-57-04-02-03
KYENJOJO,MWENGE COUNTY SOUTH,NYANTUNGO,KIGARALE,KIGARALE HEALTH UNIT,614,3,0,1,8,449,461,7,468,0,O-48-57-04-03-01
KYENJOJO,MWENGE COUNTY SOUTH,NYANTUNGO,KIGARALE,KAWANYANA,542,3,1,2,9,384,399,4,403,0,O-48-57-04-03-02
KYENJOJO,MWENGE COUNTY SOUTH,NYANTUNGO,KIGARALE,GALIHUUMA P/S,216,0,0,0,5,165,170,2,172,0,O-48-57-04-03-03
KYENJOJO,MWENGE COUNTY SOUTH,NYANTUNGO,KIGARALE,RQWMPIKE P/S,326,0,0,3,15,218,236,6,242,0,O-48-57-04-03-04
KYENJOJO,MWENGE COUNTY SOUTH,NYANTUNGO,KYAMUTASA A,KIREEGA,432,1,0,2,11,308,322,0,322,0,O-48-57-04-04-01
KYENJOJO,MWENGE COUNTY SOUTH,NYANTUNGO,KYAMUTASA A,KIDUDU P. S.,787,3,2,2,47,484,538,16,554,0,O-48-57-04-04-02
KYENJOJO,MWENGE COUNTY SOUTH,NYANTUNGO,NYAIBANDA,KANGONDO,515,2,1,4,31,255,293,7,300,0,O-48-57-04-05-01
KYENJOJO,MWENGE COUNTY SOUTH,NYANTUNGO,NYAIBANDA,NYAMIIRONGO,603,4,0,3,44,380,431,16,447,0,O-48-57-04-05-02
KYENJOJO,MWENGE COUNTY SOUTH,NYANTUNGO,NYAIBANDA,KIHUMBYA KYEGANYWA B,485,2,1,1,13,361,378,12,390,0,O-48-57-04-05-03
KYENJOJO,MWENGE COUNTY SOUTH,NYANTUNGO,NYAIBANDA,KYEGANYWA A MWARO,590,3,1,10,25,358,397,11,408,0,O-48-57-04-05-04
KYENJOJO,MWENGE COUNTY SOUTH,NYANTUNGO,NYAIBANDA,OMWIBALE,600,2,0,10,47,369,428,16,444,0,O-48-57-04-05-05
KYENJOJO,MWENGE COUNTY SOUTH,NYANTUNGO,NYAIBANDA,KABUTA C.O.U,357,2,2,5,2,278,289,11,300,0,O-48-57-04-05-06
KYENJOJO,MWENGE COUNTY SOUTH,NYANTUNGO,NYAIBANDA,MWARO C.O.U,295,1,1,3,11,225,241,13,254,0,O-48-57-04-05-07
KYENJOJO,MWENGE COUNTY SOUTH,NYANTUNGO,RUHOKO,KYANYAMA,742,1,0,3,13,525,542,14,556,0,O-48-57-04-06-01
KYENJOJO,MWENGE COUNTY SOUTH,NYANTUNGO,RUHOKO,RUHOKO,545,2,2,6,11,374,395,8,403,0,O-48-57-04-06-02
KYENJOJO,MWENGE COUNTY SOUTH,NYANTUNGO,RUHOKO,MABALE,654,2,1,2,17,463,485,3,488,0,O-48-57-04-06-03
KANUNGU,KINKIZI CTY EAST,KAMBUGA,BUGONGI,KYENJOKA I,679,0,2,4,108,380,494,13,507,0,O-55-195-01-01-01
KANUNGU,KINKIZI CTY EAST,KAMBUGA,BUGONGI,RUKUKUKURU,743,1,0,7,139,384,531,17,548,0,O-55-195-01-01-02
KANUNGU,KINKIZI CTY EAST,KAMBUGA,BUGONGI,RUKUKUKURU II,635,0,1,2,165,319,487,16,503,0,O-55-195-01-01-03
KANUNGU,KINKIZI CTY EAST,KAMBUGA,BUGONGI,KYENJOKA II,744,4,0,3,149,373,529,9,538,0,O-55-195-01-01-04
KANUNGU,KINKIZI CTY EAST,KAMBUGA,KATETE,KISHURO,793,0,0,1,110,463,574,0,574,0,O-55-195-01-02-01
KANUNGU,KINKIZI CTY EAST,KAMBUGA,KATETE,NYAMABARE I,431,1,0,0,88,221,310,1,311,0,O-55-195-01-02-02
KANUNGU,KINKIZI CTY EAST,KAMBUGA,KATETE,NYAMABARE II,309,0,0,1,49,155,205,4,209,0,O-55-195-01-02-03
KANUNGU,KINKIZI CTY EAST,KAMBUGA,KATETE,MPANGANGO P/S,340,1,0,1,82,159,243,11,254,0,O-55-195-01-02-04
KANUNGU,KINKIZI CTY EAST,KAMBUGA,KATETE,KATETE MKT,350,2,0,0,59,192,253,5,258,0,O-55-195-01-02-05
KANUNGU,KINKIZI CTY EAST,KAMBUGA,KIRINGA,BWANGA I,523,5,0,0,78,297,380,4,384,0,O-55-195-01-03-01
KANUNGU,KINKIZI CTY EAST,KAMBUGA,KIRINGA,KATEMBA,786,4,0,0,141,433,578,9,587,0,O-55-195-01-03-02
KANUNGU,KINKIZI CTY EAST,KAMBUGA,KIRINGA,BWANGA II,352,0,0,0,53,198,251,1,252,0,O-55-195-01-03-03
KANUNGU,KINKIZI CTY EAST,KAMBUGA,NYARUGUNDA,KATOJO I,802,2,1,4,177,376,560,12,572,0,O-55-195-01-04-01
KANUNGU,KINKIZI CTY EAST,KAMBUGA,NYARUGUNDA,KAKONI I,634,2,0,2,150,300,454,2,456,0,O-55-195-01-04-02
KANUNGU,KINKIZI CTY EAST,KAMBUGA,NYARUGUNDA,KAKONI IIKATOJA II,565,8,1,4,141,269,423,3,426,0,O-55-195-01-04-03
KANUNGU,KINKIZI CTY EAST,KAMBUGA,NYARUTOJO,NYAKAGYEZI I,475,0,0,2,53,276,331,14,345,0,O-55-195-01-05-01
KANUNGU,KINKIZI CTY EAST,KAMBUGA,NYARUTOJO,NYAKAGYEZI II/KYAMUGAGA,435,6,0,2,60,284,352,6,358,0,O-55-195-01-05-02
KANUNGU,KINKIZI CTY EAST,KAMBUGA,NYARUTOJO,KYAMUGAGA II,461,2,0,3,60,238,303,6,309,0,O-55-195-01-05-03
KANUNGU,KINKIZI CTY EAST,KAMBUGA,NYARUTOJO,KYAMUGAGA III,243,1,0,1,42,128,172,1,173,0,O-55-195-01-05-04
KANUNGU,KINKIZI CTY EAST,KAMBUGA,NYARUTOJO,NYAKAGYEZI III,758,4,1,1,107,342,455,10,465,0,O-55-195-01-05-05
KANUNGU,KINKIZI CTY EAST,KAMBUGA,NYARUTOJO,KASHAYO,542,1,0,0,50,291,342,10,352,0,O-55-195-01-05-06
KANUNGU,KINKIZI CTY EAST,KAMBUGA,RUHANDAGAZI,NYAKATUNGURU I,874,6,1,0,227,307,541,20,561,0,O-55-195-01-06-01
KANUNGU,KINKIZI CTY EAST,KAMBUGA,RUHANDAGAZI,NYAKATUNGURU II/KAMAJUNE I,615,0,1,0,126,289,416,13,429,0,O-55-195-01-06-02
KANUNGU,KINKIZI CTY EAST,KAMBUGA,RUHANDAGAZI,KAMAJUNE II,676,1,0,1,123,336,461,24,485,0,O-55-195-01-06-03
KANUNGU,KINKIZI CTY EAST,KAMBUGA,RUHANDAGAZI,KAMAJUNE III/NYAKATUNGURU III,476,2,2,2,107,237,350,6,356,0,O-55-195-01-06-04
KANUNGU,KINKIZI CTY EAST,KANUNGU TOWN COUNCIL,EASTERN WARD,KIFUNJO,658,2,0,2,175,327,506,6,512,0,O-55-195-02-01-01
KANUNGU,KINKIZI CTY EAST,KANUNGU TOWN COUNCIL,EASTERN WARD,MUSHASHA,638,4,0,1,104,409,518,6,524,0,O-55-195-02-01-02
KANUNGU,KINKIZI CTY EAST,KANUNGU TOWN COUNCIL,NORTHERN WARD,KARUBANDA,678,7,1,1,167,329,505,2,507,0,O-55-195-02-02-01
KANUNGU,KINKIZI CTY EAST,KANUNGU TOWN COUNCIL,NORTHERN WARD,KARUHINDA,560,3,0,1,161,257,422,5,427,0,O-55-195-02-02-02
KANUNGU,KINKIZI CTY EAST,KANUNGU TOWN COUNCIL,SOUTHERN WARD,ITEMBEZO,726,3,0,1,129,421,554,7,561,0,O-55-195-02-03-01
KANUNGU,KINKIZI CTY EAST,KANUNGU TOWN COUNCIL,SOUTHERN WARD,MASYA,687,1,1,1,146,358,507,14,521,0,O-55-195-02-03-02
KANUNGU,KINKIZI CTY EAST,KANUNGU TOWN COUNCIL,SOUTHERN WARD,OMOMBUGA P/SCHOOL,494,4,1,5,92,276,378,13,391,0,O-55-195-02-03-03
KANUNGU,KINKIZI CTY EAST,KANUNGU TOWN COUNCIL,WESTERN WARD,KANUNGU,825,6,0,0,252,288,546,7,553,0,O-55-195-02-04-01
KANUNGU,KINKIZI CTY EAST,KANUNGU TOWN COUNCIL,WESTERN WARD,BUREBANE,638,1,1,2,156,297,457,5,462,0,O-55-195-02-04-02
KANUNGU,KINKIZI CTY EAST,KIRIMA,BUSHURA,KAJUGANGOMA I,582,0,0,0,102,311,413,9,422,0,O-55-195-03-01-01
KANUNGU,KINKIZI CTY EAST,KIRIMA,BUSHURA,KAJUGANGOMA II/KAZURU I,823,4,0,5,117,445,571,10,581,0,O-55-195-03-01-02
KANUNGU,KINKIZI CTY EAST,KIRIMA,BUSHURA,MIGYERA/BWANJA I,389,4,0,1,23,283,311,8,319,0,O-55-195-03-01-03
KANUNGU,KINKIZI CTY EAST,KIRIMA,KIHANDA,NYAKIBUGA I,644,0,0,1,167,309,477,9,486,0,O-55-195-03-02-01
KANUNGU,KINKIZI CTY EAST,KIRIMA,KIHANDA,NYAKIBUGA II/MIREHE I,659,0,0,3,144,332,479,13,492,0,O-55-195-03-02-02
KANUNGU,KINKIZI CTY EAST,KIRIMA,KIHANDA,MIREHE II,684,6,0,0,148,325,479,14,493,0,O-55-195-03-02-03
KANUNGU,KINKIZI CTY EAST,KIRIMA,RUBIMBWA,RWAMISINGA,717,2,1,7,145,399,554,8,562,0,O-55-195-03-03-01
KANUNGU,KINKIZI CTY EAST,KIRIMA,RUBIMBWA,KITUNGA,443,1,0,1,93,248,343,8,351,0,O-55-195-03-03-02
KANUNGU,KINKIZI CTY EAST,KIRIMA,RUTUGUNDA,RUTOOMA I,849,3,0,4,185,441,633,17,650,0,O-55-195-03-04-01
KANUNGU,KINKIZI CTY EAST,KIRIMA,RUTUGUNDA,RUTOOMA II/KITARIRO,670,2,0,3,157,338,500,8,508,0,O-55-195-03-04-02
KANUNGU,KINKIZI CTY EAST,RUGYEYO,KASHOJWA,NYAMAKAMBA/MURARA I,630,1,1,5,163,340,510,17,527,0,O-55-195-04-01-01
KANUNGU,KINKIZI CTY EAST,RUGYEYO,KASHOJWA,MURARA II,742,6,1,3,211,389,610,18,628,0,O-55-195-04-01-02
KANUNGU,KINKIZI CTY EAST,RUGYEYO,KATUNGU,BIKOMERO,553,1,0,2,126,318,447,7,454,0,O-55-195-04-02-01
KANUNGU,KINKIZI CTY EAST,RUGYEYO,KATUNGU,BURORA,541,4,1,1,122,266,394,19,413,0,O-55-195-04-02-02
KANUNGU,KINKIZI CTY EAST,RUGYEYO,KATUNGU,KAGASHE,524,1,1,1,139,296,438,1,439,0,O-55-195-04-02-03
KANUNGU,KINKIZI CTY EAST,RUGYEYO,KAYUNGWE,BUKUNGA I/KATEBERE I,464,3,0,1,59,256,319,12,331,0,O-55-195-04-03-01
KANUNGU,KINKIZI CTY EAST,RUGYEYO,KAYUNGWE,BUKUNGA II/KATEBERE II,566,1,0,4,74,364,443,3,446,0,O-55-195-04-03-02
KANUNGU,KINKIZI CTY EAST,RUGYEYO,KITOJO,BUSHEKWE,527,1,0,0,95,312,408,10,418,0,O-55-195-04-04-01
KANUNGU,KINKIZI CTY EAST,RUGYEYO,KITOJO,MPAMIZO,705,3,2,2,195,353,555,6,561,0,O-55-195-04-04-02
KANUNGU,KINKIZI CTY EAST,RUGYEYO,MISHENYI,KABUGIRI,520,3,0,1,83,327,414,5,419,0,O-55-195-04-05-01
KANUNGU,KINKIZI CTY EAST,RUGYEYO,MISHENYI,KAYANJA,646,3,1,4,66,434,508,0,508,0,O-55-195-04-05-02
KANUNGU,KINKIZI CTY EAST,RUGYEYO,NYARURAMBI,MABARE I,744,2,1,0,205,374,582,29,611,0,O-55-195-04-06-01
KANUNGU,KINKIZI CTY EAST,RUGYEYO,NYARURAMBI,MABARE II/MUKINGA I,571,2,0,4,140,303,449,11,460,0,O-55-195-04-06-02
KANUNGU,KINKIZI CTY EAST,RUGYEYO,NYARURAMBI,MUKIGA II,638,2,1,5,138,349,495,9,504,0,O-55-195-04-06-03
KANUNGU,KINKIZI CTY EAST,RUTENGA,KATOJO,KARAGYERE I,315,2,1,3,59,156,221,6,227,0,O-55-195-05-01-01
KANUNGU,KINKIZI CTY EAST,RUTENGA,KATOJO,RUGANDO,451,1,0,6,35,238,280,11,291,0,O-55-195-05-01-02
KANUNGU,KINKIZI CTY EAST,RUTENGA,KATOJO,KATAGIRAMAIZI,754,4,1,4,119,414,542,15,557,0,O-55-195-05-01-03
KANUNGU,KINKIZI CTY EAST,RUTENGA,KINABA,MAHEMBE I,690,5,1,12,95,386,499,22,521,0,O-55-195-05-02-01
KANUNGU,KINKIZI CTY EAST,RUTENGA,KINABA,MAHEMBE II,750,6,2,10,108,396,522,23,545,0,O-55-195-05-02-02
KANUNGU,KINKIZI CTY EAST,RUTENGA,KINABA,KIZIBA,745,3,1,10,59,395,468,27,495,0,O-55-195-05-02-03
KANUNGU,KINKIZI CTY EAST,RUTENGA,MAFUGA,ISHASHA I,491,3,0,3,51,322,379,9,388,0,O-55-195-05-03-01
KANUNGU,KINKIZI CTY EAST,RUTENGA,MAFUGA,ISHASHA II,419,2,0,0,44,259,305,8,313,0,O-55-195-05-03-02
KANUNGU,KINKIZI CTY EAST,RUTENGA,MAFUGA,NYAMIYAGA,693,8,0,2,75,399,484,30,514,0,O-55-195-05-03-03
KANUNGU,KINKIZI CTY EAST,RUTENGA,MURAMBA,MASHENYA,396,3,0,1,49,251,304,18,322,0,O-55-195-05-04-01
KANUNGU,KINKIZI CTY EAST,RUTENGA,MURAMBA,KYANKYERE I/KYANKYERE II,480,4,2,1,57,291,355,15,370,0,O-55-195-05-04-02
KANUNGU,KINKIZI CTY EAST,RUTENGA,MURAMBA,RUHAGO,593,1,0,10,48,362,421,10,431,0,O-55-195-05-04-03
KANUNGU,KINKIZI CTY EAST,RUTENGA,MURAMBA,RWAKATUNGU,554,2,0,1,79,341,423,4,427,0,O-55-195-05-04-04
KANUNGU,KINKIZI CTY WEST,KANYANTOROGO,BUREMA,BUREMA P/S,388,1,1,0,83,226,311,9,320,0,O-55-196-01-01-01
KANUNGU,KINKIZI CTY WEST,KANYANTOROGO,BUREMA,KAHAMA,433,1,0,0,126,213,340,5,345,0,O-55-196-01-01-02
KANUNGU,KINKIZI CTY WEST,KANYANTOROGO,BUREMA,KANYANTOROGO SECONDRY SC,637,0,0,0,105,234,339,22,361,0,O-55-196-01-01-03
KANUNGU,KINKIZI CTY WEST,KANYANTOROGO,KIHEMBE,RUKARARA,614,1,1,2,116,356,476,12,488,0,O-55-196-01-02-01
KANUNGU,KINKIZI CTY WEST,KANYANTOROGO,KIHEMBE,NYABIREHE P/S,535,1,0,2,61,347,411,7,418,0,O-55-196-01-02-02
KANUNGU,KINKIZI CTY WEST,KANYANTOROGO,KIHEMBE,KARAMBI C.O.U,510,1,0,1,89,289,380,13,393,0,O-55-196-01-02-03
KANUNGU,KINKIZI CTY WEST,KANYANTOROGO,KIHEMBE,KIHEMBE P/S,569,1,0,1,83,306,391,9,400,0,O-55-196-01-02-04
KANUNGU,KINKIZI CTY WEST,KANYANTOROGO,KIHEMBE,NTABAGWE P/S,598,3,0,2,105,290,400,3,403,0,O-55-196-01-02-05
KANUNGU,KINKIZI CTY WEST,KANYANTOROGO,KISHENYI,KANYANGUSI I/KISHAYO I,656,1,0,0,173,301,475,20,495,0,O-55-196-01-03-01
KANUNGU,KINKIZI CTY WEST,KANYANTOROGO,KISHENYI,KANYANGUSI II/KISHAYO II,630,0,0,0,157,350,507,8,515,0,O-55-196-01-03-02
KANUNGU,KINKIZI CTY WEST,KANYANTOROGO,NYAMIGOYE,NYABUBARE I,563,2,0,3,61,349,415,2,417,0,O-55-196-01-04-01
KANUNGU,KINKIZI CTY WEST,KANYANTOROGO,NYAMIGOYE,NYABUBARE II/BUGIRI I,695,1,0,1,85,463,550,6,556,0,O-55-196-01-04-02
KANUNGU,KINKIZI CTY WEST,KANYANTOROGO,NYAMIGOYE,BUGIRI II,612,1,0,3,52,412,468,8,476,0,O-55-196-01-04-03
KANUNGU,KINKIZI CTY WEST,KAYONZA,BUJENGWE,BYUMBA,787,1,0,2,48,556,607,21,628,0,O-55-196-02-01-01
KANUNGU,KINKIZI CTY WEST,KAYONZA,BUJENGWE,MUSHORERO I/MUSHORERO II (A,513,0,0,1,38,345,384,13,397,0,O-55-196-02-01-02
KANUNGU,KINKIZI CTY WEST,KAYONZA,BUJENGWE,MUSHORERO I/MUSHORERO II (M,660,1,0,6,42,389,438,12,450,0,O-55-196-02-01-03
KANUNGU,KINKIZI CTY WEST,KAYONZA,KARANGARA,NYAKABINGO/KISHENYI I,408,2,1,0,59,282,344,14,358,0,O-55-196-02-02-01
KANUNGU,KINKIZI CTY WEST,KAYONZA,KARANGARA,KISHENYI II,636,2,0,3,130,380,515,34,549,0,O-55-196-02-02-02
KANUNGU,KINKIZI CTY WEST,KAYONZA,KARANGARA,RUTARE,528,3,0,1,61,380,445,7,452,0,O-55-196-02-02-03
KANUNGU,KINKIZI CTY WEST,KAYONZA,KYESHERO,RUGANDO I,561,3,1,3,140,275,422,18,440,0,O-55-196-02-03-01
KANUNGU,KINKIZI CTY WEST,KAYONZA,KYESHERO,RUGANDO II,435,2,0,2,58,194,256,16,272,0,O-55-196-02-03-02
KANUNGU,KINKIZI CTY WEST,KAYONZA,KYESHERO,RUGANDO III/RUTENDERE I,908,1,1,4,85,402,493,17,510,0,O-55-196-02-03-03
KANUNGU,KINKIZI CTY WEST,KAYONZA,KYESHERO,RUTENDERE II,593,1,2,8,108,303,422,9,431,0,O-55-196-02-03-04
KANUNGU,KINKIZI CTY WEST,KAYONZA,KYESHERO,KYESHERO,575,2,0,3,76,266,347,19,366,0,O-55-196-02-03-05
KANUNGU,KINKIZI CTY WEST,KAYONZA,KYESHERO,KATABURAZA,356,1,0,5,21,264,291,13,304,0,O-55-196-02-03-06
KANUNGU,KINKIZI CTY WEST,KAYONZA,KYESHERO,KYESHERO OUTSIDE Q. GUARD,50,0,0,0,2,46,48,2,50,0,O-55-196-02-03-07
KANUNGU,KINKIZI CTY WEST,KAYONZA,MUKONO,BUHOMA I,438,1,0,4,15,345,365,17,382,0,O-55-196-02-04-01
KANUNGU,KINKIZI CTY WEST,KAYONZA,MUKONO,BUHOMA II,784,1,1,7,59,491,559,15,574,0,O-55-196-02-04-02
KANUNGU,KINKIZI CTY WEST,KAYONZA,MUKONO,KASHEBEYA,636,3,0,3,39,520,565,2,567,0,O-55-196-02-04-03
KANUNGU,KINKIZI CTY WEST,KAYONZA,MUKONO,KANYASHANDE,469,1,1,3,21,328,354,11,365,0,O-55-196-02-04-04
KANUNGU,KINKIZI CTY WEST,KAYONZA,MUKONO,MUKONO OUTSIDE Q.GUARD,583,3,1,1,80,309,394,8,402,0,O-55-196-02-04-05
KANUNGU,KINKIZI CTY WEST,KAYONZA,NTUNGAMO,KYABUYORWA,629,1,0,0,58,359,418,12,430,0,O-55-196-02-05-01
KANUNGU,KINKIZI CTY WEST,KAYONZA,NTUNGAMO,FACTORY,602,2,1,0,54,354,411,27,438,0,O-55-196-02-05-02
KANUNGU,KINKIZI CTY WEST,KAYONZA,NTUNGAMO,HAKIREHE,519,1,0,2,43,326,372,11,383,0,O-55-196-02-05-03
KANUNGU,KINKIZI CTY WEST,KAYONZA,NTUNGAMO,BUTOGOTA I,645,1,0,0,131,282,414,14,428,0,O-55-196-02-05-04
KANUNGU,KINKIZI CTY WEST,KAYONZA,NTUNGAMO,BUTOGOTA II,746,0,0,2,179,276,457,17,474,0,O-55-196-02-05-05
KANUNGU,KINKIZI CTY WEST,KAYONZA,NTUNGAMO,BIKUUTO,426,3,0,2,88,217,310,17,327,0,O-55-196-02-05-06
KANUNGU,KINKIZI CTY WEST,KAYONZA,NTUNGAMO,NYABITANDA,179,0,0,0,18,102,120,11,131,0,O-55-196-02-05-07
KANUNGU,KINKIZI CTY WEST,KIHIIHI,KABUGA,BUSHERE P/S,693,1,2,5,158,359,525,8,533,0,O-55-196-03-01-01
KANUNGU,KINKIZI CTY WEST,KIHIIHI,KABUGA,KAYEMBE,469,5,0,1,100,214,320,6,326,0,O-55-196-03-01-02
KANUNGU,KINKIZI CTY WEST,KIHIIHI,KARUBEIZI,NSHAKA I,644,0,0,0,71,410,481,1,482,0,O-55-196-03-02-01
KANUNGU,KINKIZI CTY WEST,KIHIIHI,KARUBEIZI,NSHAKA II,687,2,1,3,128,397,531,0,531,0,O-55-196-03-02-02
KANUNGU,KINKIZI CTY WEST,KIHIIHI,KIBIMBIRI,RUSOROZA P/SCH,718,4,0,3,104,427,538,8,546,0,O-55-196-03-03-01
KANUNGU,KINKIZI CTY WEST,KIHIIHI,KIBIMBIRI,KIBIMBIRE PARISH HQRS,726,3,0,2,107,343,455,10,465,0,O-55-196-03-03-02
KANUNGU,KINKIZI CTY WEST,KIHIIHI,KIBIMBIRI,RWERERE,577,3,2,4,63,289,361,16,377,0,O-55-196-03-03-03
KANUNGU,KINKIZI CTY WEST,KIHIIHI,KIBIMBIRI,MATANDA P/S (A-M),457,1,0,1,55,148,205,7,212,0,O-55-196-03-03-04
KANUNGU,KINKIZI CTY WEST,KIHIIHI,KIBIMBIRI,KAMEME,658,6,0,4,54,368,432,8,440,0,O-55-196-03-03-05
KANUNGU,KINKIZI CTY WEST,KIHIIHI,KIBIMBIRI,KYENYABUTONGO,250,0,0,2,33,157,192,17,209,0,O-55-196-03-03-06
KANUNGU,KINKIZI CTY WEST,KIHIIHI,KIBIMBIRI,MATANDA P/S (N-Z),364,1,0,1,55,148,205,7,212,0,O-55-196-03-03-07
KANUNGU,KINKIZI CTY WEST,KIHIIHI,KIBIMBIRI,KATOKYE GATE OUTSIDE Q. GUA,586,3,0,1,20,412,436,12,448,0,O-55-196-03-03-08
KANUNGU,KINKIZI CTY WEST,KIHIIHI,NKUNDA,KAMAHE I,698,3,0,2,77,480,562,9,571,0,O-55-196-03-04-01
KANUNGU,KINKIZI CTY WEST,KIHIIHI,NKUNDA,NYARUTEMEMBA/KAMAHE II,646,2,0,2,58,428,490,4,494,0,O-55-196-03-04-02
KANUNGU,KINKIZI CTY WEST,KIHIIHI,NYANGA,ISHASHA,607,1,0,0,31,433,465,6,471,0,O-55-196-03-05-01
KANUNGU,KINKIZI CTY WEST,KIHIIHI,NYANGA,RUTOOMA,632,1,2,1,49,421,474,9,483,0,O-55-196-03-05-02
KANUNGU,KINKIZI CTY WEST,KIHIIHI,NYANGA,KARAMBI,463,0,0,2,13,336,351,10,361,0,O-55-196-03-05-03
KANUNGU,KINKIZI CTY WEST,KIHIIHI,NYANGA,BUKORWE,248,0,0,1,16,175,192,0,192,0,O-55-196-03-05-04
KANUNGU,KINKIZI CTY WEST,KIHIIHI,RUSOROZA,KAZINGA (A-M),480,1,0,0,38,297,336,7,343,0,O-55-196-03-06-01
KANUNGU,KINKIZI CTY WEST,KIHIIHI,RUSOROZA,TUKUNDANE (A-M),403,2,0,1,38,259,300,5,305,0,O-55-196-03-06-02
KANUNGU,KINKIZI CTY WEST,KIHIIHI,RUSOROZA,KAZINGA (N-Z),431,0,0,1,30,268,299,6,305,0,O-55-196-03-06-03
KANUNGU,KINKIZI CTY WEST,KIHIIHI,RUSOROZA,KASHOJWA,364,0,0,0,46,232,278,12,290,0,O-55-196-03-06-04
KANUNGU,KINKIZI CTY WEST,KIHIIHI,RUSOROZA,TUKUNDANE (N-Z),334,0,0,1,29,223,253,10,263,0,O-55-196-03-06-05
KANUNGU,KINKIZI CTY WEST,KIHIIHI,SAMARIA,KAYAMBEHO,328,3,1,0,46,195,245,6,251,0,O-55-196-03-07-01
KANUNGU,KINKIZI CTY WEST,KIHIIHI,SAMARIA,BUSHOGYE P/S,592,2,1,1,109,302,415,9,424,0,O-55-196-03-07-02
KANUNGU,KINKIZI CTY WEST,KIHIIHI,SAMARIA,SAMARIA,854,7,0,4,170,399,580,10,590,0,O-55-196-03-07-03
KANUNGU,KINKIZI CTY WEST,KIHIIHI TOWN COUNCIL,BIHOMBORWA,RWENYERERE,344,2,0,3,40,238,283,8,291,0,O-55-196-04-01-01
KANUNGU,KINKIZI CTY WEST,KIHIIHI TOWN COUNCIL,BIHOMBORWA,BUZANIRO,537,1,0,0,68,371,440,10,450,0,O-55-196-04-01-02
KANUNGU,KINKIZI CTY WEST,KIHIIHI TOWN COUNCIL,BIHOMBORWA,BIHOMBOMWA,482,1,0,0,65,319,385,7,392,0,O-55-196-04-01-03
KANUNGU,KINKIZI CTY WEST,KIHIIHI TOWN COUNCIL,BIHOMBORWA,KINYANGWE,598,2,0,2,83,372,459,1,460,0,O-55-196-04-01-04
KANUNGU,KINKIZI CTY WEST,KIHIIHI TOWN COUNCIL,KIHIIHI TOWN,MEIZIMERA I,724,3,0,1,187,288,479,3,482,0,O-55-196-04-02-01
KANUNGU,KINKIZI CTY WEST,KIHIIHI TOWN COUNCIL,KIHIIHI TOWN,MEIZIMERA II,676,0,0,3,136,311,450,4,454,0,O-55-196-04-02-02
KANUNGU,KINKIZI CTY WEST,KIHIIHI TOWN COUNCIL,KIHIIHI TOWN,KASIRO,525,2,2,1,107,244,356,4,360,0,O-55-196-04-02-03
KANUNGU,KINKIZI CTY WEST,KIHIIHI TOWN COUNCIL,NYAKATUNGURU,BUGONGO,492,0,0,0,104,272,376,1,377,0,O-55-196-04-03-01
KANUNGU,KINKIZI CTY WEST,KIHIIHI TOWN COUNCIL,NYAKATUNGURU,KIRURUMA,749,3,1,1,141,394,540,9,549,0,O-55-196-04-03-02
KANUNGU,KINKIZI CTY WEST,KIHIIHI TOWN COUNCIL,NYAKATUNGURU,NYAMWEGABIRA,790,0,1,2,127,403,533,4,537,0,O-55-196-04-03-03
KANUNGU,KINKIZI CTY WEST,KIHIIHI TOWN COUNCIL,RWANGA,RWANGA A,336,2,0,1,36,190,229,5,234,0,O-55-196-04-04-01
KANUNGU,KINKIZI CTY WEST,KIHIIHI TOWN COUNCIL,RWANGA,IBAMBIRO,346,0,0,1,35,222,258,10,268,0,O-55-196-04-04-02
KANUNGU,KINKIZI CTY WEST,KIHIIHI TOWN COUNCIL,RWANGA,BINYUNGU,328,0,0,0,60,150,210,17,227,0,O-55-196-04-04-03
KANUNGU,KINKIZI CTY WEST,KIHIIHI TOWN COUNCIL,RWANGA,RWANGA P/S,464,0,0,1,47,268,316,5,321,0,O-55-196-04-04-04
KANUNGU,KINKIZI CTY WEST,MPUNGU,BUREMBA,BUREMBA I,378,2,0,1,34,304,341,7,348,0,O-55-196-05-01-01
KANUNGU,KINKIZI CTY WEST,MPUNGU,BUREMBA,BUREMBA II,502,1,0,4,59,378,442,9,451,0,O-55-196-05-01-02
KANUNGU,KINKIZI CTY WEST,MPUNGU,MPUNGU,MPUNGU I,507,2,1,3,81,360,447,20,467,0,O-55-196-05-02-01
KANUNGU,KINKIZI CTY WEST,MPUNGU,MPUNGU,MPUNGU II,411,1,0,1,37,278,317,12,329,0,O-55-196-05-02-02
KANUNGU,KINKIZI CTY WEST,MPUNGU,MURAMBA,MURAMBA I A (A - M),579,2,1,1,61,344,409,1,410,0,O-55-196-05-03-01
KANUNGU,KINKIZI CTY WEST,MPUNGU,MURAMBA,MURAMBA I A (N - Z),517,1,0,5,43,322,371,17,388,0,O-55-196-05-03-02
KANUNGU,KINKIZI CTY WEST,MPUNGU,NGARA,NGARA,818,2,0,6,106,582,696,4,700,0,O-55-196-05-04-01
KANUNGU,KINKIZI CTY WEST,NYAMIRAMA,KIGARAMA,KARONDE,536,2,0,2,107,298,409,1,410,0,O-55-196-06-01-01
KANUNGU,KINKIZI CTY WEST,NYAMIRAMA,KIGARAMA,NYAKINONI I /NYAKINONI II,563,0,0,3,137,303,443,11,454,0,O-55-196-06-01-02
KANUNGU,KINKIZI CTY WEST,NYAMIRAMA,KIGARAMA,KIGARAMA P/S,540,3,0,2,143,289,437,13,450,0,O-55-196-06-01-03
KANUNGU,KINKIZI CTY WEST,NYAMIRAMA,MASHAKU,KYENJOJO/NYABUYONDO I,490,1,0,1,83,306,391,21,412,0,O-55-196-06-02-01
KANUNGU,KINKIZI CTY WEST,NYAMIRAMA,MASHAKU,NYABUYONDO II,474,1,0,4,131,254,390,11,401,0,O-55-196-06-02-02
KANUNGU,KINKIZI CTY WEST,NYAMIRAMA,NTUNGWA,KANIABIZO I,748,4,1,1,185,358,549,26,575,0,O-55-196-06-03-01
KANUNGU,KINKIZI CTY WEST,NYAMIRAMA,NTUNGWA,KANIABIZO II,552,3,0,1,115,330,449,16,465,0,O-55-196-06-03-02
KANUNGU,KINKIZI CTY WEST,NYAMIRAMA,NYAKASHURE,BUYUNDO I,757,8,0,2,169,379,558,6,564,0,O-55-196-06-04-01
KANUNGU,KINKIZI CTY WEST,NYAMIRAMA,NYAKASHURE,BUYUNDO II,515,0,0,1,136,283,420,12,432,0,O-55-196-06-04-02
KANUNGU,KINKIZI CTY WEST,NYAMIRAMA,NYARURAMBI,NYAKAGYERA/MPANGANGO I,481,1,0,1,129,260,391,7,398,0,O-55-196-06-05-01
KANUNGU,KINKIZI CTY WEST,NYAMIRAMA,NYARURAMBI,MPANGANGO II,616,1,1,1,149,349,501,4,505,0,O-55-196-06-05-02
KANUNGU,KINKIZI CTY WEST,NYAMIRAMA,RUSHAKA,KYANTUHE/BUZAKI I,731,3,1,3,152,433,592,18,610,0,O-55-196-06-06-01
KANUNGU,KINKIZI CTY WEST,NYAMIRAMA,RUSHAKA,BUZAKI II,663,6,0,4,168,370,548,16,564,0,O-55-196-06-06-02
IBANDA,IBANDA CTY NORTH,BISHESHE,BUGARAMA,BISHESHE S/COUNTY HQRS,739,1,0,0,78,404,483,12,495,0,O-61-136-01-01-01
IBANDA,IBANDA CTY NORTH,BISHESHE,BUGARAMA,KITONTOMA T.C,496,0,0,1,18,349,368,6,374,0,O-61-136-01-01-02
IBANDA,IBANDA CTY NORTH,BISHESHE,BUGARAMA,BUGARAMA T.C,539,2,0,1,54,254,311,15,326,0,O-61-136-01-01-03
IBANDA,IBANDA CTY NORTH,BISHESHE,BUGARAMA,BUGARAMA PARISH HQRS,545,1,1,0,38,340,380,1,381,0,O-61-136-01-01-04
IBANDA,IBANDA CTY NORTH,BISHESHE,BUGARAMA,KIBAGARWA CENTRAL,243,0,1,1,22,153,177,4,181,0,O-61-136-01-01-05
IBANDA,IBANDA CTY NORTH,BISHESHE,KABARE,KABAARE 1,234,0,0,1,17,134,152,3,155,0,O-61-136-01-02-01
IBANDA,IBANDA CTY NORTH,BISHESHE,KABARE,KABAARE 2,173,0,1,0,41,100,142,6,148,0,O-61-136-01-02-02
IBANDA,IBANDA CTY NORTH,BISHESHE,KABARE,KABAARE 3,192,0,0,0,13,143,156,2,158,0,O-61-136-01-02-03
IBANDA,IBANDA CTY NORTH,BISHESHE,KABARE,KABAARE C.O.U,391,0,0,0,26,244,270,10,280,0,O-61-136-01-02-04
IBANDA,IBANDA CTY NORTH,BISHESHE,KABARE,KABAARE PARISH HQRS,289,0,0,1,32,199,232,1,233,0,O-61-136-01-02-05
IBANDA,IBANDA CTY NORTH,BISHESHE,KABARE,KYEMBOGO PRI. SCHOOL,645,4,0,2,61,400,467,4,471,0,O-61-136-01-02-06
IBANDA,IBANDA CTY NORTH,BISHESHE,KAKATSI,KAKIZERERE,437,1,0,1,55,267,324,6,330,0,O-61-136-01-03-01
IBANDA,IBANDA CTY NORTH,BISHESHE,KAKATSI,MIGYERA P/S / BIGYERA MARKET,451,0,0,1,37,312,350,6,356,0,O-61-136-01-03-02
IBANDA,IBANDA CTY NORTH,BISHESHE,KAKATSI,KAKATSI 4,316,0,0,1,21,143,165,7,172,0,O-61-136-01-03-03
IBANDA,IBANDA CTY NORTH,BISHESHE,KAKATSI,KAKATSI PARISH HQRS / BIGYERA,576,0,3,3,43,301,350,14,364,0,O-61-136-01-03-04
IBANDA,IBANDA CTY NORTH,BISHESHE,KAKATSI,MISHOZI P/S,372,0,1,1,20,259,281,10,291,0,O-61-136-01-03-05
IBANDA,IBANDA CTY NORTH,BISHESHE,KARANGARA,KARANGARA,257,0,0,0,16,140,156,4,160,0,O-61-136-01-04-01
IBANDA,IBANDA CTY NORTH,BISHESHE,KARANGARA,BUGARAMA P/S,457,0,0,2,43,320,365,9,374,0,O-61-136-01-04-02
IBANDA,IBANDA CTY NORTH,BISHESHE,KARANGARA,KATAFARI T.C,647,3,0,2,47,456,508,6,514,0,O-61-136-01-04-03
IBANDA,IBANDA CTY NORTH,BISHESHE,KARANGARA,IREME MARKET,536,0,0,0,25,351,376,60,436,0,O-61-136-01-04-04
IBANDA,IBANDA CTY NORTH,BISHESHE,KARANGARA,NYAKAHAMA P/S,352,0,0,0,30,251,281,5,286,0,O-61-136-01-04-05
IBANDA,IBANDA CTY NORTH,BISHESHE,KASHANGURA,KASHANGURA 1,713,0,2,1,52,481,536,20,556,0,O-61-136-01-05-01
IBANDA,IBANDA CTY NORTH,BISHESHE,KASHANGURA,KASHANGURA 2,545,0,0,1,21,376,398,5,403,0,O-61-136-01-05-02
IBANDA,IBANDA CTY NORTH,BISHESHE,KASHANGURA,KASHANGURA 3,568,1,0,2,47,381,431,9,440,0,O-61-136-01-05-03
IBANDA,IBANDA CTY NORTH,BISHESHE,KYEIKUCU,KYEIKUCU HEALTH CENTRE,342,0,0,0,18,239,257,2,259,0,O-61-136-01-06-01
IBANDA,IBANDA CTY NORTH,BISHESHE,KYEIKUCU,MAHEGA T.C,421,1,0,0,26,312,339,7,346,0,O-61-136-01-06-02
IBANDA,IBANDA CTY NORTH,BISHESHE,KYEIKUCU,RWAMPAGAMA CHURCH,477,1,0,1,15,324,341,9,350,0,O-61-136-01-06-03
IBANDA,IBANDA CTY NORTH,BISHESHE,KYEIKUCU,KYEIKUCU PARISH HQRS,511,0,0,3,43,365,411,6,417,0,O-61-136-01-06-04
IBANDA,IBANDA CTY NORTH,BISHESHE,NYAKATOKYE,KANAAMA P/S,537,1,0,0,40,356,397,3,400,0,O-61-136-01-07-01
IBANDA,IBANDA CTY NORTH,BISHESHE,NYAKATOKYE,NYAMIYAGA,475,1,0,1,33,341,376,7,383,0,O-61-136-01-07-02
IBANDA,IBANDA CTY NORTH,BISHESHE,NYAKATOKYE,KANAAMA,302,0,0,0,18,205,223,5,228,0,O-61-136-01-07-03
IBANDA,IBANDA CTY NORTH,BISHESHE,NYAKATOKYE,NYAKATOOKYE PARISH HQRS,569,1,3,2,37,395,438,5,443,0,O-61-136-01-07-04
IBANDA,IBANDA CTY NORTH,BISHESHE,NYAKATOKYE,NYAKATOOKYE PRII. SCHOOL,287,0,0,0,26,184,210,6,216,0,O-61-136-01-07-05
IBANDA,IBANDA CTY NORTH,BISHESHE,NYAKATOKYE,KAKINDO,385,0,0,1,18,242,261,0,261,0,O-61-136-01-07-06
IBANDA,IBANDA CTY NORTH,ISHONGORORO,BIRONGO,BIRONGO 1,365,2,1,4,28,201,236,22,258,0,O-61-136-02-01-01
IBANDA,IBANDA CTY NORTH,ISHONGORORO,BIRONGO,BIRONGO 2,781,4,1,4,66,448,523,13,536,0,O-61-136-02-01-02
IBANDA,IBANDA CTY NORTH,ISHONGORORO,BIRONGO,RWAMBU,436,0,0,7,34,252,293,5,298,0,O-61-136-02-01-03
IBANDA,IBANDA CTY NORTH,ISHONGORORO,BIRONGO,BIRONGO 3,634,0,3,4,103,321,431,3,434,0,O-61-136-02-01-04
IBANDA,IBANDA CTY NORTH,ISHONGORORO,BIRONGO,BIRONGO 4,267,0,2,1,19,180,202,6,208,0,O-61-136-02-01-05
IBANDA,IBANDA CTY NORTH,ISHONGORORO,KAKINGA,KAKINGA 1,468,4,0,1,58,229,292,3,295,0,O-61-136-02-02-01
IBANDA,IBANDA CTY NORTH,ISHONGORORO,KAKINGA,KAKINGA 2,808,2,0,1,87,497,587,16,603,0,O-61-136-02-02-02
IBANDA,IBANDA CTY NORTH,ISHONGORORO,KAKINGA,KAKINGA 3,565,1,0,1,36,342,380,10,390,0,O-61-136-02-02-03
IBANDA,IBANDA CTY NORTH,ISHONGORORO,KAKINGA,KAKINGA 4,640,1,1,3,87,322,414,6,420,0,O-61-136-02-02-04
IBANDA,IBANDA CTY NORTH,ISHONGORORO,KAKINGA,KAKINGA 5,403,0,1,0,39,154,194,1,195,0,O-61-136-02-02-05
IBANDA,IBANDA CTY NORTH,ISHONGORORO,KAKINGA,KAKINDO,525,1,0,0,36,299,336,5,341,0,O-61-136-02-02-06
IBANDA,IBANDA CTY NORTH,ISHONGORORO,KASHOZI,KASHOZI 1,253,0,0,3,30,171,204,2,206,0,O-61-136-02-03-01
IBANDA,IBANDA CTY NORTH,ISHONGORORO,KASHOZI,KASHOZI 2,574,1,1,1,67,364,434,7,441,0,O-61-136-02-03-02
IBANDA,IBANDA CTY NORTH,ISHONGORORO,KASHOZI,KASHOZI 3,313,2,0,1,15,210,228,3,231,0,O-61-136-02-03-03
IBANDA,IBANDA CTY NORTH,ISHONGORORO,KASHOZI,KASHOZI 4,408,3,0,4,37,236,280,5,285,0,O-61-136-02-03-04
IBANDA,IBANDA CTY NORTH,ISHONGORORO,KASHOZI,KANIAMPIHA,368,0,0,2,21,270,293,4,297,0,O-61-136-02-03-05
IBANDA,IBANDA CTY NORTH,ISHONGORORO,KASHOZI,KASHOZI 6,318,0,1,0,17,204,222,2,224,0,O-61-136-02-03-06
IBANDA,IBANDA CTY NORTH,ISHONGORORO,KASHOZI,KASHOZI 7,633,2,0,0,48,395,445,5,450,0,O-61-136-02-03-07
IBANDA,IBANDA CTY NORTH,ISHONGORORO,KIJONGO,KIJONGO I,313,0,0,0,21,207,228,3,231,0,O-61-136-02-04-01
IBANDA,IBANDA CTY NORTH,ISHONGORORO,KIJONGO,KIJONGO 2,575,2,0,5,65,350,422,3,425,0,O-61-136-02-04-02
IBANDA,IBANDA CTY NORTH,ISHONGORORO,KIJONGO,KIJONGO 3,702,1,0,2,60,411,474,7,481,0,O-61-136-02-04-03
IBANDA,IBANDA CTY NORTH,ISHONGORORO,KIJONGO,KIJONGO 4,719,1,1,4,67,399,472,5,477,0,O-61-136-02-04-04
IBANDA,IBANDA CTY NORTH,ISHONGORORO,KIJONGO,KIJONGO 7,543,1,0,1,67,311,380,7,387,0,O-61-136-02-04-05
IBANDA,IBANDA CTY NORTH,ISHONGORORO,NYANTSIMBO,NYANTSIMBO 1,611,1,1,0,98,276,376,5,381,0,O-61-136-02-05-01
IBANDA,IBANDA CTY NORTH,ISHONGORORO,NYANTSIMBO,NYANTSIMBO 2,450,0,0,3,46,239,288,6,294,0,O-61-136-02-05-02
IBANDA,IBANDA CTY NORTH,ISHONGORORO,NYANTSIMBO,NYANTSIMBO 3,376,3,0,2,32,235,272,1,273,0,O-61-136-02-05-03
IBANDA,IBANDA CTY NORTH,ISHONGORORO,NYANTSIMBO,NYANTSIMBO 4,516,0,0,0,47,308,355,9,364,0,O-61-136-02-05-04
IBANDA,IBANDA CTY NORTH,ISHONGORORO,NYANTSIMBO,NYANTSIMBO 5,677,1,1,2,74,311,389,12,401,0,O-61-136-02-05-05
IBANDA,IBANDA CTY NORTH,ISHONGORORO,NYANTSIMBO,NYANTSIMBO 6,856,5,0,3,119,482,609,8,617,0,O-61-136-02-05-06
IBANDA,IBANDA CTY NORTH,ISHONGORORO,NYANTSIMBO,NYANTSIMBO 7,472,1,0,0,36,347,384,2,386,0,O-61-136-02-05-07
IBANDA,IBANDA CTY NORTH,NYAMAREBE,BIHANGA,BIHANGA 1,429,0,0,2,53,272,327,2,329,0,O-61-136-03-01-01
IBANDA,IBANDA CTY NORTH,NYAMAREBE,BIHANGA,BIHANGA 2,654,1,0,6,41,376,424,8,432,0,O-61-136-03-01-02
IBANDA,IBANDA CTY NORTH,NYAMAREBE,BIHANGA,BIHANGA 3,625,1,0,1,58,396,456,7,463,0,O-61-136-03-01-03
IBANDA,IBANDA CTY NORTH,NYAMAREBE,BIHANGA,BIHANGA 4,589,1,0,2,29,427,459,1,460,0,O-61-136-03-01-04
IBANDA,IBANDA CTY NORTH,NYAMAREBE,BIHANGA,BIHANGA 5,480,0,1,1,18,325,345,4,349,0,O-61-136-03-01-05
IBANDA,IBANDA CTY NORTH,NYAMAREBE,BIHANGA,BIHANGA BARRACKS OUTSIDE Q.,184,0,0,0,14,169,183,1,184,0,O-61-136-03-01-06
IBANDA,IBANDA CTY NORTH,NYAMAREBE,KYENGANDO,KYENGANDO 1,398,2,0,2,13,182,199,2,201,0,O-61-136-03-02-01
IBANDA,IBANDA CTY NORTH,NYAMAREBE,KYENGANDO,KYENGANDO 2,814,3,0,0,50,413,466,14,480,0,O-61-136-03-02-02
IBANDA,IBANDA CTY NORTH,NYAMAREBE,KYENGANDO,KYENGANDO 3,328,2,0,0,20,235,257,1,258,0,O-61-136-03-02-03
IBANDA,IBANDA CTY NORTH,NYAMAREBE,KYENGANDO,KYENGANDO 4,462,0,0,0,10,166,176,4,180,0,O-61-136-03-02-04
IBANDA,IBANDA CTY NORTH,NYAMAREBE,KYENGANDO,KYENGANDO 5,242,0,0,0,6,129,135,4,139,0,O-61-136-03-02-05
IBANDA,IBANDA CTY NORTH,NYAMAREBE,KYENGANDO,KYENGANDO 6,245,0,0,0,6,129,135,4,139,0,O-61-136-03-02-06
IBANDA,IBANDA CTY NORTH,NYAMAREBE,KYENGANDO,KYENGANDO 7,565,0,0,1,20,320,341,7,348,0,O-61-136-03-02-07
IBANDA,IBANDA CTY NORTH,NYAMAREBE,KYENGANDO,KYENGANDO 8,313,1,1,1,28,170,201,2,203,0,O-61-136-03-02-08
IBANDA,IBANDA CTY NORTH,NYAMAREBE,RUSHANGO,RUSHANGO 1,663,2,0,3,24,399,428,7,435,0,O-61-136-03-03-01
IBANDA,IBANDA CTY NORTH,NYAMAREBE,RUSHANGO,RUSHANGO 2,580,1,0,6,32,376,415,8,423,0,O-61-136-03-03-02
IBANDA,IBANDA CTY NORTH,NYAMAREBE,RUSHANGO,RUSHANGO 3,732,1,0,1,34,401,437,12,449,0,O-61-136-03-03-03
IBANDA,IBANDA CTY NORTH,NYAMAREBE,RUSHANGO,KATIKAMWE/KAGOMA,591,0,0,2,10,351,363,5,368,0,O-61-136-03-03-04
IBANDA,IBANDA CTY NORTH,NYAMAREBE,RUSHANGO,MITWEBIRI,409,1,0,4,21,260,286,3,289,0,O-61-136-03-03-05
IBANDA,IBANDA CTY SOUTH,IBANDA TOWN COUNCIL,BUFUNDA,IBANDA C.O.U,503,1,0,0,36,345,382,9,391,0,O-61-137-01-01-01
IBANDA,IBANDA CTY SOUTH,IBANDA TOWN COUNCIL,BUFUNDA,IBANDA,400,0,3,0,59,173,235,2,237,0,O-61-137-01-01-02
IBANDA,IBANDA CTY SOUTH,IBANDA TOWN COUNCIL,BUFUNDA,JUBILEE/KITWE,494,0,0,0,77,246,323,4,327,0,O-61-137-01-01-03
IBANDA,IBANDA CTY SOUTH,IBANDA TOWN COUNCIL,BUFUNDA,IBANDA DIST. HQRS,480,0,1,1,65,288,355,2,357,0,O-61-137-01-01-04
IBANDA,IBANDA CTY SOUTH,IBANDA TOWN COUNCIL,BUFUNDA,IBANDA MAIN STREET,484,0,0,0,85,210,295,4,299,0,O-61-137-01-01-05
IBANDA,IBANDA CTY SOUTH,IBANDA TOWN COUNCIL,BUFUNDA,NYAKATETE PRI. SCHOOL,337,2,0,1,38,217,258,2,260,0,O-61-137-01-01-06
IBANDA,IBANDA CTY SOUTH,IBANDA TOWN COUNCIL,BUFUNDA,BUKUTO/KAGORORO,230,0,0,0,14,180,194,4,198,0,O-61-137-01-01-07
IBANDA,IBANDA CTY SOUTH,IBANDA TOWN COUNCIL,BUFUNDA,SAAZA PLAYGROUND,508,0,0,1,44,368,413,5,418,0,O-61-137-01-01-08
IBANDA,IBANDA CTY SOUTH,IBANDA TOWN COUNCIL,BUFUNDA,KYEGWISA,280,1,0,0,33,200,234,2,236,0,O-61-137-01-01-09
IBANDA,IBANDA CTY SOUTH,IBANDA TOWN COUNCIL,BUFUNDA,BUFUNDA PRI. SCHOOL,543,2,0,1,44,334,381,3,384,0,O-61-137-01-01-10
IBANDA,IBANDA CTY SOUTH,IBANDA TOWN COUNCIL,BUFUNDA,IBANDA SAAZA HQRS,492,0,0,0,61,258,319,1,320,0,O-61-137-01-01-11
IBANDA,IBANDA CTY SOUTH,IBANDA TOWN COUNCIL,BUFUNDA,MPIIRA,303,1,0,0,42,142,185,4,189,0,O-61-137-01-01-12
IBANDA,IBANDA CTY SOUTH,IBANDA TOWN COUNCIL,BUFUNDA,BUFUNDA STREET,533,1,0,0,79,217,297,4,301,0,O-61-137-01-01-13
IBANDA,IBANDA CTY SOUTH,IBANDA TOWN COUNCIL,BUFUNDA,KIGARAMA T/C,663,0,1,1,67,414,483,4,487,0,O-61-137-01-01-14
IBANDA,IBANDA CTY SOUTH,IBANDA TOWN COUNCIL,KAGONGO WARD,RUHOOKO T.C,311,1,0,0,26,166,193,0,193,0,O-61-137-01-02-01
IBANDA,IBANDA CTY SOUTH,IBANDA TOWN COUNCIL,KAGONGO WARD,KATOOMA CATHOLIC CHURCH,689,1,0,0,46,475,522,8,530,0,O-61-137-01-02-02
IBANDA,IBANDA CTY SOUTH,IBANDA TOWN COUNCIL,KAGONGO WARD,KAGONGO/KASHARARA,823,1,2,4,120,349,476,8,484,0,O-61-137-01-02-03
IBANDA,IBANDA CTY SOUTH,IBANDA TOWN COUNCIL,KAGONGO WARD,KYEIKUCU,457,1,0,1,63,262,327,11,338,0,O-61-137-01-02-04
IBANDA,IBANDA CTY SOUTH,IBANDA TOWN COUNCIL,KAGONGO WARD,IBANDA DEMO PRI. SCHOOL,442,0,0,1,41,252,294,8,302,0,O-61-137-01-02-05
IBANDA,IBANDA CTY SOUTH,IBANDA TOWN COUNCIL,KAGONGO WARD,NYAKATOOKYE,401,0,0,1,14,293,308,5,313,0,O-61-137-01-02-06
IBANDA,IBANDA CTY SOUTH,IBANDA TOWN COUNCIL,KAGONGO WARD,RUGAZI PRI. SCHOOL,446,0,0,1,28,325,354,7,361,0,O-61-137-01-02-07
IBANDA,IBANDA CTY SOUTH,IBANDA TOWN COUNCIL,KAGONGO WARD,KASHAKA T.C,343,1,1,1,27,259,289,5,294,0,O-61-137-01-02-08
IBANDA,IBANDA CTY SOUTH,KICUZI,IRIMYA,KWEREBERERA PRI. SCHOOL 1,529,1,0,2,30,341,374,9,383,0,O-61-137-02-01-01
IBANDA,IBANDA CTY SOUTH,KICUZI,IRIMYA,KWEREBERERA PRI. SCHOOL 2,412,1,0,3,15,250,269,16,285,0,O-61-137-02-01-02
IBANDA,IBANDA CTY SOUTH,KICUZI,IRIMYA,IRIMYA P/S,677,10,1,8,64,330,413,18,431,0,O-61-137-02-01-03
IBANDA,IBANDA CTY SOUTH,KICUZI,IRIMYA,IRIMYA HEALTH CENTRE II,682,7,2,12,53,339,413,19,432,0,O-61-137-02-01-04
IBANDA,IBANDA CTY SOUTH,KICUZI,KANYWAMBOGO,RYABATENGA SEC. SCHOOL,722,5,1,7,51,509,573,16,589,0,O-61-137-02-02-01
IBANDA,IBANDA CTY SOUTH,KICUZI,KANYWAMBOGO,KANYWAMBOGO PARISH HQRS,484,1,0,3,63,307,374,7,381,0,O-61-137-02-02-02
IBANDA,IBANDA CTY SOUTH,KICUZI,KICUZI,KICUZI PRI. SCHOOL 1,367,2,0,5,6,335,348,6,354,0,O-61-137-02-03-01
IBANDA,IBANDA CTY SOUTH,KICUZI,KICUZI,KICUZI PRI. SCHOOL 2,633,4,0,7,26,504,541,10,551,0,O-61-137-02-03-02
IBANDA,IBANDA CTY SOUTH,KICUZI,KICUZI,MUTUURE PRI. SCHOOL 1,332,2,0,1,4,300,307,4,311,0,O-61-137-02-03-03
IBANDA,IBANDA CTY SOUTH,KICUZI,KICUZI,MUTUURE PRI. SCHOOL 2,359,4,0,1,3,290,298,4,302,0,O-61-137-02-03-04
IBANDA,IBANDA CTY SOUTH,KIKYENKYE,KEIHANGARA,KEIHANGARA 1,671,1,0,4,59,434,498,5,503,0,O-61-137-03-01-01
IBANDA,IBANDA CTY SOUTH,KIKYENKYE,KEIHANGARA,KEIHANGARA 4,420,0,0,1,36,272,309,12,321,0,O-61-137-03-01-02
IBANDA,IBANDA CTY SOUTH,KIKYENKYE,KEIHANGARA,KEIHANGARA 5,400,0,0,0,66,199,265,2,267,0,O-61-137-03-01-03
IBANDA,IBANDA CTY SOUTH,KIKYENKYE,KEIHANGARA,KEIHANGARA 6,580,2,0,2,35,381,420,10,430,0,O-61-137-03-01-04
IBANDA,IBANDA CTY SOUTH,KIKYENKYE,KEIHANGARA,KEIHANGARA 7,600,1,0,0,54,389,444,2,446,0,O-61-137-03-01-05
IBANDA,IBANDA CTY SOUTH,KIKYENKYE,KEIHANGARA,KANYEGANYEGYE,171,0,0,0,12,131,143,8,151,0,O-61-137-03-01-06
IBANDA,IBANDA CTY SOUTH,KIKYENKYE,KEIHANGARA,NGANGO,439,0,0,3,23,349,375,4,379,0,O-61-137-03-01-07
IBANDA,IBANDA CTY SOUTH,KIKYENKYE,KIHANI,KIHANI 1,392,0,0,2,35,265,302,7,309,0,O-61-137-03-02-01
IBANDA,IBANDA CTY SOUTH,KIKYENKYE,KIHANI,KIHANI 2,542,4,2,5,33,349,393,10,403,0,O-61-137-03-02-02
IBANDA,IBANDA CTY SOUTH,KIKYENKYE,KIHANI,KIHANI 3,503,1,0,1,36,304,342,2,344,0,O-61-137-03-02-03
IBANDA,IBANDA CTY SOUTH,KIKYENKYE,KIHANI,KIHANI 4,510,1,0,1,36,304,342,2,344,0,O-61-137-03-02-04
IBANDA,IBANDA CTY SOUTH,KIKYENKYE,KIHANI,KIHANI / NYAKABINGO,350,2,0,0,35,207,244,1,245,0,O-61-137-03-02-05
IBANDA,IBANDA CTY SOUTH,KIKYENKYE,KIHANI,SIGIRIRA,236,0,0,0,5,202,207,1,208,0,O-61-137-03-02-06
IBANDA,IBANDA CTY SOUTH,KIKYENKYE,KIHANI,RWANKUBA,434,3,0,0,32,293,328,1,329,0,O-61-137-03-02-07
IBANDA,IBANDA CTY SOUTH,KIKYENKYE,RUGAAGA,RUGAAGA 1,649,1,0,3,51,414,469,7,476,0,O-61-137-03-03-01
IBANDA,IBANDA CTY SOUTH,KIKYENKYE,RUGAAGA,RUGAAGA 2,527,3,1,1,63,318,386,6,392,0,O-61-137-03-03-02
IBANDA,IBANDA CTY SOUTH,KIKYENKYE,RUGAAGA,RUGAAGA 3,501,1,0,2,37,328,368,0,368,0,O-61-137-03-03-03
IBANDA,IBANDA CTY SOUTH,KIKYENKYE,RUGAAGA,RUGAAGA 4,414,0,1,2,47,264,314,0,314,0,O-61-137-03-03-04
IBANDA,IBANDA CTY SOUTH,KIKYENKYE,RUGAAGA,RUGAAGA 5,460,0,0,2,55,290,347,2,349,0,O-61-137-03-03-05
IBANDA,IBANDA CTY SOUTH,KIKYENKYE,RUGAAGA,RUGAAGA 6,404,4,0,1,37,254,296,8,304,0,O-61-137-03-03-06
IBANDA,IBANDA CTY SOUTH,KIKYENKYE,RUGAAGA,KABURO,440,3,0,3,56,297,359,4,363,0,O-61-137-03-03-07
IBANDA,IBANDA CTY SOUTH,KIKYENKYE,RWENGWE,RWENGWE 1,574,1,0,1,34,376,412,4,416,0,O-61-137-03-04-01
IBANDA,IBANDA CTY SOUTH,KIKYENKYE,RWENGWE,RWENGWE 2,543,0,0,0,25,377,402,6,408,0,O-61-137-03-04-02
IBANDA,IBANDA CTY SOUTH,KIKYENKYE,RWENGWE,RWENGWE 3,725,2,0,4,52,502,560,8,568,0,O-61-137-03-04-03
IBANDA,IBANDA CTY SOUTH,KIKYENKYE,RWENGWE,RWENGWE 4,754,4,0,7,66,467,544,2,546,0,O-61-137-03-04-04
IBANDA,IBANDA CTY SOUTH,KIKYENKYE,RWENGWE,RWENGWE 5,728,3,0,4,44,473,524,1,525,0,O-61-137-03-04-05
IBANDA,IBANDA CTY SOUTH,KIKYENKYE,RWENGWE,KAMIGAMBA,258,4,0,1,23,171,199,3,202,0,O-61-137-03-04-06
IBANDA,IBANDA CTY SOUTH,NYABUHIKYE,BWAHWA,BWAHWA I,603,0,0,3,6,523,532,4,536,0,O-61-137-04-01-01
IBANDA,IBANDA CTY SOUTH,NYABUHIKYE,BWAHWA,BWAHWA II PRI. SCHOOL,447,0,0,1,6,341,348,19,367,0,O-61-137-04-01-02
IBANDA,IBANDA CTY SOUTH,NYABUHIKYE,KANYANSHEKO,KANYENSHEKO 1,577,1,0,0,26,427,454,11,465,0,O-61-137-04-02-01
IBANDA,IBANDA CTY SOUTH,NYABUHIKYE,KANYANSHEKO,KANYANSHEKO 2,585,1,0,1,30,446,478,5,483,0,O-61-137-04-02-02
IBANDA,IBANDA CTY SOUTH,NYABUHIKYE,KAYENJE,KAYENJE 1,705,1,0,2,40,460,503,17,520,0,O-61-137-04-03-01
IBANDA,IBANDA CTY SOUTH,NYABUHIKYE,KAYENJE,KAYENJE 2,662,0,0,1,30,400,431,6,437,0,O-61-137-04-03-02
IBANDA,IBANDA CTY SOUTH,NYABUHIKYE,KAYENJE,RUYONZA PRI. SCHOOL,390,2,0,0,28,249,279,3,282,0,O-61-137-04-03-03
IBANDA,IBANDA CTY SOUTH,NYABUHIKYE,KAYENJE,KAYENJE 4,569,2,0,0,21,425,448,6,454,0,O-61-137-04-03-04
IBANDA,IBANDA CTY SOUTH,NYABUHIKYE,NSASI,NYABUGANDO,247,0,0,1,9,184,194,3,197,0,O-61-137-04-04-01
IBANDA,IBANDA CTY SOUTH,NYABUHIKYE,NSASI,NSANSI 2,531,0,2,0,21,376,399,3,402,0,O-61-137-04-04-02
IBANDA,IBANDA CTY SOUTH,NYABUHIKYE,NSASI,NSANSI 3,428,0,1,1,36,293,331,10,341,0,O-61-137-04-04-03
IBANDA,IBANDA CTY SOUTH,NYABUHIKYE,NSASI,NSANSI 4,635,1,2,1,37,453,494,7,501,0,O-61-137-04-04-04
IBANDA,IBANDA CTY SOUTH,NYABUHIKYE,NYAMIRIMA,NYAMIRIMA 1,404,0,0,3,16,359,378,12,390,0,O-61-137-04-05-01
IBANDA,IBANDA CTY SOUTH,NYABUHIKYE,NYAMIRIMA,NYAMIRIMA 2,625,2,0,2,85,349,438,14,452,0,O-61-137-04-05-02
IBANDA,IBANDA CTY SOUTH,NYABUHIKYE,NYAMIRIMA,NYAMIRIMA 3,528,2,1,1,30,366,400,6,406,0,O-61-137-04-05-03
IBANDA,IBANDA CTY SOUTH,NYABUHIKYE,NYAMIRIMA,KAGANDO CATHOLIC CHURCH,715,2,0,1,12,581,596,4,600,0,O-61-137-04-05-04
IBANDA,IBANDA CTY SOUTH,NYABUHIKYE,NYAMIRIMA,RWENSINGA,387,0,0,0,23,257,280,10,290,0,O-61-137-04-05-05
IBANDA,IBANDA CTY SOUTH,NYABUHIKYE,RWOBUZIZI,RWOBUZIZI I,540,1,1,1,18,347,368,9,377,0,O-61-137-04-06-01
IBANDA,IBANDA CTY SOUTH,NYABUHIKYE,RWOBUZIZI,KATEMBE,214,1,0,0,6,142,149,2,151,0,O-61-137-04-06-02
IBANDA,IBANDA CTY SOUTH,NYABUHIKYE,RWOBUZIZI,RWOBUZIZI II,635,2,0,1,58,408,469,0,469,0,O-61-137-04-06-03
IBANDA,IBANDA CTY SOUTH,RUKIRI,BWENDA,RUKIRI SUB COUNTY,576,1,1,1,28,456,487,5,492,0,O-61-137-05-01-01
IBANDA,IBANDA CTY SOUTH,RUKIRI,BWENDA,BWENDA PLAYGROUND,518,0,0,3,24,432,459,4,463,0,O-61-137-05-01-02
IBANDA,IBANDA CTY SOUTH,RUKIRI,BWENDA,NTUNGAMO P/S,472,0,0,0,34,362,396,5,401,0,O-61-137-05-01-03
IBANDA,IBANDA CTY SOUTH,RUKIRI,KATEMBE,KAIJORORONGA P/S,543,1,0,0,43,410,454,1,455,0,O-61-137-05-02-01
IBANDA,IBANDA CTY SOUTH,RUKIRI,KATEMBE,KATEMBE TRADING CENTRE,519,0,0,0,14,438,452,0,452,0,O-61-137-05-02-02
IBANDA,IBANDA CTY SOUTH,RUKIRI,KATEMBE,KIBANDE P/S,248,0,0,1,8,207,216,3,219,0,O-61-137-05-02-03
IBANDA,IBANDA CTY SOUTH,RUKIRI,KATEMBE,MUGARAMA,377,2,0,3,12,327,344,6,350,0,O-61-137-05-02-04
IBANDA,IBANDA CTY SOUTH,RUKIRI,KIGUNGA,KIGUNGA PLAYGROUND,364,1,1,2,20,320,344,20,364,0,O-61-137-05-03-01
IBANDA,IBANDA CTY SOUTH,RUKIRI,KIGUNGA,RWOBUHUNGYE CHURCH,120,1,0,0,2,98,101,0,101,0,O-61-137-05-03-02
IBANDA,IBANDA CTY SOUTH,RUKIRI,KIGUNGA,KIGUNGA CATHOLIC CHURCH,562,1,1,2,30,496,530,6,536,0,O-61-137-05-03-03
IBANDA,IBANDA CTY SOUTH,RUKIRI,MABONA,MABONWA P/S,685,1,0,3,33,542,579,5,584,0,O-61-137-05-04-01
IBANDA,IBANDA CTY SOUTH,RUKIRI,MABONA,MIGAMBA/IKIKONA TRADING CEN,707,2,1,4,26,553,586,10,596,0,O-61-137-05-04-02
IBANDA,IBANDA CTY SOUTH,RUKIRI,MABONA,MABONA C.O.U,154,0,0,0,7,141,148,2,150,0,O-61-137-05-04-03
IBANDA,IBANDA CTY SOUTH,RUKIRI,MPASHA,MPASHA P/S,515,1,1,5,45,398,450,8,458,0,O-61-137-05-05-01
IBANDA,IBANDA CTY SOUTH,RUKIRI,MPASHA,RWENGOGOGORO TRADING CEN,604,1,0,1,34,482,518,4,522,0,O-61-137-05-05-02
IBANDA,IBANDA CTY SOUTH,RUKIRI,MPASHA,KANONI PLAYGROUND,320,1,0,0,36,227,264,2,266,0,O-61-137-05-05-03
IBANDA,IBANDA CTY SOUTH,RUKIRI,MPASHA,KYANIKA,237,0,0,0,4,203,207,2,209,0,O-61-137-05-05-04
IBANDA,IBANDA CTY SOUTH,RUKIRI,NYARUKIIKA,NYARUKIIKA PLAYGROUND 1,534,0,0,2,51,398,451,7,458,0,O-61-137-05-06-01
IBANDA,IBANDA CTY SOUTH,RUKIRI,NYARUKIIKA,NYARUKIIKA PLAYGROUND 2,421,3,0,0,35,303,341,14,355,0,O-61-137-05-06-02
IBANDA,IBANDA CTY SOUTH,RUKIRI,NYARUKIIKA,RWENSINGA,309,0,0,1,40,225,266,6,272,0,O-61-137-05-06-03
IBANDA,IBANDA CTY SOUTH,RUKIRI,NYARUKIIKA,RUGARAMA,264,1,0,0,9,216,226,7,233,0,O-61-137-05-06-04
ISINGIRO,BUKANGA COUNTY,ENDINZI,BUSHEKA,BUSHEKA 1,473,0,0,0,13,444,457,4,461,0,O-62-135-01-01-01
ISINGIRO,BUKANGA COUNTY,ENDINZI,BUSHEKA,BUSHEKA [A - L],519,0,0,0,0,0,0,0,0,1,O-62-135-01-01-02
ISINGIRO,BUKANGA COUNTY,ENDINZI,BUSHEKA,BUSHEKA [M - Z],441,0,0,0,2,438,440,0,440,0,O-62-135-01-01-03
ISINGIRO,BUKANGA COUNTY,ENDINZI,BUSHEKA,RWAMBAGA,268,0,0,0,0,267,267,0,267,0,O-62-135-01-01-04
ISINGIRO,BUKANGA COUNTY,ENDINZI,KIKOBA,KIKOBA 1,510,2,0,3,29,462,496,7,503,0,O-62-135-01-02-01
ISINGIRO,BUKANGA COUNTY,ENDINZI,KIKOBA,KIKOBA 2,665,3,0,1,70,571,645,7,652,0,O-62-135-01-02-02
ISINGIRO,BUKANGA COUNTY,ENDINZI,KIKOBA,KAMAANYA A & B,357,1,0,0,23,325,349,5,354,0,O-62-135-01-02-03
ISINGIRO,BUKANGA COUNTY,ENDINZI,KIKOBA,ENDIINZI S/COUNTY HQRS,356,0,0,1,14,334,349,7,356,0,O-62-135-01-02-04
ISINGIRO,BUKANGA COUNTY,ENDINZI,NYABYONDO,NYABYONDO 1,334,0,0,0,20,258,278,5,283,0,O-62-135-01-03-01
ISINGIRO,BUKANGA COUNTY,ENDINZI,NYABYONDO,NYABYONDO 2,628,0,0,0,49,561,610,3,613,0,O-62-135-01-03-02
ISINGIRO,BUKANGA COUNTY,ENDINZI,NYABYONDO,ENDIINZI P/S,249,0,0,0,1,245,246,3,249,0,O-62-135-01-03-03
ISINGIRO,BUKANGA COUNTY,ENDINZI,NYABYONDO,MPIKYE C.O.U,306,1,0,0,7,297,305,0,305,0,O-62-135-01-03-04
ISINGIRO,BUKANGA COUNTY,ENDINZI,RWANJOGYERA,RWANJOGYERA 2,723,0,0,2,46,669,717,5,722,0,O-62-135-01-04-01
ISINGIRO,BUKANGA COUNTY,ENDINZI,RWANJOGYERA,RWANJOGYERA 3,833,0,0,1,14,806,821,11,832,0,O-62-135-01-04-02
ISINGIRO,BUKANGA COUNTY,ENDINZI,RWANTAHA,RWANTAHA 1,348,0,0,3,10,300,313,35,348,0,O-62-135-01-05-01
ISINGIRO,BUKANGA COUNTY,ENDINZI,RWANTAHA,KYABUZAARE MARKET,208,0,0,0,3,195,198,2,200,0,O-62-135-01-05-02
ISINGIRO,BUKANGA COUNTY,ENDINZI,RWANTAHA,NYAKAHIMBURA C.O.U,432,0,0,4,6,402,412,13,425,0,O-62-135-01-05-03
ISINGIRO,BUKANGA COUNTY,KASHUMBA,KASHUMBA,KASHUMBA 1,673,1,0,4,30,434,469,14,483,0,O-62-135-02-01-01
ISINGIRO,BUKANGA COUNTY,KASHUMBA,KASHUMBA,KASHUMBA 2,420,1,0,0,10,400,411,8,419,0,O-62-135-02-01-02
ISINGIRO,BUKANGA COUNTY,KASHUMBA,KASHUMBA,JURU,795,4,1,2,47,640,694,8,702,0,O-62-135-02-01-03
ISINGIRO,BUKANGA COUNTY,KASHUMBA,KASHUMBA,KANGINGI/KAGANGO,283,0,0,0,0,0,0,0,0,1,O-62-135-02-01-04
ISINGIRO,BUKANGA COUNTY,KASHUMBA,KASHUMBA,KASHOJWA/RUKINGA,328,3,0,0,22,239,264,5,269,0,O-62-135-02-01-05
ISINGIRO,BUKANGA COUNTY,KASHUMBA,KIGARAGARA,KIGARAGARA P/S [A - K],497,0,0,1,36,442,479,12,491,0,O-62-135-02-02-01
ISINGIRO,BUKANGA COUNTY,KASHUMBA,KIGARAGARA,KASHESHE P/S [A - K],466,1,0,1,35,404,441,5,446,0,O-62-135-02-02-02
ISINGIRO,BUKANGA COUNTY,KASHUMBA,KIGARAGARA,KIYENJE P/S,612,2,1,3,20,577,603,3,606,0,O-62-135-02-02-03
ISINGIRO,BUKANGA COUNTY,KASHUMBA,KIGARAGARA,KASHUMBA INTERGRATED P/S,634,1,0,2,23,602,628,6,634,0,O-62-135-02-02-04
ISINGIRO,BUKANGA COUNTY,KASHUMBA,KIGARAGARA,KIGARAGARA P/S [L - Z],477,2,0,1,55,331,389,8,397,0,O-62-135-02-02-05
ISINGIRO,BUKANGA COUNTY,KASHUMBA,KIGARAGARA,KASHESHE P/S [L - Z],454,1,0,1,45,375,422,12,434,0,O-62-135-02-02-06
ISINGIRO,BUKANGA COUNTY,KASHUMBA,MUREMA,MUREMA 1/MUREMA P/S [A - L],78,0,0,0,1,77,78,0,78,0,O-62-135-02-03-01
ISINGIRO,BUKANGA COUNTY,KASHUMBA,MUREMA,MUREMA 2/KABURA P/S [A - K],447,1,2,0,35,355,393,8,401,0,O-62-135-02-03-02
ISINGIRO,BUKANGA COUNTY,KASHUMBA,MUREMA,MUREMA 3/KITEREDE P/S,513,1,0,0,2,510,513,0,513,0,O-62-135-02-03-03
ISINGIRO,BUKANGA COUNTY,KASHUMBA,MUREMA,MUREMA 1/MUREMA P/S [M - Z],719,1,2,1,25,680,709,3,712,0,O-62-135-02-03-04
ISINGIRO,BUKANGA COUNTY,KASHUMBA,MUREMA,MUREMA 2/KABURA P/S [L - Z],541,1,1,2,72,363,439,10,449,0,O-62-135-02-03-05
ISINGIRO,BUKANGA COUNTY,MBARE,KIHANDA,KIHANDA 1,522,0,0,0,6,500,506,8,514,0,O-62-135-03-01-01
ISINGIRO,BUKANGA COUNTY,MBARE,KIHANDA,KIHANDA 2,153,0,0,0,0,150,150,3,153,0,O-62-135-03-01-02
ISINGIRO,BUKANGA COUNTY,MBARE,KIHANDA,KIHANDA SEC. SCHOOL,425,0,0,1,20,392,413,6,419,0,O-62-135-03-01-03
ISINGIRO,BUKANGA COUNTY,MBARE,KIHANDA,KIREBAREBE,567,0,0,0,37,464,501,4,505,0,O-62-135-03-01-04
ISINGIRO,BUKANGA COUNTY,MBARE,KYABAHESI,KYABAHESI P/S,434,4,0,2,95,272,373,27,400,0,O-62-135-03-02-01
ISINGIRO,BUKANGA COUNTY,MBARE,KYABAHESI,KAHUNGYE P/S,568,3,0,2,47,366,418,4,422,0,O-62-135-03-02-02
ISINGIRO,BUKANGA COUNTY,MBARE,KYABAHESI,KORANORYA T/C,824,3,1,2,105,551,662,14,676,0,O-62-135-03-02-03
ISINGIRO,BUKANGA COUNTY,MBARE,KYABAHESI,KATOJO CHURCH,399,0,0,0,0,0,0,0,0,1,O-62-135-03-02-04
ISINGIRO,BUKANGA COUNTY,MBARE,NSHORORO,MBAARE P/S,581,0,0,2,48,513,563,7,570,0,O-62-135-03-03-01
ISINGIRO,BUKANGA COUNTY,MBARE,NSHORORO,BUJUBWE,642,8,0,2,47,582,639,2,641,0,O-62-135-03-03-02
ISINGIRO,BUKANGA COUNTY,MBARE,NSHORORO,NSHORORO P/S,440,3,0,0,8,421,432,1,433,0,O-62-135-03-03-03
ISINGIRO,BUKANGA COUNTY,MBARE,NSHORORO,BUGANGO,813,0,0,0,0,0,0,0,0,1,O-62-135-03-03-04
ISINGIRO,BUKANGA COUNTY,MBARE,NYAMARUNGI,BURIGI CHURCH,390,0,0,0,14,375,389,0,389,0,O-62-135-03-04-01
ISINGIRO,BUKANGA COUNTY,MBARE,NYAMARUNGI,NYAMARUNGI P/S,782,0,0,2,63,711,776,0,776,0,O-62-135-03-04-02
ISINGIRO,BUKANGA COUNTY,MBARE,NYAMARUNGI,BUHUNGA P/S,449,0,2,0,56,383,441,6,447,0,O-62-135-03-04-03
ISINGIRO,BUKANGA COUNTY,MBARE,RUTEETE,RUTEETE I,484,1,0,3,22,408,434,27,461,0,O-62-135-03-05-01
ISINGIRO,BUKANGA COUNTY,MBARE,RUTEETE,RWENGE C.O.U,451,0,0,0,6,440,446,5,451,0,O-62-135-03-05-02
ISINGIRO,BUKANGA COUNTY,MBARE,RUTEETE,BURIGI CATHOLIC,280,0,0,0,3,263,266,11,277,0,O-62-135-03-05-03
ISINGIRO,BUKANGA COUNTY,NGARAMA,BURUNGAMO,BURUNGAMO 1,541,0,0,1,36,379,416,37,453,0,O-62-135-04-01-01
ISINGIRO,BUKANGA COUNTY,NGARAMA,BURUNGAMO,BURUNGAMO 2,646,2,0,2,72,516,592,8,600,0,O-62-135-04-01-02
ISINGIRO,BUKANGA COUNTY,NGARAMA,BURUNGAMO,KYAKABINDI,582,2,0,0,60,450,512,6,518,0,O-62-135-04-01-03
ISINGIRO,BUKANGA COUNTY,NGARAMA,BURUNGAMO,BIZEERA,291,0,0,1,43,137,181,4,185,0,O-62-135-04-01-04
ISINGIRO,BUKANGA COUNTY,NGARAMA,BURUNGAMO,RWOBUYAGAZA,271,0,0,1,27,240,268,0,268,0,O-62-135-04-01-05
ISINGIRO,BUKANGA COUNTY,NGARAMA,KABAARE,KAMATARISI,703,6,2,2,51,626,687,15,702,0,O-62-135-04-02-01
ISINGIRO,BUKANGA COUNTY,NGARAMA,KABAARE,KAMUTINDA T/C,501,2,0,2,35,450,489,9,498,0,O-62-135-04-02-02
ISINGIRO,BUKANGA COUNTY,NGARAMA,KABAARE,KYATUNGU PRIMARY SCHOOL,617,0,1,0,23,465,489,5,494,0,O-62-135-04-02-03
ISINGIRO,BUKANGA COUNTY,NGARAMA,KABAARE,KIREREMA C.O.U,271,0,0,0,7,222,229,2,231,0,O-62-135-04-02-04
ISINGIRO,BUKANGA COUNTY,NGARAMA,KAGAAGA,KATUNGAMO COMMUNITY P/S,584,0,0,0,48,361,409,2,411,0,O-62-135-04-03-01
ISINGIRO,BUKANGA COUNTY,NGARAMA,KAGAAGA,RWENSHEKYE,396,0,0,2,19,327,348,4,352,0,O-62-135-04-03-02
ISINGIRO,BUKANGA COUNTY,NGARAMA,KAGAAGA,KIGAAGA PRI. SCHOOL,416,2,1,4,24,302,333,3,336,0,O-62-135-04-03-03
ISINGIRO,BUKANGA COUNTY,NGARAMA,KAGAAGA,KYANDERA,156,1,0,1,11,102,115,2,117,0,O-62-135-04-03-04
ISINGIRO,BUKANGA COUNTY,NGARAMA,KAKAMBA,NGARAMA 2 [A - L],916,0,0,0,9,906,915,0,915,0,O-62-135-04-04-01
ISINGIRO,BUKANGA COUNTY,NGARAMA,KAKAMBA,BURUMBA PRIMARY SCHOOL,697,0,0,3,48,262,313,3,316,0,O-62-135-04-04-02
ISINGIRO,BUKANGA COUNTY,NGARAMA,KAKAMBA,NGARAMA 2 [M - Z],898,1,1,1,32,811,846,2,848,0,O-62-135-04-04-03
ISINGIRO,BUKANGA COUNTY,NGARAMA,KAKAMBA,RURONGO,278,0,0,1,14,238,253,1,254,0,O-62-135-04-04-04
ISINGIRO,BUKANGA COUNTY,NGARAMA,NGARAMA,NGARAMA 1,773,2,0,3,76,647,728,1,729,0,O-62-135-04-05-01
ISINGIRO,BUKANGA COUNTY,NGARAMA,NGARAMA,NGARAMA 3,595,0,0,2,62,465,529,2,531,0,O-62-135-04-05-02
ISINGIRO,BUKANGA COUNTY,NGARAMA,NGARAMA,NGARAMA 4,603,2,1,2,53,423,481,0,481,0,O-62-135-04-05-03
ISINGIRO,BUKANGA COUNTY,NGARAMA,NGARAMA,NGARAMA 5,482,2,0,3,27,404,436,1,437,0,O-62-135-04-05-04
ISINGIRO,BUKANGA COUNTY,NGARAMA,NGARAMA,KIGANDO,282,1,0,1,32,225,259,4,263,0,O-62-135-04-05-05
ISINGIRO,BUKANGA COUNTY,RUGAAGA,KASHOJWA,KABAZANA PRI. SCHOOL,915,1,1,1,58,693,754,26,780,0,O-62-135-05-01-01
ISINGIRO,BUKANGA COUNTY,RUGAAGA,KASHOJWA,KYABARE MARKET PLACE,272,0,0,0,0,266,266,6,272,0,O-62-135-05-01-02
ISINGIRO,BUKANGA COUNTY,RUGAAGA,KASHOJWA,KASHOJWA PRI. SCHOOL,540,1,0,1,42,485,529,11,540,0,O-62-135-05-01-03
ISINGIRO,BUKANGA COUNTY,RUGAAGA,KYAMPANGO,KYAMPANGO 1,772,2,0,3,71,557,633,5,638,0,O-62-135-05-02-01
ISINGIRO,BUKANGA COUNTY,RUGAAGA,KYAMPANGO,KYAMPANGO 2,528,0,0,2,51,384,437,12,449,0,O-62-135-05-02-02
ISINGIRO,BUKANGA COUNTY,RUGAAGA,KYAMPANGO,KYAMPANGO 3,769,1,1,2,77,477,558,6,564,0,O-62-135-05-02-03
ISINGIRO,BUKANGA COUNTY,RUGAAGA,KYAMPANGO,KYANYANDA MARKET PLACE,614,1,1,0,92,520,614,0,614,0,O-62-135-05-02-04
ISINGIRO,BUKANGA COUNTY,RUGAAGA,KYARUBAMBURA,KYARUBAMBURA I,673,1,1,2,56,503,563,9,572,0,O-62-135-05-03-01
ISINGIRO,BUKANGA COUNTY,RUGAAGA,KYARUBAMBURA,KYARUBAMBURA 2,539,3,0,0,40,481,524,2,526,0,O-62-135-05-03-02
ISINGIRO,BUKANGA COUNTY,RUGAAGA,KYARUBAMBURA,KYARUBAMBURA 3,597,1,1,0,34,552,588,0,588,0,O-62-135-05-03-03
ISINGIRO,BUKANGA COUNTY,RUGAAGA,KYARUBAMBURA,RWAKANKIRI,549,1,1,3,38,410,453,9,462,0,O-62-135-05-03-04
ISINGIRO,BUKANGA COUNTY,RUGAAGA,KYARUBAMBURA,BIRUNDUMA P/S,532,3,1,2,47,305,358,7,365,0,O-62-135-05-03-05
ISINGIRO,BUKANGA COUNTY,RUGAAGA,NYABUBAARE,RUSHASHA 2,626,1,0,0,45,490,536,12,548,0,O-62-135-05-04-01
ISINGIRO,BUKANGA COUNTY,RUGAAGA,NYABUBAARE,RUSHASHA 3,475,4,0,5,45,387,441,9,450,0,O-62-135-05-04-02
ISINGIRO,BUKANGA COUNTY,RUGAAGA,RUSHASHA,RUSHASHA 1,533,0,0,0,52,481,533,0,533,0,O-62-135-05-05-01
ISINGIRO,BUKANGA COUNTY,RUGAAGA,RUSHASHA,KENDOBO,227,1,0,0,15,205,221,0,221,0,O-62-135-05-05-02
ISINGIRO,BUKANGA COUNTY,RUGAAGA,RUSHASHA,RUSHASHA,271,1,0,1,7,258,267,4,271,0,O-62-135-05-05-03
ISINGIRO,BUKANGA COUNTY,RUGAAGA,RWANGABO,RWANGABO 1,601,2,2,1,40,451,496,12,508,0,O-62-135-05-06-01
ISINGIRO,BUKANGA COUNTY,RUGAAGA,RWANGABO,RWANGABO 2,376,1,2,0,39,194,236,9,245,0,O-62-135-05-06-02
ISINGIRO,BUKANGA COUNTY,RUGAAGA,RWANGABO,KAGANDO,382,0,0,4,37,272,313,5,318,0,O-62-135-05-06-03
ISINGIRO,BUKANGA COUNTY,RUGAAGA,RWANGABO,NYARUHUZI,432,0,0,3,49,310,362,8,370,0,O-62-135-05-06-04
ISINGIRO,ISINGIRO COUNTY NORTH,BIRERE,IBUMBA,IBUMBA 2,528,0,0,2,77,324,403,7,410,0,O-62-138-01-01-01
ISINGIRO,ISINGIRO COUNTY NORTH,BIRERE,IBUMBA,IBUMBA 3,465,1,0,1,50,289,341,5,346,0,O-62-138-01-01-02
ISINGIRO,ISINGIRO COUNTY NORTH,BIRERE,IBUMBA,IBUMBA 1,538,0,0,2,62,310,374,22,396,0,O-62-138-01-01-03
ISINGIRO,ISINGIRO COUNTY NORTH,BIRERE,KAHENDA,KAHENDA,594,1,0,3,105,381,490,13,503,0,O-62-138-01-02-01
ISINGIRO,ISINGIRO COUNTY NORTH,BIRERE,KAHENDA,KAHENDA II,208,0,0,3,22,134,159,7,166,0,O-62-138-01-02-02
ISINGIRO,ISINGIRO COUNTY NORTH,BIRERE,KAHENDA,KAHENDA 3,536,1,0,6,108,310,425,18,443,0,O-62-138-01-02-03
ISINGIRO,ISINGIRO COUNTY NORTH,BIRERE,KASAANA,KASANA 1,379,1,0,3,104,198,306,9,315,0,O-62-138-01-03-01
ISINGIRO,ISINGIRO COUNTY NORTH,BIRERE,KASAANA,KASANA 2,394,2,0,0,101,196,299,6,305,0,O-62-138-01-03-02
ISINGIRO,ISINGIRO COUNTY NORTH,BIRERE,KASAANA,KASANA 3,536,2,0,8,66,336,412,13,425,0,O-62-138-01-03-03
ISINGIRO,ISINGIRO COUNTY NORTH,BIRERE,KASAANA,KASANA 4,266,1,0,0,59,144,204,4,208,0,O-62-138-01-03-04
ISINGIRO,ISINGIRO COUNTY NORTH,BIRERE,KATANOGA,KATANOGA 1,570,2,1,1,132,285,421,0,421,0,O-62-138-01-04-01
ISINGIRO,ISINGIRO COUNTY NORTH,BIRERE,KATANOGA,KATANOGA 2,658,3,2,1,77,432,515,6,521,0,O-62-138-01-04-02
ISINGIRO,ISINGIRO COUNTY NORTH,BIRERE,KIGYENDA,KIGYENDA 1,451,0,1,0,61,281,343,2,345,0,O-62-138-01-05-01
ISINGIRO,ISINGIRO COUNTY NORTH,BIRERE,KIGYENDA,KIGYENDA 2,417,3,0,2,79,189,273,4,277,0,O-62-138-01-05-02
ISINGIRO,ISINGIRO COUNTY NORTH,BIRERE,KIGYENDA,KIGYENDWA VILLAGE,341,0,0,0,56,160,216,12,228,0,O-62-138-01-05-03
ISINGIRO,ISINGIRO COUNTY NORTH,BIRERE,KIKOKWA,KIKOKWA 1,524,1,0,5,86,249,341,8,349,0,O-62-138-01-06-01
ISINGIRO,ISINGIRO COUNTY NORTH,BIRERE,KIKOKWA,KIKOKWA 2,588,0,0,0,114,263,377,6,383,0,O-62-138-01-06-02
ISINGIRO,ISINGIRO COUNTY NORTH,BIRERE,KIKOKWA,KIKOKWA 3,370,0,0,0,77,158,235,2,237,0,O-62-138-01-06-03
ISINGIRO,ISINGIRO COUNTY NORTH,BIRERE,KIKOKWA,KIKOKWA 4,343,0,0,0,38,171,209,6,215,0,O-62-138-01-06-04
ISINGIRO,ISINGIRO COUNTY NORTH,BIRERE,KIKOKWA,KIKOKWA 5,477,2,0,0,96,229,327,5,332,0,O-62-138-01-06-05
ISINGIRO,ISINGIRO COUNTY NORTH,BIRERE,KIKOKWA,KYABUTOOTO,258,1,0,0,52,126,179,4,183,0,O-62-138-01-06-06
ISINGIRO,ISINGIRO COUNTY NORTH,BIRERE,KIKOKWA,KABEREBERE II,292,1,0,0,53,174,228,1,229,0,O-62-138-01-06-07
ISINGIRO,ISINGIRO COUNTY NORTH,BIRERE,KIKOKWA,RWEZIRINGIRO,520,2,0,1,126,245,374,6,380,0,O-62-138-01-06-08
ISINGIRO,ISINGIRO COUNTY NORTH,BIRERE,KISHURO,KISHURO 1,368,0,0,2,60,210,272,8,280,0,O-62-138-01-07-01
ISINGIRO,ISINGIRO COUNTY NORTH,BIRERE,KISHURO,KISHURO 2,946,1,1,1,183,322,508,10,518,0,O-62-138-01-07-02
ISINGIRO,ISINGIRO COUNTY NORTH,BIRERE,KISHURO,KISHURO 4,858,3,1,2,124,452,582,6,588,0,O-62-138-01-07-03
ISINGIRO,ISINGIRO COUNTY NORTH,BIRERE,KISHURO,KISHURO 5,215,0,0,0,25,135,160,2,162,0,O-62-138-01-07-04
ISINGIRO,ISINGIRO COUNTY NORTH,BIRERE,KYERA,KYERA 1,588,0,0,2,98,319,419,8,427,0,O-62-138-01-08-01
ISINGIRO,ISINGIRO COUNTY NORTH,BIRERE,KYERA,KYERA 2,522,1,0,0,103,282,386,18,404,0,O-62-138-01-08-02
ISINGIRO,ISINGIRO COUNTY NORTH,BIRERE,KYERA,KYERA 3,706,0,0,1,105,288,394,20,414,0,O-62-138-01-08-03
ISINGIRO,ISINGIRO COUNTY NORTH,BIRERE,KYERA,KASHENYI,328,1,0,1,50,161,213,6,219,0,O-62-138-01-08-04
ISINGIRO,ISINGIRO COUNTY NORTH,BIRERE,NYAMUYANZA,NYAMUYANJA 1,690,2,0,5,121,358,486,14,500,0,O-62-138-01-09-01
ISINGIRO,ISINGIRO COUNTY NORTH,BIRERE,NYAMUYANZA,NYAMUYANJA 2,624,5,2,2,131,342,482,8,490,0,O-62-138-01-09-02
ISINGIRO,ISINGIRO COUNTY NORTH,BIRERE,NYAMUYANZA,NYAMUYANJA 4,305,0,1,2,48,209,260,6,266,0,O-62-138-01-09-03
ISINGIRO,ISINGIRO COUNTY NORTH,BIRERE,NYAMUYANZA,NYAMUYANJA 6,293,3,0,2,62,161,228,4,232,0,O-62-138-01-09-04
ISINGIRO,ISINGIRO COUNTY NORTH,ISINGIRO T. C.,KAHARO,KAHARO 1,663,3,1,1,121,364,490,16,506,0,O-62-138-02-01-01
ISINGIRO,ISINGIRO COUNTY NORTH,ISINGIRO T. C.,KAHARO,KAHARO 2,732,2,2,6,121,374,505,11,516,0,O-62-138-02-01-02
ISINGIRO,ISINGIRO COUNTY NORTH,ISINGIRO T. C.,KAHARO,KASENYI PRI. SCHOOL,240,0,0,0,19,110,129,5,134,0,O-62-138-02-01-03
ISINGIRO,ISINGIRO COUNTY NORTH,ISINGIRO T. C.,KAHARO,KYEIRUMBA HEALTH CENTRE,440,0,0,1,101,246,348,4,352,0,O-62-138-02-01-04
ISINGIRO,ISINGIRO COUNTY NORTH,ISINGIRO T. C.,KAMURI,MUSLIM P/S / KAMURI 1,583,1,0,1,78,301,381,7,388,0,O-62-138-02-02-01
ISINGIRO,ISINGIRO COUNTY NORTH,ISINGIRO T. C.,KAMURI,PARISH HQRS / KAMURI 2,537,5,0,2,38,337,382,6,388,0,O-62-138-02-02-02
ISINGIRO,ISINGIRO COUNTY NORTH,ISINGIRO T. C.,KAMURI,KAMURI 3,710,3,0,4,84,475,566,6,572,0,O-62-138-02-02-03
ISINGIRO,ISINGIRO COUNTY NORTH,ISINGIRO T. C.,KAMURI,RWEMBWA C.O.U,289,1,1,0,23,188,213,9,222,0,O-62-138-02-02-04
ISINGIRO,ISINGIRO COUNTY NORTH,ISINGIRO T. C.,KAMURI,RWENGIRI,395,0,0,1,29,282,312,4,316,0,O-62-138-02-02-05
ISINGIRO,ISINGIRO COUNTY NORTH,ISINGIRO T. C.,KYABISHAHO,KYABISHAHO 1 [A - K],695,3,1,5,31,314,354,6,360,0,O-62-138-02-03-01
ISINGIRO,ISINGIRO COUNTY NORTH,ISINGIRO T. C.,KYABISHAHO,KYABISHAHO 2,406,1,0,1,41,223,266,3,269,0,O-62-138-02-03-02
ISINGIRO,ISINGIRO COUNTY NORTH,ISINGIRO T. C.,KYABISHAHO,RWEKUBO DISPENSARY,869,0,0,3,45,460,508,7,515,0,O-62-138-02-03-03
ISINGIRO,ISINGIRO COUNTY NORTH,ISINGIRO T. C.,KYABISHAHO,KYABISHAHO 1 [L - Z],710,1,1,2,41,285,330,6,336,0,O-62-138-02-03-04
ISINGIRO,ISINGIRO COUNTY NORTH,ISINGIRO T. C.,KYABISHAHO,KANYEREKE,561,2,0,7,29,461,499,3,502,0,O-62-138-02-03-05
ISINGIRO,ISINGIRO COUNTY NORTH,ISINGIRO T. C.,MABONA,MABONA 1,738,3,0,3,91,424,521,0,521,0,O-62-138-02-04-01
ISINGIRO,ISINGIRO COUNTY NORTH,ISINGIRO T. C.,MABONA,MABONA 2,741,0,0,3,79,479,561,7,568,0,O-62-138-02-04-02
ISINGIRO,ISINGIRO COUNTY NORTH,ISINGIRO T. C.,MABONA,MABONA 3,637,1,0,1,109,383,494,8,502,0,O-62-138-02-04-03
ISINGIRO,ISINGIRO COUNTY NORTH,KABINGO,KAGARAMA,KAGARAMA 1,668,1,0,2,80,439,522,4,526,0,O-62-138-03-01-01
ISINGIRO,ISINGIRO COUNTY NORTH,KABINGO,KAGARAMA,BUNGURA,560,1,0,2,60,461,524,14,538,0,O-62-138-03-01-02
ISINGIRO,ISINGIRO COUNTY NORTH,KABINGO,KAGARAMA,KYABINUGA,632,0,0,2,51,392,445,15,460,0,O-62-138-03-01-03
ISINGIRO,ISINGIRO COUNTY NORTH,KABINGO,KAGARAMA,KICWEKANO PRI. SCHOOL,384,0,0,1,63,270,334,3,337,0,O-62-138-03-01-04
ISINGIRO,ISINGIRO COUNTY NORTH,KABINGO,KAGARAMA,KITURA,291,1,1,0,18,219,239,3,242,0,O-62-138-03-01-05
ISINGIRO,ISINGIRO COUNTY NORTH,KABINGO,KAGARAMA,KABINGO 2,395,1,0,2,26,295,324,0,324,0,O-62-138-03-01-06
ISINGIRO,ISINGIRO COUNTY NORTH,KABINGO,KATEMBE,KATEMBE 1,523,3,0,2,52,428,485,8,493,0,O-62-138-03-02-01
ISINGIRO,ISINGIRO COUNTY NORTH,KABINGO,KATEMBE,KATEMBE 2,446,0,2,2,50,379,433,2,435,0,O-62-138-03-02-02
ISINGIRO,ISINGIRO COUNTY NORTH,KABINGO,KYARUGAAJU,KYARUGAJU I,282,0,0,1,7,219,227,3,230,0,O-62-138-03-03-01
ISINGIRO,ISINGIRO COUNTY NORTH,KABINGO,KYARUGAAJU,KYARUGAJU HEALTH CENTER,343,0,0,1,22,255,278,1,279,0,O-62-138-03-03-02
ISINGIRO,ISINGIRO COUNTY NORTH,KABINGO,KYARUGAAJU,RWEMIGANGO,482,0,0,1,43,348,392,6,398,0,O-62-138-03-03-03
ISINGIRO,ISINGIRO COUNTY NORTH,KABINGO,KYARUGAAJU,KAGOGO P/S,305,1,0,0,70,208,279,3,282,0,O-62-138-03-03-04
ISINGIRO,ISINGIRO COUNTY NORTH,KABINGO,KYARUGAAJU,RUBIRA T.C,144,0,0,0,1,143,144,0,144,0,O-62-138-03-03-05
ISINGIRO,ISINGIRO COUNTY NORTH,KABINGO,NYAKIGYERA,NYAKIGYERA 1,660,0,0,2,163,300,465,16,481,0,O-62-138-03-04-01
ISINGIRO,ISINGIRO COUNTY NORTH,KABINGO,NYAKIGYERA,NYAKIGYERA 2,703,1,0,2,146,388,537,18,555,0,O-62-138-03-04-02
ISINGIRO,ISINGIRO COUNTY NORTH,KABINGO,NYAKIGYERA,NYAKIGYERA 3,717,2,0,2,104,406,514,10,524,0,O-62-138-03-04-03
ISINGIRO,ISINGIRO COUNTY NORTH,MASHA,KABAARE,KABAARE 1,476,0,1,1,83,210,295,7,302,0,O-62-138-04-01-01
ISINGIRO,ISINGIRO COUNTY NORTH,MASHA,KABAARE,KABAARE 2,743,0,1,1,100,410,512,5,517,0,O-62-138-04-01-02
ISINGIRO,ISINGIRO COUNTY NORTH,MASHA,KABAARE,KABAARE 3,397,2,1,1,70,208,282,6,288,0,O-62-138-04-01-03
ISINGIRO,ISINGIRO COUNTY NORTH,MASHA,NYAKAKONI,NYAKAKONI P/S,619,2,0,5,94,309,410,3,413,0,O-62-138-04-02-01
ISINGIRO,ISINGIRO COUNTY NORTH,MASHA,NYAKAKONI,NYAKAKONI 2,551,3,0,2,68,298,371,4,375,0,O-62-138-04-02-02
ISINGIRO,ISINGIRO COUNTY NORTH,MASHA,NYAMITSINDO,NYAMITSINDO 1,627,1,0,1,64,400,466,5,471,0,O-62-138-04-03-01
ISINGIRO,ISINGIRO COUNTY NORTH,MASHA,NYAMITSINDO,BUYOJWA,371,0,0,0,54,208,262,2,264,0,O-62-138-04-03-02
ISINGIRO,ISINGIRO COUNTY NORTH,MASHA,NYAMITSINDO,NYAMITSINDO 3,545,1,0,2,72,267,342,16,358,0,O-62-138-04-03-03
ISINGIRO,ISINGIRO COUNTY NORTH,MASHA,NYARUBUNGO,NYARUBUNGO CELL,519,0,2,2,131,219,354,5,359,0,O-62-138-04-04-01
ISINGIRO,ISINGIRO COUNTY NORTH,MASHA,NYARUBUNGO,NYARUBUNGO 1,389,1,1,0,70,200,272,15,287,0,O-62-138-04-04-02
ISINGIRO,ISINGIRO COUNTY NORTH,MASHA,NYARUBUNGO,NYARUBUNGO 2,342,2,0,2,60,192,256,6,262,0,O-62-138-04-04-03
ISINGIRO,ISINGIRO COUNTY NORTH,MASHA,NYARUBUNGO,NYARUBUNGO 3,439,0,0,2,69,205,276,0,276,0,O-62-138-04-04-04
ISINGIRO,ISINGIRO COUNTY NORTH,MASHA,RUKUUBA,RWENDEZI,638,3,1,1,123,306,434,4,438,0,O-62-138-04-05-01
ISINGIRO,ISINGIRO COUNTY NORTH,MASHA,RUKUUBA,NYAMAREBE,542,1,0,2,82,288,373,6,379,0,O-62-138-04-05-02
ISINGIRO,ISINGIRO COUNTY NORTH,MASHA,RUKUUBA,KAKUUTO,541,1,0,1,60,287,349,11,360,0,O-62-138-04-05-03
ISINGIRO,ISINGIRO COUNTY NORTH,MASHA,RWATANGO,RWETANGO 1,739,1,0,3,56,527,587,11,598,0,O-62-138-04-06-01
ISINGIRO,ISINGIRO COUNTY NORTH,MASHA,RWATANGO,RWETANGO 2,612,3,0,1,57,400,461,7,468,0,O-62-138-04-06-02
ISINGIRO,ISINGIRO COUNTY SOUTH,KABUYANDA,KABUGU,KIGABAGABA C.O.U,404,2,1,2,60,249,314,18,332,0,O-62-139-01-01-01
ISINGIRO,ISINGIRO COUNTY SOUTH,KABUYANDA,KABUGU,KABUGU PARISH HQRS,438,1,0,0,59,265,325,5,330,0,O-62-139-01-01-02
ISINGIRO,ISINGIRO COUNTY SOUTH,KABUYANDA,KABUGU,KIGABAGABA PRI. SCHOOL,659,1,0,3,146,353,503,5,508,0,O-62-139-01-01-03
ISINGIRO,ISINGIRO COUNTY SOUTH,KABUYANDA,KABUGU,EDEN CHURCH,674,0,0,3,128,342,473,10,483,0,O-62-139-01-01-04
ISINGIRO,ISINGIRO COUNTY SOUTH,KABUYANDA,KABUGU,KABUGU HEALTH CENTRE,519,0,1,1,89,255,346,27,373,0,O-62-139-01-01-05
ISINGIRO,ISINGIRO COUNTY SOUTH,KABUYANDA,KANYWAMEIZI,KANYWAMAIZI PARISH HQRS,593,4,1,6,120,325,456,7,463,0,O-62-139-01-02-01
ISINGIRO,ISINGIRO COUNTY SOUTH,KABUYANDA,KANYWAMEIZI,KANYWAMAIZI CATHOLIC CHURC,359,2,0,3,73,185,263,12,275,0,O-62-139-01-02-02
ISINGIRO,ISINGIRO COUNTY SOUTH,KABUYANDA,KANYWAMEIZI,KANYWAMAIZI HEALTH CENTRE,287,0,0,0,34,186,220,11,231,0,O-62-139-01-02-03
ISINGIRO,ISINGIRO COUNTY SOUTH,KABUYANDA,KANYWAMEIZI,ST. MARY'S P/S,623,1,0,6,120,348,475,18,493,0,O-62-139-01-02-04
ISINGIRO,ISINGIRO COUNTY SOUTH,KABUYANDA,KANYWAMEIZI,RUBAGANO C.O.U,314,3,0,2,61,212,278,10,288,0,O-62-139-01-02-05
ISINGIRO,ISINGIRO COUNTY SOUTH,KABUYANDA,KANYWAMEIZI,KAGARA CATHOLIC CHURCH,488,0,0,1,62,308,371,11,382,0,O-62-139-01-02-06
ISINGIRO,ISINGIRO COUNTY SOUTH,KABUYANDA,KARAMA,KARAMA PRI. SCHOOL,492,3,0,2,54,303,362,6,368,0,O-62-139-01-03-01
ISINGIRO,ISINGIRO COUNTY SOUTH,KABUYANDA,KARAMA,KARAMA PARISH HQRS,603,2,0,2,117,339,460,7,467,0,O-62-139-01-03-02
ISINGIRO,ISINGIRO COUNTY SOUTH,KABUYANDA,KARAMA,KARAMA 3,298,0,1,2,30,203,236,3,239,0,O-62-139-01-03-03
ISINGIRO,ISINGIRO COUNTY SOUTH,KABUYANDA,KARAMA,KENTEKO PRI. SCHOOL,463,2,1,3,80,270,356,19,375,0,O-62-139-01-03-04
ISINGIRO,ISINGIRO COUNTY SOUTH,KABUYANDA,KISYORO,RUTOOMA,657,3,0,3,89,336,431,13,444,0,O-62-139-01-04-01
ISINGIRO,ISINGIRO COUNTY SOUTH,KABUYANDA,KISYORO,KABUYANDA,599,0,0,0,91,201,292,3,295,0,O-62-139-01-04-02
ISINGIRO,ISINGIRO COUNTY SOUTH,KABUYANDA,KISYORO,KABUYANDA ADVENTIST CHURCH,418,0,1,0,43,220,264,0,264,0,O-62-139-01-04-03
ISINGIRO,ISINGIRO COUNTY SOUTH,KABUYANDA,KISYORO,KISYORO P/S,541,0,1,3,41,358,403,11,414,0,O-62-139-01-04-04
ISINGIRO,ISINGIRO COUNTY SOUTH,KABUYANDA,KISYORO,KAROKARUNGI PRI. SCHOOL,728,0,3,0,105,400,508,16,524,0,O-62-139-01-04-05
ISINGIRO,ISINGIRO COUNTY SOUTH,KABUYANDA,KISYORO,KISYORO C.O.U,455,1,0,0,25,213,239,56,295,0,O-62-139-01-04-06
ISINGIRO,ISINGIRO COUNTY SOUTH,KABUYANDA,KISYORO,KINANGYE C.O.U,566,1,0,5,67,341,414,8,422,0,O-62-139-01-04-07
ISINGIRO,ISINGIRO COUNTY SOUTH,KABUYANDA,KISYORO,NYAMPIKYE C.O.U,271,0,0,0,31,157,188,8,196,0,O-62-139-01-04-08
ISINGIRO,ISINGIRO COUNTY SOUTH,KABUYANDA,KYAMUSONI,KYAMUSOONI PARISH HQRS,598,0,1,5,76,392,474,7,481,0,O-62-139-01-05-01
ISINGIRO,ISINGIRO COUNTY SOUTH,KABUYANDA,KYAMUSONI,KYAMUSOONI 2,366,0,0,1,40,269,310,1,311,0,O-62-139-01-05-02
ISINGIRO,ISINGIRO COUNTY SOUTH,KABUYANDA,KYAMUSONI,KYAMUSOONI 3,504,2,0,4,67,282,355,11,366,0,O-62-139-01-05-03
ISINGIRO,ISINGIRO COUNTY SOUTH,KABUYANDA,KYAMUSONI,KYAMUSOONI 4,334,1,0,1,44,234,280,4,284,0,O-62-139-01-05-04
ISINGIRO,ISINGIRO COUNTY SOUTH,KABUYANDA,KYAMUSONI,KYAMUSOONI PRI. SCHOOL,415,3,0,1,144,162,310,0,310,0,O-62-139-01-05-05
ISINGIRO,ISINGIRO COUNTY SOUTH,KABUYANDA,KYAMUSONI,RUBOROGOTA PRI. SCHOOL,393,1,0,1,44,240,286,17,303,0,O-62-139-01-05-06
ISINGIRO,ISINGIRO COUNTY SOUTH,KABUYANDA,KYAMUSONI,RYABOONA C.O.U,464,0,0,1,95,243,339,9,348,0,O-62-139-01-05-07
ISINGIRO,ISINGIRO COUNTY SOUTH,KABUYANDA,KYAMUSONI,RUKUREIJO MARKET GROUND,686,3,0,5,104,399,511,18,529,0,O-62-139-01-05-08
ISINGIRO,ISINGIRO COUNTY SOUTH,KABUYANDA,RUBOROGOTA,RUBOROGOTA PARISH HQRS,548,1,1,1,89,275,367,15,382,0,O-62-139-01-06-01
ISINGIRO,ISINGIRO COUNTY SOUTH,KABUYANDA,RUBOROGOTA,MPOMA P/S,1194,1,1,1,70,538,611,20,631,0,O-62-139-01-06-02
ISINGIRO,ISINGIRO COUNTY SOUTH,KABUYANDA,RWAKAKWENDA,KIGABAGABA PRI. SCHOOL,654,4,1,2,94,373,474,9,483,0,O-62-139-01-07-01
ISINGIRO,ISINGIRO COUNTY SOUTH,KABUYANDA,RWAKAKWENDA,RWAKAKWENDA C.O.U,382,1,0,0,39,216,256,7,263,0,O-62-139-01-07-02
ISINGIRO,ISINGIRO COUNTY SOUTH,KABUYANDA,RWAKAKWENDA,RWAKAKWENDA PARISH HQRS,623,3,1,1,86,326,417,14,431,0,O-62-139-01-07-03
ISINGIRO,ISINGIRO COUNTY SOUTH,KABUYANDA,RWAKAKWENDA,RUKIRI CATHOLIC CHURCH,534,3,1,5,131,299,439,9,448,0,O-62-139-01-07-04
ISINGIRO,ISINGIRO COUNTY SOUTH,KIKAGATE,KAJAHO,KAJAHO 1,776,0,1,2,85,550,638,8,646,0,O-62-139-02-01-01
ISINGIRO,ISINGIRO COUNTY SOUTH,KIKAGATE,KAJAHO,KAJAHO 2,411,1,2,2,49,226,280,5,285,0,O-62-139-02-01-02
ISINGIRO,ISINGIRO COUNTY SOUTH,KIKAGATE,KAJAHO,RWAMURUNGA SEC. SCHOOL,442,0,0,0,37,216,253,0,253,0,O-62-139-02-01-03
ISINGIRO,ISINGIRO COUNTY SOUTH,KIKAGATE,KAJAHO,KAJAHO 4,366,0,0,1,18,279,298,4,302,0,O-62-139-02-01-04
ISINGIRO,ISINGIRO COUNTY SOUTH,KIKAGATE,KAJAHO,RUBIRIZI HEALTH CENTRE,458,0,0,2,29,420,451,4,455,0,O-62-139-02-01-05
ISINGIRO,ISINGIRO COUNTY SOUTH,KIKAGATE,KAMUBEIZI,KAMUBEIZI 1,652,0,0,3,25,499,527,8,535,0,O-62-139-02-02-01
ISINGIRO,ISINGIRO COUNTY SOUTH,KIKAGATE,KAMUBEIZI,KAMUBEIZI 2,639,1,0,2,50,459,512,8,520,0,O-62-139-02-02-02
ISINGIRO,ISINGIRO COUNTY SOUTH,KIKAGATE,KAMUBEIZI,KAMUBEIZI 3,413,0,0,2,6,310,318,8,326,0,O-62-139-02-02-03
ISINGIRO,ISINGIRO COUNTY SOUTH,KIKAGATE,KAMUBEIZI,BUBANGIZI CATHOLIC CHURCH,494,0,0,2,10,384,396,11,407,0,O-62-139-02-02-04
ISINGIRO,ISINGIRO COUNTY SOUTH,KIKAGATE,KAMUBEIZI,KAMUBEIZI 5,786,4,1,1,48,604,658,1,659,0,O-62-139-02-02-05
ISINGIRO,ISINGIRO COUNTY SOUTH,KIKAGATE,KAMUBEIZI,RUGARAMA CATHOLIC CHURCH,474,0,1,1,29,321,352,3,355,0,O-62-139-02-02-06
ISINGIRO,ISINGIRO COUNTY SOUTH,KIKAGATE,KAMUBEIZI,KIBARE P/S,524,0,0,1,43,383,427,6,433,0,O-62-139-02-02-07
ISINGIRO,ISINGIRO COUNTY SOUTH,KIKAGATE,KYEZIMBIRE,KYEZIMBIRE 1,422,1,0,1,37,299,338,5,343,0,O-62-139-02-03-01
ISINGIRO,ISINGIRO COUNTY SOUTH,KIKAGATE,KYEZIMBIRE,KYEZIMBIRE SEC. SCHOOL,497,0,0,1,58,297,356,15,371,0,O-62-139-02-03-02
ISINGIRO,ISINGIRO COUNTY SOUTH,KIKAGATE,KYEZIMBIRE,KYAMUSHAIJA MARKET,490,1,1,1,37,298,338,13,351,0,O-62-139-02-03-03
ISINGIRO,ISINGIRO COUNTY SOUTH,KIKAGATE,KYEZIMBIRE,KYEZIMBIRE 4,506,1,1,3,41,373,419,7,426,0,O-62-139-02-03-04
ISINGIRO,ISINGIRO COUNTY SOUTH,KIKAGATE,KYEZIMBIRE,NYARUBUNGO C.O.U,470,1,0,1,22,372,396,4,400,0,O-62-139-02-03-05
ISINGIRO,ISINGIRO COUNTY SOUTH,KIKAGATE,KYEZIMBIRE,KYEZIMBIRE 6,342,0,0,0,18,285,303,1,304,0,O-62-139-02-03-06
ISINGIRO,ISINGIRO COUNTY SOUTH,KIKAGATE,KYEZIMBIRE,KYEZIMBIRE PARISH HQRS,394,0,1,3,19,298,321,5,326,0,O-62-139-02-03-07
ISINGIRO,ISINGIRO COUNTY SOUTH,KIKAGATE,KYEZIMBIRE,KYAMUSHAIJA CHURCH,432,2,0,3,14,270,289,10,299,0,O-62-139-02-03-08
ISINGIRO,ISINGIRO COUNTY SOUTH,KIKAGATE,KYEZIMBIRE,NYABUSHENYI AID POST,414,0,0,1,26,340,367,1,368,0,O-62-139-02-03-09
ISINGIRO,ISINGIRO COUNTY SOUTH,KIKAGATE,KYEZIMBIRE,RWAKIJUMA,355,1,0,1,36,230,268,5,273,0,O-62-139-02-03-10
ISINGIRO,ISINGIRO COUNTY SOUTH,KIKAGATE,NTUNDU,KIKAGATE S/COUNTY HQRS,654,0,2,2,74,404,482,12,494,0,O-62-139-02-04-01
ISINGIRO,ISINGIRO COUNTY SOUTH,KIKAGATE,NTUNDU,NTUNDU 2,449,1,0,0,62,254,317,7,324,0,O-62-139-02-04-02
ISINGIRO,ISINGIRO COUNTY SOUTH,KIKAGATE,NTUNDU,KABASHAKI P/S,269,30,0,0,0,222,252,0,252,0,O-62-139-02-04-03
ISINGIRO,ISINGIRO COUNTY SOUTH,KIKAGATE,NTUNDU,KABUMBA,602,0,0,1,91,400,492,7,499,0,O-62-139-02-04-04
ISINGIRO,ISINGIRO COUNTY SOUTH,KIKAGATE,NTUNDU,NTUNDU 5,553,3,1,3,78,346,431,4,435,0,O-62-139-02-04-05
ISINGIRO,ISINGIRO COUNTY SOUTH,KIKAGATE,NTUNDU,KIKAGATE PLAYGROUND,406,0,0,0,32,267,299,9,308,0,O-62-139-02-04-06
ISINGIRO,ISINGIRO COUNTY SOUTH,KIKAGATE,NTUNDU,MBARARA I / KITEZO P/S,405,0,0,1,47,300,348,3,351,0,O-62-139-02-04-07
ISINGIRO,ISINGIRO COUNTY SOUTH,KIKAGATE,RUYANGA,RUYANGA 1,719,3,0,1,77,295,376,137,513,0,O-62-139-02-05-01
ISINGIRO,ISINGIRO COUNTY SOUTH,KIKAGATE,RUYANGA,KATOJO P/S [A - L],383,0,0,2,14,228,244,2,246,0,O-62-139-02-05-02
ISINGIRO,ISINGIRO COUNTY SOUTH,KIKAGATE,RUYANGA,KATOJO P/S [M - Z],461,1,0,1,36,286,324,5,329,0,O-62-139-02-05-03
ISINGIRO,ISINGIRO COUNTY SOUTH,KIKAGATE,RUYANGA,KABASHEKYERE C.O.U,487,0,0,0,2,477,479,8,487,0,O-62-139-02-05-04
ISINGIRO,ISINGIRO COUNTY SOUTH,KIKAGATE,RUYANGA,RUYANGA 3,491,1,0,0,14,476,491,0,491,0,O-62-139-02-05-05
ISINGIRO,ISINGIRO COUNTY SOUTH,KIKAGATE,RWAMWIJUKA,KASHARIRA AID POST / RWAMWIJ,600,0,1,2,81,386,470,10,480,0,O-62-139-02-06-01
ISINGIRO,ISINGIRO COUNTY SOUTH,KIKAGATE,RWAMWIJUKA,BUBAARE CHURCH SCHOOL,521,3,0,4,41,459,507,13,520,0,O-62-139-02-06-02
ISINGIRO,ISINGIRO COUNTY SOUTH,KIKAGATE,RWAMWIJUKA,NYAKABUNGO P/S [A - L],440,1,1,2,55,295,354,3,357,0,O-62-139-02-06-03
ISINGIRO,ISINGIRO COUNTY SOUTH,KIKAGATE,RWAMWIJUKA,NYAKABUNGO P/S [M - Z],540,2,0,1,60,375,438,2,440,0,O-62-139-02-06-04
ISINGIRO,ISINGIRO COUNTY SOUTH,KIKAGATE,RWAMWIJUKA,NYABUSHENYI,310,0,0,0,26,258,284,0,284,0,O-62-139-02-06-05
ISINGIRO,ISINGIRO COUNTY SOUTH,NYAKITUNDA,BUGONGI,NYAKITINDA S/COUNTY,195,0,0,0,13,173,186,4,190,0,O-62-139-03-01-01
ISINGIRO,ISINGIRO COUNTY SOUTH,NYAKITUNDA,BUGONGI,BUGONGI 2,486,1,0,1,17,352,371,0,371,0,O-62-139-03-01-02
ISINGIRO,ISINGIRO COUNTY SOUTH,NYAKITUNDA,BUGONGI,BUGONGI 3,1099,0,1,3,88,651,743,338,1081,0,O-62-139-03-01-03
ISINGIRO,ISINGIRO COUNTY SOUTH,NYAKITUNDA,KAMUBEIZI,KAMUBEIZI 1,627,2,0,4,49,440,495,27,522,0,O-62-139-03-02-01
ISINGIRO,ISINGIRO COUNTY SOUTH,NYAKITUNDA,KAMUBEIZI,KAMUBEIZI 2,542,1,0,6,40,445,492,6,498,0,O-62-139-03-02-02
ISINGIRO,ISINGIRO COUNTY SOUTH,NYAKITUNDA,KAMUBEIZI,KAMUBEIZI 3,444,1,4,0,29,339,373,21,394,0,O-62-139-03-02-03
ISINGIRO,ISINGIRO COUNTY SOUTH,NYAKITUNDA,KAMUBEIZI,KYARUGOZA,328,1,0,0,9,282,292,2,294,0,O-62-139-03-02-04
ISINGIRO,ISINGIRO COUNTY SOUTH,NYAKITUNDA,KAMUBEIZI,KANANI C.O.U,584,1,1,2,59,412,475,12,487,0,O-62-139-03-02-05
ISINGIRO,ISINGIRO COUNTY SOUTH,NYAKITUNDA,KIHIIHI,KIHIIHI 1,415,0,0,1,15,279,295,1,296,0,O-62-139-03-03-01
ISINGIRO,ISINGIRO COUNTY SOUTH,NYAKITUNDA,KIHIIHI,KIHIIHI 2,696,1,1,2,64,404,472,9,481,0,O-62-139-03-03-02
ISINGIRO,ISINGIRO COUNTY SOUTH,NYAKITUNDA,KIHIIHI,KIHIIHI 3,568,0,0,2,52,390,444,8,452,0,O-62-139-03-03-03
ISINGIRO,ISINGIRO COUNTY SOUTH,NYAKITUNDA,KIHIIHI,NYANDAMA,487,2,0,2,27,388,419,6,425,0,O-62-139-03-03-04
ISINGIRO,ISINGIRO COUNTY SOUTH,NYAKITUNDA,NTUNGU,NTUNGU 1,655,2,0,2,66,415,485,15,500,0,O-62-139-03-04-01
ISINGIRO,ISINGIRO COUNTY SOUTH,NYAKITUNDA,NTUNGU,NTUNGU 2,631,0,4,3,57,450,514,7,521,0,O-62-139-03-04-02
ISINGIRO,ISINGIRO COUNTY SOUTH,NYAKITUNDA,NTUNGU,NTUNGU 3,438,0,0,0,30,335,365,2,367,0,O-62-139-03-04-03
ISINGIRO,ISINGIRO COUNTY SOUTH,NYAKITUNDA,NTUNGU,BIRARA/KINYINA,374,0,1,1,25,330,357,3,360,0,O-62-139-03-04-04
ISINGIRO,ISINGIRO COUNTY SOUTH,NYAKITUNDA,NYAKARAMBI,NYAKARAMBI 3,496,1,0,3,37,339,380,0,380,0,O-62-139-03-05-01
ISINGIRO,ISINGIRO COUNTY SOUTH,NYAKITUNDA,NYAKARAMBI,NYAKARAMBI 4,906,2,0,2,56,647,707,14,721,0,O-62-139-03-05-02
ISINGIRO,ISINGIRO COUNTY SOUTH,NYAKITUNDA,NYAKARAMBI,NYAKARAMBI 1,518,3,2,5,19,388,417,9,426,0,O-62-139-03-05-03
ISINGIRO,ISINGIRO COUNTY SOUTH,NYAKITUNDA,NYAKARAMBI,NYAKARAMBI 2,442,0,1,2,33,321,357,6,363,0,O-62-139-03-05-04
ISINGIRO,ISINGIRO COUNTY SOUTH,NYAKITUNDA,RUHIRA,RUHIIRA 1,219,0,0,0,30,149,179,8,187,0,O-62-139-03-06-01
ISINGIRO,ISINGIRO COUNTY SOUTH,NYAKITUNDA,RUHIRA,RUHIIRA 2,731,2,1,1,93,515,612,6,618,0,O-62-139-03-06-02
ISINGIRO,ISINGIRO COUNTY SOUTH,NYAKITUNDA,RUHIRA,RUHIIRA 3,493,1,0,0,60,348,409,9,418,0,O-62-139-03-06-03
ISINGIRO,ISINGIRO COUNTY SOUTH,NYAKITUNDA,RUHIRA,RUHIIRA 4,473,0,0,4,50,328,382,6,388,0,O-62-139-03-06-04
ISINGIRO,ISINGIRO COUNTY SOUTH,NYAKITUNDA,RUHIRA,RUHIIRA 5,689,1,1,5,62,463,532,11,543,0,O-62-139-03-06-05
KIRUHURA,NYABUSHOZI COUNTY,KANYARYERU,AKAKU,RWAHONGYERA,383,0,0,0,0,383,383,0,383,0,O-65-142-01-01-01
KIRUHURA,NYABUSHOZI COUNTY,KANYARYERU,AKAYANJA,AKAYANJA,408,0,1,0,5,400,406,2,408,0,O-65-142-01-02-01
KIRUHURA,NYABUSHOZI COUNTY,KANYARYERU,AKAYANJA,RUSHORORO,230,0,0,0,0,230,230,0,230,0,O-65-142-01-02-02
KIRUHURA,NYABUSHOZI COUNTY,KANYARYERU,KANYARYERU RES S,KANYARYERU,848,0,0,0,0,844,844,4,848,0,O-65-142-01-03-01
KIRUHURA,NYABUSHOZI COUNTY,KANYARYERU,KANYARYERU RES S,MPANGAMU-SHANJU,116,0,0,0,0,116,116,0,116,0,O-65-142-01-03-02
KIRUHURA,NYABUSHOZI COUNTY,KANYARYERU,KIBEGA,KIBEGA,302,0,0,0,0,298,298,3,301,0,O-65-142-01-04-01
KIRUHURA,NYABUSHOZI COUNTY,KANYARYERU,RWAMURANDA,RWAMURANDA,297,0,0,0,0,292,292,2,294,0,O-65-142-01-05-01
KIRUHURA,NYABUSHOZI COUNTY,KANYARYERU,RWAMURANDA,OBWAPA,219,0,0,0,0,219,219,0,219,0,O-65-142-01-05-02
KIRUHURA,NYABUSHOZI COUNTY,KASHONGI,BYANAMIRA,BYANAMIRA 1,586,1,1,1,84,356,443,44,487,0,O-65-142-02-01-01
KIRUHURA,NYABUSHOZI COUNTY,KASHONGI,BYANAMIRA,BYANAMIRA 2,347,0,0,0,3,289,292,35,327,0,O-65-142-02-01-02
KIRUHURA,NYABUSHOZI COUNTY,KASHONGI,BYANAMIRA,BYANAMIRA 3,573,5,1,1,55,431,493,12,505,0,O-65-142-02-01-03
KIRUHURA,NYABUSHOZI COUNTY,KASHONGI,BYANAMIRA,RUKINGA,465,0,2,0,52,297,351,6,357,0,O-65-142-02-01-04
KIRUHURA,NYABUSHOZI COUNTY,KASHONGI,KITABO,KITABO I [A - L],493,0,0,2,55,270,327,3,330,0,O-65-142-02-02-01
KIRUHURA,NYABUSHOZI COUNTY,KASHONGI,KITABO,KITABO II,583,1,0,4,83,266,354,1,355,0,O-65-142-02-02-02
KIRUHURA,NYABUSHOZI COUNTY,KASHONGI,KITABO,KITABO III,286,2,1,1,57,193,254,2,256,0,O-65-142-02-02-03
KIRUHURA,NYABUSHOZI COUNTY,KASHONGI,KITABO,KITABO I [M - Z],374,1,0,0,46,170,217,1,218,0,O-65-142-02-02-04
KIRUHURA,NYABUSHOZI COUNTY,KASHONGI,KITURA,KITURA P/S E,531,1,0,1,65,308,375,5,380,0,O-65-142-02-03-01
KIRUHURA,NYABUSHOZI COUNTY,KASHONGI,KITURA,KITURA P/S C,282,0,2,0,20,196,218,5,223,0,O-65-142-02-03-02
KIRUHURA,NYABUSHOZI COUNTY,KASHONGI,KITURA,KITURA P/S D,392,1,0,0,39,209,249,13,262,0,O-65-142-02-03-03
KIRUHURA,NYABUSHOZI COUNTY,KASHONGI,KITURA,AKAREERE T/C,567,0,1,1,77,309,388,4,392,0,O-65-142-02-03-04
KIRUHURA,NYABUSHOZI COUNTY,KASHONGI,KITURA,KITURA P/S A,510,3,1,0,73,305,382,9,391,0,O-65-142-02-03-05
KIRUHURA,NYABUSHOZI COUNTY,KASHONGI,KITURA,KITURA P/S B,487,0,2,2,57,267,328,7,335,0,O-65-142-02-03-06
KIRUHURA,NYABUSHOZI COUNTY,KASHONGI,KITURA,KITURA,266,1,0,1,41,143,186,5,191,0,O-65-142-02-03-07
KIRUHURA,NYABUSHOZI COUNTY,KASHONGI,MOOYA,MOOYA 1,717,1,1,3,41,501,547,7,554,0,O-65-142-02-04-01
KIRUHURA,NYABUSHOZI COUNTY,KASHONGI,MOOYA,MOOYA 2,519,0,0,0,30,430,460,40,500,0,O-65-142-02-04-02
KIRUHURA,NYABUSHOZI COUNTY,KASHONGI,MOOYA,MOOYA 3,527,0,0,1,49,340,390,7,397,0,O-65-142-02-04-03
KIRUHURA,NYABUSHOZI COUNTY,KASHONGI,MOOYA,MOOYA 4,416,1,0,1,39,247,288,3,291,0,O-65-142-02-04-04
KIRUHURA,NYABUSHOZI COUNTY,KASHONGI,RWEMAMBA,RWEMAMBA /BWEZA,630,1,0,1,53,335,390,6,396,0,O-65-142-02-05-01
KIRUHURA,NYABUSHOZI COUNTY,KASHONGI,RWEMAMBA,KYAMAREBE / AKATOJO,415,0,1,1,30,251,283,2,285,0,O-65-142-02-05-02
KIRUHURA,NYABUSHOZI COUNTY,KASHONGI,RWEMAMBA,RWOBUHURA,635,2,3,0,64,382,451,2,453,0,O-65-142-02-05-03
KIRUHURA,NYABUSHOZI COUNTY,KASHONGI,RWEMAMBA,KANYABIKARA /NYABISHEKYE,569,1,0,1,42,418,462,1,463,0,O-65-142-02-05-04
KIRUHURA,NYABUSHOZI COUNTY,KASHONGI,RWEMAMBA,RWEMAMBA II / III,459,0,0,0,43,263,306,0,306,0,O-65-142-02-05-05
KIRUHURA,NYABUSHOZI COUNTY,KASHONGI,RWENJUBU,RWENJUBU I,712,4,3,2,129,351,489,6,495,0,O-65-142-02-06-01
KIRUHURA,NYABUSHOZI COUNTY,KASHONGI,RWENJUBU,RWENJUBU 2,666,1,0,1,25,446,473,5,478,0,O-65-142-02-06-02
KIRUHURA,NYABUSHOZI COUNTY,KASHONGI,RWENJUBU,RWENJUBU 3,833,2,2,2,83,550,639,7,646,0,O-65-142-02-06-03
KIRUHURA,NYABUSHOZI COUNTY,KASHONGI,RWENJUBU,RWENJUBU 4,431,0,0,0,34,234,268,21,289,0,O-65-142-02-06-04
KIRUHURA,NYABUSHOZI COUNTY,KASHONGI,RWENJUBU,RWENJUBU C.O.U,762,3,0,3,66,428,500,0,500,0,O-65-142-02-06-05
KIRUHURA,NYABUSHOZI COUNTY,KASHONGI,RWENYANGWE,RWENYANGWE 1,504,1,2,2,60,304,369,2,371,0,O-65-142-02-07-01
KIRUHURA,NYABUSHOZI COUNTY,KASHONGI,RWENYANGWE,RWENYANGWE,502,4,1,0,35,358,398,0,398,0,O-65-142-02-07-02
KIRUHURA,NYABUSHOZI COUNTY,KASHONGI,RWENYANGWE,RWENYANGWE II,457,0,0,1,28,347,376,0,376,0,O-65-142-02-07-03
KIRUHURA,NYABUSHOZI COUNTY,KENSHUNGA,NSHWERENKYE,NSHWERENKYE 1,823,0,0,0,0,823,823,0,823,0,O-65-142-03-01-01
KIRUHURA,NYABUSHOZI COUNTY,KENSHUNGA,NSHWERENKYE,NSHWERENKYE 2,250,0,0,0,0,247,247,3,250,0,O-65-142-03-01-02
KIRUHURA,NYABUSHOZI COUNTY,KENSHUNGA,NSHWERENKYE,MUGORE T/C,368,0,0,0,0,358,358,4,362,0,O-65-142-03-01-03
KIRUHURA,NYABUSHOZI COUNTY,KENSHUNGA,NSHWERENKYE,RWAKITURA,495,0,0,0,0,478,478,4,482,0,O-65-142-03-01-04
KIRUHURA,NYABUSHOZI COUNTY,KENSHUNGA,NSHWERENKYE,KYABAGYENYI II,162,0,0,0,0,162,162,0,162,0,O-65-142-03-01-05
KIRUHURA,NYABUSHOZI COUNTY,KENSHUNGA,NYAKASHARARA,NYAKASHARARA 2,744,0,0,0,20,607,627,23,650,0,O-65-142-03-02-01
KIRUHURA,NYABUSHOZI COUNTY,KENSHUNGA,NYAKASHARARA,NYAKASHARARA 3,537,0,2,0,6,511,519,16,535,0,O-65-142-03-02-02
KIRUHURA,NYABUSHOZI COUNTY,KENSHUNGA,NYAKASHARARA,KANYABIHARA,156,0,0,0,0,156,156,0,156,0,O-65-142-03-02-03
KIRUHURA,NYABUSHOZI COUNTY,KENSHUNGA,NYAKASHARARA,BUTEMBERWA,178,1,1,1,9,166,178,0,178,0,O-65-142-03-02-04
KIRUHURA,NYABUSHOZI COUNTY,KENSHUNGA,RUGONGI,RUGONGI 1,746,0,1,2,9,714,726,3,729,0,O-65-142-03-03-01
KIRUHURA,NYABUSHOZI COUNTY,KENSHUNGA,RUGONGI,RUGONGI 2,529,0,0,0,1,505,506,23,529,0,O-65-142-03-03-02
KIRUHURA,NYABUSHOZI COUNTY,KENSHUNGA,RUGONGI,RUGONGI 3,299,0,1,0,13,284,298,1,299,0,O-65-142-03-03-03
KIRUHURA,NYABUSHOZI COUNTY,KENSHUNGA,RUGONGI,MIRAMA,155,0,0,1,12,138,151,0,151,0,O-65-142-03-03-04
KIRUHURA,NYABUSHOZI COUNTY,KENSHUNGA,RUGONGI,MIGAMBA,554,1,0,1,4,485,491,4,495,0,O-65-142-03-03-05
KIRUHURA,NYABUSHOZI COUNTY,KENSHUNGA,RUSHERE,RUSHERE [A - L],778,0,1,0,3,710,714,30,744,0,O-65-142-03-04-01
KIRUHURA,NYABUSHOZI COUNTY,KENSHUNGA,RUSHERE,RUSHERE 2,934,0,0,0,5,917,922,8,930,0,O-65-142-03-04-02
KIRUHURA,NYABUSHOZI COUNTY,KENSHUNGA,RUSHERE,RUSHERE 3,496,0,0,2,1,478,481,0,481,0,O-65-142-03-04-03
KIRUHURA,NYABUSHOZI COUNTY,KENSHUNGA,RUSHERE,RUSHERE [M - Z],921,0,0,1,1,841,843,0,843,0,O-65-142-03-04-04
KIRUHURA,NYABUSHOZI COUNTY,KENSHUNGA,RUSHERE,KYABAGYENYI I,177,0,0,0,0,171,171,4,175,0,O-65-142-03-04-05
KIRUHURA,NYABUSHOZI COUNTY,KIKATSI,EMBARE,EMBARE 1,429,0,1,1,7,390,399,0,399,0,O-65-142-04-01-01
KIRUHURA,NYABUSHOZI COUNTY,KIKATSI,EMBARE,EMBARE [A - L],506,0,1,2,27,464,494,4,498,0,O-65-142-04-01-02
KIRUHURA,NYABUSHOZI COUNTY,KIKATSI,EMBARE,BUNONKO T/C,282,0,1,0,3,268,272,4,276,0,O-65-142-04-01-03
KIRUHURA,NYABUSHOZI COUNTY,KIKATSI,EMBARE,NGIRA T/C,258,0,0,0,1,251,252,0,252,0,O-65-142-04-01-04
KIRUHURA,NYABUSHOZI COUNTY,KIKATSI,EMBARE,EMBARE [M - Z],385,0,0,0,14,343,357,24,381,0,O-65-142-04-01-05
KIRUHURA,NYABUSHOZI COUNTY,KIKATSI,KANYANYA,KANYANYA 1,802,0,1,2,2,791,796,4,800,0,O-65-142-04-02-01
KIRUHURA,NYABUSHOZI COUNTY,KIKATSI,KANYANYA,KANYANYA 2,718,0,0,1,2,706,709,1,710,0,O-65-142-04-02-02
KIRUHURA,NYABUSHOZI COUNTY,KIKATSI,KANYANYA,RWESHANDE,491,0,1,0,1,483,485,0,485,0,O-65-142-04-02-03
KIRUHURA,NYABUSHOZI COUNTY,KIKATSI,KAYONZA,KAYONZA,304,0,1,1,1,297,300,0,300,0,O-65-142-04-03-01
KIRUHURA,NYABUSHOZI COUNTY,KIKATSI,KAYONZA,KARUKOKO,267,0,0,0,5,259,264,3,267,0,O-65-142-04-03-02
KIRUHURA,NYABUSHOZI COUNTY,KIKATSI,KAYONZA,KAYONZA PARISH HQTRS,274,0,0,0,0,191,191,0,191,0,O-65-142-04-03-03
KIRUHURA,NYABUSHOZI COUNTY,KIKATSI,KAYONZA,EKIMOMO T/C,199,0,0,1,10,183,194,0,194,0,O-65-142-04-03-04
KIRUHURA,NYABUSHOZI COUNTY,KIKATSI,KAYONZA,KAYONZA T/C,287,0,1,1,2,277,281,0,281,0,O-65-142-04-03-05
KIRUHURA,NYABUSHOZI COUNTY,KIKATSI,KEIKOTI,KEIKOTI,258,0,0,0,0,258,258,0,258,0,O-65-142-04-04-01
KIRUHURA,NYABUSHOZI COUNTY,KIKATSI,KEIKOTI,EKIYONZA,296,0,0,1,7,283,291,0,291,0,O-65-142-04-04-02
KIRUHURA,NYABUSHOZI COUNTY,KIKATSI,KEIKOTI,KIGABAGABA,280,0,0,0,0,278,278,2,280,0,O-65-142-04-04-03
KIRUHURA,NYABUSHOZI COUNTY,KINONI,KAITANTURENGYE,KAITANTUREGYE 1,296,0,0,0,2,294,296,0,296,0,O-65-142-05-01-01
KIRUHURA,NYABUSHOZI COUNTY,KINONI,KAITANTURENGYE,KYAWANYANA CATHOLIC CHURC,203,0,0,0,0,189,189,5,194,0,O-65-142-05-01-02
KIRUHURA,NYABUSHOZI COUNTY,KINONI,KAITANTURENGYE,KANISYA,232,0,0,0,0,230,230,2,232,0,O-65-142-05-01-03
KIRUHURA,NYABUSHOZI COUNTY,KINONI,KAITANTURENGYE,KABUYANDA,733,0,1,1,0,675,677,1,678,0,O-65-142-05-01-04
KIRUHURA,NYABUSHOZI COUNTY,KINONI,KASAANA,KASAANA 1,701,0,0,0,3,687,690,10,700,0,O-65-142-05-02-01
KIRUHURA,NYABUSHOZI COUNTY,KINONI,KASAANA,KASAANA 2,721,0,0,0,0,706,706,7,713,0,O-65-142-05-02-02
KIRUHURA,NYABUSHOZI COUNTY,KINONI,KASAANA,AKAYANJA MARKET,246,0,0,0,0,243,243,3,246,0,O-65-142-05-02-03
KIRUHURA,NYABUSHOZI COUNTY,KINONI,KASAANA,KINONI TC,237,0,0,1,3,231,235,1,236,0,O-65-142-05-02-04
KIRUHURA,NYABUSHOZI COUNTY,KINONI,MACUNCU,MACUNCU 1,783,0,0,0,0,776,776,4,780,0,O-65-142-05-03-01
KIRUHURA,NYABUSHOZI COUNTY,KINONI,MACUNCU,MACUNCU 2,775,0,0,0,0,771,771,4,775,0,O-65-142-05-03-02
KIRUHURA,NYABUSHOZI COUNTY,KINONI,MACUNCU,MACUNCU 3,512,0,0,0,0,507,507,0,507,0,O-65-142-05-03-03
KIRUHURA,NYABUSHOZI COUNTY,KINONI,MACUNCU,KYANGA,344,0,0,0,0,341,341,3,344,0,O-65-142-05-03-04
KIRUHURA,NYABUSHOZI COUNTY,KINONI,RWETAMU,RWETAMU 1,546,0,0,0,0,540,540,6,546,0,O-65-142-05-04-01
KIRUHURA,NYABUSHOZI COUNTY,KINONI,RWETAMU,RWETAMU 2,466,0,0,0,0,463,463,1,464,0,O-65-142-05-04-02
KIRUHURA,NYABUSHOZI COUNTY,KINONI,RWETAMU,AKAJUMBURA,364,0,0,0,0,364,364,0,364,0,O-65-142-05-04-03
KIRUHURA,NYABUSHOZI COUNTY,KIRUHURA TOWN COUNCIL,KASHWA WARD,KYEITAGI,525,0,0,0,28,490,518,5,523,0,O-65-142-06-01-01
KIRUHURA,NYABUSHOZI COUNTY,KIRUHURA TOWN COUNCIL,KIRUHURA WARD,NYAKASHARARA 1,336,2,0,1,16,286,305,10,315,0,O-65-142-06-02-01
KIRUHURA,NYABUSHOZI COUNTY,KIRUHURA TOWN COUNCIL,NYAKASHARARA WA,NYAKASHARARA 3,893,0,0,1,9,674,684,26,710,0,O-65-142-06-03-01
KIRUHURA,NYABUSHOZI COUNTY,NYAKASHASHARA,BIJUBWE,BIJUBWE,474,0,0,0,21,340,361,25,386,0,O-65-142-07-01-01
KIRUHURA,NYABUSHOZI COUNTY,NYAKASHASHARA,BIJUBWE,AKENGOMA,96,0,0,0,0,94,94,0,94,0,O-65-142-07-01-02
KIRUHURA,NYABUSHOZI COUNTY,NYAKASHASHARA,BIJUBWE,RUSHOGA,314,0,0,1,26,282,309,5,314,0,O-65-142-07-01-03
KIRUHURA,NYABUSHOZI COUNTY,NYAKASHASHARA,BIJUBWE,MUTAJWARA,176,0,0,0,9,147,156,2,158,0,O-65-142-07-01-04
KIRUHURA,NYABUSHOZI COUNTY,NYAKASHASHARA,KYAKABUNGA,KYAKABUNGA 1,443,0,0,1,24,382,407,22,429,0,O-65-142-07-02-01
KIRUHURA,NYABUSHOZI COUNTY,NYAKASHASHARA,KYAKABUNGA,KYAKABUNGA 2,488,0,0,0,17,463,480,7,487,0,O-65-142-07-02-02
KIRUHURA,NYABUSHOZI COUNTY,NYAKASHASHARA,KYAKABUNGA,NYAKASHASHARA PRI. SCHOOL,303,0,0,0,7,274,281,2,283,0,O-65-142-07-02-03
KIRUHURA,NYABUSHOZI COUNTY,NYAKASHASHARA,KYAKABUNGA,KAMARYA,244,0,0,0,0,244,244,0,244,0,O-65-142-07-02-04
KIRUHURA,NYABUSHOZI COUNTY,NYAKASHASHARA,NYAKAHITA,NYAKAHITA 1,613,0,0,0,0,608,608,5,613,0,O-65-142-07-03-01
KIRUHURA,NYABUSHOZI COUNTY,NYAKASHASHARA,NYAKAHITA,NYAKAHITA 2,194,0,0,0,1,193,194,0,194,0,O-65-142-07-03-02
KIRUHURA,NYABUSHOZI COUNTY,NYAKASHASHARA,NYAKAHITA,KARENGO PRI. SCHOOL,408,0,0,0,5,391,396,1,397,0,O-65-142-07-03-03
KIRUHURA,NYABUSHOZI COUNTY,NYAKASHASHARA,NYAKAHITA,RWEITSIRU,356,0,0,0,5,346,351,5,356,0,O-65-142-07-03-04
KIRUHURA,NYABUSHOZI COUNTY,NYAKASHASHARA,NYAKAHITA,AKATOMA,241,0,0,0,0,241,241,0,241,0,O-65-142-07-03-05
KIRUHURA,NYABUSHOZI COUNTY,NYAKASHASHARA,RURAMBIRA,RURAMBIRA,357,0,0,0,0,357,357,0,357,0,O-65-142-07-04-01
KIRUHURA,NYABUSHOZI COUNTY,NYAKASHASHARA,RURAMBIRA,KAKYERA,204,0,0,0,6,194,200,0,200,0,O-65-142-07-04-02
KIRUHURA,NYABUSHOZI COUNTY,NYAKASHASHARA,RURAMBIRA,NYANGA,276,0,0,0,0,262,262,1,263,0,O-65-142-07-04-03
KIRUHURA,NYABUSHOZI COUNTY,SANGA,NOMBE I,NYARUTEGURA,204,0,0,0,3,195,198,6,204,0,O-65-142-08-01-01
KIRUHURA,NYABUSHOZI COUNTY,SANGA,NOMBE I,NOMBE 2,684,0,1,0,3,679,683,1,684,0,O-65-142-08-01-02
KIRUHURA,NYABUSHOZI COUNTY,SANGA,NOMBE I,NOMBE 3,1131,1,0,1,26,1076,1104,23,1127,0,O-65-142-08-01-03
KIRUHURA,NYABUSHOZI COUNTY,SANGA,NOMBE II,RWENSHEKO,209,0,0,0,0,208,208,1,209,0,O-65-142-08-02-01
KIRUHURA,NYABUSHOZI COUNTY,SANGA,NOMBE II,RWAKOBO,107,0,0,0,0,106,106,1,107,0,O-65-142-08-02-02
KIRUHURA,NYABUSHOZI COUNTY,SANGA,NOMBE II,NKONGORO,491,0,0,0,0,491,491,0,491,0,O-65-142-08-02-03
KIRUHURA,NYABUSHOZI COUNTY,SANGA,NOMBE II,KIGARAMA,319,0,0,0,0,319,319,0,319,0,O-65-142-08-02-04
KIRUHURA,NYABUSHOZI COUNTY,SANGA,NOMBE II,NYANKUMBA,405,0,0,0,0,402,402,3,405,0,O-65-142-08-02-05
KIRUHURA,NYABUSHOZI COUNTY,SANGA,RWABARATA,RWABARATA 1,592,0,0,0,14,531,545,0,545,0,O-65-142-08-03-01
KIRUHURA,NYABUSHOZI COUNTY,SANGA,RWABARATA,RWABARATA 2,591,1,2,0,39,544,586,5,591,0,O-65-142-08-03-02
KIRUHURA,NYABUSHOZI COUNTY,SANGA,RWABARATA,KIRIBWA,322,1,0,0,17,300,318,0,318,0,O-65-142-08-03-03
MASINDI,BULIISA COUNTY,BIISO,BIISO,BIISO T/CENTRE,914,2,1,6,83,440,532,52,584,0,O-73-123-01-01-01
MASINDI,BULIISA COUNTY,BIISO,BIISO,BUSINGIRO,867,4,7,7,46,464,528,17,545,0,O-73-123-01-01-02
MASINDI,BULIISA COUNTY,BIISO,BIISO,KIHUUHA,724,2,2,8,77,444,533,34,567,0,O-73-123-01-01-03
MASINDI,BULIISA COUNTY,BIISO,BIISO,NYAMASOGA,1020,12,11,6,23,502,554,59,613,0,O-73-123-01-01-04
MASINDI,BULIISA COUNTY,BIISO,BIISO,SITINI COU,555,8,3,2,62,326,401,35,436,0,O-73-123-01-01-05
MASINDI,BULIISA COUNTY,BIISO,BIISO,KALENGEIJA,731,3,2,9,62,413,489,27,516,0,O-73-123-01-01-06
MASINDI,BULIISA COUNTY,BIISO,BIISO,KAMPALA A,425,2,2,2,12,229,247,27,274,0,O-73-123-01-01-07
MASINDI,BULIISA COUNTY,BIISO,BUTIABA,BOOMA,725,7,2,3,68,276,356,33,389,0,O-73-123-01-02-01
MASINDI,BULIISA COUNTY,BIISO,BUTIABA,KIGUNGA,388,7,0,1,111,145,264,13,277,0,O-73-123-01-02-02
MASINDI,BULIISA COUNTY,BIISO,BUTIABA,PIIDA (A-L),577,4,6,4,83,226,323,19,342,0,O-73-123-01-02-03
MASINDI,BULIISA COUNTY,BIISO,BUTIABA,SERULE (A-L),563,6,2,6,96,172,282,8,290,0,O-73-123-01-02-04
MASINDI,BULIISA COUNTY,BIISO,BUTIABA,WALUKUBA (A-L),480,8,2,2,31,269,312,15,327,0,O-73-123-01-02-05
MASINDI,BULIISA COUNTY,BIISO,BUTIABA,PIIDA (M-Z),578,2,2,1,69,255,329,18,347,0,O-73-123-01-02-06
MASINDI,BULIISA COUNTY,BIISO,BUTIABA,SERULE (M-Z),541,6,2,0,117,152,277,24,301,0,O-73-123-01-02-07
MASINDI,BULIISA COUNTY,BIISO,BUTIABA,WALUKUBA (M-Z),749,9,6,5,56,405,481,40,521,0,O-73-123-01-02-08
MASINDI,BULIISA COUNTY,BIISO,KIHUNGYA,AKOLO,296,0,0,0,44,138,182,0,182,0,O-73-123-01-03-01
MASINDI,BULIISA COUNTY,BIISO,KIHUNGYA,GARASOYA COU (A-L),468,2,4,0,68,220,294,29,323,0,O-73-123-01-03-02
MASINDI,BULIISA COUNTY,BIISO,KIHUNGYA,KIHUNGYA T/CENTRE,757,4,2,4,44,471,525,42,567,0,O-73-123-01-03-03
MASINDI,BULIISA COUNTY,BIISO,KIHUNGYA,NYERAMYA,440,2,1,2,108,185,298,10,308,0,O-73-123-01-03-04
MASINDI,BULIISA COUNTY,BIISO,KIHUNGYA,WAAKI,547,4,4,8,57,338,411,29,440,0,O-73-123-01-03-05
MASINDI,BULIISA COUNTY,BIISO,KIHUNGYA,GARASOYA B,277,1,2,1,31,132,167,10,177,0,O-73-123-01-03-06
MASINDI,BULIISA COUNTY,BIISO,KIHUNGYA,GARASOYA COU (M-Z),377,0,1,4,32,183,220,9,229,0,O-73-123-01-03-07
MASINDI,BULIISA COUNTY,BULIISA,KIGWERA,KATANGA COU,680,3,0,9,94,403,509,12,521,0,O-73-123-02-01-01
MASINDI,BULIISA COUNTY,BULIISA,KIGWERA,KICHOKE TRADING CENTRE,524,6,2,1,41,338,388,8,396,0,O-73-123-02-01-02
MASINDI,BULIISA COUNTY,BULIISA,KIGWERA,KIGWERA P/SOCIETY,436,3,0,3,66,227,299,18,317,0,O-73-123-02-01-03
MASINDI,BULIISA COUNTY,BULIISA,KIGWERA,KIGWERA P/SOCIETY STORE,348,2,0,1,48,178,229,11,240,0,O-73-123-02-01-04
MASINDI,BULIISA COUNTY,BULIISA,KIGWERA,KIGWERA PARISH HQRS,469,1,3,2,80,234,320,7,327,0,O-73-123-02-01-05
MASINDI,BULIISA COUNTY,BULIISA,KIGWERA,KIRAMA PRI. SCHOOL,597,4,2,3,58,419,486,6,492,0,O-73-123-02-01-06
MASINDI,BULIISA COUNTY,BULIISA,KIGWERA,KISANSYA,760,6,2,2,143,407,560,20,580,0,O-73-123-02-01-07
MASINDI,BULIISA COUNTY,BULIISA,KIGWERA,WANSEKO BOREHOLE,919,5,3,2,128,429,567,16,583,0,O-73-123-02-01-08
MASINDI,BULIISA COUNTY,BULIISA,KIGWERA,WANSEKO P/S,518,2,2,0,55,277,336,14,350,0,O-73-123-02-01-09
MASINDI,BULIISA COUNTY,BULIISA,KIGWERA,KISANSYA C.O.U,550,3,4,0,87,292,386,12,398,0,O-73-123-02-01-10
MASINDI,BULIISA COUNTY,BULIISA,KIGWERA,NDADAMIRE P/S,388,0,0,2,43,245,290,11,301,0,O-73-123-02-01-11
MASINDI,BULIISA COUNTY,BULIISA,KISIABI,BIROYA CHURCH - KAKORA,522,6,2,11,15,328,362,23,385,0,O-73-123-02-02-01
MASINDI,BULIISA COUNTY,BULIISA,KISIABI,BULIISA CTY HQRS,695,2,2,1,124,339,468,6,474,0,O-73-123-02-02-02
MASINDI,BULIISA COUNTY,BULIISA,KISIABI,KABOLWA T/CENTRE,699,2,1,7,100,298,408,14,422,0,O-73-123-02-02-03
MASINDI,BULIISA COUNTY,BULIISA,KISIABI,KATALEBA - KICHOKE,880,15,9,9,162,414,609,33,642,0,O-73-123-02-02-04
MASINDI,BULIISA COUNTY,BULIISA,KISIABI,KIJANGI P/S,602,5,0,6,60,290,361,22,383,0,O-73-123-02-02-05
MASINDI,BULIISA COUNTY,BULIISA,KISIABI,KISIABI P/HQRS 1,404,5,1,1,94,176,277,20,297,0,O-73-123-02-02-06
MASINDI,BULIISA COUNTY,BULIISA,KISIABI,KISIABI P/HQRS 2,497,0,1,4,138,251,394,15,409,0,O-73-123-02-02-07
MASINDI,BULIISA COUNTY,BULIISA,KISIABI,URIIBO - PANDEGA,884,7,1,7,65,525,605,25,630,0,O-73-123-02-02-08
MASINDI,BULIISA COUNTY,BULIISA,KISIABI,BULLISA S/CTY HQRS,367,3,0,3,55,196,257,5,262,0,O-73-123-02-02-09
MASINDI,BULIISA COUNTY,BULIISA,NGWEDO,AVOGERA P/S,674,10,0,3,42,425,480,22,502,0,O-73-123-02-03-01
MASINDI,BULIISA COUNTY,BULIISA,NGWEDO,KARTUM T/CENTRE,619,6,2,5,88,299,400,19,419,0,O-73-123-02-03-02
MASINDI,BULIISA COUNTY,BULIISA,NGWEDO,KASINYI BOREHOLE,851,7,4,7,94,401,513,28,541,0,O-73-123-02-03-03
MASINDI,BULIISA COUNTY,BULIISA,NGWEDO,NGWEDO P/SCHOOL,975,4,4,4,69,470,551,32,583,0,O-73-123-02-03-04
MASINDI,BULIISA COUNTY,BULIISA,NGWEDO,NGWEDO P/SOCIETY,926,9,6,7,128,442,592,33,625,0,O-73-123-02-03-05
MASINDI,BULIISA COUNTY,BULIISA,NGWEDO,MUBAKU/PARAA P/S,338,0,0,0,92,33,125,4,129,0,O-73-123-02-03-06
MASINDI,BULIISA COUNTY,BULIISA,NGWEDO,AVOGERA HEALTH CENTRE,505,3,6,5,60,289,363,14,377,0,O-73-123-02-03-07
KYENJOJO,KYAKA COUNTY,HAPUYO,IRINGA,IRINGA PARISH HQRS,534,2,0,1,38,285,326,17,343,0,O-84-55-01-01-01
KYENJOJO,KYAKA COUNTY,HAPUYO,IRINGA,NKAKWA T. C. A,918,2,1,4,32,611,650,2,652,0,O-84-55-01-01-02
KYENJOJO,KYAKA COUNTY,HAPUYO,IRINGA,ISUNGA T. C. PLAY GROUND,993,2,2,7,67,510,588,16,604,0,O-84-55-01-01-03
KYENJOJO,KYAKA COUNTY,HAPUYO,IRINGA,NKAKWA T. C. B,726,2,1,6,26,556,591,23,614,0,O-84-55-01-01-04
KYENJOJO,KYAKA COUNTY,HAPUYO,IRINGA,IRINGA P/S,403,0,2,1,21,249,273,6,279,0,O-84-55-01-01-05
KYENJOJO,KYAKA COUNTY,HAPUYO,KIGAMBO,KIGAMBO C.O.U,633,3,2,5,34,340,384,2,386,0,O-84-55-01-02-01
KYENJOJO,KYAKA COUNTY,HAPUYO,KIGAMBO,NTUNTU P/S,771,3,1,7,23,364,398,12,410,0,O-84-55-01-02-02
KYENJOJO,KYAKA COUNTY,HAPUYO,KIGAMBO,KATATURWA P/S,245,0,2,0,14,162,178,6,184,0,O-84-55-01-02-03
KYENJOJO,KYAKA COUNTY,HAPUYO,KIGAMBO,KYANYAMBALI P/S,517,3,2,2,19,284,310,6,316,0,O-84-55-01-02-04
KYENJOJO,KYAKA COUNTY,HAPUYO,KIJUMA,KIJUMA TRADING CENTRE,832,0,0,7,51,583,641,8,649,0,O-84-55-01-03-01
KYENJOJO,KYAKA COUNTY,HAPUYO,KIJUMA,KARUMAIMA T. C.,750,1,3,2,24,566,596,11,607,0,O-84-55-01-03-02
KYENJOJO,KYAKA COUNTY,HAPUYO,KITALESA,HAPUYO S/C HQRS,557,1,2,2,23,355,383,5,388,0,O-84-55-01-04-01
KYENJOJO,KYAKA COUNTY,HAPUYO,KITALESA,KITALEESA P. S.,803,4,2,6,17,658,687,13,700,0,O-84-55-01-04-02
KYENJOJO,KYAKA COUNTY,HAPUYO,KITALESA,HAPUUYO P/S,258,0,0,0,4,235,239,10,249,0,O-84-55-01-04-03
KYENJOJO,KYAKA COUNTY,KAKABARA,KIJAGUZO,KYAISAZA P/S,929,0,1,6,37,604,648,8,656,0,O-84-55-02-01-01
KYENJOJO,KYAKA COUNTY,KAKABARA,KIJAGUZO,KISOKO P/S,694,3,0,3,37,399,442,14,456,0,O-84-55-02-01-02
KYENJOJO,KYAKA COUNTY,KAKABARA,KIJAGUZO,KIJAGUZO ITAMBIRO,726,1,0,4,21,462,488,12,500,0,O-84-55-02-01-03
KYENJOJO,KYAKA COUNTY,KAKABARA,KIJAGUZO,KAKABARA P/S,723,4,0,3,37,459,503,9,512,0,O-84-55-02-01-04
KYENJOJO,KYAKA COUNTY,KAKABARA,KIJAGUZO,KYARWEHUTA P/S,428,3,2,1,28,280,314,14,328,0,O-84-55-02-01-05
KYENJOJO,KYAKA COUNTY,KAKABARA,KIJAGUZO,KIHAGUZI ITAMBIRO,370,4,0,0,24,248,276,5,281,0,O-84-55-02-01-06
KYENJOJO,KYAKA COUNTY,KAKABARA,KYATEGA,KICUMU P/S,695,1,0,4,15,485,505,12,517,0,O-84-55-02-02-01
KYENJOJO,KYAKA COUNTY,KAKABARA,KYATEGA,KYATEGA HQRS,607,1,0,1,16,393,411,7,418,0,O-84-55-02-02-02
KYENJOJO,KYAKA COUNTY,KAKABARA,KYATEGA,KITAMBA C.O.U,361,0,1,2,7,291,301,13,314,0,O-84-55-02-02-03
KYENJOJO,KYAKA COUNTY,KAKABARA,MIGONGWE,MIGONGWE P. SCHOOL,940,2,1,4,34,657,698,25,723,0,O-84-55-02-03-01
KYENJOJO,KYAKA COUNTY,KAKABARA,MIGONGWE,KIKYEDO T. C.,582,3,1,1,15,417,437,13,450,0,O-84-55-02-03-02
KYENJOJO,KYAKA COUNTY,KAKABARA,MIGONGWE,KAGORANI P. S.,885,1,0,0,55,599,655,10,665,0,O-84-55-02-03-03
KYENJOJO,KYAKA COUNTY,KAKABARA,MIGONGWE,KIKUBA P/S,340,1,0,1,12,233,247,3,250,0,O-84-55-02-03-04
KYENJOJO,KYAKA COUNTY,KASULE,KARAMA,KARAMA PARISH HQRS,757,2,1,2,27,501,533,9,542,0,O-84-55-03-01-01
KYENJOJO,KYAKA COUNTY,KASULE,KARAMA,NGANGI CHURCH,1089,1,1,4,25,541,572,34,606,0,O-84-55-03-01-02
KYENJOJO,KYAKA COUNTY,KASULE,KARAMA,BUGOGO P/S,1059,5,1,4,58,742,810,12,822,0,O-84-55-03-01-03
KYENJOJO,KYAKA COUNTY,KASULE,KASULE,KASULE S/C HQRS,806,1,3,2,30,586,622,41,663,0,O-84-55-03-02-01
KYENJOJO,KYAKA COUNTY,KASULE,KIBUUBA,KIBUBA PARISH HQRS,967,1,0,1,49,720,771,13,784,0,O-84-55-03-03-01
KYENJOJO,KYAKA COUNTY,KYEGEGWA,KABWEZA,KABWEZA P/S,428,1,0,2,21,292,316,7,323,0,O-84-55-04-01-01
KYENJOJO,KYAKA COUNTY,KYEGEGWA,KABWEZA,BUKERE P/S,1118,2,1,5,69,419,496,19,515,0,O-84-55-04-01-02
KYENJOJO,KYAKA COUNTY,KYEGEGWA,KABWEZA,BUKERE (L-Z),593,0,2,3,47,280,332,17,349,0,O-84-55-04-01-03
KYENJOJO,KYAKA COUNTY,KYEGEGWA,KABWEZA,MUHANGI C.O.U,389,1,1,2,7,311,322,7,329,0,O-84-55-04-01-04
KYENJOJO,KYAKA COUNTY,KYEGEGWA,KABWEZA,KYAKATWANGA,233,0,1,0,13,167,181,4,185,0,O-84-55-04-01-05
KYENJOJO,KYAKA COUNTY,KYEGEGWA,KIBUYE,BUTOOKE,733,3,0,4,18,553,578,2,580,0,O-84-55-04-02-01
KYENJOJO,KYAKA COUNTY,KYEGEGWA,KIBUYE,KIBUYE PARISH HQRS,815,3,2,2,19,601,627,15,642,0,O-84-55-04-02-02
KYENJOJO,KYAKA COUNTY,KYEGEGWA,KIBUYE,NYAMUHANAMI,694,0,0,4,22,470,496,10,506,0,O-84-55-04-02-03
KYENJOJO,KYAKA COUNTY,KYEGEGWA,KIHAMBA,WEKOMIRE A,576,1,2,3,20,393,419,18,437,0,O-84-55-04-03-01
KYENJOJO,KYAKA COUNTY,KYEGEGWA,KIHAMBA,WEKOMIRE B,613,0,0,0,27,453,480,14,494,0,O-84-55-04-03-02
KYENJOJO,KYAKA COUNTY,KYEGEGWA,KIHAMBA,KIHAMBA,777,4,2,4,22,607,639,5,644,0,O-84-55-04-03-03
KYENJOJO,KYAKA COUNTY,KYEGEGWA,NKAAKA,HUMURA P/S,549,1,1,1,44,269,316,11,327,0,O-84-55-04-04-01
KYENJOJO,KYAKA COUNTY,KYEGEGWA,NKAAKA,NKAAKA PARISH HQRS,896,2,1,2,26,611,642,24,666,0,O-84-55-04-04-02
KYENJOJO,KYAKA COUNTY,KYEGEGWA,NKAAKA,KIBIRA,513,3,2,1,17,404,427,3,430,0,O-84-55-04-04-03
KYENJOJO,KYAKA COUNTY,KYEGEGWA,NKAAKA,KYEGEGWA COMMUNITY HALL,658,3,1,2,50,355,411,4,415,0,O-84-55-04-04-04
KYENJOJO,KYAKA COUNTY,KYEGEGWA,NKAAKA,KACUMBI ITAMBIRO,278,0,0,1,6,175,182,13,195,0,O-84-55-04-04-05
KYENJOJO,KYAKA COUNTY,MPARA,BUGIDO,HARUNYINYA PARISH HQRS,823,5,1,7,29,520,562,8,570,0,O-84-55-05-01-01
KYENJOJO,KYAKA COUNTY,MPARA,BUGIDO,NGANGI P/S,755,3,0,2,25,460,490,7,497,0,O-84-55-05-01-02
KYENJOJO,KYAKA COUNTY,MPARA,BUGIDO,KAZINGA P/S,811,4,0,1,58,479,542,8,550,0,O-84-55-05-01-03
KYENJOJO,KYAKA COUNTY,MPARA,BUGIDO,KYARUJUMBA,531,0,4,3,47,308,362,6,368,0,O-84-55-05-01-04
KYENJOJO,KYAKA COUNTY,MPARA,BUGIDO,NGANJUI B,721,2,0,4,15,321,342,3,345,0,O-84-55-05-01-05
KYENJOJO,KYAKA COUNTY,MPARA,BUGIDO,KAKINDO PRIMARY SCHOOL,434,0,0,0,16,283,299,1,300,0,O-84-55-05-01-06
KYENJOJO,KYAKA COUNTY,MPARA,BUGIDO,KABARABARA,263,1,0,2,16,172,191,2,193,0,O-84-55-05-01-07
KYENJOJO,KYAKA COUNTY,MPARA,BUGIDO,RUSAYUMBE,830,0,1,7,46,478,532,5,537,0,O-84-55-05-01-08
KYENJOJO,KYAKA COUNTY,MPARA,KARWENYI,KARWENYI P/S,729,0,0,2,20,528,550,7,557,0,O-84-55-05-02-01
KYENJOJO,KYAKA COUNTY,MPARA,KARWENYI,KAJUMBURA,323,0,0,2,6,216,224,7,231,0,O-84-55-05-02-02
KYENJOJO,KYAKA COUNTY,MPARA,KARWENYI,KIBURARA P/S,386,0,0,1,11,258,270,3,273,0,O-84-55-05-02-03
KYENJOJO,KYAKA COUNTY,MPARA,KIJONGOBYA,RUTEERWA,477,1,0,2,31,383,417,6,423,0,O-84-55-05-03-01
KYENJOJO,KYAKA COUNTY,MPARA,KIJONGOBYA,KIJUNGOBYA PARISH HQRS,837,1,0,0,26,669,696,4,700,0,O-84-55-05-03-02
KYENJOJO,KYAKA COUNTY,MPARA,KIJONGOBYA,KAMUTUUMI,390,1,1,5,11,297,315,3,318,0,O-84-55-05-03-03
KYENJOJO,KYAKA COUNTY,MPARA,KIJONGOBYA,KISAGAZI P/S,366,0,0,0,4,267,271,5,276,0,O-84-55-05-03-04
KYENJOJO,KYAKA COUNTY,MPARA,KISAMBYA,KISAMBYA P. S.,668,0,0,2,27,489,518,8,526,0,O-84-55-05-04-01
KYENJOJO,KYAKA COUNTY,MPARA,KISAMBYA,KYEIGAKE T. C.,478,3,0,2,33,325,363,5,368,0,O-84-55-05-04-02
KYENJOJO,KYAKA COUNTY,MPARA,KISAMBYA,BUJUBULI PRIMARY SCHOOL,911,0,1,5,30,601,637,16,653,0,O-84-55-05-04-03
KYENJOJO,KYAKA COUNTY,MPARA,RWAHUNGA,MPARA P/S,675,3,2,5,22,396,428,8,436,0,O-84-55-05-05-01
KYENJOJO,KYAKA COUNTY,MPARA,RWAHUNGA,NYAKATOMA P/S,783,2,1,8,19,443,473,9,482,0,O-84-55-05-05-02
KYENJOJO,KYAKA COUNTY,MPARA,RWAHUNGA,KISINDA P/S,1097,0,1,4,39,537,581,9,590,0,O-84-55-05-05-03
KYENJOJO,KYAKA COUNTY,MPARA,RWAHUNGA,NYAKATOMA B,523,1,1,2,21,224,249,5,254,0,O-84-55-05-05-04
KYENJOJO,KYAKA COUNTY,MPARA,RWAHUNGA,KISINDA B,767,2,0,7,32,374,415,10,425,0,O-84-55-05-05-05
KYENJOJO,KYAKA COUNTY,MPARA,RWAHUNGA,RWAHUNGA CATHOLIC CHURCH,467,3,1,2,20,269,295,6,301,0,O-84-55-05-05-06
KYENJOJO,KYAKA COUNTY,MPARA,RWAHUNGA,SOOBA,368,0,0,1,29,196,226,7,233,0,O-84-55-05-05-07
MASINDI,KIBANDA COUNTY,KIGUMBA,KIGUMBA,KIBYAMA T/C,663,3,6,5,98,341,453,3,456,0,O-92-125-01-01-01
MASINDI,KIBANDA COUNTY,KIGUMBA,KIGUMBA,KIGUMBA T/C (A-L),892,2,4,1,157,231,395,21,416,0,O-92-125-01-01-02
MASINDI,KIBANDA COUNTY,KIGUMBA,KIGUMBA,KYEGANYA C.O.U,755,12,2,15,183,255,467,50,517,0,O-92-125-01-01-03
MASINDI,KIBANDA COUNTY,KIGUMBA,KIGUMBA,MPUMWE T/C (A-M),535,3,9,3,48,239,302,30,332,0,O-92-125-01-01-04
MASINDI,KIBANDA COUNTY,KIGUMBA,KIGUMBA,NYAKATUGO (A-L),806,6,4,3,218,191,422,36,458,0,O-92-125-01-01-05
MASINDI,KIBANDA COUNTY,KIGUMBA,KIGUMBA,NYAKIBETE T/C (A-M),624,6,0,8,178,175,367,31,398,0,O-92-125-01-01-06
MASINDI,KIBANDA COUNTY,KIGUMBA,KIGUMBA,UGANDA COOP COLLEGE,789,3,3,8,179,261,454,20,474,0,O-92-125-01-01-07
MASINDI,KIBANDA COUNTY,KIGUMBA,KIGUMBA,KIGUMBA T/C (M-Z),753,3,2,5,160,196,366,12,378,0,O-92-125-01-01-08
MASINDI,KIBANDA COUNTY,KIGUMBA,KIGUMBA,MPUMWE T/C (N-Z),534,2,9,2,50,242,305,33,338,0,O-92-125-01-01-09
MASINDI,KIBANDA COUNTY,KIGUMBA,KIGUMBA,NYAKATUGO (M-Z),647,4,5,4,194,170,377,22,399,0,O-92-125-01-01-10
MASINDI,KIBANDA COUNTY,KIGUMBA,KIGUMBA,NYAKIBETE T/C (N-Z),531,4,2,8,119,165,298,23,321,0,O-92-125-01-01-11
MASINDI,KIBANDA COUNTY,KIGUMBA,KIGUMBA,KYAMUGYENYI B.C.S P/S,224,3,1,2,50,75,131,5,136,0,O-92-125-01-01-12
MASINDI,KIBANDA COUNTY,KIGUMBA,KIGUMBA,KIDIDIMA MKT,574,1,1,2,73,265,342,18,360,0,O-92-125-01-01-13
MASINDI,KIBANDA COUNTY,KIGUMBA,KIIGYA,KADUKU P/S,515,4,1,5,34,240,284,16,300,0,O-92-125-01-02-01
MASINDI,KIBANDA COUNTY,KIGUMBA,KIIGYA,KIGUMBA P/S,815,1,4,4,141,285,435,27,462,0,O-92-125-01-02-02
MASINDI,KIBANDA COUNTY,KIGUMBA,KIIGYA,KIHURA,469,4,1,1,116,130,252,20,272,0,O-92-125-01-02-03
MASINDI,KIBANDA COUNTY,KIGUMBA,KIIGYA,KIIGYA P/S I,976,6,6,3,98,463,576,23,599,0,O-92-125-01-02-04
MASINDI,KIBANDA COUNTY,KIGUMBA,KIIGYA,KIIGYA P/S II,297,0,2,2,41,138,183,4,187,0,O-92-125-01-02-05
MASINDI,KIBANDA COUNTY,KIGUMBA,KIIGYA,KIZIBU CATH. CHURCH,833,6,13,10,73,483,585,27,612,0,O-92-125-01-02-06
MASINDI,KIBANDA COUNTY,KIGUMBA,KIIGYA,JEEJA P/S (A-L),348,1,0,0,46,164,211,5,216,0,O-92-125-01-02-07
MASINDI,KIBANDA COUNTY,KIGUMBA,KIIGYA,KIGUMBA TAX PARK,594,4,4,1,127,220,356,12,368,0,O-92-125-01-02-08
MASINDI,KIBANDA COUNTY,KIGUMBA,KIIGYA,KIHURA I MANGO,689,6,9,2,160,269,446,10,456,0,O-92-125-01-02-09
MASINDI,KIBANDA COUNTY,KIGUMBA,KIIGYA,KINYALA MKT,282,4,2,4,44,142,196,7,203,0,O-92-125-01-02-10
MASINDI,KIBANDA COUNTY,KIGUMBA,KIIGYA,JEEJA P/S (M-Z),384,2,2,3,43,177,227,11,238,0,O-92-125-01-02-11
MASINDI,KIBANDA COUNTY,KIGUMBA,MBOIRA,APODORWA MARKET,760,14,15,14,148,248,439,42,481,0,O-92-125-01-03-01
MASINDI,KIBANDA COUNTY,KIGUMBA,MBOIRA,CHUNGAMENO MARKET,701,18,6,14,139,205,382,33,415,0,O-92-125-01-03-02
MASINDI,KIBANDA COUNTY,KIGUMBA,MBOIRA,HANGA P/S,446,9,4,5,0,208,226,8,234,0,O-92-125-01-03-03
MASINDI,KIBANDA COUNTY,KIGUMBA,MBOIRA,MBOIRA P/S,1276,15,10,22,205,441,693,91,784,0,O-92-125-01-03-04
MASINDI,KIBANDA COUNTY,KIGUMBA,MBOIRA,NKWENDA MARKET,556,22,10,23,153,172,380,35,415,0,O-92-125-01-03-05
MASINDI,KIBANDA COUNTY,KIGUMBA,MBOIRA,NYAKATITI CHURCH,583,7,5,15,127,219,373,16,389,0,O-92-125-01-03-06
MASINDI,KIBANDA COUNTY,KIGUMBA,MBOIRA,KYAKAKUNGURU CATH. CHURCH,488,6,10,7,112,116,251,25,276,0,O-92-125-01-03-07
MASINDI,KIBANDA COUNTY,KIGUMBA,MBOIRA,NYAKABALE T.C,345,3,3,7,52,155,220,13,233,0,O-92-125-01-03-08
MASINDI,KIBANDA COUNTY,KIRYANDONGO,KICHWABUGINGO,BWEYALE PR / SCHOOL A (A-AL),841,5,1,7,147,79,239,18,257,0,O-92-125-02-01-01
MASINDI,KIBANDA COUNTY,KIRYANDONGO,KICHWABUGINGO,BWEYALE P/S B,1083,2,3,4,207,83,299,22,321,0,O-92-125-02-01-02
MASINDI,KIBANDA COUNTY,KIRYANDONGO,KICHWABUGINGO,KARUNGU T/C,1096,9,11,9,285,219,533,42,575,0,O-92-125-02-01-03
MASINDI,KIBANDA COUNTY,KIRYANDONGO,KICHWABUGINGO,KATULIKIRE P/S A,558,2,2,3,107,147,261,43,304,0,O-92-125-02-01-04
MASINDI,KIBANDA COUNTY,KIRYANDONGO,KICHWABUGINGO,KATULIKIRE P/S B (A-L),581,6,3,6,109,138,262,31,293,0,O-92-125-02-01-05
MASINDI,KIBANDA COUNTY,KIRYANDONGO,KICHWABUGINGO,KISONA,599,4,3,6,100,122,235,40,275,0,O-92-125-02-01-06
MASINDI,KIBANDA COUNTY,KIRYANDONGO,KICHWABUGINGO,OPOK P/S A,769,11,4,16,60,318,409,49,458,0,O-92-125-02-01-07
MASINDI,KIBANDA COUNTY,KIRYANDONGO,KICHWABUGINGO,OPOK P/S B,614,9,3,5,74,207,298,30,328,0,O-92-125-02-01-08
MASINDI,KIBANDA COUNTY,KIRYANDONGO,KICHWABUGINGO,SIRIBA CLUB I (A - L),933,15,15,7,249,156,442,29,471,0,O-92-125-02-01-09
MASINDI,KIBANDA COUNTY,KIRYANDONGO,KICHWABUGINGO,SIRIBA CLUB 2 (A - K),1021,5,8,4,323,61,401,51,452,0,O-92-125-02-01-10
MASINDI,KIBANDA COUNTY,KIRYANDONGO,KICHWABUGINGO,BWEYALE PR / SCHOOL A (AM-D),507,0,3,0,86,49,138,9,147,0,O-92-125-02-01-11
MASINDI,KIBANDA COUNTY,KIRYANDONGO,KICHWABUGINGO,BWEYALE PR / SCHOOL A (E-M),534,4,2,0,89,73,168,8,176,0,O-92-125-02-01-12
MASINDI,KIBANDA COUNTY,KIRYANDONGO,KICHWABUGINGO,SIRIBA CLUB I (M - Z),460,3,3,0,107,61,174,68,242,0,O-92-125-02-01-13
MASINDI,KIBANDA COUNTY,KIRYANDONGO,KICHWABUGINGO,SIRIBA CLUB 2 (L - Z),550,2,2,2,226,47,279,14,293,0,O-92-125-02-01-14
MASINDI,KIBANDA COUNTY,KIRYANDONGO,KICHWABUGINGO,BWEYALE PUBLIC SCH,358,0,3,1,88,128,220,24,244,0,O-92-125-02-01-15
MASINDI,KIBANDA COUNTY,KIRYANDONGO,KICHWABUGINGO,KATULIKIRE P/S B (M-Z),361,3,2,3,83,113,204,14,218,0,O-92-125-02-01-16
MASINDI,KIBANDA COUNTY,KIRYANDONGO,KICHWABUGINGO,KIGOMA T.C,431,4,5,5,47,124,185,3,188,0,O-92-125-02-01-17
MASINDI,KIBANDA COUNTY,KIRYANDONGO,KICHWABUGINGO,BWEYALE PR / SCHOOL A (N-OM),423,0,2,0,130,55,187,4,191,0,O-92-125-02-01-18
MASINDI,KIBANDA COUNTY,KIRYANDONGO,KICHWABUGINGO,BWEYALE PR / SCHOOL A (ON-Z),424,0,0,1,122,60,183,10,193,0,O-92-125-02-01-19
MASINDI,KIBANDA COUNTY,KIRYANDONGO,KIKUBE,DYANGI P/S,319,1,3,0,22,193,219,48,267,0,O-92-125-02-02-01
MASINDI,KIBANDA COUNTY,KIRYANDONGO,KIKUBE,KARWALA MARKET,953,12,14,4,128,412,570,29,599,0,O-92-125-02-02-02
MASINDI,KIBANDA COUNTY,KIRYANDONGO,KIKUBE,KIBANDA COUNTY HQRS,833,4,5,1,131,312,453,74,527,0,O-92-125-02-02-03
MASINDI,KIBANDA COUNTY,KIRYANDONGO,KIKUBE,KIRYANDONGO SCTY HQRS,910,3,5,3,132,356,499,9,508,0,O-92-125-02-02-04
MASINDI,KIBANDA COUNTY,KIRYANDONGO,KIKUBE,KYEMBERA,821,4,10,10,166,302,492,63,555,0,O-92-125-02-02-05
MASINDI,KIBANDA COUNTY,KIRYANDONGO,KIKUBE,NYABISO T/C,480,2,1,1,41,254,299,29,328,0,O-92-125-02-02-06
MASINDI,KIBANDA COUNTY,KIRYANDONGO,KIKUBE,NYAKAGANDO MARKET,724,5,8,7,124,301,445,30,475,0,O-92-125-02-02-07
MASINDI,KIBANDA COUNTY,KIRYANDONGO,KIKUBE,NYAKATAMA,873,2,5,3,79,515,604,57,661,0,O-92-125-02-02-08
MASINDI,KIBANDA COUNTY,KIRYANDONGO,KIKUBE,RUNYANYA P/S,766,9,4,7,84,365,469,19,488,0,O-92-125-02-02-09
MASINDI,KIBANDA COUNTY,KIRYANDONGO,KIKUBE,TECHWA T.C,146,0,0,0,33,33,66,3,69,0,O-92-125-02-02-10
MASINDI,KIBANDA COUNTY,KIRYANDONGO,KIKUBE,RUNYANYA P/S II,413,2,0,3,18,286,309,9,318,0,O-92-125-02-02-11
MASINDI,KIBANDA COUNTY,KIRYANDONGO,KITWARA,KAMUSENENE,136,0,0,0,0,136,136,0,136,0,O-92-125-02-03-01
MASINDI,KIBANDA COUNTY,KIRYANDONGO,KITWARA,KANKOBA MARKET,387,1,1,0,31,62,95,11,106,0,O-92-125-02-03-02
MASINDI,KIBANDA COUNTY,KIRYANDONGO,KITWARA,KANKOBA MARKET (K),345,0,2,0,20,213,235,5,240,0,O-92-125-02-03-03
MASINDI,KIBANDA COUNTY,KIRYANDONGO,KITWARA,KIMOGOLO,505,1,1,1,25,329,357,7,364,0,O-92-125-02-03-04
MASINDI,KIBANDA COUNTY,KIRYANDONGO,KITWARA,KITWARA P/S,723,1,5,0,15,551,572,14,586,0,O-92-125-02-03-05
MASINDI,KIBANDA COUNTY,KIRYANDONGO,KITWARA,KYAMUKUBAGI,721,0,3,1,28,446,478,18,496,0,O-92-125-02-03-06
MASINDI,KIBANDA COUNTY,KIRYANDONGO,KITWARA,KAPUNDO T.C,244,1,0,0,21,160,182,7,189,0,O-92-125-02-03-07
MASINDI,KIBANDA COUNTY,KIRYANDONGO,KITWARA,KITONGOZI P/S,519,1,2,0,34,286,323,17,340,0,O-92-125-02-03-08
MASINDI,KIBANDA COUNTY,KIRYANDONGO,KYANKENDE,DIIKA P/S,484,3,3,3,37,205,251,12,263,0,O-92-125-02-04-01
MASINDI,KIBANDA COUNTY,KIRYANDONGO,KYANKENDE,DIIKA P/S B,846,9,6,4,123,282,424,49,473,0,O-92-125-02-04-02
MASINDI,KIBANDA COUNTY,KIRYANDONGO,KYANKENDE,DIIKA T.C,370,4,3,4,64,111,186,21,207,0,O-92-125-02-04-03
MASINDI,KIBANDA COUNTY,KIRYANDONGO,KYANKENDE,KIRWALA T/C,494,5,2,4,37,188,236,49,285,0,O-92-125-02-04-04
MASINDI,KIBANDA COUNTY,KIRYANDONGO,KYANKENDE,KIRYANDONGO BSC P/S,797,4,4,3,153,297,461,10,471,0,O-92-125-02-04-05
MASINDI,KIBANDA COUNTY,KIRYANDONGO,KYANKENDE,KONYOKONYO MARKET (A-D),722,6,6,3,111,199,325,17,342,0,O-92-125-02-04-06
MASINDI,KIBANDA COUNTY,KIRYANDONGO,KYANKENDE,KONYOKONYO MARKET (E-N),579,6,5,7,58,226,302,30,332,0,O-92-125-02-04-07
MASINDI,KIBANDA COUNTY,KIRYANDONGO,KYANKENDE,KONYOKONYO MARKET (O-Z),576,9,4,3,107,152,275,32,307,0,O-92-125-02-04-08
MASINDI,KIBANDA COUNTY,KIRYANDONGO,KYANKENDE,BUNYAMA T.C,626,4,2,7,96,219,328,22,350,0,O-92-125-02-04-09
MASINDI,KIBANDA COUNTY,KIRYANDONGO,KYANKENDE,DYANGI P/SCH,245,0,0,0,82,70,152,10,162,0,O-92-125-02-04-10
MASINDI,KIBANDA COUNTY,KIRYANDONGO,KYANKENDE,KALAGALYA P/S,252,4,1,4,39,101,149,24,173,0,O-92-125-02-04-11
MASINDI,KIBANDA COUNTY,MASINDI PORT,KADUKU,KAYEMBE,867,2,7,10,65,429,513,19,532,0,O-92-125-03-01-01
MASINDI,KIBANDA COUNTY,MASINDI PORT,KADUKU,MUSISA TREE,292,0,0,0,24,189,213,11,224,0,O-92-125-03-01-02
MASINDI,KIBANDA COUNTY,MASINDI PORT,KADUKU,WAKISANYI CLUB,593,0,1,0,23,295,319,5,324,0,O-92-125-03-01-03
MASINDI,KIBANDA COUNTY,MASINDI PORT,WAIBANGO,KITUKUZA,724,7,5,4,188,253,457,50,507,0,O-92-125-03-02-01
MASINDI,KIBANDA COUNTY,MASINDI PORT,WAIBANGO,WAIBANGO (A-L),638,1,1,8,68,313,391,17,408,0,O-92-125-03-02-02
MASINDI,KIBANDA COUNTY,MASINDI PORT,WAIBANGO,WAIBANGO (M-Z),374,3,2,2,32,188,227,14,241,0,O-92-125-03-02-03
MASINDI,KIBANDA COUNTY,MUTUNDA,DIIMA,BEDOMOT(A-K),530,4,1,2,207,45,259,33,292,0,O-92-125-04-01-01
MASINDI,KIBANDA COUNTY,MUTUNDA,DIIMA,DIIMA P/S,1136,12,20,15,215,355,617,87,704,0,O-92-125-04-01-02
MASINDI,KIBANDA COUNTY,MUTUNDA,DIIMA,DIIMA PARISH HQTRS (A-J),755,12,9,14,186,126,347,12,359,0,O-92-125-04-01-03
MASINDI,KIBANDA COUNTY,MUTUNDA,DIIMA,GWARA P/S 1,649,7,5,9,140,183,344,9,353,0,O-92-125-04-01-04
MASINDI,KIBANDA COUNTY,MUTUNDA,DIIMA,GWARA P/S 2,335,2,4,5,88,79,178,10,188,0,O-92-125-04-01-05
MASINDI,KIBANDA COUNTY,MUTUNDA,DIIMA,KARUMA CHURCH,722,0,6,2,231,94,333,9,342,0,O-92-125-04-01-06
MASINDI,KIBANDA COUNTY,MUTUNDA,DIIMA,KARUMA P/S,620,5,3,3,161,60,232,10,242,0,O-92-125-04-01-07
MASINDI,KIBANDA COUNTY,MUTUNDA,DIIMA,OGENGO P/S,604,4,6,3,119,105,237,104,341,0,O-92-125-04-01-08
MASINDI,KIBANDA COUNTY,MUTUNDA,DIIMA,OKWECE PRI. SCHOOL,565,5,3,6,285,50,349,8,357,0,O-92-125-04-01-09
MASINDI,KIBANDA COUNTY,MUTUNDA,DIIMA,TE-YAGO CHURCH,953,14,5,7,269,282,577,11,588,0,O-92-125-04-01-10
MASINDI,KIBANDA COUNTY,MUTUNDA,DIIMA,BEDOMOT (L-Z),423,8,4,5,216,36,269,4,273,0,O-92-125-04-01-11
MASINDI,KIBANDA COUNTY,MUTUNDA,DIIMA,DIIMA PARISH HQTRS (K-Z),359,3,1,1,107,67,179,6,185,0,O-92-125-04-01-12
MASINDI,KIBANDA COUNTY,MUTUNDA,DIIMA,KOMBONI P/S,292,7,3,2,116,44,172,4,176,0,O-92-125-04-01-13
MASINDI,KIBANDA COUNTY,MUTUNDA,DIIMA,LABONGO-LOGO P/S,535,11,7,5,219,46,288,13,301,0,O-92-125-04-01-14
MASINDI,KIBANDA COUNTY,MUTUNDA,KAKWOKO,ISINGA I,936,9,4,9,99,222,343,46,389,0,O-92-125-04-02-01
MASINDI,KIBANDA COUNTY,MUTUNDA,KAKWOKO,KAWITI A (A-L),339,4,2,1,75,84,166,13,179,0,O-92-125-04-02-02
MASINDI,KIBANDA COUNTY,MUTUNDA,KAKWOKO,KAWITI B,608,5,2,1,160,111,279,30,309,0,O-92-125-04-02-03
MASINDI,KIBANDA COUNTY,MUTUNDA,KAKWOKO,ISINGA II,421,8,1,4,35,150,198,19,217,0,O-92-125-04-02-04
MASINDI,KIBANDA COUNTY,MUTUNDA,KAKWOKO,KAKOKWA,387,5,4,3,127,100,239,12,251,0,O-92-125-04-02-05
MASINDI,KIBANDA COUNTY,MUTUNDA,KAKWOKO,KAWITI A (M-Z),316,0,0,2,142,58,202,7,209,0,O-92-125-04-02-06
MASINDI,KIBANDA COUNTY,MUTUNDA,KAKWOKO,MUTUNDA SCTY HQRS,210,1,1,1,39,95,137,4,141,0,O-92-125-04-02-07
MASINDI,KIBANDA COUNTY,MUTUNDA,NYAMAHASA,ALARO TINGA,619,2,4,5,95,295,401,18,419,0,O-92-125-04-03-01
MASINDI,KIBANDA COUNTY,MUTUNDA,NYAMAHASA,ALERO TENAM,132,0,0,1,38,25,64,0,64,0,O-92-125-04-03-02
MASINDI,KIBANDA COUNTY,MUTUNDA,NYAMAHASA,LABOKE,778,5,8,8,136,272,429,47,476,0,O-92-125-04-03-03
MASINDI,KIBANDA COUNTY,MUTUNDA,NYAMAHASA,LATWORO,323,2,2,5,17,182,208,19,227,0,O-92-125-04-03-04
MASINDI,KIBANDA COUNTY,MUTUNDA,NYAMAHASA,NANDA (A - M),649,3,1,12,118,163,297,16,313,0,O-92-125-04-03-05
MASINDI,KIBANDA COUNTY,MUTUNDA,NYAMAHASA,NYAMAHASA,484,5,6,7,65,192,275,23,298,0,O-92-125-04-03-06
MASINDI,KIBANDA COUNTY,MUTUNDA,NYAMAHASA,POPARA WEST,612,6,9,7,145,176,343,14,357,0,O-92-125-04-03-07
MASINDI,KIBANDA COUNTY,MUTUNDA,NYAMAHASA,ALERO P/S C,724,6,8,10,273,87,384,15,399,0,O-92-125-04-03-08
MASINDI,KIBANDA COUNTY,MUTUNDA,NYAMAHASA,NANDA (N - Z),710,7,4,10,117,166,304,29,333,0,O-92-125-04-03-09
MASINDI,KIBANDA COUNTY,MUTUNDA,NYAMAHASA,MUTUNDA P/S,287,4,3,2,76,103,188,8,196,0,O-92-125-04-03-10
MASINDI,KIBANDA COUNTY,MUTUNDA,NYAMAHASA,ALERO P/S A,447,3,9,4,212,40,268,26,294,0,O-92-125-04-03-11
BUNDIBUGYO,NTOROKO COUNTY,KANARA,NTOROKO,NTOROKO TRADING CENTRE,831,5,0,4,71,359,439,27,466,0,O-96-15-01-01-01
BUNDIBUGYO,NTOROKO COUNTY,KANARA,NTOROKO,NTOROKO HEALTH UNIT,673,2,1,2,58,298,361,17,378,0,O-96-15-01-01-02
BUNDIBUGYO,NTOROKO COUNTY,KANARA,NTOROKO,KANARA FISHING VILLAGE,259,0,0,0,7,176,183,10,193,0,O-96-15-01-01-03
BUNDIBUGYO,NTOROKO COUNTY,KANARA,RWANGARA,RWANGARA PARISH HQRS (A),621,3,0,0,42,274,319,26,345,0,O-96-15-01-02-01
BUNDIBUGYO,NTOROKO COUNTY,KANARA,RWANGARA,KATANGA,918,5,0,2,49,360,416,18,434,0,O-96-15-01-02-02
BUNDIBUGYO,NTOROKO COUNTY,KANARA,RWANGARA,RWANGARA C.O.U,180,1,0,1,1,114,117,5,122,0,O-96-15-01-02-03
BUNDIBUGYO,NTOROKO COUNTY,KARUGUTU,ITOJO,ITOJO PR. SCHOOL,668,10,0,11,175,209,405,24,429,0,O-96-15-02-01-01
BUNDIBUGYO,NTOROKO COUNTY,KARUGUTU,ITOJO,BURANGA PASS,774,15,1,18,268,83,385,29,414,0,O-96-15-02-01-02
BUNDIBUGYO,NTOROKO COUNTY,KARUGUTU,ITOJO,NYABIKUNGU P.S,344,11,6,6,176,34,233,0,233,0,O-96-15-02-01-03
BUNDIBUGYO,NTOROKO COUNTY,KARUGUTU,KARUGUTU,KARUGUTA TR. CENTRE,1179,7,1,19,209,443,679,9,688,0,O-96-15-02-02-01
BUNDIBUGYO,NTOROKO COUNTY,KARUGUTU,KARUGUTU,KARUGUTU HEALTH CENTRE 'A',617,5,2,7,141,239,394,17,411,0,O-96-15-02-02-02
BUNDIBUGYO,NTOROKO COUNTY,KARUGUTU,KARUGUTU,KARUGUTU PR. SCHOOL,309,3,5,6,67,146,227,14,241,0,O-96-15-02-02-03
BUNDIBUGYO,NTOROKO COUNTY,KARUGUTU,KARUGUTU,ECONOMIC TRADING CENTRE,481,2,0,5,155,207,369,12,381,0,O-96-15-02-02-04
BUNDIBUGYO,NTOROKO COUNTY,KARUGUTU,KARUGUTU,KARUGUTU HEALTH CENTRE 'B',303,4,1,4,67,110,186,6,192,0,O-96-15-02-02-05
BUNDIBUGYO,NTOROKO COUNTY,KARUGUTU,KARUGUTU,KARUGUTU OUTSIDE Q.GUARD,345,1,0,1,8,309,319,11,330,0,O-96-15-02-02-06
BUNDIBUGYO,NTOROKO COUNTY,KARUGUTU,MUSANDAMA,KISINA TRADING CENTRE,376,4,0,0,109,104,217,64,281,0,O-96-15-02-03-01
BUNDIBUGYO,NTOROKO COUNTY,KARUGUTU,MUSANDAMA,MUSANDAMA PR. SCHOOL.,664,4,3,15,211,156,389,23,412,0,O-96-15-02-03-02
BUNDIBUGYO,NTOROKO COUNTY,KARUGUTU,TORO GAME RESERV,KYABANDARA TRADING CENTRE,953,8,2,6,171,164,351,18,369,0,O-96-15-02-04-01
BUNDIBUGYO,NTOROKO COUNTY,KARUGUTU,TORO GAME RESERV,KYABANDARA B,601,15,2,7,241,92,357,18,375,0,O-96-15-02-04-02
BUNDIBUGYO,NTOROKO COUNTY,KARUGUTU,TORO GAME RESERV,KYABANDARA PRI. SCH.,292,6,0,3,35,129,173,11,184,0,O-96-15-02-04-03
BUNDIBUGYO,NTOROKO COUNTY,RWEBISENGO,BUTUNGAMA,BUDIBA-MASOJO,916,7,0,4,8,655,674,22,696,0,O-96-15-03-01-01
BUNDIBUGYO,NTOROKO COUNTY,RWEBISENGO,BUTUNGAMA,BUTUNGAMA PR. SCHOOL,342,7,0,0,8,237,252,5,257,0,O-96-15-03-01-02
BUNDIBUGYO,NTOROKO COUNTY,RWEBISENGO,BUTUNGAMA,MASOJO P.S,146,0,0,0,3,107,110,2,112,0,O-96-15-03-01-03
BUNDIBUGYO,NTOROKO COUNTY,RWEBISENGO,BUTUNGAMA,NYAKASENYI,241,0,0,1,6,177,184,3,187,0,O-96-15-03-01-04
BUNDIBUGYO,NTOROKO COUNTY,RWEBISENGO,BWERAMURE,BWERAMURE,937,0,0,4,17,629,650,15,665,0,O-96-15-03-02-01
BUNDIBUGYO,NTOROKO COUNTY,RWEBISENGO,BWERAMURE,KIBUUKU,392,0,0,0,7,241,248,9,257,0,O-96-15-03-02-02
BUNDIBUGYO,NTOROKO COUNTY,RWEBISENGO,BWERAMURE,BUTUNGAME PRI. SCH.,272,3,1,3,5,200,212,6,218,0,O-96-15-03-02-03
BUNDIBUGYO,NTOROKO COUNTY,RWEBISENGO,HAIBALE,KABIMBIRI,1036,0,0,0,29,663,692,17,709,0,O-96-15-03-03-01
BUNDIBUGYO,NTOROKO COUNTY,RWEBISENGO,HAIBALE,BUGANDO C.O.U,166,1,0,0,0,85,86,6,92,0,O-96-15-03-03-02
BUNDIBUGYO,NTOROKO COUNTY,RWEBISENGO,KASUNGU,BUTUNGAMA P/S(A-KA),565,1,0,1,7,364,373,21,394,0,O-96-15-03-04-01
BUNDIBUGYO,NTOROKO COUNTY,RWEBISENGO,KASUNGU,BUTUNGAMA P/S(KE-Z),505,4,0,1,7,362,374,11,385,0,O-96-15-03-04-02
BUNDIBUGYO,NTOROKO COUNTY,RWEBISENGO,KIRANGA,MAJUMBA P/S,716,4,0,3,12,473,492,12,504,0,O-96-15-03-05-01
BUNDIBUGYO,NTOROKO COUNTY,RWEBISENGO,KIRANGA,KIRANGA P.S AT MUHUMUZA'S PL,406,2,0,0,7,256,265,4,269,0,O-96-15-03-05-02
BUNDIBUGYO,NTOROKO COUNTY,RWEBISENGO,MASAKA,NYAKASENYI P/S,613,2,0,2,6,448,458,7,465,0,O-96-15-03-06-01
BUNDIBUGYO,NTOROKO COUNTY,RWEBISENGO,RWEBISHENGO,RWEBISENGO TR. CENTRE,1051,2,1,2,37,489,531,5,536,0,O-96-15-03-07-01
BUNDIBUGYO,NTOROKO COUNTY,RWEBISENGO,RWEBISHENGO,MUKIMBA,476,2,0,1,7,310,320,11,331,0,O-96-15-03-07-02
BUNDIBUGYO,NTOROKO COUNTY,RWEBISENGO,RWEBISHENGO,RWEBISENGO NORTH,213,1,0,0,13,122,136,2,138,0,O-96-15-03-07-03
BUNDIBUGYO,NTOROKO COUNTY,RWEBISENGO,RWEBISHENGO,MAKONDO PRI. SCHOOL,553,6,1,3,5,364,379,8,387,0,O-96-15-03-07-04
BUSHENYI,SHEEMA CTY NORTH,KABWOHE/ITENDERO T.C,ITENDERO,KYAMUNGWE P. SCHOOL,560,2,0,0,114,297,413,4,417,0,O-101-21-01-01-01
BUSHENYI,SHEEMA CTY NORTH,KABWOHE/ITENDERO T.C,ITENDERO,ITENDERO MUSLIM P. SCHOOL,555,2,0,2,128,240,372,11,383,0,O-101-21-01-01-02
BUSHENYI,SHEEMA CTY NORTH,KABWOHE/ITENDERO T.C,ITENDERO,ITENDERO PARISH HQRS,422,1,0,2,43,238,284,3,287,0,O-101-21-01-01-03
BUSHENYI,SHEEMA CTY NORTH,KABWOHE/ITENDERO T.C,KABWOHE,ISHEKYE INVALIDS P. SCHOOL I,439,1,2,0,109,254,366,0,366,0,O-101-21-01-02-01
BUSHENYI,SHEEMA CTY NORTH,KABWOHE/ITENDERO T.C,KABWOHE,NGANWA HIGH SCHOOL PLAY GR,259,0,0,2,83,100,185,2,187,0,O-101-21-01-02-02
BUSHENYI,SHEEMA CTY NORTH,KABWOHE/ITENDERO T.C,KABWOHE,SHEEMA STADIUM - KABWOHE I,867,2,0,0,246,284,532,0,532,0,O-101-21-01-02-03
BUSHENYI,SHEEMA CTY NORTH,KABWOHE/ITENDERO T.C,KABWOHE,NYAMIYAGA PRIMARY SCHOOL,353,1,0,1,55,239,296,1,297,0,O-101-21-01-02-04
BUSHENYI,SHEEMA CTY NORTH,KABWOHE/ITENDERO T.C,KABWOHE,SHEEMA STADIUM - KABWOHE II,287,0,1,0,76,109,186,26,212,0,O-101-21-01-02-05
BUSHENYI,SHEEMA CTY NORTH,KABWOHE/ITENDERO T.C,KANYINASHEEMA,KAGANGO SUBCOUNTY HQRS,325,3,1,1,56,159,220,1,221,0,O-101-21-01-03-01
BUSHENYI,SHEEMA CTY NORTH,KABWOHE/ITENDERO T.C,KANYINASHEEMA,RWABUTURA P/S,550,0,0,2,108,318,428,2,430,0,O-101-21-01-03-02
BUSHENYI,SHEEMA CTY NORTH,KABWOHE/ITENDERO T.C,KANYINASHEEMA,RWENTUNDA P/S,592,0,0,1,107,363,471,5,476,0,O-101-21-01-03-03
BUSHENYI,SHEEMA CTY NORTH,KABWOHE/ITENDERO T.C,NYANGA,KABWOHE MIXED PLAY GROUND,535,1,1,1,134,259,396,1,397,0,O-101-21-01-04-01
BUSHENYI,SHEEMA CTY NORTH,KABWOHE/ITENDERO T.C,NYANGA,NYAKASHAMBYA PARISH HQRS,366,2,0,2,66,220,290,3,293,0,O-101-21-01-04-02
BUSHENYI,SHEEMA CTY NORTH,KABWOHE/ITENDERO T.C,NYANGA,NYAKABWERA III (SHADE TREE),523,1,1,1,122,275,400,3,403,0,O-101-21-01-04-03
BUSHENYI,SHEEMA CTY NORTH,KABWOHE/ITENDERO T.C,NYANGA,MABANGA HOUSE,773,0,1,1,226,230,458,4,462,0,O-101-21-01-04-04
BUSHENYI,SHEEMA CTY NORTH,KAGANGO,KIHUNDA,KIHUNDA PARISH HQRS,619,2,1,5,134,368,510,3,513,0,O-101-21-02-01-01
BUSHENYI,SHEEMA CTY NORTH,KAGANGO,KIHUNDA,RWENTOBO P. SCHOOL,622,3,0,1,94,332,430,76,506,0,O-101-21-02-01-02
BUSHENYI,SHEEMA CTY NORTH,KAGANGO,KIHUNDA,KIHUNDA P. SCHOOL I,550,1,0,2,101,255,359,83,442,0,O-101-21-02-01-03
BUSHENYI,SHEEMA CTY NORTH,KAGANGO,KIHUNDA,KIHUNDA P. SCHOOL II,213,1,0,2,42,124,169,2,171,0,O-101-21-02-01-04
BUSHENYI,SHEEMA CTY NORTH,KAGANGO,KIZIBA,KIZIBA PARISH HQRS,741,0,0,2,125,454,581,10,591,0,O-101-21-02-02-01
BUSHENYI,SHEEMA CTY NORTH,KAGANGO,KIZIBA,RWENGANDO P. SCHOOL I,250,1,0,1,43,129,174,25,199,0,O-101-21-02-02-02
BUSHENYI,SHEEMA CTY NORTH,KAGANGO,KIZIBA,MBAGWA SUB T. CENTRE,589,2,0,0,117,302,421,58,479,0,O-101-21-02-02-03
BUSHENYI,SHEEMA CTY NORTH,KAGANGO,KIZIBA,NGOMA P. SCHOOL,565,0,1,0,86,368,455,0,455,0,O-101-21-02-02-04
BUSHENYI,SHEEMA CTY NORTH,KAGANGO,KIZIBA,RWENGANDO P. SCHOOL II,290,0,0,0,69,167,236,4,240,0,O-101-21-02-02-05
BUSHENYI,SHEEMA CTY NORTH,KAGANGO,KYABANDARA,KATWE P. SCHOOL,548,1,0,1,94,335,431,12,443,0,O-101-21-02-03-01
BUSHENYI,SHEEMA CTY NORTH,KAGANGO,KYABANDARA,KYABANDARA PARISH HQRS,577,2,0,2,97,361,462,4,466,0,O-101-21-02-03-02
BUSHENYI,SHEEMA CTY NORTH,KAGANGO,KYABANDARA,KYABANDARA MOSQUE,375,0,0,0,51,246,297,5,302,0,O-101-21-02-03-03
BUSHENYI,SHEEMA CTY NORTH,KAGANGO,KYABANDARA,RWEYESHERA P. SCHOOL,416,0,1,1,63,296,361,1,362,0,O-101-21-02-03-04
BUSHENYI,SHEEMA CTY NORTH,KAGANGO,KYAGAJU,KYAGANJU PARISH HQRS,347,0,1,2,82,192,277,2,279,0,O-101-21-02-04-01
BUSHENYI,SHEEMA CTY NORTH,KAGANGO,KYAGAJU,KAMUGUNGUNU P. SCHOOL,462,2,2,1,99,252,356,7,363,0,O-101-21-02-04-02
BUSHENYI,SHEEMA CTY NORTH,KAGANGO,MIGINA II,NYAKABIRA P. SCHOOL,427,0,0,0,89,238,327,0,327,0,O-101-21-02-05-01
BUSHENYI,SHEEMA CTY NORTH,KAGANGO,MIGINA II,MIGINA T. CENTRE,534,1,0,0,72,335,408,3,411,0,O-101-21-02-05-02
BUSHENYI,SHEEMA CTY NORTH,KAGANGO,MIGINA II,KATANGA T. CENTRE,403,1,1,0,69,235,306,7,313,0,O-101-21-02-05-03
BUSHENYI,SHEEMA CTY NORTH,KAGANGO,MIGINA II,KAGANDO RC I OFFICE COMP,438,1,0,1,54,305,361,1,362,0,O-101-21-02-05-04
BUSHENYI,SHEEMA CTY NORTH,KAGANGO,NYAKASHAMBYA,NYAKASHAMBYA PARISH HQRS,223,1,0,1,25,144,171,1,172,0,O-101-21-02-06-01
BUSHENYI,SHEEMA CTY NORTH,KAGANGO,NYAKASHAMBYA,NYAKASHAMBYA P. SCHOOL,537,0,0,0,88,332,420,13,433,0,O-101-21-02-06-02
BUSHENYI,SHEEMA CTY NORTH,KAGANGO,NYARWESHAMA,KAGONGI P. SCHOOL,592,2,0,1,118,363,484,2,486,0,O-101-21-02-07-01
BUSHENYI,SHEEMA CTY NORTH,KAGANGO,NYARWESHAMA,KYOGERA TERTIARY COLLEGE,372,2,0,0,69,209,280,4,284,0,O-101-21-02-07-02
BUSHENYI,SHEEMA CTY NORTH,KAGANGO,NYARWESHAMA,MUKINGA P. SCHOOL,491,0,0,0,84,267,351,0,351,0,O-101-21-02-07-03
BUSHENYI,SHEEMA CTY NORTH,KAGANGO,NYARWESHAMA,MUSHANGA S.S.S,422,1,0,0,78,208,287,35,322,0,O-101-21-02-07-04
BUSHENYI,SHEEMA CTY NORTH,KAGANGO,RWAMUJOJO,RWAMUJOJO P. SCHOOL,572,2,0,2,119,314,437,1,438,0,O-101-21-02-08-01
BUSHENYI,SHEEMA CTY NORTH,KAGANGO,RWAMUJOJO,RWAMUJOJO PARISH HQRS,409,1,0,1,58,278,338,2,340,0,O-101-21-02-08-02
BUSHENYI,SHEEMA CTY NORTH,KAGANGO,RWAMUJOJO,KAREGYERO T. CENTRE,296,2,1,4,57,165,229,0,229,0,O-101-21-02-08-03
BUSHENYI,SHEEMA CTY NORTH,KIGARAMA,BYAYEGAMBA,BWAYEGAMBA T. CENTRE,573,1,1,0,91,347,440,6,446,0,O-101-21-03-01-01
BUSHENYI,SHEEMA CTY NORTH,KIGARAMA,BYAYEGAMBA,BWAYEGAMBA P. SCHOOL,516,0,0,0,55,351,406,11,417,0,O-101-21-03-01-02
BUSHENYI,SHEEMA CTY NORTH,KIGARAMA,BYAYEGAMBA,(KIYUNGU W) AKABATI,579,3,0,3,72,382,460,1,461,0,O-101-21-03-01-03
BUSHENYI,SHEEMA CTY NORTH,KIGARAMA,BYAYEGAMBA,(KIKUUTO I) MAILO II,303,1,0,0,53,197,251,5,256,0,O-101-21-03-01-04
BUSHENYI,SHEEMA CTY NORTH,KIGARAMA,KATOMA,NSHONGI I,597,2,1,0,137,316,456,5,461,0,O-101-21-03-02-01
BUSHENYI,SHEEMA CTY NORTH,KIGARAMA,KATOMA,KATERAMO,467,1,2,2,97,215,317,2,319,0,O-101-21-03-02-02
BUSHENYI,SHEEMA CTY NORTH,KIGARAMA,KATOMA,KAJU I,503,0,0,5,47,341,393,9,402,0,O-101-21-03-02-03
BUSHENYI,SHEEMA CTY NORTH,KIGARAMA,KATOMA,KATOOMA CENTRAL,496,0,1,1,85,272,359,5,364,0,O-101-21-03-02-04
BUSHENYI,SHEEMA CTY NORTH,KIGARAMA,KIGARAMA,KABUSTYE P. SCHOOL,644,2,0,2,95,381,480,6,486,0,O-101-21-03-03-01
BUSHENYI,SHEEMA CTY NORTH,KIGARAMA,KIGARAMA,KATANOGA P. SCHOOL,645,0,0,3,161,328,492,6,498,0,O-101-21-03-03-02
BUSHENYI,SHEEMA CTY NORTH,KIGARAMA,KIGARAMA,KIGARAMA SUBCOUNTY HQRS,442,2,0,1,56,266,325,1,326,0,O-101-21-03-03-03
BUSHENYI,SHEEMA CTY NORTH,KIGARAMA,KIGARAMA,RUBUMBA P. SCHOOL,359,0,0,1,73,231,305,9,314,0,O-101-21-03-03-04
BUSHENYI,SHEEMA CTY NORTH,KIGARAMA,KYABUHARAMBO,KYABUHARAMBO P. SCHOOL,562,1,0,2,81,374,458,1,459,0,O-101-21-03-04-01
BUSHENYI,SHEEMA CTY NORTH,KIGARAMA,KYABUHARAMBO,NYAKAYOJO P. SCHOOL,633,1,0,2,67,446,516,14,530,0,O-101-21-03-04-02
BUSHENYI,SHEEMA CTY NORTH,KIGARAMA,KYABUHARAMBO,NYABWINA S.S.S,429,1,0,0,80,270,351,5,356,0,O-101-21-03-04-03
BUSHENYI,SHEEMA CTY NORTH,KIGARAMA,MABARE,MASHERUKA MODERN P. SCHOOL,593,0,0,4,146,278,428,1,429,0,O-101-21-03-05-01
BUSHENYI,SHEEMA CTY NORTH,KIGARAMA,MABARE,RWEICUMU P. SCHOOL,446,0,0,3,80,261,344,6,350,0,O-101-21-03-05-02
BUSHENYI,SHEEMA CTY NORTH,KIGARAMA,MABARE,BURINGO P. SCHOOL,394,0,0,3,106,175,284,16,300,0,O-101-21-03-05-03
BUSHENYI,SHEEMA CTY NORTH,KIGARAMA,MABARE,NYAKAMBU P. SCHOOL,456,1,0,3,57,281,342,14,356,0,O-101-21-03-05-04
BUSHENYI,SHEEMA CTY NORTH,KIGARAMA,MABARE,MUKONO P. SCHOOL,536,3,0,1,155,265,424,13,437,0,O-101-21-03-05-05
BUSHENYI,SHEEMA CTY NORTH,KIGARAMA,MASHERUKA,KAGAZI P. SCHOOL,662,3,1,3,84,423,514,3,517,0,O-101-21-03-06-01
BUSHENYI,SHEEMA CTY NORTH,KIGARAMA,MASHERUKA,KATOJO P. SCHOOL,608,1,0,3,116,363,483,0,483,0,O-101-21-03-06-02
BUSHENYI,SHEEMA CTY NORTH,KIGARAMA,MASHERUKA,MASHERUKA PARISH HQRS,486,0,0,0,47,117,164,3,167,0,O-101-21-03-06-03
BUSHENYI,SHEEMA CTY NORTH,KIGARAMA,MASHERUKA,MASHERUKA COOP SOCIETY,341,1,0,0,51,213,265,3,268,0,O-101-21-03-06-04
BUSHENYI,SHEEMA CTY NORTH,KIGARAMA,RUNYINYA,RUNYINYA P. SCHOOL,699,1,0,1,102,464,568,1,569,0,O-101-21-03-07-01
BUSHENYI,SHEEMA CTY NORTH,KIGARAMA,RUNYINYA,KAMULINDA P. SCHOOL,616,0,0,2,72,418,492,3,495,0,O-101-21-03-07-02
BUSHENYI,SHEEMA CTY NORTH,KYANGENYI,KITOJO,BUSESIRE P. SCHOOL,474,0,0,0,66,304,370,2,372,0,O-101-21-04-01-01
BUSHENYI,SHEEMA CTY NORTH,KYANGENYI,KITOJO,KITOJO PARISH HQRS,467,0,1,1,93,262,357,4,361,0,O-101-21-04-01-02
BUSHENYI,SHEEMA CTY NORTH,KYANGENYI,KITOJO,MUTOJO INTEGRATED P. SCHOOL,725,2,0,1,131,438,572,5,577,0,O-101-21-04-01-03
BUSHENYI,SHEEMA CTY NORTH,KYANGENYI,KITOJO,RUSHOROZA P. SCHOOL,444,0,0,2,76,266,344,7,351,0,O-101-21-04-01-04
BUSHENYI,SHEEMA CTY NORTH,KYANGENYI,KYANGUNDU,KAKINDO TECH. SCHOOL,511,2,2,1,97,267,369,4,373,0,O-101-21-04-02-01
BUSHENYI,SHEEMA CTY NORTH,KYANGENYI,KYANGUNDU,KYABAHAIJA P. SCHOOL,506,2,0,0,60,336,398,8,406,0,O-101-21-04-02-02
BUSHENYI,SHEEMA CTY NORTH,KYANGENYI,KYANGUNDU,KYANGYENYI P. SCHOOL,670,2,2,3,114,408,529,3,532,0,O-101-21-04-02-03
BUSHENYI,SHEEMA CTY NORTH,KYANGENYI,KYANGUNDU,KAKINDO P. SCHOOL,242,0,0,0,46,136,182,2,184,0,O-101-21-04-02-04
BUSHENYI,SHEEMA CTY NORTH,KYANGENYI,MASYORO,MIGYERA II P. SCHOOL,425,2,1,3,110,209,325,13,338,0,O-101-21-04-03-01
BUSHENYI,SHEEMA CTY NORTH,KYANGENYI,MASYORO,MASYORO P. SCHOOL,437,1,0,1,129,243,374,0,374,0,O-101-21-04-03-02
BUSHENYI,SHEEMA CTY NORTH,KYANGENYI,MASYORO,KAKSHANJURE P. SCHOOL,448,2,0,0,91,270,363,4,367,0,O-101-21-04-03-03
BUSHENYI,SHEEMA CTY NORTH,KYANGENYI,MUZIRA,KARYANGO PLAYGROUND,322,4,0,4,111,162,281,4,285,0,O-101-21-04-04-01
BUSHENYI,SHEEMA CTY NORTH,KYANGENYI,MUZIRA,RYAMASA P. SCHOOL,450,0,1,2,96,247,346,6,352,0,O-101-21-04-04-02
BUSHENYI,SHEEMA CTY NORTH,KYANGENYI,MUZIRA,MUZIRA PLAYGROUND,632,2,1,2,125,374,504,3,507,0,O-101-21-04-04-03
BUSHENYI,SHEEMA CTY NORTH,KYANGENYI,MUZIRA,MUZIRA PARISH HQRS,596,1,0,0,135,346,482,2,484,0,O-101-21-04-04-04
BUSHENYI,SHEEMA CTY NORTH,KYANGENYI,RUSHOZI,KIBUTAMO P. SCHOOL,670,3,2,1,167,359,532,1,533,0,O-101-21-04-05-01
BUSHENYI,SHEEMA CTY NORTH,KYANGENYI,RUSHOZI,RWEMBUGU P. SCHOOL,426,0,0,1,71,280,352,4,356,0,O-101-21-04-05-02
BUSHENYI,SHEEMA CTY NORTH,KYANGENYI,RUSHOZI,RUSHOZI PARISH HQRS,611,2,0,0,83,341,426,10,436,0,O-101-21-04-05-03
BUSHENYI,SHEEMA CTY NORTH,KYANGENYI,RUSHOZI,RUSHOZI P. SCHOOL,556,3,0,2,144,251,400,10,410,0,O-101-21-04-05-04
BUSHENYI,SHEEMA CTY NORTH,KYANGENYI,RWEIBARE,RWEIBARE P. SCHOOL,650,0,1,0,118,338,457,3,460,0,O-101-21-04-06-01
BUSHENYI,SHEEMA CTY NORTH,KYANGENYI,RWEIBARE,RWEIBARE PLAY GROUND,533,2,0,0,108,275,385,0,385,0,O-101-21-04-06-02
BUSHENYI,SHEEMA CTY NORTH,KYANGENYI,RWEIBARE,RWEIBARE KITOOKYE FULL GOSP,535,1,0,0,69,355,425,2,427,0,O-101-21-04-06-03
BUSHENYI,SHEEMA CTY NORTH,KYANGENYI,RWEIBARE,KYANGUNDU MOSQUE,148,0,1,0,22,86,109,1,110,0,O-101-21-04-06-04
BUSHENYI,SHEEMA CTY SOUTH,BUGONGI,ISINGIRO,ISINGIRO PARISH HQRS I,562,4,1,3,168,218,394,20,414,0,O-101-22-01-01-01
BUSHENYI,SHEEMA CTY SOUTH,BUGONGI,ISINGIRO,KYARUKUNDA P. SCHOOL,647,2,1,4,140,354,501,16,517,0,O-101-22-01-01-02
BUSHENYI,SHEEMA CTY SOUTH,BUGONGI,ISINGIRO,ISINGIRO PARISH HQRS II,522,1,0,3,107,286,397,7,404,0,O-101-22-01-01-03
BUSHENYI,SHEEMA CTY SOUTH,BUGONGI,ISINGIRO,KYENGIRI P. SCHOOL,611,1,0,0,143,302,446,68,514,0,O-101-22-01-01-04
BUSHENYI,SHEEMA CTY SOUTH,BUGONGI,KARERA,KARERA PARISH HQRS,489,2,0,0,54,338,394,4,398,0,O-101-22-01-02-01
BUSHENYI,SHEEMA CTY SOUTH,BUGONGI,KARERA,KISO - KARERA P. SCHOOL,709,2,0,3,113,441,559,11,570,0,O-101-22-01-02-02
BUSHENYI,SHEEMA CTY SOUTH,BUGONGI,KARERA,KIKONKO P. SCHOOL,612,2,0,3,149,326,480,11,491,0,O-101-22-01-02-03
BUSHENYI,SHEEMA CTY SOUTH,BUGONGI,KARERA,ITEGYERO P. SCHOOL,607,1,1,3,81,415,501,13,514,0,O-101-22-01-02-04
BUSHENYI,SHEEMA CTY SOUTH,BUGONGI,KYAMURARI,RWENDAHI P. SCHOOL I,546,1,0,2,79,385,467,10,477,0,O-101-22-01-03-01
BUSHENYI,SHEEMA CTY SOUTH,BUGONGI,KYAMURARI,RWENDAHI P. SCHOOL II,432,1,0,4,81,247,333,8,341,0,O-101-22-01-03-02
BUSHENYI,SHEEMA CTY SOUTH,BUGONGI,KYAMURARI,KYAMURARI PARISH HQRS,633,3,1,3,109,406,522,4,526,0,O-101-22-01-03-03
BUSHENYI,SHEEMA CTY SOUTH,BUGONGI,KYAMURARI,BUGONGI SUBCOUNTY HQRS,625,1,0,4,172,282,459,8,467,0,O-101-22-01-03-04
BUSHENYI,SHEEMA CTY SOUTH,BUGONGI,RUGARAMA,MURARI T. CENTRE,694,3,1,8,178,325,515,8,523,0,O-101-22-01-04-01
BUSHENYI,SHEEMA CTY SOUTH,BUGONGI,RUGARAMA,RUGARAMA PARISH HQRS,459,1,0,3,147,227,378,8,386,0,O-101-22-01-04-02
BUSHENYI,SHEEMA CTY SOUTH,BUGONGI,RUGARAMA,NYAKASHOGA T. CENTRE,599,2,0,0,130,231,363,108,471,0,O-101-22-01-04-03
BUSHENYI,SHEEMA CTY SOUTH,KITAGATA,BURARO,BURARO TRADING CENTRE,568,1,0,3,70,322,396,8,404,0,O-101-22-02-01-01
BUSHENYI,SHEEMA CTY SOUTH,KITAGATA,BURARO,BURARO PARISH HQRS,271,0,0,1,40,163,204,6,210,0,O-101-22-02-01-02
BUSHENYI,SHEEMA CTY SOUTH,KITAGATA,BURARO,KYEIHARA PRIMARY SCHOOL,448,0,0,6,62,306,374,8,382,0,O-101-22-02-01-03
BUSHENYI,SHEEMA CTY SOUTH,KITAGATA,KASAANA WEST,KITAGATA AGRIC FARM SCHOOL I,446,2,0,0,97,194,293,11,304,0,O-101-22-02-02-01
BUSHENYI,SHEEMA CTY SOUTH,KITAGATA,KASAANA WEST,KYABIGO P. SCHOOL,756,0,0,1,121,426,548,22,570,0,O-101-22-02-02-02
BUSHENYI,SHEEMA CTY SOUTH,KITAGATA,KASAANA WEST,KASANA PARISH HQRS,377,0,0,1,56,198,255,11,266,0,O-101-22-02-02-03
BUSHENYI,SHEEMA CTY SOUTH,KITAGATA,KASAANA WEST,KITAGATA AGRIC FARM SCHOOL,663,1,0,3,142,323,469,17,486,0,O-101-22-02-02-04
BUSHENYI,SHEEMA CTY SOUTH,KITAGATA,KASANA EAST,NYAKABUNGO P/SCHOOL,388,0,0,0,73,205,278,52,330,0,O-101-22-02-03-01
BUSHENYI,SHEEMA CTY SOUTH,KITAGATA,KASANA EAST,MISHENYI P/SCHOOL,326,0,0,1,42,211,254,6,260,0,O-101-22-02-03-02
BUSHENYI,SHEEMA CTY SOUTH,KITAGATA,KASANA EAST,KASAANA EAST PARISH HQRS,488,3,0,3,108,280,394,6,400,0,O-101-22-02-03-03
BUSHENYI,SHEEMA CTY SOUTH,KITAGATA,KASHEKURO,KASHEKURO PARISH HQRS I,261,0,1,0,42,146,189,0,189,0,O-101-22-02-04-01
BUSHENYI,SHEEMA CTY SOUTH,KITAGATA,KASHEKURO,KASHEKURO PARISH HQRS II,509,1,1,2,97,261,362,7,369,0,O-101-22-02-04-02
BUSHENYI,SHEEMA CTY SOUTH,KITAGATA,KASHEKURO,KISHENYI P. SCHOOL,621,2,0,1,147,265,415,1,416,0,O-101-22-02-04-03
BUSHENYI,SHEEMA CTY SOUTH,KITAGATA,KASHEKURO,KASHERUKO P. SCHOOL,332,0,0,0,70,175,245,7,252,0,O-101-22-02-04-04
BUSHENYI,SHEEMA CTY SOUTH,KITAGATA,KASHEKURO,KASHARAZI PRIMARY SCHOOL,533,0,2,0,64,313,379,19,398,0,O-101-22-02-04-05
BUSHENYI,SHEEMA CTY SOUTH,KITAGATA,KYARUSHAKARA,KINYEMI P. SCHOOL,487,2,1,3,108,277,391,0,391,0,O-101-22-02-05-01
BUSHENYI,SHEEMA CTY SOUTH,KITAGATA,KYARUSHAKARA,KYARUSHAKARA PARISH HQRS,582,7,1,5,140,262,415,13,428,0,O-101-22-02-05-02
BUSHENYI,SHEEMA CTY SOUTH,KITAGATA,KYEIBANGA,NYARUTOOMA P. SCHOOL,467,1,1,0,94,173,269,51,320,0,O-101-22-02-06-01
BUSHENYI,SHEEMA CTY SOUTH,KITAGATA,KYEIBANGA,KYEIBANGA P. SCHOOL,689,6,2,1,150,333,492,18,510,0,O-101-22-02-06-02
BUSHENYI,SHEEMA CTY SOUTH,KITAGATA,KYEIBANGA,KYEIBANGA PARISH HQRS,788,3,4,1,198,335,541,18,559,0,O-101-22-02-06-03
BUSHENYI,SHEEMA CTY SOUTH,KITAGATA,KYEIBANGA,NYAKANYINYA P. SCHOOL,301,3,1,2,60,143,209,7,216,0,O-101-22-02-06-04
BUSHENYI,SHEEMA CTY SOUTH,KITAGATA,MUHITO,RWEMIHINGO P. SCHOOL,659,2,1,3,155,349,510,13,523,0,O-101-22-02-07-01
BUSHENYI,SHEEMA CTY SOUTH,KITAGATA,MUHITO,MUHITO P. SCHOOL I,423,0,0,1,40,277,318,11,329,0,O-101-22-02-07-02
BUSHENYI,SHEEMA CTY SOUTH,KITAGATA,MUHITO,MUHITO P. SCHOOL II,407,3,0,3,67,218,291,14,305,0,O-101-22-02-07-03
BUSHENYI,SHEEMA CTY SOUTH,KITAGATA,MUHITO,KITAGATA SUBCOUNTY HQRS I,423,0,1,0,114,189,304,7,311,0,O-101-22-02-07-04
BUSHENYI,SHEEMA CTY SOUTH,KITAGATA,MUHITO,KITAGATA SUBCOUNTY HQRS II,496,2,1,0,154,194,351,4,355,0,O-101-22-02-07-05
BUSHENYI,SHEEMA CTY SOUTH,KITAGATA,RUKONDO,RUKONDO PARISH HQRS,597,0,2,6,105,320,433,17,450,0,O-101-22-02-08-01
BUSHENYI,SHEEMA CTY SOUTH,KITAGATA,RUKONDO,RUKONDO P. SCHOOL,564,1,1,2,97,278,379,34,413,0,O-101-22-02-08-02
BUSHENYI,SHEEMA CTY SOUTH,SHUUKU,KASHOZI,BUTSIBO P. SCHOOL,548,3,2,3,88,300,396,8,404,0,O-101-22-03-01-01
BUSHENYI,SHEEMA CTY SOUTH,SHUUKU,KASHOZI,RWIGAAGA P. SCHOOL,481,4,0,2,121,216,343,50,393,0,O-101-22-03-01-02
BUSHENYI,SHEEMA CTY SOUTH,SHUUKU,KASHOZI,KANEKYE TRADING CENTRE,780,2,1,3,201,460,667,15,682,0,O-101-22-03-01-03
BUSHENYI,SHEEMA CTY SOUTH,SHUUKU,KASHOZI,KASHOZI P. SCHOOL,537,5,1,0,135,300,441,5,446,0,O-101-22-03-01-04
BUSHENYI,SHEEMA CTY SOUTH,SHUUKU,KASHOZI,KASHOZI PARISH HQRS,277,3,0,0,57,144,204,13,217,0,O-101-22-03-01-05
BUSHENYI,SHEEMA CTY SOUTH,SHUUKU,KASHOZI,RWANYAMUKINYA MARKET,495,1,0,4,113,261,379,14,393,0,O-101-22-03-01-06
BUSHENYI,SHEEMA CTY SOUTH,SHUUKU,KISHABYA,SHUUKU S/CTY HQRS,462,2,1,4,149,215,371,1,372,0,O-101-22-03-02-01
BUSHENYI,SHEEMA CTY SOUTH,SHUUKU,KISHABYA,KISHABYA T. CENTRE,983,7,0,0,259,520,786,5,791,0,O-101-22-03-02-02
BUSHENYI,SHEEMA CTY SOUTH,SHUUKU,KISHABYA,RYAKASINGA PLAYGROUND,531,3,0,1,97,289,390,6,396,0,O-101-22-03-02-03
BUSHENYI,SHEEMA CTY SOUTH,SHUUKU,KISHABYA,RYAKASINGA P.SCHOOL,460,1,0,1,110,218,330,12,342,0,O-101-22-03-02-04
BUSHENYI,SHEEMA CTY SOUTH,SHUUKU,KISHABYA,BUTAGATSI T. CENTRE,499,1,1,5,98,289,394,13,407,0,O-101-22-03-02-05
BUSHENYI,SHEEMA CTY SOUTH,SHUUKU,KYEMPITSI,KYEMPITSI P. SCHOOL I,626,1,0,5,114,270,390,79,469,0,O-101-22-03-03-01
BUSHENYI,SHEEMA CTY SOUTH,SHUUKU,KYEMPITSI,KYEMPITSI PARISH HQRS,408,0,0,0,101,197,298,4,302,0,O-101-22-03-03-02
BUSHENYI,SHEEMA CTY SOUTH,SHUUKU,KYEMPITSI,NYAMABARE P. SCHOOL I,596,7,0,3,150,302,462,12,474,0,O-101-22-03-03-03
BUSHENYI,SHEEMA CTY SOUTH,SHUUKU,KYEMPITSI,NYAMABARE P. SCHOOL II,373,1,0,0,111,188,300,2,302,0,O-101-22-03-03-04
BUSHENYI,SHEEMA CTY SOUTH,SHUUKU,NYAKARAMA,KIRUNDO P. SCHOOL,587,1,0,2,88,367,458,19,477,0,O-101-22-03-04-01
BUSHENYI,SHEEMA CTY SOUTH,SHUUKU,NYAKARAMA,NYAKARAMA PARISH HQRS,534,3,0,1,132,270,406,6,412,0,O-101-22-03-04-02
BUSHENYI,SHEEMA CTY SOUTH,SHUUKU,NYAKARAMA,NYAKARAMA P. SCHOOL II,325,3,0,0,69,184,256,6,262,0,O-101-22-03-04-03
BUSHENYI,SHEEMA CTY SOUTH,SHUUKU,NYAKARAMA,RWAMUNENA T. CENTRE,262,0,0,3,61,134,198,4,202,0,O-101-22-03-04-04
BUSHENYI,SHEEMA CTY SOUTH,SHUUKU,NYAKARAMA,BIGONA P. SCHOOL,284,0,0,1,57,192,250,6,256,0,O-101-22-03-04-05
BUSHENYI,RUHINDA COUNTY,BITEREKO,BUSHEREGYENYI,KEBIREMU C.O.U,628,1,0,1,62,449,513,5,518,0,O-106-20-01-01-01
BUSHENYI,RUHINDA COUNTY,BITEREKO,BUSHEREGYENYI,BUSHEREGYENYI PARISH HQRS,793,3,1,7,98,503,612,9,621,0,O-106-20-01-01-02
BUSHENYI,RUHINDA COUNTY,BITEREKO,KARIMBIRO,KARIMBIRO PARISH HQRS,552,4,0,2,58,452,516,6,522,0,O-106-20-01-02-01
BUSHENYI,RUHINDA COUNTY,BITEREKO,KARIMBIRO,MAHUNGYE SEC SCHOOL,560,3,1,0,57,416,477,3,480,0,O-106-20-01-02-02
BUSHENYI,RUHINDA COUNTY,BITEREKO,KARIMBIRO,KABARE II TRADING CENTRE,542,1,0,2,69,355,427,11,438,0,O-106-20-01-02-03
BUSHENYI,RUHINDA COUNTY,BITEREKO,KARIMBIRO,KARANGARA T/CENTRE,741,2,2,2,176,419,601,6,607,0,O-106-20-01-02-04
BUSHENYI,RUHINDA COUNTY,BITEREKO,KIGARAMA,KAMABARE OPEN MARKET,412,3,0,0,82,237,322,5,327,0,O-106-20-01-03-01
BUSHENYI,RUHINDA COUNTY,BITEREKO,KIGARAMA,KIGARAMA SSS,755,0,0,1,120,423,544,6,550,0,O-106-20-01-03-02
BUSHENYI,RUHINDA COUNTY,BITEREKO,KIGARAMA,BITEREKO TRADING CENTRE,565,1,0,0,87,382,470,0,470,0,O-106-20-01-03-03
BUSHENYI,RUHINDA COUNTY,BITEREKO,KIGARAMA,KIRAMA TRADING CENTRE,794,8,0,2,190,399,599,6,605,0,O-106-20-01-03-04
BUSHENYI,RUHINDA COUNTY,BITEREKO,NYAKASHOJWA,NYAKASHOJWA P/S,479,0,0,0,0,0,0,0,0,1,O-106-20-01-04-01
BUSHENYI,RUHINDA COUNTY,BITEREKO,NYAKASHOJWA,NYAKATSIRO P/SCHOOL,694,1,1,1,125,386,514,13,527,0,O-106-20-01-04-02
BUSHENYI,RUHINDA COUNTY,BITEREKO,NYAKASHOJWA,RUTOOKYE P/S I,532,0,0,4,85,310,399,12,411,0,O-106-20-01-04-03
BUSHENYI,RUHINDA COUNTY,BITEREKO,NYAKASHOJWA,NYAKASHOJWA PARISH HQRS,822,2,0,4,172,406,584,15,599,0,O-106-20-01-04-04
BUSHENYI,RUHINDA COUNTY,BITEREKO,NYAKASHOJWA,RUTOOKYE P/S II,408,3,0,1,68,226,298,9,307,0,O-106-20-01-04-05
BUSHENYI,RUHINDA COUNTY,BITEREKO,NYAKASHOJWA,NYARUTUNTU C.O.U,306,1,0,0,62,169,232,9,241,0,O-106-20-01-04-06
BUSHENYI,RUHINDA COUNTY,KABIRA,BUHARAMBO,BUHARAMBO P/SCHOOL,551,5,0,0,105,281,391,16,407,0,O-106-20-02-01-01
BUSHENYI,RUHINDA COUNTY,KABIRA,BUHARAMBO,RUCURURU P/SCHOOL,503,1,1,7,84,279,372,7,379,0,O-106-20-02-01-02
BUSHENYI,RUHINDA COUNTY,KABIRA,BUHARAMBO,BUHARAMBO PARISH HQRS,387,2,0,1,63,224,290,7,297,0,O-106-20-02-01-03
BUSHENYI,RUHINDA COUNTY,KABIRA,MAYANGA,ITARA P/SCHOOL,597,1,0,3,94,353,451,0,451,0,O-106-20-02-02-01
BUSHENYI,RUHINDA COUNTY,KABIRA,MAYANGA,MAYANGA PRIMARY SCHOOL,445,1,1,3,82,243,330,10,340,0,O-106-20-02-02-02
BUSHENYI,RUHINDA COUNTY,KABIRA,MAYANGA,MAYANGA TRADING CENTRE,644,4,0,4,111,359,478,13,491,0,O-106-20-02-02-03
BUSHENYI,RUHINDA COUNTY,KABIRA,MAYANGA,OMUKIDANDARI TRADING CENTR,511,2,0,1,45,340,388,8,396,0,O-106-20-02-02-04
BUSHENYI,RUHINDA COUNTY,KABIRA,NYABUBARE,NYAMABARE CHURCH,432,2,2,4,81,242,331,16,347,0,O-106-20-02-03-01
BUSHENYI,RUHINDA COUNTY,KABIRA,NYABUBARE,NYABUBARE PARISH HQRS,480,0,0,0,73,309,382,0,382,0,O-106-20-02-03-02
BUSHENYI,RUHINDA COUNTY,KABIRA,NYABUBARE,KABIRA TECHNICAL INSTITUTE,486,2,1,2,60,326,391,11,402,0,O-106-20-02-03-03
BUSHENYI,RUHINDA COUNTY,KABIRA,NYABUBARE,KABIRA S/CTY HQRS,416,0,1,2,76,238,317,3,320,0,O-106-20-02-03-04
BUSHENYI,RUHINDA COUNTY,KABIRA,NYAKATETE,NYAKATEETE PARISH HQRS,350,0,0,1,63,229,293,0,293,0,O-106-20-02-04-01
BUSHENYI,RUHINDA COUNTY,KABIRA,NYAKATETE,NYAKATEETE P/SCHOOL,434,0,2,2,79,237,320,8,328,0,O-106-20-02-04-02
BUSHENYI,RUHINDA COUNTY,KANYABWANGA,KANYABWANGA,KANYABWANGA P/SCHOOL,488,3,1,6,35,347,392,11,403,0,O-106-20-03-01-01
BUSHENYI,RUHINDA COUNTY,KANYABWANGA,KANYABWANGA,MUYAMBI T/CENTRE,508,0,2,0,39,315,356,55,411,0,O-106-20-03-01-02
BUSHENYI,RUHINDA COUNTY,KANYABWANGA,KASHONGERERO,KASHONGERERO PARISH HQRS,465,4,0,1,53,340,398,6,404,0,O-106-20-03-02-01
BUSHENYI,RUHINDA COUNTY,KANYABWANGA,KASHONGERERO,RWENKURIJU TRADING CENTRE,494,2,0,0,124,289,415,7,422,0,O-106-20-03-02-02
BUSHENYI,RUHINDA COUNTY,KASHENSHERO,BUKARI,KASHENSHERO SUBCOUNTY HQR,638,3,0,0,115,321,439,8,447,0,O-106-20-04-01-01
BUSHENYI,RUHINDA COUNTY,KASHENSHERO,BUKARI,KATOOMA CHURCH,620,1,1,4,58,420,484,8,492,0,O-106-20-04-01-02
BUSHENYI,RUHINDA COUNTY,KASHENSHERO,BUKARI,KYABAHESI P/SCHOOL,580,0,0,2,101,358,461,4,465,0,O-106-20-04-01-03
BUSHENYI,RUHINDA COUNTY,KASHENSHERO,BUKUBA,RUTTI TRADING CENTRE,567,1,0,3,106,336,446,9,455,0,O-106-20-04-02-01
BUSHENYI,RUHINDA COUNTY,KASHENSHERO,BUKUBA,BUKUBA P/SCHOOL,573,0,0,3,62,378,443,0,443,0,O-106-20-04-02-02
BUSHENYI,RUHINDA COUNTY,KASHENSHERO,KIRERA,RWENTERAMO CHURCH,315,2,1,2,105,123,233,9,242,0,O-106-20-04-03-01
BUSHENYI,RUHINDA COUNTY,KASHENSHERO,KIRERA,RWENTARAMO P/SCHOOL,305,5,1,0,53,175,234,4,238,0,O-106-20-04-03-02
BUSHENYI,RUHINDA COUNTY,KASHENSHERO,KIRERA,KIRERA PARISH HQRS,364,0,1,0,100,187,288,1,289,0,O-106-20-04-03-03
BUSHENYI,RUHINDA COUNTY,KASHENSHERO,KIRERA,KIKUNYU P/S,286,0,0,3,53,159,215,0,215,0,O-106-20-04-03-04
BUSHENYI,RUHINDA COUNTY,KASHENSHERO,KYANZIRE,KANSHENSHERO P/SCHOOL,624,1,0,2,102,373,478,10,488,0,O-106-20-04-04-01
BUSHENYI,RUHINDA COUNTY,KASHENSHERO,KYANZIRE,KYANZAIRE PARISH HQRS 1,505,0,0,0,86,276,362,9,371,0,O-106-20-04-04-02
BUSHENYI,RUHINDA COUNTY,KASHENSHERO,KYANZIRE,KYANZAIRE PARISH HQRS II,302,0,0,1,41,164,206,6,212,0,O-106-20-04-04-03
BUSHENYI,RUHINDA COUNTY,KASHENSHERO,KYANZIRE,RWANYAMUNYONYI P/S,343,2,0,0,63,196,261,0,261,0,O-106-20-04-04-04
BUSHENYI,RUHINDA COUNTY,KASHENSHERO,KYANZIRE,MAKUNYU C.O.U,248,1,0,1,40,155,197,3,200,0,O-106-20-04-04-05
BUSHENYI,RUHINDA COUNTY,KASHENSHERO,NYAKATOOMA,KEIGURIRE P/S,334,0,0,0,64,180,244,7,251,0,O-106-20-04-05-01
BUSHENYI,RUHINDA COUNTY,KASHENSHERO,NYAKATOOMA,NYAKATOOMA T/CENTRE,345,0,0,0,37,228,265,10,275,0,O-106-20-04-05-02
BUSHENYI,RUHINDA COUNTY,KATI,KASHONGERERO,RWAMUNIORI T. CENTRE,639,2,0,3,69,430,504,10,514,0,O-106-20-05-01-01
BUSHENYI,RUHINDA COUNTY,KATI,KASHONGERERO,KATI PARISH HQRS,570,2,1,2,128,305,438,10,448,0,O-106-20-05-01-02
BUSHENYI,RUHINDA COUNTY,KATI,KASHONGERERO,KATERAMPUNGU CHURCH,562,1,2,2,102,304,411,8,419,0,O-106-20-05-01-03
BUSHENYI,RUHINDA COUNTY,KATI,RUCENCE,RWEMPUNGU P/SCHOOL 1,515,1,1,0,137,286,425,10,435,0,O-106-20-05-02-01
BUSHENYI,RUHINDA COUNTY,KATI,RUCENCE,RWEMPUNGU P/SCHOOL 2,620,3,0,3,148,304,458,21,479,0,O-106-20-05-02-02
BUSHENYI,RUHINDA COUNTY,KATI,RUCENCE,KATERERA SSS,487,2,2,3,135,251,393,10,403,0,O-106-20-05-02-03
BUSHENYI,RUHINDA COUNTY,KATI,RUCENCE,NYANDAGO CHURCH GROUND,536,2,0,4,141,289,436,11,447,0,O-106-20-05-02-04
BUSHENYI,RUHINDA COUNTY,KIYANGA,IRARAMIRA,IRARAMIRA T/C I,593,1,0,1,52,418,472,8,480,0,O-106-20-06-01-01
BUSHENYI,RUHINDA COUNTY,KIYANGA,IRARAMIRA,KAYEMBE T/CENTRE,411,1,1,0,39,297,338,3,341,0,O-106-20-06-01-02
BUSHENYI,RUHINDA COUNTY,KIYANGA,KIYANGA,KASHASHA TRADING CENTRE,765,4,1,4,103,462,574,16,590,0,O-106-20-06-02-01
BUSHENYI,RUHINDA COUNTY,KIYANGA,KIYANGA,BUKIRIRO TRADING CENTRE,564,1,1,6,112,325,445,7,452,0,O-106-20-06-02-02
BUSHENYI,RUHINDA COUNTY,KIYANGA,KIYANGA,NYANGA CATHOLIC CHURCH,576,3,1,4,71,342,421,14,435,0,O-106-20-06-02-03
BUSHENYI,RUHINDA COUNTY,KIYANGA,KIYANGA,KIYANGA S/CTY HQRS,227,1,0,2,32,127,162,4,166,0,O-106-20-06-02-04
BUSHENYI,RUHINDA COUNTY,KIYANGA,KIYANGA,KISIIZI P/SCHOOL 2,530,1,0,3,58,355,417,6,423,0,O-106-20-06-02-05
BUSHENYI,RUHINDA COUNTY,KIYANGA,KIYANGA,NYAMIRAMA CATHOLIC CHURCH,482,1,0,5,90,291,387,10,397,0,O-106-20-06-02-06
BUSHENYI,RUHINDA COUNTY,KIYANGA,RWOBURUNGA,NDURUMO PRIMARY SCHOOL,528,0,0,1,43,369,413,16,429,0,O-106-20-06-03-01
BUSHENYI,RUHINDA COUNTY,KIYANGA,RWOBURUNGA,KAGATI TRADING CENTRE,603,2,0,4,76,346,428,8,436,0,O-106-20-06-03-02
BUSHENYI,RUHINDA COUNTY,KIYANGA,RWOBURUNGA,KYEMENGO TRADING CENTRE,344,0,0,2,8,229,239,7,246,0,O-106-20-06-03-03
BUSHENYI,RUHINDA COUNTY,KIYANGA,RWOBURUNGA,KENGEYA TRADING CENTRE,676,1,0,2,81,428,512,9,521,0,O-106-20-06-03-04
BUSHENYI,RUHINDA COUNTY,KIYANGA,RWOBURUNGA,NYAMITAMBA P. SCHOOL,297,2,0,1,48,199,250,5,255,0,O-106-20-06-03-05
BUSHENYI,RUHINDA COUNTY,MITOOMA,BITOOMA,BITOOMA P/SCHOOL,593,0,3,3,152,320,478,5,483,0,O-106-20-07-01-01
BUSHENYI,RUHINDA COUNTY,MITOOMA,BITOOMA,RWAGASHANI P. SCHOOL,582,0,1,2,141,275,419,7,426,0,O-106-20-07-01-02
BUSHENYI,RUHINDA COUNTY,MITOOMA,BITOOMA,BITOOMA PARISH HQRS,541,2,1,1,147,241,392,13,405,0,O-106-20-07-01-03
BUSHENYI,RUHINDA COUNTY,MITOOMA,BITOOMA,IGAMBIRO P. SCHOOL,447,0,0,3,70,299,372,17,389,0,O-106-20-07-01-04
BUSHENYI,RUHINDA COUNTY,MITOOMA,BITOOMA,KYAMUSHONGORA P. SCHOOL,522,1,1,6,83,327,418,7,425,0,O-106-20-07-01-05
BUSHENYI,RUHINDA COUNTY,MITOOMA,IJUMO,KANJWIGA,468,2,0,1,105,245,353,1,354,0,O-106-20-07-02-01
BUSHENYI,RUHINDA COUNTY,MITOOMA,IJUMO,KIRAMBI MARKET,450,2,0,2,131,201,336,3,339,0,O-106-20-07-02-02
BUSHENYI,RUHINDA COUNTY,MITOOMA,IJUMO,IJUMO T. CENTRE,439,4,0,0,154,186,344,1,345,0,O-106-20-07-02-03
BUSHENYI,RUHINDA COUNTY,MITOOMA,IJUMO,RWIRARA I OMUBUBARE,532,2,1,1,98,320,422,9,431,0,O-106-20-07-02-04
BUSHENYI,RUHINDA COUNTY,MITOOMA,KIREMBE,RWENTUNDA CHURCH,643,4,0,1,112,385,502,10,512,0,O-106-20-07-03-01
BUSHENYI,RUHINDA COUNTY,MITOOMA,KIREMBE,RUTAKA P. SCHOOL,638,0,1,1,86,374,462,70,532,0,O-106-20-07-03-02
BUSHENYI,RUHINDA COUNTY,MITOOMA,KIREMBE,KIREMBE PARISH HQRS,613,1,0,1,109,353,464,0,464,0,O-106-20-07-03-03
BUSHENYI,RUHINDA COUNTY,MITOOMA,MUSHUNGA,KYANKUKWE PLAY GROUND I,234,1,0,4,48,109,162,3,165,0,O-106-20-07-04-01
BUSHENYI,RUHINDA COUNTY,MITOOMA,MUSHUNGA,KYANKUKWE PLAY GROUND II,358,0,1,1,71,195,268,1,269,0,O-106-20-07-04-02
BUSHENYI,RUHINDA COUNTY,MITOOMA,MUSHUNGA,KIBINGO P. SCHOOL,505,0,1,0,65,295,361,3,364,0,O-106-20-07-04-03
BUSHENYI,RUHINDA COUNTY,MITOOMA,MUSHUNGA,MUSHUNGA PARISH HQRS I,538,2,0,1,78,281,362,3,365,0,O-106-20-07-04-04
BUSHENYI,RUHINDA COUNTY,MITOOMA,MUSHUNGA,MUSHUNGA PARISH HQRS III,323,2,1,0,46,170,219,11,230,0,O-106-20-07-04-05
BUSHENYI,RUHINDA COUNTY,MITOOMA,MUSHUNGA,RYAKAHIMBI P/S,552,5,0,0,123,290,418,9,427,0,O-106-20-07-04-06
BUSHENYI,RUHINDA COUNTY,MITOOMA,MUSHUNGA,KATUNDA P/S,302,0,0,0,76,154,230,4,234,0,O-106-20-07-04-07
BUSHENYI,RUHINDA COUNTY,MITOOMA,NYAKISHOJWA,KYEHIMBA PLAY GROUND I,680,1,1,1,96,389,488,8,496,0,O-106-20-07-05-01
BUSHENYI,RUHINDA COUNTY,MITOOMA,NYAKISHOJWA,KYEHIMBA PLAY GROUND II,451,0,0,3,43,283,329,4,333,0,O-106-20-07-05-02
BUSHENYI,RUHINDA COUNTY,MITOOMA,NYAKISHOJWA,NKINGA P. SCHOOL I,390,1,0,3,46,247,297,9,306,0,O-106-20-07-05-03
BUSHENYI,RUHINDA COUNTY,MITOOMA,NYAKISHOJWA,NKINGA P. SCHOOL II,332,0,0,0,24,233,257,5,262,0,O-106-20-07-05-04
BUSHENYI,RUHINDA COUNTY,MITOOMA,NYAKISHOJWA,KAROZA GROUND,705,0,2,3,117,377,499,7,506,0,O-106-20-07-05-05
BUSHENYI,RUHINDA COUNTY,MITOOMA,RUKARARWE,RUKARARWE PARISH HQRS,671,7,1,5,143,322,478,10,488,0,O-106-20-07-06-01
BUSHENYI,RUHINDA COUNTY,MITOOMA,RUKARARWE,NYAKAHITA P. SCHOOL,590,1,1,3,88,349,442,15,457,0,O-106-20-07-06-02
BUSHENYI,RUHINDA COUNTY,MITOOMA,RUKARARWE,OMUKINYINYA P. SCHOOL,624,1,0,4,138,360,503,4,507,0,O-106-20-07-06-03
BUSHENYI,RUHINDA COUNTY,MITOOMA,RUSHOROZA,RUHINDA COUNTY HQRS,663,2,0,4,195,267,468,4,472,0,O-106-20-07-07-01
BUSHENYI,RUHINDA COUNTY,MITOOMA,RUSHOROZA,MITOOMA CENTRAL P. SCHOOL,528,2,0,0,214,191,407,14,421,0,O-106-20-07-07-02
BUSHENYI,RUHINDA COUNTY,MITOOMA,RUSHOROZA,BWEIBARE P. SCHOOL,268,0,4,0,82,124,210,0,210,0,O-106-20-07-07-03
BUSHENYI,RUHINDA COUNTY,MUTARA,BIKUNGU,NYAMIYAGA P. SCHOOL,230,1,0,0,40,143,184,1,185,0,O-106-20-08-01-01
BUSHENYI,RUHINDA COUNTY,MUTARA,BIKUNGU,BIKUNGU P. SCHOOL,536,1,0,5,148,237,391,4,395,0,O-106-20-08-01-02
BUSHENYI,RUHINDA COUNTY,MUTARA,BIKUNGU,KYAKATANDA T. CENTRE,273,0,0,3,74,112,189,13,202,0,O-106-20-08-01-03
BUSHENYI,RUHINDA COUNTY,MUTARA,BUKONGORO,KIGABAGABA CATHOLIC CHURCH,441,2,0,2,73,260,337,17,354,0,O-106-20-08-02-01
BUSHENYI,RUHINDA COUNTY,MUTARA,BUKONGORO,MUTARA P. SCHOOL,435,0,2,3,81,257,343,14,357,0,O-106-20-08-02-02
BUSHENYI,RUHINDA COUNTY,MUTARA,BUKONGORO,BUKONGORO PARISH HQRS,684,1,0,5,120,391,517,9,526,0,O-106-20-08-02-03
BUSHENYI,RUHINDA COUNTY,MUTARA,BUKONGORO,FURUMA CATHOLIC CHURCH,459,1,2,3,96,281,383,8,391,0,O-106-20-08-02-04
BUSHENYI,RUHINDA COUNTY,MUTARA,KYEIBARE,KYEIBARE PARISH HQRS I,559,3,0,1,155,279,438,11,449,0,O-106-20-08-03-01
BUSHENYI,RUHINDA COUNTY,MUTARA,KYEIBARE,KYEIBARE PARISH HQRS II,658,1,0,3,177,303,484,1,485,0,O-106-20-08-03-02
BUSHENYI,RUHINDA COUNTY,MUTARA,KYEIBARE,MAHWIZI P. SCHOOL,669,2,1,1,153,359,516,2,518,0,O-106-20-08-03-03
BUSHENYI,RUHINDA COUNTY,MUTARA,NYAKIZINGA,EKIBATE,640,0,0,4,112,359,475,16,491,0,O-106-20-08-04-01
BUSHENYI,RUHINDA COUNTY,MUTARA,NYAKIZINGA,NYAKIZINGA P. SCHOOL,668,0,1,0,94,394,489,11,500,0,O-106-20-08-04-02
BUSHENYI,RUHINDA COUNTY,MUTARA,NYAKIZINGA,NYAKAZINGA PARISH HQRS,518,1,0,1,99,301,402,6,408,0,O-106-20-08-04-03
BUSHENYI,RUHINDA COUNTY,MUTARA,NYAKIZINGA,MUTI P. SCHOOL,406,1,0,1,56,237,295,10,305,0,O-106-20-08-04-04
BUSHENYI,RUHINDA COUNTY,MUTARA,RYAKITANGA,AKAREERE T. CENTRE,323,1,1,1,76,164,243,7,250,0,O-106-20-08-05-01
BUSHENYI,RUHINDA COUNTY,MUTARA,RYAKITANGA,RYAKITANGA PARISH HQRS I,80,0,0,1,26,37,64,1,65,0,O-106-20-08-05-02
BUSHENYI,RUHINDA COUNTY,MUTARA,RYAKITANGA,RYAKITANGA PARISH HQRS II,838,1,0,6,238,393,638,23,661,0,O-106-20-08-05-03
BUSHENYI,RUHINDA COUNTY,RUREHE,NYAKATETE,NYAKISHOJWA P/SCHOOL,768,1,0,2,57,367,427,9,436,0,O-106-20-09-01-01
BUSHENYI,RUHINDA COUNTY,RUREHE,NYAKATETE,RUREHE MARKET,520,2,0,0,45,352,399,12,411,0,O-106-20-09-01-02
BUSHENYI,RUHINDA COUNTY,RUREHE,NYAKATETE,RUREHE P/SCHOOL,731,0,0,0,72,442,514,10,524,0,O-106-20-09-01-03
BUSHENYI,RUHINDA COUNTY,RUREHE,NYAKATETE,KITWE P/SCHOOL,664,2,0,3,58,494,557,11,568,0,O-106-20-09-01-04
BUSHENYI,RUHINDA COUNTY,RWANJA,NYAKATETE,RUKANGA TRADING CENTRE,572,1,0,0,70,350,421,4,425,0,O-106-20-10-01-05
BUSHENYI,RUHINDA COUNTY,RWANJA,NYAKATETE,KANGANGA P/SCHOOL,642,1,1,2,93,364,461,4,465,0,O-106-20-10-01-06
BUSHENYI,RUHINDA COUNTY,RWANJA,NYAKATETE,RWANJA P/SCHOOL,436,2,0,2,102,249,355,9,364,0,O-106-20-10-01-07
BUSHENYI,RUHINDA COUNTY,RWANJA,NYAKATETE,RWANJA TRADING CENTRE,449,0,0,0,66,258,324,5,329,0,O-106-20-10-01-08
BUSHENYI,RUHINDA COUNTY,RWANJA,RYENGYERERO,RYENGYERERO PARISH HQRS,463,1,0,6,83,277,367,7,374,0,O-106-20-10-02-01
BUSHENYI,RUHINDA COUNTY,RWANJA,RYENGYERERO,BUHASHA P/SCHOOL,594,0,0,3,61,393,457,7,464,0,O-106-20-10-02-02
BUSHENYI,RUHINDA COUNTY,RWANJA,RYENGYERERO,RUTOOMA P/SCHOOL,530,4,0,5,83,320,412,10,422,0,O-106-20-10-02-03
BUSHENYI,RUHINDA COUNTY,RWANJA,RYENGYERERO,KIGIMBI TRADING CENTRE,511,2,1,1,89,305,398,14,412,0,O-106-20-10-02-04
BUSHENYI,BUHWEJU COUNTY,BIHANGA,KAJUMBURA,MARINDE T. CENTRE,609,1,1,1,35,252,290,127,417,0,O-109-16-01-01-01
BUSHENYI,BUHWEJU COUNTY,BIHANGA,KAJUMBURA,KOBURIMBI PRIMARY SCHOOL,371,2,0,5,23,300,330,13,343,0,O-109-16-01-01-02
BUSHENYI,BUHWEJU COUNTY,BIHANGA,KAJUMBURA,KYAHENDA PRIMARY SCHOOL,532,4,3,5,42,359,413,32,445,0,O-109-16-01-01-03
BUSHENYI,BUHWEJU COUNTY,BIHANGA,KAJUMBURA,OMUKATOJO T CENTRE,499,6,0,4,71,340,421,10,431,0,O-109-16-01-01-04
BUSHENYI,BUHWEJU COUNTY,BIHANGA,KAREMBE,KAREMBE T. CENTRE,595,0,0,1,28,511,540,2,542,0,O-109-16-01-02-01
BUSHENYI,BUHWEJU COUNTY,BIHANGA,KAREMBE,KASHAMBYA T. CENTRE,480,0,0,2,42,368,412,11,423,0,O-109-16-01-02-02
BUSHENYI,BUHWEJU COUNTY,BIHANGA,KATONGO,KATONGO PARISH HQRS,547,4,0,1,47,423,475,9,484,0,O-109-16-01-03-01
BUSHENYI,BUHWEJU COUNTY,BIHANGA,KATONGO,ENGAJU T. CENTRE,720,1,1,13,40,527,582,22,604,0,O-109-16-01-03-02
BUSHENYI,BUHWEJU COUNTY,BIHANGA,KATONGO,KAGOROGORO CHURCH COMP.,429,2,1,1,14,346,364,7,371,0,O-109-16-01-03-03
BUSHENYI,BUHWEJU COUNTY,BIHANGA,NYAKAZIBA,KIYANJA T. CENTRE,596,4,1,4,34,476,519,9,528,0,O-109-16-01-04-01
BUSHENYI,BUHWEJU COUNTY,BIHANGA,NYAKAZIBA,ISHAKA T. CENTRE,610,3,0,1,45,386,435,92,527,0,O-109-16-01-04-02
BUSHENYI,BUHWEJU COUNTY,BIHANGA,NYAKAZIBA,NYAKAZIBA P. SCHOOL,705,1,0,2,88,399,490,97,587,0,O-109-16-01-04-03
BUSHENYI,BUHWEJU COUNTY,BIHANGA,RUKIRI,BIHANGA S/C HQRS,651,3,0,1,26,492,522,46,568,0,O-109-16-01-05-01
BUSHENYI,BUHWEJU COUNTY,BIHANGA,RUKIRI,NYAKISHENYI P. SCHOOL,478,1,0,4,38,380,423,8,431,0,O-109-16-01-05-02
BUSHENYI,BUHWEJU COUNTY,BURERE,KATINDA,KATINDA T. CENTRE,477,4,0,4,73,287,368,0,368,0,O-109-16-02-01-01
BUSHENYI,BUHWEJU COUNTY,BURERE,KATINDA,KATINDA P. SCHOOL,382,1,1,2,45,294,343,7,350,0,O-109-16-02-01-02
BUSHENYI,BUHWEJU COUNTY,BURERE,KIRAMIRA,BURERE S/C HQRS,423,2,3,3,44,249,301,7,308,0,O-109-16-02-02-01
BUSHENYI,BUHWEJU COUNTY,BURERE,KIRAMIRA,KIRAMIRA PARISH HQRS,398,1,0,2,18,254,275,45,320,0,O-109-16-02-02-02
BUSHENYI,BUHWEJU COUNTY,BURERE,KIRAMIRA,MABANGA T. CENTRE,236,0,1,1,29,121,152,41,193,0,O-109-16-02-02-03
BUSHENYI,BUHWEJU COUNTY,BURERE,KIRAMIRA,EKIKORA,336,3,3,1,26,240,273,4,277,0,O-109-16-02-02-04
BUSHENYI,BUHWEJU COUNTY,BURERE,KIRAMIRA,RYAMUJUNI P.SCHOOL,211,1,0,0,19,123,143,38,181,0,O-109-16-02-02-05
BUSHENYI,BUHWEJU COUNTY,BURERE,NYAKITOKO,KIBARYA P. SCHOOL,590,3,2,5,101,320,431,10,441,0,O-109-16-02-03-01
BUSHENYI,BUHWEJU COUNTY,BURERE,NYAKITOKO,OMUKASHENYI T. CENTRE,458,1,0,0,101,224,326,5,331,0,O-109-16-02-03-02
BUSHENYI,BUHWEJU COUNTY,BURERE,RUBENGYE,KAKOMBE T. CENTRE,325,1,0,1,32,175,209,50,259,0,O-109-16-02-04-01
BUSHENYI,BUHWEJU COUNTY,BURERE,RUBENGYE,RUBENGYE P. SCHOOL,286,1,0,3,40,141,185,33,218,0,O-109-16-02-04-02
BUSHENYI,BUHWEJU COUNTY,BURERE,RUBENGYE,KYAMATO P. SCHOOL,310,2,1,2,31,234,270,6,276,0,O-109-16-02-04-03
BUSHENYI,BUHWEJU COUNTY,BURERE,RUBENGYE,KITOJO CATHOLIC CHURCH,317,1,0,5,31,229,266,7,273,0,O-109-16-02-04-04
BUSHENYI,BUHWEJU COUNTY,BURERE,RUSHAYO,KYAMATO C.O.U,214,3,3,4,28,118,156,18,174,0,O-109-16-02-05-01
BUSHENYI,BUHWEJU COUNTY,BURERE,RUSHAYO,KAYANJA P.SCHOOL,326,2,0,1,18,219,240,27,267,0,O-109-16-02-05-02
BUSHENYI,BUHWEJU COUNTY,BURERE,RUSHAYO,NYEIGABIRO P. SCHOOL,547,0,1,2,35,291,329,73,402,0,O-109-16-02-05-03
BUSHENYI,BUHWEJU COUNTY,BURERE,RWAJERE,RWAJERE PARISH HQRS,475,3,0,4,42,286,335,8,343,0,O-109-16-02-06-01
BUSHENYI,BUHWEJU COUNTY,BURERE,RWAJERE,RUHIIJA T. CENTRE,631,1,1,1,36,430,469,8,477,0,O-109-16-02-06-02
BUSHENYI,BUHWEJU COUNTY,BURERE,RWAJERE,RUSHAMBYA P. SCHOOL,740,1,1,8,84,441,535,9,544,0,O-109-16-02-06-03
BUSHENYI,BUHWEJU COUNTY,BURERE,RWAJERE,KIKOMBE T. CENTRE,155,1,0,1,23,101,126,6,132,0,O-109-16-02-06-04
BUSHENYI,BUHWEJU COUNTY,BURERE,RWAJERE,KATAGATA P. SCHOOL,521,1,2,1,46,309,359,72,431,0,O-109-16-02-06-05
BUSHENYI,BUHWEJU COUNTY,BURERE,RWANYAMABARE,KABEGARAMIRE C.O.U,765,1,0,9,65,544,619,5,624,0,O-109-16-02-07-01
BUSHENYI,BUHWEJU COUNTY,BURERE,RWANYAMABARE,RWANYAMABARE PARISH HQRS,1009,2,0,6,49,737,794,19,813,0,O-109-16-02-07-02
BUSHENYI,BUHWEJU COUNTY,KARUNGU,BITSYA,BITSYA CATHOLIC CENTRE,382,0,0,5,20,322,347,7,354,0,O-109-16-03-01-01
BUSHENYI,BUHWEJU COUNTY,KARUNGU,BITSYA,KAZIRWA T. CENTRE,468,2,0,1,17,393,413,6,419,0,O-109-16-03-01-02
BUSHENYI,BUHWEJU COUNTY,KARUNGU,BITSYA,BITSYA P. SCHOOL,335,2,0,2,36,243,283,5,288,0,O-109-16-03-01-03
BUSHENYI,BUHWEJU COUNTY,KARUNGU,KASHARARA,KAMAJUMBA P. SCHOOL,270,1,0,0,11,225,237,2,239,0,O-109-16-03-02-01
BUSHENYI,BUHWEJU COUNTY,KARUNGU,KASHARARA,KASHARARA P. SCHOOL,508,2,0,4,39,351,396,13,409,0,O-109-16-03-02-02
BUSHENYI,BUHWEJU COUNTY,KARUNGU,KASHARARA,IBOGORA T. CENTRE,328,2,0,1,10,288,301,3,304,0,O-109-16-03-02-03
BUSHENYI,BUHWEJU COUNTY,KARUNGU,KASHARARA,RWANKONDO T. CENTRE,181,0,0,0,4,120,124,29,153,0,O-109-16-03-02-04
BUSHENYI,BUHWEJU COUNTY,KARUNGU,KATARA,KATARA P. SCHOOL I,518,1,0,0,82,265,348,93,441,0,O-109-16-03-03-01
BUSHENYI,BUHWEJU COUNTY,KARUNGU,KATARA,KATARA P. SCHOOL II,421,1,0,0,33,236,270,82,352,0,O-109-16-03-03-02
BUSHENYI,BUHWEJU COUNTY,KARUNGU,KATARA,KAMUKAKI P. SCHOOL,368,2,0,2,36,288,328,3,331,0,O-109-16-03-03-03
BUSHENYI,BUHWEJU COUNTY,KARUNGU,KITEGA,KANKARA P. SCHOOL,585,2,1,6,44,421,474,18,492,0,O-109-16-03-04-01
BUSHENYI,BUHWEJU COUNTY,KARUNGU,KITEGA,KASHORERO CATHOLIC CHURCH,610,2,2,3,66,411,484,5,489,0,O-109-16-03-04-02
BUSHENYI,BUHWEJU COUNTY,KARUNGU,KITEGA,KYENJOGYERA T. CENTRE,363,0,0,2,26,291,319,4,323,0,O-109-16-03-04-03
BUSHENYI,BUHWEJU COUNTY,KARUNGU,KITEGA,KITEGA COOP. SOCIETY,217,0,0,0,19,159,178,15,193,0,O-109-16-03-04-04
BUSHENYI,BUHWEJU COUNTY,KARUNGU,KITEGA,ISINGIRO P. SCHOOL,169,0,0,0,8,124,132,14,146,0,O-109-16-03-04-05
BUSHENYI,BUHWEJU COUNTY,KARUNGU,MUSHASHA,MUSHASHA PARISH HQRS,641,2,0,5,21,548,576,10,586,0,O-109-16-03-05-01
BUSHENYI,BUHWEJU COUNTY,KARUNGU,MUSHASHA,BUHUNGA,716,2,1,2,26,540,571,73,644,0,O-109-16-03-05-02
BUSHENYI,BUHWEJU COUNTY,KARUNGU,RUGONGO,RUBONGO P. SCHOOL,454,3,3,3,53,295,357,6,363,0,O-109-16-03-06-01
BUSHENYI,BUHWEJU COUNTY,KARUNGU,RUGONGO,KARUNGU P. SCHOOL,650,0,0,3,48,510,561,8,569,0,O-109-16-03-06-02
BUSHENYI,BUHWEJU COUNTY,KARUNGU,RUGONGO,RUGONGO PARISH HQRS,380,2,0,0,22,234,258,54,312,0,O-109-16-03-06-03
BUSHENYI,BUHWEJU COUNTY,KARUNGU,RUGONGO,BUTURO P. SCHOOL,395,1,0,0,8,267,276,62,338,0,O-109-16-03-06-04
BUSHENYI,BUHWEJU COUNTY,RWENGWE,BWOGA,BWOGA T. CENTRE,745,5,0,1,73,413,492,166,658,0,O-109-16-04-01-01
BUSHENYI,BUHWEJU COUNTY,RWENGWE,KASHENYI,KASHENYI T. CENTRE,405,1,0,1,20,316,338,2,340,0,O-109-16-04-02-01
BUSHENYI,BUHWEJU COUNTY,RWENGWE,KASHENYI,BUTARE S.S.S,430,0,0,1,42,251,294,44,338,0,O-109-16-04-02-02
BUSHENYI,BUHWEJU COUNTY,RWENGWE,KIBIMBA,KIBIMBA PARISH HQRS,674,1,0,3,86,428,518,63,581,0,O-109-16-04-03-01
BUSHENYI,BUHWEJU COUNTY,RWENGWE,KIBIMBA,IBARO/KABINGO,563,1,1,0,23,387,412,99,511,0,O-109-16-04-03-02
BUSHENYI,BUHWEJU COUNTY,RWENGWE,KYEYARE,KYEYARE P. SCHOOL,391,1,0,2,28,315,346,14,360,0,O-109-16-04-04-01
BUSHENYI,BUHWEJU COUNTY,RWENGWE,KYEYARE,KYAKANDA T. CENTRE,524,1,1,4,63,366,435,19,454,0,O-109-16-04-04-02
BUSHENYI,BUHWEJU COUNTY,RWENGWE,KYEYARE,KANIGA T. CENTRE,454,0,0,0,26,303,329,75,404,0,O-109-16-04-04-03
BUSHENYI,BUHWEJU COUNTY,RWENGWE,RWENGWE,RUGABA TEA COLLECTING CENT,760,1,2,2,66,479,550,114,664,0,O-109-16-04-05-01
BUSHENYI,BUHWEJU COUNTY,RWENGWE,RWENGWE,RWENGWE PARISH HQRS,761,3,0,0,70,452,525,136,661,0,O-109-16-04-05-02
BUSHENYI,BUHWEJU COUNTY,RWENGWE,RWENGWE,NYAKISHOJWA CATTLE MARKET,678,1,0,1,42,396,440,122,562,0,O-109-16-04-05-03
BUSHENYI,BUNYARUGURU COUNTY,KATERERA,KAKARI,KAKARI P. SCHOOL,715,0,1,2,74,473,550,10,560,0,O-112-17-01-01-01
BUSHENYI,BUNYARUGURU COUNTY,KATERERA,KAKARI,KAKARI PARISH HQRS,579,4,0,2,68,308,382,31,413,0,O-112-17-01-01-02
BUSHENYI,BUNYARUGURU COUNTY,KATERERA,KAKARI,NGORO TRADING CENTRE,488,3,0,4,57,316,380,12,392,0,O-112-17-01-01-03
BUSHENYI,BUNYARUGURU COUNTY,KATERERA,KAKARI,GARHMA'S COMPOUND,290,3,2,0,26,214,245,5,250,0,O-112-17-01-01-04
BUSHENYI,BUNYARUGURU COUNTY,KATERERA,KATANDA,KATANDA P. SCHOOL,312,6,0,1,29,197,233,13,246,0,O-112-17-01-02-01
BUSHENYI,BUNYARUGURU COUNTY,KATERERA,KATANDA,KATANDA II MOSQUE,404,1,0,1,67,253,322,12,334,0,O-112-17-01-02-02
BUSHENYI,BUNYARUGURU COUNTY,KATERERA,KATANDA,KEMPUNU T. CENTRE,367,5,0,4,74,178,261,21,282,0,O-112-17-01-02-03
BUSHENYI,BUNYARUGURU COUNTY,KATERERA,KATANDA,KARAMA T/CENTRE,605,12,0,3,37,325,377,23,400,0,O-112-17-01-02-04
BUSHENYI,BUNYARUGURU COUNTY,KATERERA,KATANDA,AHAKASHANSHA,713,6,0,1,142,358,507,10,517,0,O-112-17-01-02-05
BUSHENYI,BUNYARUGURU COUNTY,KATERERA,KATERERA,KATERERA MARKET,692,2,0,1,103,354,460,8,468,0,O-112-17-01-03-01
BUSHENYI,BUNYARUGURU COUNTY,KATERERA,KATERERA,KATERERA PLAY GROUND,519,4,0,3,55,306,368,14,382,0,O-112-17-01-03-02
BUSHENYI,BUNYARUGURU COUNTY,KATERERA,KATERERA,KACU P. SCHOOL,630,10,0,4,107,348,469,14,483,0,O-112-17-01-03-03
BUSHENYI,BUNYARUGURU COUNTY,KATERERA,KATERERA,NYAMIRIMA C.O.U,680,3,0,6,79,477,565,9,574,0,O-112-17-01-03-04
BUSHENYI,BUNYARUGURU COUNTY,KATERERA,KATERERA,KANYWERO P. SCHOOL,159,0,0,0,53,75,128,1,129,0,O-112-17-01-03-05
BUSHENYI,BUNYARUGURU COUNTY,KATERERA,KYABAKARA,RWENZURURU,646,3,0,6,141,336,486,10,496,0,O-112-17-01-04-01
BUSHENYI,BUNYARUGURU COUNTY,KATERERA,KYABAKARA,KYABAKARA P. SCHOOL I,537,6,0,4,71,310,391,10,401,0,O-112-17-01-04-02
BUSHENYI,BUNYARUGURU COUNTY,KATERERA,KYABAKARA,OMUKANYINA T. CENTRE,506,2,0,5,99,266,372,8,380,0,O-112-17-01-04-03
BUSHENYI,BUNYARUGURU COUNTY,KATERERA,KYABAKARA,KYEBANDO C.O.U,706,3,2,4,136,355,500,7,507,0,O-112-17-01-04-04
BUSHENYI,BUNYARUGURU COUNTY,KATERERA,MUGYERA,KISHARU - RYAMATUMBA (B),571,5,0,1,57,397,460,14,474,0,O-112-17-01-05-01
BUSHENYI,BUNYARUGURU COUNTY,KATERERA,MUGYERA,KANYANSHANDE P. SCHOOL,548,1,0,3,53,341,398,3,401,0,O-112-17-01-05-02
BUSHENYI,BUNYARUGURU COUNTY,KATERERA,MUGYERA,MUGYERA P. SCHOOL,544,5,0,5,87,327,424,13,437,0,O-112-17-01-05-03
BUSHENYI,BUNYARUGURU COUNTY,KATERERA,MUGYERA,NYAKATUNGA C.O.U,627,11,3,4,48,410,476,18,494,0,O-112-17-01-05-04
BUSHENYI,BUNYARUGURU COUNTY,KATERERA,MUNYONYI,MUKATOOMA,300,1,1,3,32,207,244,13,257,0,O-112-17-01-06-01
BUSHENYI,BUNYARUGURU COUNTY,KATERERA,MUNYONYI,KATSYOHA P. SCHOOL I,705,14,1,8,37,490,550,23,573,0,O-112-17-01-06-02
BUSHENYI,BUNYARUGURU COUNTY,KATERERA,MUNYONYI,KATSYOHA P. SCHOOL II,196,2,1,1,4,157,165,2,167,0,O-112-17-01-06-03
BUSHENYI,BUNYARUGURU COUNTY,KATERERA,MUNYONYI,MUNYONYI B TUMUSIIME 'S COM,241,4,0,2,15,182,203,17,220,0,O-112-17-01-06-04
BUSHENYI,BUNYARUGURU COUNTY,KATERERA,MUNYONYI,NYANDONGO,426,11,0,4,30,298,343,19,362,0,O-112-17-01-06-05
BUSHENYI,BUNYARUGURU COUNTY,KATERERA,MWONGYERA,MWONGYERA PLAY GROUND,720,5,1,4,99,420,529,14,543,0,O-112-17-01-07-01
BUSHENYI,BUNYARUGURU COUNTY,KATERERA,MWONGYERA,MWONGYERA T. CENTRE,608,2,0,2,107,350,461,6,467,0,O-112-17-01-07-02
BUSHENYI,BUNYARUGURU COUNTY,KATERERA,MWONGYERA,MWONGYERA P. SCHOOL,815,6,1,3,72,504,586,14,600,0,O-112-17-01-07-03
BUSHENYI,BUNYARUGURU COUNTY,KATERERA,MWONGYERA,KATERERA SUB CTY HQRS,403,7,0,1,37,242,287,11,298,0,O-112-17-01-07-04
BUSHENYI,BUNYARUGURU COUNTY,KATERERA,MWONGYERA,OMUKAMBUGU,418,7,1,3,46,232,289,11,300,0,O-112-17-01-07-05
BUSHENYI,BUNYARUGURU COUNTY,KATUNGURU,KASHAKA,KASHAKA AID POST,442,0,1,2,57,196,256,15,271,0,O-112-17-02-01-01
BUSHENYI,BUNYARUGURU COUNTY,KATUNGURU,KATUNGURU,KATUNGURU SUB - CYT HQRS,314,0,1,0,36,159,196,36,232,0,O-112-17-02-02-01
BUSHENYI,BUNYARUGURU COUNTY,KATUNGURU,KAZINGA,KAZINGA PLAY GROUND,470,2,0,2,59,225,288,6,294,0,O-112-17-02-03-01
BUSHENYI,BUNYARUGURU COUNTY,KATUNGURU,KISHENYI,KISHENYI PARISH HQRS,691,6,2,2,118,271,399,19,418,0,O-112-17-02-04-01
BUSHENYI,BUNYARUGURU COUNTY,KICHWAMBA,KICHWAMBA,KICWAMBA SUB - CTY HQRS I,318,0,0,1,58,150,209,12,221,0,O-112-17-03-01-01
BUSHENYI,BUNYARUGURU COUNTY,KICHWAMBA,KICHWAMBA,KICWAMBA SUB - CTY HQRS II,488,0,2,2,62,292,358,13,371,0,O-112-17-03-01-02
BUSHENYI,BUNYARUGURU COUNTY,KICHWAMBA,KICHWAMBA,KICWAMBA PARISH HQRS,315,0,1,0,22,190,213,5,218,0,O-112-17-03-01-03
BUSHENYI,BUNYARUGURU COUNTY,KICHWAMBA,KICHWAMBA,KYAMBURA P. SCHOOL I,588,5,1,0,109,275,390,7,397,0,O-112-17-03-01-04
BUSHENYI,BUNYARUGURU COUNTY,KICHWAMBA,KICHWAMBA,KAGANDO (MUMPENDE'S PLACE),655,3,1,2,144,320,470,13,483,0,O-112-17-03-01-05
BUSHENYI,BUNYARUGURU COUNTY,KICHWAMBA,KICHWAMBA,BUSONGA T. CENTRE,554,4,3,4,90,321,422,16,438,0,O-112-17-03-01-06
BUSHENYI,BUNYARUGURU COUNTY,KICHWAMBA,KIKUMBO,NTUNGA PLAY GROUND,527,10,2,1,47,336,396,19,415,0,O-112-17-03-02-01
BUSHENYI,BUNYARUGURU COUNTY,KICHWAMBA,KIKUMBO,KIKUMBO CHURCH SCHOOL,578,2,0,1,80,358,441,8,449,0,O-112-17-03-02-02
BUSHENYI,BUNYARUGURU COUNTY,KICHWAMBA,KIRUGU,KIRUGU SECONDARY SCHOOL,467,9,1,5,70,252,337,10,347,0,O-112-17-03-03-01
BUSHENYI,BUNYARUGURU COUNTY,KICHWAMBA,KIRUGU,KIRUGU MOSLEM SCHOOL,604,8,0,3,107,329,447,33,480,0,O-112-17-03-03-02
BUSHENYI,BUNYARUGURU COUNTY,KICHWAMBA,KIRUGU,KYENZAZA T. CENTRE,646,7,0,5,104,320,436,26,462,0,O-112-17-03-03-03
BUSHENYI,BUNYARUGURU COUNTY,KICHWAMBA,KIRUGU,KAFURO T. CENTRE,535,4,0,2,59,282,347,11,358,0,O-112-17-03-03-04
BUSHENYI,BUNYARUGURU COUNTY,KICHWAMBA,KIRUGU,KIRUGI OUTSIDE Q.GUARD (A-L),593,3,0,1,37,402,443,7,450,0,O-112-17-03-03-05
BUSHENYI,BUNYARUGURU COUNTY,KICHWAMBA,KIRUGU,KIRUGI OUTSIDE Q.GUARD(M-Z),700,1,0,0,31,276,308,2,310,0,O-112-17-03-03-06
BUSHENYI,BUNYARUGURU COUNTY,KICHWAMBA,RUMURI,BUHINGO T. CENTRE,711,6,0,5,86,377,474,25,499,0,O-112-17-03-04-01
BUSHENYI,BUNYARUGURU COUNTY,KICHWAMBA,RUMURI,KABUKAGA'S CENTRE (BUHINGO,430,1,2,5,55,270,333,13,346,0,O-112-17-03-04-02
BUSHENYI,BUNYARUGURU COUNTY,KICHWAMBA,RUMURI,RUMURI T. CENTRE,508,0,1,0,60,357,418,7,425,0,O-112-17-03-04-03
BUSHENYI,BUNYARUGURU COUNTY,KICHWAMBA,RUMURI,KATAARA - OMUKATEETE,162,0,0,2,15,87,104,6,110,0,O-112-17-03-04-04
BUSHENYI,BUNYARUGURU COUNTY,KICHWAMBA,RUMURI,AHAKABIRA,463,1,2,0,50,271,324,12,336,0,O-112-17-03-04-05
BUSHENYI,BUNYARUGURU COUNTY,KICHWAMBA,RUMURI,KYARUGANDA NUTRITION SCHOO,245,1,0,2,27,170,200,9,209,0,O-112-17-03-04-06
BUSHENYI,BUNYARUGURU COUNTY,RYERU,BUGAYA,BUGAYA PARISH HQRS,457,0,0,5,42,346,393,12,405,0,O-112-17-04-01-01
BUSHENYI,BUNYARUGURU COUNTY,RYERU,BUGAYA,RUKIIZI T. CENTRE,608,0,0,5,66,398,469,11,480,0,O-112-17-04-01-02
BUSHENYI,BUNYARUGURU COUNTY,RYERU,BUTOOHA,BUTOOHA PARISH HQRS,279,0,0,2,36,198,236,13,249,0,O-112-17-04-02-01
BUSHENYI,BUNYARUGURU COUNTY,RYERU,BUTOOHA,BUTOOHA P. SCHOOL II,597,1,0,5,75,410,491,23,514,0,O-112-17-04-02-02
BUSHENYI,BUNYARUGURU COUNTY,RYERU,BUTOOHA,NYANGOROGORO PLAY GROUND,611,4,1,3,66,400,474,9,483,0,O-112-17-04-02-03
BUSHENYI,BUNYARUGURU COUNTY,RYERU,BUZENGA,BUZENGA T. CENTRE,697,3,1,3,65,420,492,23,515,0,O-112-17-04-03-01
BUSHENYI,BUNYARUGURU COUNTY,RYERU,BUZENGA,KAMACUMU P. SCHOOL,457,3,0,0,43,294,340,11,351,0,O-112-17-04-03-02
BUSHENYI,BUNYARUGURU COUNTY,RYERU,MAGAMBO,NYAKASARU PLAY GROUND,604,4,1,6,84,351,446,22,468,0,O-112-17-04-04-01
BUSHENYI,BUNYARUGURU COUNTY,RYERU,MAGAMBO,NYAKASARU MARKET,555,3,2,4,73,340,422,15,437,0,O-112-17-04-04-02
BUSHENYI,BUNYARUGURU COUNTY,RYERU,MUSHUMBA,MUSHUMBA COOP SOCIETY OFFI,455,0,1,6,20,334,361,17,378,0,O-112-17-04-05-01
BUSHENYI,BUNYARUGURU COUNTY,RYERU,MUSHUMBA,MUSHUMBA PARISH HQRS,639,2,1,6,52,412,473,20,493,0,O-112-17-04-05-02
BUSHENYI,BUNYARUGURU COUNTY,RYERU,MUSHUMBA,MUSHUMBA P. SCHOOL,551,0,0,2,61,331,394,0,394,0,O-112-17-04-05-03
BUSHENYI,BUNYARUGURU COUNTY,RYERU,NDANGARO,KASHENYI P. SCHOOL,593,4,1,6,101,343,455,27,482,0,O-112-17-04-06-01
BUSHENYI,BUNYARUGURU COUNTY,RYERU,NDANGARO,NYABWINA T. CENTRE,390,4,0,1,25,227,257,0,257,0,O-112-17-04-06-02
BUSHENYI,BUNYARUGURU COUNTY,RYERU,NDANGARO,RUTOTO SEC SCHOOL,803,9,0,4,94,495,602,15,617,0,O-112-17-04-06-03
BUSHENYI,BUNYARUGURU COUNTY,RYERU,NDANGARO,RUTOTO P. SCHOOL II,611,2,1,1,84,357,445,20,465,0,O-112-17-04-06-04
BUSHENYI,BUNYARUGURU COUNTY,RYERU,NDEKYE,RYERU SUB - COUNTY HQRS,613,2,0,0,84,345,431,12,443,0,O-112-17-04-07-01
BUSHENYI,BUNYARUGURU COUNTY,RYERU,NDEKYE,NDEKYE MARKET,906,4,0,0,121,384,509,42,551,0,O-112-17-04-07-02
BUSHENYI,BUNYARUGURU COUNTY,RYERU,NDEKYE,MUGOGO P. SCHOOL,450,3,1,2,31,280,317,8,325,0,O-112-17-04-07-03
BUSHENYI,BUNYARUGURU COUNTY,RYERU,NDEKYE,NDEKYE PARISH HQRS,287,0,0,1,24,182,207,3,210,0,O-112-17-04-07-04
BUSHENYI,BUNYARUGURU COUNTY,RYERU,NYABUBARE,NYABUBARE P. SCHOOL,487,5,0,2,51,254,312,19,331,0,O-112-17-04-08-01
BUSHENYI,BUNYARUGURU COUNTY,RYERU,NYABUBARE,BUHINDA P. SCHOOL I,711,4,2,7,78,360,451,22,473,0,O-112-17-04-08-02
BUSHENYI,BUNYARUGURU COUNTY,RYERU,NYABUBARE,BUHINDA P. SCHOOL II,718,3,1,1,46,455,506,31,537,0,O-112-17-04-08-03
BUSHENYI,BUNYARUGURU COUNTY,RYERU,NYABUBARE,RWEMITAGU P. SCHOOL,429,5,1,2,20,290,318,17,335,0,O-112-17-04-08-04
BUSHENYI,BUNYARUGURU COUNTY,RYERU,NYAKIYANJA,NYAKIYANJA UPPER,675,3,0,4,80,327,414,16,430,0,O-112-17-04-09-01
BUSHENYI,BUNYARUGURU COUNTY,RYERU,NYAKIYANJA,NYAKIYANJA LOWER,595,3,1,1,74,315,394,18,412,0,O-112-17-04-09-02
BUSHENYI,BUNYARUGURU COUNTY,RYERU,NYAKIYANJA,KABUKWIRE T. CENTRE,226,1,1,3,12,132,149,10,159,0,O-112-17-04-09-03
BUSHENYI,BUNYARUGURU COUNTY,RYERU,RUGAZI,RUGAZI PLAY GROUND I,378,1,0,4,78,212,295,3,298,0,O-112-17-04-10-01
BUSHENYI,BUNYARUGURU COUNTY,RYERU,RUGAZI,RUGAZI PLAY GROUND II,272,0,0,2,41,175,218,11,229,0,O-112-17-04-10-02
BUSHENYI,BUNYARUGURU COUNTY,RYERU,RUGAZI,RUBIRIZI SAZA HQRS,487,0,0,4,60,312,376,2,378,0,O-112-17-04-10-03
KIBAALE,BUYAGA COUNTY,BWIKARA,KISUURA,KISUURA PRIMARY SCHOOL,77,0,0,0,3,50,53,1,54,0,O-113-82-01-01-01
KIBAALE,BUYAGA COUNTY,BWIKARA,KISUURA,KATIKENGEYO CENTRE [A-MO],413,0,1,3,54,266,324,14,338,0,O-113-82-01-01-02
KIBAALE,BUYAGA COUNTY,BWIKARA,KISUURA,MABERENGA P/SCHOOL (A-L),474,1,1,1,32,242,277,0,277,0,O-113-82-01-01-03
KIBAALE,BUYAGA COUNTY,BWIKARA,KISUURA,NAMBA MUNANA MARKET,642,0,1,2,39,363,405,10,415,0,O-113-82-01-01-04
KIBAALE,BUYAGA COUNTY,BWIKARA,KISUURA,KAGUGO TRADING CENTRE,476,1,6,3,25,290,325,12,337,0,O-113-82-01-01-05
KIBAALE,BUYAGA COUNTY,BWIKARA,KISUURA,BWIKARA SUB CTY HQTRS,167,1,2,1,5,143,152,3,155,0,O-113-82-01-01-06
KIBAALE,BUYAGA COUNTY,BWIKARA,KISUURA,MABERENGA P/SCHOOL (M-Z),580,5,1,3,36,395,440,17,457,0,O-113-82-01-01-07
KIBAALE,BUYAGA COUNTY,BWIKARA,KISUURA,KYAKATIKENGEYO CENTRE [MP-Z,408,0,1,3,40,271,315,13,328,0,O-113-82-01-01-08
KIBAALE,BUYAGA COUNTY,BWIKARA,KISUURA,NAMBA MUNANA MARKET [KW-Z],449,1,2,2,16,258,279,10,289,0,O-113-82-01-01-09
KIBAALE,BUYAGA COUNTY,BWIKARA,MAIRIRWE,KYEMA TRADING CENTRE A,465,3,0,3,43,298,347,8,355,0,O-113-82-01-02-01
KIBAALE,BUYAGA COUNTY,BWIKARA,MAIRIRWE,KYEMA TRADING CENTRE B,432,1,0,0,25,301,327,5,332,0,O-113-82-01-02-02
KIBAALE,BUYAGA COUNTY,BWIKARA,MAIRIRWE,MUNSENYI TRADING CENTRE,569,3,0,4,34,402,443,14,457,0,O-113-82-01-02-03
KIBAALE,BUYAGA COUNTY,BWIKARA,MAIRIRWE,KAYANJA TRADING CENTRE,489,0,2,3,33,337,375,5,380,0,O-113-82-01-02-04
KIBAALE,BUYAGA COUNTY,BWIKARA,MAIRIRWE,KIKUNYU TRADING CENTRE,522,0,1,2,47,349,399,23,422,0,O-113-82-01-02-05
KIBAALE,BUYAGA COUNTY,BWIKARA,MAIRIRWE,KITEHE PRIMARY SCHOOL,326,1,0,1,17,230,249,17,266,0,O-113-82-01-02-06
KIBAALE,BUYAGA COUNTY,BWIKARA,NYAKARONGO,KONDO TC,781,1,0,7,24,616,648,12,660,0,O-113-82-01-03-01
KIBAALE,BUYAGA COUNTY,BWIKARA,NYAKARONGO,NYAKARONGO T/C A,606,1,2,2,29,437,471,16,487,0,O-113-82-01-03-02
KIBAALE,BUYAGA COUNTY,BWIKARA,NYAKARONGO,NYAKARONGO T/C B,604,0,0,2,25,416,443,18,461,0,O-113-82-01-03-03
KIBAALE,BUYAGA COUNTY,BWIKARA,NYAKARONGO,KISUNGU PR/SCHOOL A,658,3,0,12,39,424,478,27,505,0,O-113-82-01-03-04
KIBAALE,BUYAGA COUNTY,BWIKARA,NYAKARONGO,KISUNGU PR. SCH. B,415,2,1,1,20,290,314,14,328,0,O-113-82-01-03-05
KIBAALE,BUYAGA COUNTY,BWIKARA,NYAKARONGO,MABAALE T/C,388,3,0,0,44,232,279,20,299,0,O-113-82-01-03-06
KIBAALE,BUYAGA COUNTY,BWIKARA,NYAMASA,KAMUSEEGU TRADING CENTRE A,585,2,1,4,47,328,382,23,405,0,O-113-82-01-04-01
KIBAALE,BUYAGA COUNTY,BWIKARA,NYAMASA,NYANKUBEBE (SENGENGE),610,0,2,7,18,451,478,11,489,0,O-113-82-01-04-02
KIBAALE,BUYAGA COUNTY,BWIKARA,NYAMASA,NYAMASA STORE A,485,2,0,1,33,251,287,25,312,0,O-113-82-01-04-03
KIBAALE,BUYAGA COUNTY,BWIKARA,NYAMASA,NYAMASA STORE B,524,2,0,1,29,362,394,20,414,0,O-113-82-01-04-04
KIBAALE,BUYAGA COUNTY,BWIKARA,NYAMASA,KAMUSEEGU TRADING CENTRE B,424,1,0,5,26,241,273,19,292,0,O-113-82-01-04-05
KIBAALE,BUYAGA COUNTY,BWIKARA,NYAMASA,NYABINANGA T/CENTRE,261,0,1,0,8,201,210,7,217,0,O-113-82-01-04-06
KIBAALE,BUYAGA COUNTY,KAGADI,KENGA,KATETE P/SCHOOL,315,0,0,1,13,226,240,8,248,0,O-113-82-02-01-01
KIBAALE,BUYAGA COUNTY,KAGADI,KENGA,SESE P/SCHOOL [A-M],413,2,2,4,11,281,300,6,306,0,O-113-82-02-01-02
KIBAALE,BUYAGA COUNTY,KAGADI,KENGA,KENGA P/SCHOOL,587,1,0,4,34,451,490,27,517,0,O-113-82-02-01-03
KIBAALE,BUYAGA COUNTY,KAGADI,KENGA,KANYANGOMA TRADING CENTRE,365,1,4,5,49,228,287,10,297,0,O-113-82-02-01-04
KIBAALE,BUYAGA COUNTY,KAGADI,KENGA,NSUGASUGI TRADING CENTRE,352,1,1,5,33,224,264,24,288,0,O-113-82-02-01-05
KIBAALE,BUYAGA COUNTY,KAGADI,KENGA,SESE P/SCHOOL [MU-Z],402,0,2,1,6,206,215,23,238,0,O-113-82-02-01-06
KIBAALE,BUYAGA COUNTY,KAGADI,KIYAHURA,KABWORO PR/SCHOOL,586,2,1,2,42,403,450,0,450,0,O-113-82-02-02-01
KIBAALE,BUYAGA COUNTY,KAGADI,KIYAHURA,KYOMUKAMA C.O.U A,435,1,1,1,32,293,328,8,336,0,O-113-82-02-02-02
KIBAALE,BUYAGA COUNTY,KAGADI,KIYAHURA,KYOMUKAMA C. O. U. B,351,1,0,1,26,254,282,1,283,0,O-113-82-02-02-03
KIBAALE,BUYAGA COUNTY,KAGADI,KIYAHURA,KYOMUNEMBE SDA,390,0,0,2,33,216,251,19,270,0,O-113-82-02-02-04
KIBAALE,BUYAGA COUNTY,KAGADI,KIYAHURA,BUKUNGWE PRIMARY SCHOOL,341,0,0,0,25,241,266,5,271,0,O-113-82-02-02-05
KIBAALE,BUYAGA COUNTY,KAGADI,RUBONA,NYAMIYAGA KASASA STATION,631,2,0,2,71,450,525,23,548,0,O-113-82-02-03-01
KIBAALE,BUYAGA COUNTY,KAGADI,RUBONA,SIYONI TRADING CENTRE,528,3,0,3,22,322,350,1,351,0,O-113-82-02-03-02
KIBAALE,BUYAGA COUNTY,KAGADI,RUBONA,RULEMBO CATHOLIC CHURCH,370,1,1,4,14,223,243,3,246,0,O-113-82-02-03-03
KIBAALE,BUYAGA COUNTY,KAGADI,RUBONA,RUBONA TRADING CENTRE,423,1,1,1,13,316,332,3,335,0,O-113-82-02-03-04
KIBAALE,BUYAGA COUNTY,KAGADI,RUTEETE,RUTEETE TRADING CENTRE B,599,2,0,3,94,307,406,22,428,0,O-113-82-02-04-01
KIBAALE,BUYAGA COUNTY,KAGADI,RUTEETE,NYAKASHEEMA TRADING CENTR,613,1,1,2,37,422,463,19,482,0,O-113-82-02-04-02
KIBAALE,BUYAGA COUNTY,KAGADI,RUTEETE,RUTEETE RESETTLEMENT SCHE,465,2,1,3,84,236,326,18,344,0,O-113-82-02-04-03
KIBAALE,BUYAGA COUNTY,KAGADI,RUTEETE,RUTEETE TRADING CENTRE A,482,2,1,7,85,229,324,19,343,0,O-113-82-02-04-04
KIBAALE,BUYAGA COUNTY,KAGADI,RUTEETE,NYABWEGYEREKA TRADING CEN,291,4,1,1,13,191,210,18,228,0,O-113-82-02-04-05
KIBAALE,BUYAGA COUNTY,KAGADI,RUTEETE,NYAKARONGO COU,212,3,1,2,13,128,147,16,163,0,O-113-82-02-04-06
KIBAALE,BUYAGA COUNTY,KAGADI TOWN COUNCIL,KAGADI CENTRAL,KAGADI MODEL P/SCHOOL B,259,1,0,0,39,186,226,5,231,0,O-113-82-03-01-01
KIBAALE,BUYAGA COUNTY,KAGADI TOWN COUNCIL,KAGADI CENTRAL,BISHOP RWAKAIKARA P/S,431,1,2,0,68,225,296,8,304,0,O-113-82-03-01-02
KIBAALE,BUYAGA COUNTY,KAGADI TOWN COUNCIL,KAGADI CENTRAL,KAGADI MODEL P/SCHOOL A,1427,0,1,2,177,476,656,16,672,0,O-113-82-03-01-03
KIBAALE,BUYAGA COUNTY,KAGADI TOWN COUNCIL,KAGADI CENTRAL,KAGADI TAXI PARK,275,0,1,1,58,206,266,5,271,0,O-113-82-03-01-04
KIBAALE,BUYAGA COUNTY,KAGADI TOWN COUNCIL,KAGADI CENTRAL,KAGADI OUTSIDE Q.GUARD,187,0,0,0,23,76,99,2,101,0,O-113-82-03-01-05
KIBAALE,BUYAGA COUNTY,KAGADI TOWN COUNCIL,KIBANGA,KYAKABUGAHYA T C,390,0,2,1,50,211,264,4,268,0,O-113-82-03-02-01
KIBAALE,BUYAGA COUNTY,KAGADI TOWN COUNCIL,KIBANGA,KYAMUKUNISA COU,675,5,6,1,55,455,522,11,533,0,O-113-82-03-02-02
KIBAALE,BUYAGA COUNTY,KAGADI TOWN COUNCIL,KITEGWA,KIRYANI P/SCHOOL A,721,2,2,2,85,475,566,15,581,0,O-113-82-03-03-01
KIBAALE,BUYAGA COUNTY,KAGADI TOWN COUNCIL,KITEGWA,KIRYANI P/SCHOOL B,133,0,0,0,17,83,100,7,107,0,O-113-82-03-03-02
KIBAALE,BUYAGA COUNTY,KAGADI TOWN COUNCIL,KITEGWA,NYARUZIBA CATHOLIC CHURCH,406,2,6,0,34,287,329,1,330,0,O-113-82-03-03-03
KIBAALE,BUYAGA COUNTY,KAGADI TOWN COUNCIL,MAMBUGU,MAMBUGU P/SCHOOL,677,2,4,1,53,419,479,16,495,0,O-113-82-03-04-01
KIBAALE,BUYAGA COUNTY,KIRYANGA,KABAMBA,KABAMBA P/SCHOOL,546,17,2,5,19,379,422,25,447,0,O-113-82-04-01-01
KIBAALE,BUYAGA COUNTY,KIRYANGA,KABAMBA,KIRYANJAGI P/SCHOOL N-Z,443,2,3,4,32,284,325,10,335,0,O-113-82-04-01-02
KIBAALE,BUYAGA COUNTY,KIRYANGA,KABAMBA,NYAKASOZI MARKET,742,0,3,15,11,509,538,50,588,0,O-113-82-04-01-03
KIBAALE,BUYAGA COUNTY,KIRYANGA,KABAMBA,KABAMBA RCM CHAPEL,462,3,1,8,12,318,342,43,385,0,O-113-82-04-01-04
KIBAALE,BUYAGA COUNTY,KIRYANGA,KABAMBA,KIRYANJAGI P/SCHOOL A-M,430,2,1,8,31,285,327,15,342,0,O-113-82-04-01-05
KIBAALE,BUYAGA COUNTY,KIRYANGA,KICUCURA,KIIJAGI MARKET PLACE,474,6,0,2,44,258,310,25,335,0,O-113-82-04-02-01
KIBAALE,BUYAGA COUNTY,KIRYANGA,KICUCURA,BUGWARA TRADING CENTRE N-Z,342,3,1,4,15,195,218,19,237,0,O-113-82-04-02-02
KIBAALE,BUYAGA COUNTY,KIRYANGA,KICUCURA,RUSEKERE P/SCHOOL,495,2,2,3,23,347,377,26,403,0,O-113-82-04-02-03
KIBAALE,BUYAGA COUNTY,KIRYANGA,KICUCURA,KYEMISANGO RCM CHAPEL,442,1,2,12,44,286,345,21,366,0,O-113-82-04-02-04
KIBAALE,BUYAGA COUNTY,KIRYANGA,KICUCURA,BUGWARA TRADING CENTRE A-M,347,0,1,2,22,211,236,17,253,0,O-113-82-04-02-05
KIBAALE,BUYAGA COUNTY,KIRYANGA,KIRYANGA,KIRYANGA SCTY HQRS A-K,541,2,0,2,35,317,356,12,368,0,O-113-82-04-03-01
KIBAALE,BUYAGA COUNTY,KIRYANGA,KIRYANGA,BUHARURA RCM CHAPLE,486,4,1,3,13,345,366,22,388,0,O-113-82-04-03-02
KIBAALE,BUYAGA COUNTY,KIRYANGA,KIRYANGA,KIRYANGA SCTY HQRS L-Z,442,3,2,10,19,261,295,14,309,0,O-113-82-04-03-03
KIBAALE,BUYAGA COUNTY,KIRYANGA,KIRYANGA,BUHARURA P/SCHOOL,357,3,0,0,9,241,253,18,271,0,O-113-82-04-03-04
KIBAALE,BUYAGA COUNTY,KIRYANGA,KYAKABANDA,NYAKABAALE MOSQUE,807,4,1,9,35,471,520,40,560,0,O-113-82-04-04-01
KIBAALE,BUYAGA COUNTY,KIRYANGA,KYAKABANDA,KYABASARA SUB DISPENSARY A,812,1,3,4,51,350,409,165,574,0,O-113-82-04-04-02
KIBAALE,BUYAGA COUNTY,KIRYANGA,KYAKABANDA,KYABASARA SUB DISPENSARY B,767,5,2,10,14,476,507,39,546,0,O-113-82-04-04-03
KIBAALE,BUYAGA COUNTY,KIRYANGA,PACHWA,KAHUNIRO P/SCHOOL L-Z,433,1,1,8,25,291,326,15,341,0,O-113-82-04-05-01
KIBAALE,BUYAGA COUNTY,KIRYANGA,PACHWA,PACHWA P/SCHOOL A,524,4,1,3,20,353,381,8,389,0,O-113-82-04-05-02
KIBAALE,BUYAGA COUNTY,KIRYANGA,PACHWA,PACHWA P/SCHOOL B,521,3,3,4,22,346,378,13,391,0,O-113-82-04-05-03
KIBAALE,BUYAGA COUNTY,KIRYANGA,PACHWA,KAHUNIRO P/SCHOOL A-K,378,0,1,3,22,276,302,10,312,0,O-113-82-04-05-04
KIBAALE,BUYAGA COUNTY,KYANAISOKE,KAHUNDE,KIJONJOMI PRI. SCHOOL,484,0,1,1,34,333,369,10,379,0,O-113-82-05-01-01
KIBAALE,BUYAGA COUNTY,KYANAISOKE,KAHUNDE,ISUNGA DISPENSARY A,414,1,0,0,49,176,226,6,232,0,O-113-82-05-01-02
KIBAALE,BUYAGA COUNTY,KYANAISOKE,KAHUNDE,ISUNGA DISPENSARY B,452,0,0,1,62,294,357,12,369,0,O-113-82-05-01-03
KIBAALE,BUYAGA COUNTY,KYANAISOKE,KAHUNDE,KAHUNDE PRI.SCHOOL,605,1,0,2,44,371,418,24,442,0,O-113-82-05-01-04
KIBAALE,BUYAGA COUNTY,KYANAISOKE,KAHUNDE,NGARA PRI.SCHOOL,306,0,0,2,19,213,234,7,241,0,O-113-82-05-01-05
KIBAALE,BUYAGA COUNTY,KYANAISOKE,KAMUROZA,KYARWAKYA T/C,666,2,5,1,14,468,490,6,496,0,O-113-82-05-02-01
KIBAALE,BUYAGA COUNTY,KYANAISOKE,KAMUROZA,KIHEMBA P/SCHOOL A,632,1,1,4,29,495,530,11,541,0,O-113-82-05-02-02
KIBAALE,BUYAGA COUNTY,KYANAISOKE,KAMUROZA,KIHEMBA P/SCHOOL B,391,1,1,0,26,257,285,7,292,0,O-113-82-05-02-03
KIBAALE,BUYAGA COUNTY,KYANAISOKE,KITEMA,MUGALIKE PARISH,663,3,2,5,80,397,487,18,505,0,O-113-82-05-03-01
KIBAALE,BUYAGA COUNTY,KYANAISOKE,KITEMA,KITEMA KITAHURUZO,705,0,5,3,41,450,499,11,510,0,O-113-82-05-03-02
KIBAALE,BUYAGA COUNTY,KYANAISOKE,MPAMBA,MPAMBA TRADING CENTRE,531,0,2,2,44,331,379,18,397,0,O-113-82-05-04-01
KIBAALE,BUYAGA COUNTY,KYANAISOKE,MPAMBA,KANYERAGAMIRE T/CENTRE [L-Z],480,1,2,2,27,323,355,6,361,0,O-113-82-05-04-02
KIBAALE,BUYAGA COUNTY,KYANAISOKE,MPAMBA,KIBWERA TRADING CENTRE,304,1,1,0,19,238,259,6,265,0,O-113-82-05-04-03
KIBAALE,BUYAGA COUNTY,KYANAISOKE,MPAMBA,KANYERAGAMIRE T/CENTRE [A-K],336,2,0,1,25,229,257,19,276,0,O-113-82-05-04-04
KIBAALE,BUYAGA COUNTY,KYANAISOKE,NYABUHIKE,NYABUHIKE HQRS A,372,0,3,1,16,298,318,9,327,0,O-113-82-05-05-01
KIBAALE,BUYAGA COUNTY,KYANAISOKE,NYABUHIKE,NYABUHIKE HQRS B,231,1,6,1,21,160,189,7,196,0,O-113-82-05-05-02
KIBAALE,BUYAGA COUNTY,KYANAISOKE,NYABUHIKE,KASOKERO P/SCHOOL,412,1,1,0,33,358,393,17,410,0,O-113-82-05-05-03
KIBAALE,BUYAGA COUNTY,KYANAISOKE,NYABUHIKE,KYENZIGE FOOTBALL GROUND[A-,529,0,5,3,73,296,377,0,377,0,O-113-82-05-05-04
KIBAALE,BUYAGA COUNTY,KYANAISOKE,NYABUHIKE,NAIGANA SEC SCHOOL,616,2,1,5,64,437,509,26,535,0,O-113-82-05-05-05
KIBAALE,BUYAGA COUNTY,KYANAISOKE,NYABUHIKE,KIGOYE TRADING CENTRE,451,1,5,0,51,293,350,15,365,0,O-113-82-05-05-06
KIBAALE,BUYAGA COUNTY,KYANAISOKE,NYABUHIKE,KYENZIGE FOOTBALL GROUND [K,338,1,5,1,41,245,293,9,302,0,O-113-82-05-05-07
KIBAALE,BUYAGA COUNTY,MABAALE,KIHURA,NYABUTANZI P/SCHOOL A,599,2,1,2,33,315,353,24,377,0,O-113-82-06-01-01
KIBAALE,BUYAGA COUNTY,MABAALE,KIHURA,NYABUTANZI P/SCHOOL B,527,3,2,0,44,272,321,10,331,0,O-113-82-06-01-02
KIBAALE,BUYAGA COUNTY,MABAALE,KIHURA,KYAKAHUUKU T/CENTRE,416,1,0,0,18,285,304,7,311,0,O-113-82-06-01-03
KIBAALE,BUYAGA COUNTY,MABAALE,KIHURA,KIHURA T/CENTRE A,494,3,1,0,51,285,340,14,354,0,O-113-82-06-01-04
KIBAALE,BUYAGA COUNTY,MABAALE,KIHURA,KIHURA T/CENTRE B,530,1,1,5,34,314,355,10,365,0,O-113-82-06-01-05
KIBAALE,BUYAGA COUNTY,MABAALE,KIHURA,KYAKAHUUKU PRIMARY SCHOOL,312,1,0,1,37,184,223,7,230,0,O-113-82-06-01-06
KIBAALE,BUYAGA COUNTY,MABAALE,KIRANZI,MABAALE GOMBOLOLA HQRS A,481,0,2,0,41,300,343,6,349,0,O-113-82-06-02-01
KIBAALE,BUYAGA COUNTY,MABAALE,KIRANZI,MABAALE GOMBOLOLA HQRS B,660,2,1,0,58,376,437,17,454,0,O-113-82-06-02-02
KIBAALE,BUYAGA COUNTY,MABAALE,KIRANZI,MABALE PRIMARY SCHOOL,624,1,0,1,19,395,416,10,426,0,O-113-82-06-02-03
KIBAALE,BUYAGA COUNTY,MABAALE,KIRANZI,KINYARUGONJO CATHOLIC CHUR,516,4,1,5,25,319,354,24,378,0,O-113-82-06-02-04
KIBAALE,BUYAGA COUNTY,MABAALE,KIRANZI,KYADYOKO P/SCHOOL,596,0,4,8,21,414,447,10,457,0,O-113-82-06-02-05
KIBAALE,BUYAGA COUNTY,MABAALE,KIRANZI,MUTUNGURU TRADING CENTRE,616,0,1,4,30,377,412,20,432,0,O-113-82-06-02-06
KIBAALE,BUYAGA COUNTY,MABAALE,KITEMUZI,KITEMUZI TRADING CENTRE A,451,0,2,4,15,336,357,7,364,0,O-113-82-06-03-01
KIBAALE,BUYAGA COUNTY,MABAALE,KITEMUZI,KITEMUZI TRADING CENTRE B,516,1,0,4,25,405,435,6,441,0,O-113-82-06-03-02
KIBAALE,BUYAGA COUNTY,MABAALE,KITEMUZI,KAITEMBA TRADING CENTRE,611,1,2,4,30,434,471,23,494,0,O-113-82-06-03-03
KIBAALE,BUYAGA COUNTY,MPEEFU,KYATEREKERA,BUSWAKA SAUTI YARAHA,641,2,3,4,78,329,416,4,420,0,O-113-82-07-01-01
KIBAALE,BUYAGA COUNTY,MPEEFU,KYATEREKERA,KYATEREKERA FOREST RESEVE,714,4,1,4,29,387,425,32,457,0,O-113-82-07-01-02
KIBAALE,BUYAGA COUNTY,MPEEFU,KYATEREKERA,LUBIRI T. C,310,0,0,0,16,140,156,21,177,0,O-113-82-07-01-03
KIBAALE,BUYAGA COUNTY,MPEEFU,KYATEREKERA,KYATEREKERA MARKET PLACE,882,5,1,4,52,409,471,18,489,0,O-113-82-07-01-04
KIBAALE,BUYAGA COUNTY,MPEEFU,KYATEREKERA,KATERERA TRADING CENTRE,674,2,3,6,69,308,388,22,410,0,O-113-82-07-01-05
KIBAALE,BUYAGA COUNTY,MPEEFU,KYATEREKERA,MUZIIZI PRIMARY SCHOOL,234,4,1,8,17,103,133,0,133,0,O-113-82-07-01-06
KIBAALE,BUYAGA COUNTY,MPEEFU,KYATEREKERA,RUSOROZA C.O.U,159,1,0,0,11,78,90,2,92,0,O-113-82-07-01-07
KIBAALE,BUYAGA COUNTY,MPEEFU,MUGYENZA,BURAZA P/SCHOOL,227,0,0,2,21,110,133,8,141,0,O-113-82-07-02-01
KIBAALE,BUYAGA COUNTY,MPEEFU,MUGYENZA,MUGYENZA PRIMARY SCHOOL,635,7,3,4,47,372,433,14,447,0,O-113-82-07-02-02
KIBAALE,BUYAGA COUNTY,MPEEFU,MUGYENZA,KURUKURU PRIMARY SCHOOL,617,1,0,4,69,338,412,31,443,0,O-113-82-07-02-03
KIBAALE,BUYAGA COUNTY,MPEEFU,MUGYENZA,MUGYENZA CATHOLIC CHURCH,568,5,0,2,33,380,420,57,477,0,O-113-82-07-02-04
KIBAALE,BUYAGA COUNTY,MPEEFU,NDAIGA,KITEBERE LANDING SITE,581,0,1,0,72,212,285,14,299,0,O-113-82-07-03-01
KIBAALE,BUYAGA COUNTY,MPEEFU,NDAIGA,RWEBIGONGORO LANDING SITE,561,4,0,2,39,138,183,25,208,0,O-113-82-07-03-02
KIBAALE,BUYAGA COUNTY,MPEEFU,NDAIGA,SONGARAWO LANDING SITE,223,1,0,0,22,74,97,13,110,0,O-113-82-07-03-03
KIBAALE,BUYAGA COUNTY,MPEEFU,NDAIGA,KABUKANGA PRI SCHOOL,416,9,0,1,25,125,160,23,183,0,O-113-82-07-03-04
KIBAALE,BUYAGA COUNTY,MPEEFU,NYAMUKARA,MPEEFU TRADING CENTRE (A-L),542,1,0,0,45,234,280,12,292,0,O-113-82-07-04-01
KIBAALE,BUYAGA COUNTY,MPEEFU,NYAMUKARA,MPEEFU PRIMARY SCHOOL,667,0,4,2,40,346,392,18,410,0,O-113-82-07-04-02
KIBAALE,BUYAGA COUNTY,MPEEFU,NYAMUKARA,MPEEFU TRADING CENTRE (M-Z),552,3,0,1,36,247,287,17,304,0,O-113-82-07-04-03
KIBAALE,BUYAGA COUNTY,MPEEFU,NYAMUKARA,MPOKYA TRADING CENTRE [A-L],310,1,0,2,18,169,190,10,200,0,O-113-82-07-04-04
KIBAALE,BUYAGA COUNTY,MPEEFU,NYAMUKARA,NYAMUKARA TRADING CENTRE,398,1,0,2,23,259,285,14,299,0,O-113-82-07-04-05
KIBAALE,BUYAGA COUNTY,MPEEFU,NYAMUKARA,MPOKYA TRADING CENTRE [M-Z],383,2,0,2,20,228,252,8,260,0,O-113-82-07-04-06
KIBAALE,BUYAGA COUNTY,MPEEFU,NYANTONZI,NYANTONZI P/SCHOOL,886,9,5,13,57,560,644,69,713,0,O-113-82-07-05-01
KIBAALE,BUYAGA COUNTY,MPEEFU,NYANTONZI,KANYANSI TRADING CENTRE,522,9,1,7,20,321,358,17,375,0,O-113-82-07-05-02
KIBAALE,BUYAGA COUNTY,MPEEFU,NYANTONZI,WANGEYO PRIMARY SCHOOL,588,1,1,9,19,412,442,20,462,0,O-113-82-07-05-03
KIBAALE,BUYAGA COUNTY,MPEEFU,NYANTONZI,WANGEYO TRADING CENTRE,476,0,0,6,21,278,305,18,323,0,O-113-82-07-05-04
KIBAALE,BUYAGA COUNTY,MPEEFU,NYANTONZI,KYOMUKAMA PARENTS SCHOOL,326,2,0,2,10,203,217,17,234,0,O-113-82-07-05-05
KIBAALE,BUYAGA COUNTY,MPEEFU,RUBIRIZI,WAIHEMBE PRIMARY SCHOOL,682,3,1,3,44,397,448,4,452,0,O-113-82-07-06-01
KIBAALE,BUYAGA COUNTY,MPEEFU,RUBIRIZI,KIJURU TRADING CENTRE,416,0,0,2,9,216,227,13,240,0,O-113-82-07-06-02
KIBAALE,BUYAGA COUNTY,MPEEFU,RUBIRIZI,RUBIRIZI PRIMARY SCHOOL [M-Z],500,1,0,2,29,283,315,7,322,0,O-113-82-07-06-03
KIBAALE,BUYAGA COUNTY,MPEEFU,RUBIRIZI,NYAKATOJO PRI/SCHOOL [M-Z],552,4,0,1,26,330,361,32,393,0,O-113-82-07-06-04
KIBAALE,BUYAGA COUNTY,MPEEFU,RUBIRIZI,RUBIRIZI TRADING CENTRE [A-L],304,0,0,1,18,210,229,6,235,0,O-113-82-07-06-05
KIBAALE,BUYAGA COUNTY,MPEEFU,RUBIRIZI,NYAKATOJO PR/ SCHOOL [A-L],489,1,2,3,22,268,296,38,334,0,O-113-82-07-06-06
KIBAALE,BUYAGA COUNTY,MPEEFU,RWABARANGA,RWABARANGA PRI SCHOOL [A-KY,548,1,0,4,29,254,288,28,316,0,O-113-82-07-07-01
KIBAALE,BUYAGA COUNTY,MPEEFU,RWABARANGA,KASAANA TRADING CENTRE,531,2,0,1,18,194,215,10,225,0,O-113-82-07-07-02
KIBAALE,BUYAGA COUNTY,MPEEFU,RWABARANGA,MPEEFU SEED SEC SCHOOL,743,4,1,3,19,403,430,17,447,0,O-113-82-07-07-03
KIBAALE,BUYAGA COUNTY,MPEEFU,RWABARANGA,SIYONI TRADING (A-L),510,0,1,2,17,291,311,6,317,0,O-113-82-07-07-04
KIBAALE,BUYAGA COUNTY,MPEEFU,RWABARANGA,KASOJO TRADING CENTRE (A-M),512,3,0,2,26,332,363,15,378,0,O-113-82-07-07-05
KIBAALE,BUYAGA COUNTY,MPEEFU,RWABARANGA,KASOJO TRADING CENTRE (N-Z),451,2,0,2,16,282,302,15,317,0,O-113-82-07-07-06
KIBAALE,BUYAGA COUNTY,MPEEFU,RWABARANGA,SIYONI TRADING (M-Z),379,1,1,3,30,252,287,5,292,0,O-113-82-07-07-07
KIBAALE,BUYAGA COUNTY,MPEEFU,RWABARANGA,RWABARANGA PRI SCHOOL [MA-Z,431,1,0,1,42,228,272,9,281,0,O-113-82-07-07-08
KIBAALE,BUYAGA COUNTY,MUHORRO,GALIBOLEKA,NYANKOMA P/SCHOOL A,529,1,1,1,25,327,355,9,364,0,O-113-82-08-01-01
KIBAALE,BUYAGA COUNTY,MUHORRO,GALIBOLEKA,NYANKOMA P/SCHOOL BA,295,0,0,3,10,181,194,22,216,0,O-113-82-08-01-02
KIBAALE,BUYAGA COUNTY,MUHORRO,GALIBOLEKA,KAJUMA P/SCHOOL A,653,2,0,1,52,390,445,17,462,0,O-113-82-08-01-03
KIBAALE,BUYAGA COUNTY,MUHORRO,GALIBOLEKA,KAJUMA PR/SCHOOL B,436,2,0,7,18,337,364,6,370,0,O-113-82-08-01-04
KIBAALE,BUYAGA COUNTY,MUHORRO,GALIBOLEKA,NYAKASOZI T/C A,860,5,1,7,64,566,643,18,661,0,O-113-82-08-01-05
KIBAALE,BUYAGA COUNTY,MUHORRO,GALIBOLEKA,NYAKASOZI T/C B,781,8,2,1,41,501,553,30,583,0,O-113-82-08-01-06
KIBAALE,BUYAGA COUNTY,MUHORRO,NYAMACHUMU,NYAMACUMU CENTRE,602,0,0,2,40,408,450,8,458,0,O-113-82-08-02-01
KIBAALE,BUYAGA COUNTY,MUHORRO,NYAMACHUMU,KABUGA P/SCHOOL,693,2,0,3,51,396,452,10,462,0,O-113-82-08-02-02
KIBAALE,BUYAGA COUNTY,MUHORRO,NYAMACHUMU,KASOGA CENTRE,727,4,1,5,67,457,534,9,543,0,O-113-82-08-02-03
KIBAALE,BUYAGA COUNTY,MUHORRO,NYAMACHUMU,KAGOROGORO KYESAMIRE A,767,2,2,3,57,501,565,22,587,0,O-113-82-08-02-04
KIBAALE,BUYAGA COUNTY,MUHORRO,NYAMACHUMU,KYANKOROGOTO CENTRE,269,1,0,3,18,204,226,2,228,0,O-113-82-08-02-05
KIBAALE,BUYAGA COUNTY,MUHORRO,NYAMITI,NYANZIGE RC MEETING PLACE,672,0,1,3,30,471,505,8,513,0,O-113-82-08-03-01
KIBAALE,BUYAGA COUNTY,MUHORRO,NYAMITI,MUHORO MUSLIM P/SCHOOL A,932,0,0,1,81,444,526,19,545,0,O-113-82-08-03-02
KIBAALE,BUYAGA COUNTY,MUHORRO,NYAMITI,MUHORO MUSLIM P/SCHOOL B,632,2,1,1,48,321,373,9,382,0,O-113-82-08-03-03
KIBAALE,BUYAGA COUNTY,MUHORRO,NYAMITI,NYAMITI MEETING PLACE A,436,1,0,1,47,271,320,18,338,0,O-113-82-08-03-04
KIBAALE,BUYAGA COUNTY,MUHORRO,NYAMITI,NYAMITI MEETING PLACE B,469,0,1,0,26,296,323,13,336,0,O-113-82-08-03-05
KIBAALE,BUYAGA COUNTY,MUHORRO,NYAMITI,KIBANGA P/SCHOOL,544,1,1,1,41,337,381,19,400,0,O-113-82-08-03-06
KIBAALE,BUYAGA COUNTY,MUHORRO,NYAMITI,MUHORRO S/C HQTRS,438,0,0,2,30,277,309,3,312,0,O-113-82-08-03-07
KIBAALE,BUYAGA COUNTY,MUHORRO,NYAMITI,RUSWIGA P/SCHOOL,262,1,0,0,12,188,201,4,205,0,O-113-82-08-03-08
KIBAALE,BUYAGA COUNTY,MUHORRO,NYANSEKE,NYANSEKE BAT STORES [A-KI],468,0,1,2,31,277,311,11,322,0,O-113-82-08-04-01
KIBAALE,BUYAGA COUNTY,MUHORRO,NYANSEKE,ST ADOLF SSS,848,2,1,1,62,423,489,2,491,0,O-113-82-08-04-02
KIBAALE,BUYAGA COUNTY,MUHORRO,NYANSEKE,BUSOIGI KITAHULUZO,369,0,4,0,18,273,295,5,300,0,O-113-82-08-04-03
KIBAALE,BUYAGA COUNTY,MUHORRO,NYANSEKE,NYANSEKE CATHOLIC CHURCH,356,0,0,0,20,253,273,14,287,0,O-113-82-08-04-04
KIBAALE,BUYAGA COUNTY,MUHORRO,NYANSEKE,BUTUMBA PRIMARY SCHOOL,275,0,1,2,18,222,243,4,247,0,O-113-82-08-04-05
KIBAALE,BUYAGA COUNTY,MUHORRO,NYANSEKE,NYANSEKE BAT STORES [KO-Z],377,0,2,2,26,215,245,8,253,0,O-113-82-08-04-06
KIBAALE,BUYAGA COUNTY,RUGASHARI,BURORA,NYABUGANDO TRADING CENTRE,477,2,2,3,53,249,309,12,321,0,O-113-82-09-01-01
KIBAALE,BUYAGA COUNTY,RUGASHARI,BURORA,KYABASAZIMA T. C.,405,1,2,4,22,287,316,15,331,0,O-113-82-09-01-02
KIBAALE,BUYAGA COUNTY,RUGASHARI,BURORA,BURORA TRADING CENTRE,612,4,5,8,92,236,345,21,366,0,O-113-82-09-01-03
KIBAALE,BUYAGA COUNTY,RUGASHARI,BURORA,KIHUMURO PRIMARY SCHOOL,500,3,1,5,23,376,408,9,417,0,O-113-82-09-01-04
KIBAALE,BUYAGA COUNTY,RUGASHARI,KYAKABADIIMA,KYAKABADIIMA TRADING CENTRE,356,1,1,2,10,230,244,2,246,0,O-113-82-09-02-01
KIBAALE,BUYAGA COUNTY,RUGASHARI,KYAKABADIIMA,KAMUYANGE TRADING CENTRE,696,3,1,2,40,453,499,13,512,0,O-113-82-09-02-02
KIBAALE,BUYAGA COUNTY,RUGASHARI,KYAKABADIIMA,HAMUGYI TRADING CENTRE,497,0,0,2,22,344,368,6,374,0,O-113-82-09-02-03
KIBAALE,BUYAGA COUNTY,RUGASHARI,KYAKABADIIMA,KANYABEBE TRADING CENTRE,552,4,1,4,32,427,468,13,481,0,O-113-82-09-02-04
KIBAALE,BUYAGA COUNTY,RUGASHARI,KYAKABADIIMA,KAMUYANGE R C CHURCH,272,2,1,3,25,226,257,11,268,0,O-113-82-09-02-05
KIBAALE,BUYAGA COUNTY,RUGASHARI,KYAKABADIIMA,KAVULE TRADING CENTRE,273,3,1,3,18,200,225,3,228,0,O-113-82-09-02-06
KIBAALE,BUYAGA COUNTY,RUGASHARI,KYAKABADIIMA,KASHAGAARI TRADING CENTRE,249,0,0,1,21,169,191,12,203,0,O-113-82-09-02-07
KIBAALE,BUYAGA COUNTY,RUGASHARI,KYAKABADIIMA,KANYABEBE MOSQUE,279,1,1,0,18,213,233,7,240,0,O-113-82-09-02-08
KIBAALE,BUYAGA COUNTY,RUGASHARI,KYAKABADIIMA,KYAKABADIIMA T/CENTRE [A-M],318,0,0,3,17,229,249,2,251,0,O-113-82-09-02-09
KIBAALE,BUYAGA COUNTY,RUGASHARI,NYAMUKAIKURU,BURORA T. C. A,305,1,0,1,26,129,157,0,157,0,O-113-82-09-03-01
KIBAALE,BUYAGA COUNTY,RUGASHARI,NYAMUKAIKURU,NYAMUKAIKURU ROCKS,646,3,0,7,28,436,474,21,495,0,O-113-82-09-03-02
KIBAALE,BUYAGA COUNTY,RUGASHARI,NYAMUKAIKURU,MUKABYAZA JUNCTION,602,1,0,1,43,390,435,11,446,0,O-113-82-09-03-03
KIBAALE,BUYAGA COUNTY,RUGASHARI,NYAMUKAIKURU,NYAMIGISA TRADING CENTRE,358,0,0,3,27,226,256,0,256,0,O-113-82-09-03-04
KIBAALE,BUYAGA COUNTY,RUGASHARI,RUGASHARI,RUGASHARI TRADING CENTRE A,713,3,0,4,27,424,458,23,481,0,O-113-82-09-04-01
KIBAALE,BUYAGA COUNTY,RUGASHARI,RUGASHARI,RUGASHARI TRADING CENTRE B,633,1,0,2,32,300,335,15,350,0,O-113-82-09-04-02
KIBAALE,BUYAGA COUNTY,RUGASHARI,RUGASHARI,GARIRAYA CENTRE (A-M),565,1,1,2,39,310,353,6,359,0,O-113-82-09-04-03
KIBAALE,BUYAGA COUNTY,RUGASHARI,RUGASHARI,KIBUGA MARKET,498,1,1,4,43,340,389,8,397,0,O-113-82-09-04-04
KIBAALE,BUYAGA COUNTY,RUGASHARI,RUGASHARI,IRUHURA CENTRE,588,2,1,6,47,373,429,20,449,0,O-113-82-09-04-05
KIBAALE,BUYAGA COUNTY,RUGASHARI,RUGASHARI,GARIRAYA CENTRE (N-Z),650,3,0,3,37,335,378,18,396,0,O-113-82-09-04-06
KIBAALE,BUYAGA COUNTY,RUGASHARI,RUGASHARI,RUGASHARI COMMUNITY CENTRE,260,0,1,2,10,174,187,6,193,0,O-113-82-09-04-07
KIBAALE,BUYAGA COUNTY,RUGASHARI,RUGASHARI,KANYAMUNYU TRADING CENTRE,475,4,1,0,18,333,356,15,371,0,O-113-82-09-04-08
KIBAALE,BUYAGA COUNTY,RUGASHARI,RUGASHARI,KASOZI TRADING CENTRE,247,1,1,5,11,154,172,6,178,0,O-113-82-09-04-09
KIBAALE,BUYAGA COUNTY,RUGASHARI,RUGASHARI,KYABITUNDU TRADING CENTRE,338,2,1,1,11,201,216,16,232,0,O-113-82-09-04-10
KIBAALE,BUYAGA COUNTY,RUGASHARI,RUGASHARI,BUHUMURIRO TRADING CENTRE,321,1,0,2,28,187,218,3,221,0,O-113-82-09-04-11
KIBAALE,BUGANGAIZI COUNTY,BWANSWA,GAYAZA,KANYAWAWA P/SCHOOL,568,3,3,1,27,414,448,7,455,0,O-114-81-01-01-01
KIBAALE,BUGANGAIZI COUNTY,BWANSWA,GAYAZA,KYAKAJANJA STORE,419,0,0,2,19,312,333,8,341,0,O-114-81-01-01-02
KIBAALE,BUGANGAIZI COUNTY,BWANSWA,KASINGO,BUGANGAIZI SAZA HQRS,705,0,2,0,70,385,457,4,461,0,O-114-81-01-02-01
KIBAALE,BUGANGAIZI COUNTY,BWANSWA,KASINGO,KASINGO TRADING CENTRE,543,2,1,3,36,388,430,8,438,0,O-114-81-01-02-02
KIBAALE,BUGANGAIZI COUNTY,BWANSWA,KASINGO,ST KIZITO PRI. SCHOOL,460,0,2,1,36,273,312,3,315,0,O-114-81-01-02-03
KIBAALE,BUGANGAIZI COUNTY,BWANSWA,KIHUMURO,KIHUMURO 1,279,0,0,0,11,184,195,1,196,0,O-114-81-01-03-01
KIBAALE,BUGANGAIZI COUNTY,BWANSWA,KIHUMURO,KASALABA CENTRE,438,1,2,1,19,284,307,8,315,0,O-114-81-01-03-02
KIBAALE,BUGANGAIZI COUNTY,BWANSWA,KIHUMURO,KIBAMBURA CENTRE,551,0,0,1,21,359,381,9,390,0,O-114-81-01-03-03
KIBAALE,BUGANGAIZI COUNTY,BWANSWA,KIHURUMBA,KARASA CENTER,609,1,1,3,23,405,433,0,433,0,O-114-81-01-04-01
KIBAALE,BUGANGAIZI COUNTY,BWANSWA,KIHURUMBA,SINZIRI T.C,251,0,0,2,16,165,183,3,186,0,O-114-81-01-04-02
KIBAALE,BUGANGAIZI COUNTY,BWANSWA,KIHURUMBA,KIHURUMBA,474,2,1,1,7,339,350,9,359,0,O-114-81-01-04-03
KIBAALE,BUGANGAIZI COUNTY,BWANSWA,LUBAYA,KYABASAIJA P/SCHOOL,588,1,2,0,22,452,477,7,484,0,O-114-81-01-05-01
KIBAALE,BUGANGAIZI COUNTY,BWANSWA,LUBAYA,KITANDA P/SCHOOL,763,1,1,4,34,525,565,12,577,0,O-114-81-01-05-02
KIBAALE,BUGANGAIZI COUNTY,BWANSWA,NKONDO,BUKUUMI BOYS P/SCHOOL,738,4,2,4,52,421,483,10,493,0,O-114-81-01-06-01
KIBAALE,BUGANGAIZI COUNTY,BWANSWA,NKONDO,KIKYAMUZI CHAPLE,329,1,0,0,9,290,300,1,301,0,O-114-81-01-06-02
KIBAALE,BUGANGAIZI COUNTY,BWANSWA,NKONDO,NKONDO T/C,354,1,1,3,18,253,276,8,284,0,O-114-81-01-06-03
KIBAALE,BUGANGAIZI COUNTY,KAKINDO,IGAYAZA,BURAMAGI T/C,298,2,2,3,15,199,221,6,227,0,O-114-81-02-01-01
KIBAALE,BUGANGAIZI COUNTY,KAKINDO,IGAYAZA,IGAYAZA MARKET (A-I),527,1,0,1,34,301,337,17,354,0,O-114-81-02-01-02
KIBAALE,BUGANGAIZI COUNTY,KAKINDO,IGAYAZA,KISIIJA PR SCHOOL,709,2,3,2,35,519,561,17,578,0,O-114-81-02-01-03
KIBAALE,BUGANGAIZI COUNTY,KAKINDO,IGAYAZA,IGAYAZA MARKET (J-M),599,3,2,4,38,350,397,17,414,0,O-114-81-02-01-04
KIBAALE,BUGANGAIZI COUNTY,KAKINDO,IGAYAZA,IGAYAZA CATHOLIC CHURCH,295,1,1,1,14,206,223,4,227,0,O-114-81-02-01-05
KIBAALE,BUGANGAIZI COUNTY,KAKINDO,IGAYAZA,IGAYAZA MARKET (N-Z),570,0,0,0,29,383,412,0,412,0,O-114-81-02-01-06
KIBAALE,BUGANGAIZI COUNTY,KAKINDO,KATATEMWA,KAKINDO SUB CTY HQRS,400,6,1,2,16,275,300,10,310,0,O-114-81-02-02-01
KIBAALE,BUGANGAIZI COUNTY,KAKINDO,KATATEMWA,KIHUUNA T/C,682,1,6,4,48,417,476,27,503,0,O-114-81-02-02-02
KIBAALE,BUGANGAIZI COUNTY,KAKINDO,KATATEMWA,KIRIISA P/SCHOOL,642,3,0,10,19,457,489,10,499,0,O-114-81-02-02-03
KIBAALE,BUGANGAIZI COUNTY,KAKINDO,KIKWAYA,KIKWAYA P/SCHOOL(A-L),451,1,0,2,36,288,327,10,337,0,O-114-81-02-03-01
KIBAALE,BUGANGAIZI COUNTY,KAKINDO,KIKWAYA,KAMULI COOP SOCIETY STORE,294,2,1,1,6,241,251,14,265,0,O-114-81-02-03-02
KIBAALE,BUGANGAIZI COUNTY,KAKINDO,KIKWAYA,KYAKABANGALI CENTRE,207,3,0,1,8,180,192,3,195,0,O-114-81-02-03-03
KIBAALE,BUGANGAIZI COUNTY,KAKINDO,KIKWAYA,KAMULI PRIMARY SCHOOL,206,0,0,0,8,160,168,7,175,0,O-114-81-02-03-04
KIBAALE,BUGANGAIZI COUNTY,KAKINDO,KIKWAYA,KIKWAYA P/SCHOOL(M-Z),398,1,2,2,7,233,245,0,245,0,O-114-81-02-03-05
KIBAALE,BUGANGAIZI COUNTY,KAKINDO,RUKUNYU,KAKINDO PRIMARY SCHOOL,787,3,1,2,32,541,579,8,587,0,O-114-81-02-04-01
KIBAALE,BUGANGAIZI COUNTY,KAKINDO,RUKUNYU,KISAIGI PR. SCH.,727,2,2,7,16,564,591,16,607,0,O-114-81-02-04-02
KIBAALE,BUGANGAIZI COUNTY,KAKINDO,RWEMBUBA,KIJANGI PR SCHOOL,439,6,0,6,19,321,352,10,362,0,O-114-81-02-05-01
KIBAALE,BUGANGAIZI COUNTY,KAKINDO,RWEMBUBA,RWEMBUBA P/S SCHOOL,723,1,2,2,22,459,486,31,517,0,O-114-81-02-05-02
KIBAALE,BUGANGAIZI COUNTY,KAKINDO,RWEMBUBA,RUSOLERA PRIMARY SCHOOL,377,4,2,4,22,233,265,11,276,0,O-114-81-02-05-03
KIBAALE,BUGANGAIZI COUNTY,KASAMBYA,KAKAYO,KASAMBYA SUB COUNTY HQRS,724,3,0,3,32,513,551,17,568,0,O-114-81-03-01-01
KIBAALE,BUGANGAIZI COUNTY,KASAMBYA,KAKAYO,KYAKALEGULA P/S SCHOOL,585,3,5,1,28,442,479,17,496,0,O-114-81-03-01-02
KIBAALE,BUGANGAIZI COUNTY,KASAMBYA,KAKAYO,KIGANDO PRIMARY SCHOOL,602,0,2,1,10,463,476,10,486,0,O-114-81-03-01-03
KIBAALE,BUGANGAIZI COUNTY,KASAMBYA,KIKAADA,KAKIBENGEYA/KIKAADA CENTRE,451,0,1,3,21,347,372,8,380,0,O-114-81-03-02-01
KIBAALE,BUGANGAIZI COUNTY,KASAMBYA,KIKAADA,KIGOMBA P/SCHOOL,508,0,3,5,8,391,407,8,415,0,O-114-81-03-02-02
KIBAALE,BUGANGAIZI COUNTY,KASAMBYA,KIKAADA,SEMUTO PRIMARY SCHOOL,246,0,1,1,13,196,211,1,212,0,O-114-81-03-02-03
KIBAALE,BUGANGAIZI COUNTY,KASAMBYA,KYAKARONGO,KIBOIJANA TRADING CENTRE B,463,1,3,3,15,335,357,19,376,0,O-114-81-03-03-01
KIBAALE,BUGANGAIZI COUNTY,KASAMBYA,KYAKARONGO,KIBOIJANA TRADING CENTRE A,560,0,1,1,10,402,414,6,420,0,O-114-81-03-03-02
KIBAALE,BUGANGAIZI COUNTY,KASAMBYA,KYEBANDO,KISENGWE MEETING PLACE,763,3,1,4,31,549,588,20,608,0,O-114-81-03-04-01
KIBAALE,BUGANGAIZI COUNTY,KASAMBYA,KYEBANDO,KYEBANDO TRADING CENTRE,530,4,1,2,17,397,421,3,424,0,O-114-81-03-04-02
KIBAALE,BUGANGAIZI COUNTY,KASAMBYA,KYEBANDO,KAHUNGERA CHURCH,230,0,0,0,7,191,198,11,209,0,O-114-81-03-04-03
KIBAALE,BUGANGAIZI COUNTY,KASAMBYA,RWAMALENGE,MITEMBO TRADING CENTRE,586,3,1,2,26,418,450,6,456,0,O-114-81-03-05-01
KIBAALE,BUGANGAIZI COUNTY,KASAMBYA,RWAMALENGE,KIWEZA STORE,267,1,1,2,4,210,218,5,223,0,O-114-81-03-05-02
KIBAALE,BUGANGAIZI COUNTY,KASAMBYA,RWAMALENGE,NYANSIMBI CHURCH,621,4,1,10,32,451,498,17,515,0,O-114-81-03-05-03
KIBAALE,BUGANGAIZI COUNTY,KASAMBYA,RWAMALENGE,KISENGWE PRIMARY SCHOOL,299,1,0,2,8,211,222,1,223,0,O-114-81-03-05-04
KIBAALE,BUGANGAIZI COUNTY,KISIITA,BUHONDA,BUHONDA STORE(A),430,1,0,2,23,269,295,24,319,0,O-114-81-04-01-01
KIBAALE,BUGANGAIZI COUNTY,KISIITA,BUHONDA,NYAMIRAMA PRIMARY SCHOOL,698,0,0,8,46,391,445,24,469,0,O-114-81-04-01-02
KIBAALE,BUGANGAIZI COUNTY,KISIITA,BUHONDA,KYAKAPERE CENTRE,536,0,0,2,18,400,420,5,425,0,O-114-81-04-01-03
KIBAALE,BUGANGAIZI COUNTY,KISIITA,BUHONDA,BUHONDA STORE(B),347,2,2,1,19,195,219,10,229,0,O-114-81-04-01-04
KIBAALE,BUGANGAIZI COUNTY,KISIITA,KISIITA,KISIITA MARKET A,601,3,1,6,43,323,376,29,405,0,O-114-81-04-02-01
KIBAALE,BUGANGAIZI COUNTY,KISIITA,KISIITA,KISIITA MARKET B,424,2,2,2,17,230,253,19,272,0,O-114-81-04-02-02
KIBAALE,BUGANGAIZI COUNTY,KISIITA,KISIITA,KISIITA S/CTY HQRS,604,2,0,4,38,292,336,14,350,0,O-114-81-04-02-03
KIBAALE,BUGANGAIZI COUNTY,KISIITA,KISIITA,DAMASCO CENTRE,683,2,1,6,36,460,505,10,515,0,O-114-81-04-02-04
KIBAALE,BUGANGAIZI COUNTY,KISIITA,KISIITA,NYABIRUNGI PRIMARY SCHOOL,528,1,2,2,23,374,402,19,421,0,O-114-81-04-02-05
KIBAALE,BUGANGAIZI COUNTY,KISIITA,KISIITA,NYABIRUNGI T/C,358,0,2,2,15,233,252,5,257,0,O-114-81-04-02-06
KIBAALE,BUGANGAIZI COUNTY,KISIITA,MWITANZIGE,MWITANZIGE T/CENTRE [MP-Z],412,2,0,1,19,257,279,5,284,0,O-114-81-04-03-01
KIBAALE,BUGANGAIZI COUNTY,KISIITA,MWITANZIGE,KYABUSINGYE T/CENTRE,873,2,2,4,28,542,578,20,598,0,O-114-81-04-03-02
KIBAALE,BUGANGAIZI COUNTY,KISIITA,MWITANZIGE,KYAKUTEREKERA PRIMARY SCHO,503,2,3,6,11,333,355,13,368,0,O-114-81-04-03-03
KIBAALE,BUGANGAIZI COUNTY,KISIITA,MWITANZIGE,MWITANZIGE T/CENTRE [A-MO],321,2,2,1,13,221,239,14,253,0,O-114-81-04-03-04
KIBAALE,BUGANGAIZI COUNTY,NARWEYO,KATIKALA,BUSANGA PRIMARY SCHOOL,231,1,1,4,7,139,152,6,158,0,O-114-81-05-01-01
KIBAALE,BUGANGAIZI COUNTY,NARWEYO,KATIKALA,KATIKALA T/C [A-MO],518,0,1,3,20,354,378,12,390,0,O-114-81-05-01-02
KIBAALE,BUGANGAIZI COUNTY,NARWEYO,KATIKALA,KATIKALA T/C [MP-Z],393,3,3,0,18,286,310,5,315,0,O-114-81-05-01-03
KIBAALE,BUGANGAIZI COUNTY,NARWEYO,KIRIISA,KINUNDA P.S,388,1,2,3,13,254,273,11,284,0,O-114-81-05-02-01
KIBAALE,BUGANGAIZI COUNTY,NARWEYO,KIRIISA,KITAIHUKA PRIMARY SCHOOL,215,0,0,3,5,177,185,7,192,0,O-114-81-05-02-02
KIBAALE,BUGANGAIZI COUNTY,NARWEYO,KIRIISA,KIRIISA CATHOLIC CHURCH,206,2,2,2,29,147,182,3,185,0,O-114-81-05-02-03
KIBAALE,BUGANGAIZI COUNTY,NARWEYO,KIRIISA,KITAIHUKA PRIMARY SCHOOL,242,0,2,0,15,192,209,5,214,0,O-114-81-05-02-04
KIBAALE,BUGANGAIZI COUNTY,NARWEYO,KIRIISA,KIJEGERE CENTRE,352,0,1,1,17,259,278,11,289,0,O-114-81-05-02-05
KIBAALE,BUGANGAIZI COUNTY,NARWEYO,KIRIISA,KINUNDA TC,223,0,0,1,14,163,178,11,189,0,O-114-81-05-02-06
KIBAALE,BUGANGAIZI COUNTY,NARWEYO,KYABEYA,BURUKO PRIMARY SCHOOL,451,7,0,4,36,325,372,8,380,0,O-114-81-05-03-01
KIBAALE,BUGANGAIZI COUNTY,NARWEYO,KYABEYA,IRINDIMURA PRIMARY SCHOOL,255,1,0,2,2,182,187,21,208,0,O-114-81-05-03-02
KIBAALE,BUGANGAIZI COUNTY,NARWEYO,KYABEYA,KAKOORA MEETING PLACE,363,2,0,3,13,264,282,7,289,0,O-114-81-05-03-03
KIBAALE,BUGANGAIZI COUNTY,NARWEYO,KYABEYA,KISENYI RESETTLEMENT CAMP,445,3,0,3,19,310,335,12,347,0,O-114-81-05-03-04
KIBAALE,BUGANGAIZI COUNTY,NARWEYO,KYABEYA,KAKOORA MEETING PLACE A,138,0,1,0,7,116,124,2,126,0,O-114-81-05-03-05
KIBAALE,BUGANGAIZI COUNTY,NARWEYO,KYABEYA,KITABONA T/C,664,2,0,1,17,402,422,86,508,0,O-114-81-05-03-06
KIBAALE,BUGANGAIZI COUNTY,NARWEYO,KYABEYA,KAKOORA MEETING PLACE B,168,0,0,1,3,138,142,2,144,0,O-114-81-05-03-07
KIBAALE,BUGANGAIZI COUNTY,NARWEYO,KYABEYA,MULINGA T/CENTRE,411,4,3,7,15,261,290,11,301,0,O-114-81-05-03-08
KIBAALE,BUGANGAIZI COUNTY,NARWEYO,MASAKA,KISAGARA SETTLEMENT,186,1,0,0,9,138,148,5,153,0,O-114-81-05-04-01
KIBAALE,BUGANGAIZI COUNTY,NARWEYO,MASAKA,ST CHARLES LWANGA P/S,602,2,2,6,23,451,484,17,501,0,O-114-81-05-04-02
KIBAALE,BUGANGAIZI COUNTY,NARWEYO,MASAKA,KAKUNYU CATHOLIC CHURCH,555,5,2,6,23,381,417,15,432,0,O-114-81-05-04-03
KIBAALE,BUGANGAIZI COUNTY,NARWEYO,MASAKA,KIRYAMASAASA T/C,586,2,4,11,18,394,429,10,439,0,O-114-81-05-04-04
KIBAALE,BUGANGAIZI COUNTY,NARWEYO,MASAKA,KISAGARA SETTLEMENT,328,0,0,2,9,219,230,11,241,0,O-114-81-05-04-05
KIBAALE,BUGANGAIZI COUNTY,NARWEYO,MASAKA,MASAKA CATHOLIC CHURCH,710,1,0,4,28,478,511,8,519,0,O-114-81-05-04-06
KIBAALE,BUGANGAIZI COUNTY,NKOOKO,KIBIJJO,KIBIJJO P/SCHOOL,618,3,3,9,13,428,456,18,474,0,O-114-81-06-01-01
KIBAALE,BUGANGAIZI COUNTY,NKOOKO,KIBIJJO,ISUNGA P/SCHOOL,800,4,2,8,21,505,540,0,540,0,O-114-81-06-01-02
KIBAALE,BUGANGAIZI COUNTY,NKOOKO,KITEGULA,KITEGURA P/SCHOOL,665,2,1,6,21,439,469,24,493,0,O-114-81-06-02-01
KIBAALE,BUGANGAIZI COUNTY,NKOOKO,KITEGULA,MUKOORA HEALTH UNIT,511,7,4,3,38,326,378,21,399,0,O-114-81-06-02-02
KIBAALE,BUGANGAIZI COUNTY,NKOOKO,KITEGULA,NKOOKO P/SCHOOL [A-MU],542,0,2,0,22,329,353,11,364,0,O-114-81-06-02-03
KIBAALE,BUGANGAIZI COUNTY,NKOOKO,KITEGULA,MPONGO K,259,0,0,1,9,166,176,28,204,0,O-114-81-06-02-04
KIBAALE,BUGANGAIZI COUNTY,NKOOKO,KITEGULA,RUBUMBO PRIMARY SCHOOL,423,3,0,2,17,277,299,9,308,0,O-114-81-06-02-05
KIBAALE,BUGANGAIZI COUNTY,NKOOKO,KITEGULA,NKOOKO P/SCHOOL [MW-Z],391,3,0,3,10,294,310,16,326,0,O-114-81-06-02-06
KIBAALE,BUGANGAIZI COUNTY,NKOOKO,KITUTUMA,KABUBWA HEALTH UNIT,657,1,8,3,25,451,488,19,507,0,O-114-81-06-03-01
KIBAALE,BUGANGAIZI COUNTY,NKOOKO,KITUTUMA,BUJOJO P/SCHOOL,720,2,4,8,16,524,554,17,571,0,O-114-81-06-03-02
KIBAALE,BUGANGAIZI COUNTY,NKOOKO,KITUTUMA,KAMUSENENE PRIMARY SCHOOL,285,3,0,1,28,210,242,4,246,0,O-114-81-06-03-03
KIBAALE,BUGANGAIZI COUNTY,NKOOKO,MPASANA,MPASANA P/SCHOOL [MW-Z],730,0,1,5,27,462,495,13,508,0,O-114-81-06-04-01
KIBAALE,BUGANGAIZI COUNTY,NKOOKO,MPASANA,MPONGO PRIMARY SCHOOL A,633,3,0,4,34,446,487,8,495,0,O-114-81-06-04-02
KIBAALE,BUGANGAIZI COUNTY,NKOOKO,MPASANA,BINIKIRA P/SCHOOL,781,4,5,5,32,519,565,9,574,0,O-114-81-06-04-03
KIBAALE,BUGANGAIZI COUNTY,NKOOKO,MPASANA,RWAMATA P/SCHOOL,386,1,1,4,3,286,295,5,300,0,O-114-81-06-04-04
KIBAALE,BUGANGAIZI COUNTY,NKOOKO,MPASANA,MPONGO PRIMARY SCHOOL B,421,1,0,0,22,331,354,9,363,0,O-114-81-06-04-05
KIBAALE,BUGANGAIZI COUNTY,NKOOKO,MPASANA,KITUTUMA PRIMARY SCHOOL,559,1,5,2,22,403,433,32,465,0,O-114-81-06-04-06
KIBAALE,BUGANGAIZI COUNTY,NKOOKO,MPASANA,MPASANA P/SCHOOL [A-MU],476,0,1,4,27,298,330,17,347,0,O-114-81-06-04-07
KABALE,RUBANDA CTY EAST,BUBARE,BUBARE,BUBARE GOMB HQRS A,693,0,2,2,183,303,490,8,498,0,O-116-47-01-01-01
KABALE,RUBANDA CTY EAST,BUBARE,BUBARE,BUBARE GOMB HQRS B,449,1,1,1,89,211,303,42,345,0,O-116-47-01-01-02
KABALE,RUBANDA CTY EAST,BUBARE,BUBARE,NGASIIRE,686,2,1,1,87,361,452,91,543,0,O-116-47-01-01-03
KABALE,RUBANDA CTY EAST,BUBARE,BUBARE,BUSHURA P. SCHOOL,561,2,0,5,78,301,386,77,463,0,O-116-47-01-01-04
KABALE,RUBANDA CTY EAST,BUBARE,BUTOBOORE,MUCHACHI P. SCHOOL,291,0,0,0,101,94,195,35,230,0,O-116-47-01-02-01
KABALE,RUBANDA CTY EAST,BUBARE,BUTOBOORE,IHANGA T. CENTRE,864,1,1,3,147,378,530,118,648,0,O-116-47-01-02-02
KABALE,RUBANDA CTY EAST,BUBARE,BUTOBOORE,KIBUZIGYE P. SCHOOL,660,2,2,0,120,350,474,73,547,0,O-116-47-01-02-03
KABALE,RUBANDA CTY EAST,BUBARE,BUTOBOORE,HABUHINGA T. CENTRE,640,1,0,3,79,337,420,79,499,0,O-116-47-01-02-04
KABALE,RUBANDA CTY EAST,BUBARE,BWINDI,HAKISHENYI A,249,2,0,0,34,148,184,26,210,0,O-116-47-01-03-01
KABALE,RUBANDA CTY EAST,BUBARE,BWINDI,HAKISHENYI B,560,1,1,1,59,316,378,57,435,0,O-116-47-01-03-02
KABALE,RUBANDA CTY EAST,BUBARE,BWINDI,BWINDI T.C A,707,5,0,2,94,351,452,84,536,0,O-116-47-01-03-03
KABALE,RUBANDA CTY EAST,BUBARE,BWINDI,NYAMWERU P. SCHOOL,426,1,0,3,60,272,336,12,348,0,O-116-47-01-03-04
KABALE,RUBANDA CTY EAST,BUBARE,BWINDI,BWINDI T.C B,574,2,0,1,47,307,357,71,428,0,O-116-47-01-03-05
KABALE,RUBANDA CTY EAST,BUBARE,BWINDI,KATWIGYI P/S,336,2,0,0,62,153,217,41,258,0,O-116-47-01-03-06
KABALE,RUBANDA CTY EAST,BUBARE,KAGARAMA,BUSHATO,338,2,0,1,35,157,195,77,272,0,O-116-47-01-04-01
KABALE,RUBANDA CTY EAST,BUBARE,KAGARAMA,HABUTIKI,651,2,1,5,77,423,508,35,543,0,O-116-47-01-04-02
KABALE,RUBANDA CTY EAST,BUBARE,KAGARAMA,HAMURAMBI,555,2,0,1,79,277,359,97,456,0,O-116-47-01-04-03
KABALE,RUBANDA CTY EAST,BUBARE,KAGARAMA,RWENGWE,539,1,1,1,74,273,350,77,427,0,O-116-47-01-04-04
KABALE,RUBANDA CTY EAST,BUBARE,KAGARAMA,KARANDAGASI,741,6,1,0,138,421,566,28,594,0,O-116-47-01-04-05
KABALE,RUBANDA CTY EAST,BUBARE,KAGARAMA,BUREMBO,340,0,0,1,63,125,189,91,280,0,O-116-47-01-04-06
KABALE,RUBANDA CTY EAST,BUBARE,KAGARAMA,MURAMBO P/S,545,0,2,0,161,215,378,72,450,0,O-116-47-01-04-07
KABALE,RUBANDA CTY EAST,BUBARE,KAGARAMA,OUTSIDE Q.GUARD,47,0,0,1,1,44,46,0,46,0,O-116-47-01-04-08
KABALE,RUBANDA CTY EAST,BUBARE,KASHENYI,RUTOOMA,569,1,2,0,65,319,387,70,457,0,O-116-47-01-05-01
KABALE,RUBANDA CTY EAST,BUBARE,KASHENYI,RUGARAMBIRO I,392,1,0,0,18,236,255,55,310,0,O-116-47-01-05-02
KABALE,RUBANDA CTY EAST,BUBARE,KASHENYI,RUGARAMBIRO II,646,0,1,1,92,327,421,2,423,0,O-116-47-01-05-03
KABALE,RUBANDA CTY EAST,BUBARE,MUYANJE,MUYANJE I/RWERE,702,2,2,0,134,347,485,77,562,0,O-116-47-01-06-01
KABALE,RUBANDA CTY EAST,BUBARE,MUYANJE,MUYANJE II/KAZINIRO,545,2,0,0,96,381,479,8,487,0,O-116-47-01-06-02
KABALE,RUBANDA CTY EAST,BUBARE,MUYANJE,BIGUNGIRO /MUYANJE III,628,3,1,2,90,391,487,21,508,0,O-116-47-01-06-03
KABALE,RUBANDA CTY EAST,BUBARE,NANGARA,KATERETERE,393,68,0,0,0,213,281,33,314,0,O-116-47-01-07-01
KABALE,RUBANDA CTY EAST,BUBARE,NANGARA,KAKALIISA,507,0,1,1,68,295,365,57,422,0,O-116-47-01-07-02
KABALE,RUBANDA CTY EAST,BUBARE,NANGARA,RWANYANGABO,578,0,0,2,40,354,396,49,445,0,O-116-47-01-07-03
KABALE,RUBANDA CTY EAST,BUBARE,NANGARA,RUNJANJARA P/S,370,0,0,0,58,177,235,29,264,0,O-116-47-01-07-04
KABALE,RUBANDA CTY EAST,BUBARE,NANGARA,HAKICWAMBA,225,0,0,0,31,149,180,21,201,0,O-116-47-01-07-05
KABALE,RUBANDA CTY EAST,BUBARE,NYAMIYAGA,KASHAKI P. SCHOOL A,794,1,0,0,200,356,557,101,658,0,O-116-47-01-08-01
KABALE,RUBANDA CTY EAST,BUBARE,NYAMIYAGA,KASHAKI P. SCHOOL B,842,1,0,1,164,404,570,26,596,0,O-116-47-01-08-02
KABALE,RUBANDA CTY EAST,HAMURWA,HAMURWA,HARUKARA,592,1,0,1,70,358,430,57,487,0,O-116-47-02-01-01
KABALE,RUBANDA CTY EAST,HAMURWA,HAMURWA,HAMURWA I,617,2,0,0,65,332,399,95,494,0,O-116-47-02-01-02
KABALE,RUBANDA CTY EAST,HAMURWA,HAMURWA,HAMURWA II,648,1,2,1,77,316,397,111,508,0,O-116-47-02-01-03
KABALE,RUBANDA CTY EAST,HAMURWA,IGOMANDA,IGOMANDA I,586,5,0,3,98,348,454,34,488,0,O-116-47-02-02-01
KABALE,RUBANDA CTY EAST,HAMURWA,IGOMANDA,IGOMANDA II,743,2,0,3,121,347,473,103,576,0,O-116-47-02-02-02
KABALE,RUBANDA CTY EAST,HAMURWA,IGOMANDA,IGOMANDA III,563,1,0,1,81,287,370,85,455,0,O-116-47-02-02-03
KABALE,RUBANDA CTY EAST,HAMURWA,KAKORE,KAKORE I,660,5,0,4,141,376,526,14,540,0,O-116-47-02-03-01
KABALE,RUBANDA CTY EAST,HAMURWA,KAKORE,KAKORE II,641,2,1,1,145,255,404,87,491,0,O-116-47-02-03-02
KABALE,RUBANDA CTY EAST,HAMURWA,KAKORE,KASHONGATI P/SCH PLAY GROUN,505,2,1,0,82,294,379,40,419,0,O-116-47-02-03-03
KABALE,RUBANDA CTY EAST,HAMURWA,MPUNGU,KARERE,713,0,0,0,87,326,413,135,548,0,O-116-47-02-04-01
KABALE,RUBANDA CTY EAST,HAMURWA,MPUNGU,KABURARA,623,2,0,4,94,294,394,102,496,0,O-116-47-02-04-02
KABALE,RUBANDA CTY EAST,HAMURWA,MPUNGU,HAKADONGO,518,2,0,1,39,377,419,3,422,0,O-116-47-02-04-03
KABALE,RUBANDA CTY EAST,HAMURWA,RUHONWA,KASHONGATI,662,1,1,1,87,320,410,89,499,0,O-116-47-02-05-01
KABALE,RUBANDA CTY EAST,HAMURWA,RUHONWA,NYAKANENGO,455,1,2,0,53,252,308,48,356,0,O-116-47-02-05-02
KABALE,RUBANDA CTY EAST,HAMURWA,RUHONWA,NYAMASIIZI,681,3,0,3,153,293,452,46,498,0,O-116-47-02-05-03
KABALE,RUBANDA CTY EAST,HAMURWA,SHEBEYA,RWONDO,526,1,0,0,69,243,313,82,395,0,O-116-47-02-06-01
KABALE,RUBANDA CTY EAST,HAMURWA,SHEBEYA,KIRIMA,584,2,0,3,55,334,394,48,442,0,O-116-47-02-06-02
KABALE,RUBANDA CTY EAST,HAMURWA,SHEBEYA,KABISHA,574,1,0,2,84,336,423,24,447,0,O-116-47-02-06-03
KABALE,RUBANDA CTY EAST,HAMURWA,SHEBEYA,HAMURWA P/S,286,3,0,3,77,146,229,8,237,0,O-116-47-02-06-04
KABALE,RUBANDA CTY WEST,BUFUNDI,KACHERERE,KACHERERE I,344,0,0,0,24,254,278,30,308,0,O-116-48-01-01-01
KABALE,RUBANDA CTY WEST,BUFUNDI,KACHERERE,KACHERERE II,701,1,1,4,126,406,538,25,563,0,O-116-48-01-01-02
KABALE,RUBANDA CTY WEST,BUFUNDI,KACHERERE,KACHERERE III,738,0,0,1,37,695,733,5,738,0,O-116-48-01-01-03
KABALE,RUBANDA CTY WEST,BUFUNDI,KACHERERE,KACHERERE IV,504,3,0,0,69,327,399,10,409,0,O-116-48-01-01-04
KABALE,RUBANDA CTY WEST,BUFUNDI,KACHERERE,KACHERERE V,305,0,0,0,38,192,230,7,237,0,O-116-48-01-01-05
KABALE,RUBANDA CTY WEST,BUFUNDI,KAGUNGA,HABUHINGA,528,0,1,0,44,374,419,23,442,0,O-116-48-01-02-01
KABALE,RUBANDA CTY WEST,BUFUNDI,KAGUNGA,MUZIKU,416,1,0,0,32,290,323,21,344,0,O-116-48-01-02-02
KABALE,RUBANDA CTY WEST,BUFUNDI,KAGUNGA,HABUHINGA B,432,0,0,1,95,210,306,21,327,0,O-116-48-01-02-03
KABALE,RUBANDA CTY WEST,BUFUNDI,KAGUNGA,KIRIBA,312,1,0,0,48,181,230,21,251,0,O-116-48-01-02-04
KABALE,RUBANDA CTY WEST,BUFUNDI,KASHAASHA - BUFUN,MURANDAMO,539,0,0,7,22,440,469,19,488,0,O-116-48-01-03-01
KABALE,RUBANDA CTY WEST,BUFUNDI,KASHAASHA - BUFUN,KASHAASHA P. SCHOOL,719,49,0,0,0,484,533,45,578,0,O-116-48-01-03-02
KABALE,RUBANDA CTY WEST,BUFUNDI,KASHAASHA - BUFUN,HAKATARE,622,0,0,0,54,462,516,38,554,0,O-116-48-01-03-03
KABALE,RUBANDA CTY WEST,BUFUNDI,KASHAASHA - BUFUN,KINYARUSHENGYE P/SCH,258,1,0,2,25,176,204,12,216,0,O-116-48-01-03-04
KABALE,RUBANDA CTY WEST,BUFUNDI,KISHANJE,RWABAHUNDAME,441,1,0,0,41,382,424,12,436,0,O-116-48-01-04-01
KABALE,RUBANDA CTY WEST,BUFUNDI,KISHANJE,GOMBORORA HQTRS,629,1,0,3,50,447,501,2,503,0,O-116-48-01-04-02
KABALE,RUBANDA CTY WEST,BUFUNDI,KISHANJE,KINYAMI,633,1,0,5,136,348,490,5,495,0,O-116-48-01-04-03
KABALE,RUBANDA CTY WEST,BUFUNDI,MUGYERA,HABUHINGA A,570,1,3,0,69,362,435,74,509,0,O-116-48-01-05-01
KABALE,RUBANDA CTY WEST,BUFUNDI,MUGYERA,HABUHINGA B,599,2,0,3,53,425,483,27,510,0,O-116-48-01-05-02
KABALE,RUBANDA CTY WEST,BUFUNDI,MUGYERA,HABUHINGA C,588,4,0,4,103,373,484,0,484,0,O-116-48-01-05-03
KABALE,RUBANDA CTY WEST,BUFUNDI,MUGYERA,HABUHINGA D,421,1,0,2,90,210,303,28,331,0,O-116-48-01-05-04
KABALE,RUBANDA CTY WEST,BUFUNDI,MUGYERA,HAKAHINGA,237,1,1,2,65,123,192,14,206,0,O-116-48-01-05-05
KABALE,RUBANDA CTY WEST,IKUMBA,KASHAASHA - IKUMB,KASHAASHA A/ IKUMBA,896,3,0,2,87,512,604,2,606,0,O-116-48-02-01-01
KABALE,RUBANDA CTY WEST,IKUMBA,KASHAASHA - IKUMB,KASHAASHA B,728,2,0,2,60,343,407,78,485,0,O-116-48-02-01-02
KABALE,RUBANDA CTY WEST,IKUMBA,KASHAASHA - IKUMB,KASHAASHA,342,1,0,1,47,135,184,41,225,0,O-116-48-02-01-03
KABALE,RUBANDA CTY WEST,IKUMBA,KASHAASHA - IKUMB,IHUNGA PRI. SCHOOL,328,3,0,3,57,160,223,22,245,0,O-116-48-02-01-04
KABALE,RUBANDA CTY WEST,IKUMBA,KASHAASHA - IKUMB,KYIRURUMA,594,0,0,5,58,313,376,50,426,0,O-116-48-02-01-05
KABALE,RUBANDA CTY WEST,IKUMBA,KITOJO,KYOGO ANNEX P/SCHOOL,391,5,0,2,14,253,274,6,280,0,O-116-48-02-02-01
KABALE,RUBANDA CTY WEST,IKUMBA,KITOJO,MBURAMEIZI,584,3,2,5,48,340,398,13,411,0,O-116-48-02-02-02
KABALE,RUBANDA CTY WEST,IKUMBA,KITOJO,MUSHASHA I,522,5,3,3,62,286,359,12,371,0,O-116-48-02-02-03
KABALE,RUBANDA CTY WEST,IKUMBA,KITOJO,MUSHASHA II,258,1,0,0,13,158,172,32,204,0,O-116-48-02-02-04
KABALE,RUBANDA CTY WEST,IKUMBA,KIYEBE,KIYEBE,423,1,0,5,29,270,305,5,310,0,O-116-48-02-03-01
KABALE,RUBANDA CTY WEST,IKUMBA,KIYEBE,KITOJO,587,3,0,1,34,322,360,0,360,0,O-116-48-02-03-02
KABALE,RUBANDA CTY WEST,IKUMBA,KIYEBE,KIYEBE P/SCHOOL,477,0,0,0,31,339,370,5,375,0,O-116-48-02-03-03
KABALE,RUBANDA CTY WEST,IKUMBA,MUSHANJE,MUSHANJE I,737,5,1,3,418,0,427,0,427,0,O-116-48-02-04-01
KABALE,RUBANDA CTY WEST,IKUMBA,MUSHANJE,MUSHANJE II,676,0,0,1,52,380,433,29,462,0,O-116-48-02-04-02
KABALE,RUBANDA CTY WEST,IKUMBA,MUSHANJE,KIGUMIRA P/SCHOOL,282,1,0,1,12,188,202,10,212,0,O-116-48-02-04-03
KABALE,RUBANDA CTY WEST,IKUMBA,NYAKABUNGO,NYAKABUNGO I,785,1,0,2,150,324,477,113,590,0,O-116-48-02-05-01
KABALE,RUBANDA CTY WEST,IKUMBA,NYAKABUNGO,NYAKABUNGO II,540,1,0,3,83,343,430,10,440,0,O-116-48-02-05-02
KABALE,RUBANDA CTY WEST,IKUMBA,NYAKABUNGO,NYAKABUNGO III,495,1,1,2,60,313,377,5,382,0,O-116-48-02-05-03
KABALE,RUBANDA CTY WEST,IKUMBA,NYAKABUNGO,BUGARIKA,419,2,1,1,27,278,309,3,312,0,O-116-48-02-05-04
KABALE,RUBANDA CTY WEST,IKUMBA,NYAMABARE,NYAMABALE I,568,2,0,0,53,268,323,0,323,0,O-116-48-02-06-01
KABALE,RUBANDA CTY WEST,IKUMBA,NYAMABARE,NYAMABALE II,421,1,2,0,54,187,244,59,303,0,O-116-48-02-06-02
KABALE,RUBANDA CTY WEST,IKUMBA,NYAMABARE,NYAMABALE III,681,2,2,1,87,335,427,127,554,0,O-116-48-02-06-03
KABALE,RUBANDA CTY WEST,IKUMBA,NYAMABARE,MUKIRWA CHURCH,383,0,0,1,38,223,262,42,304,0,O-116-48-02-06-04
KABALE,RUBANDA CTY WEST,IKUMBA,NYARUHANGA,KAGUNGA,500,0,0,0,124,251,375,6,381,0,O-116-48-02-07-01
KABALE,RUBANDA CTY WEST,IKUMBA,NYARUHANGA,NYARUHANGA HIGH SCHOOL,413,0,0,1,129,187,317,10,327,0,O-116-48-02-07-02
KABALE,RUBANDA CTY WEST,IKUMBA,NYARUHANGA,NYAMIYAGA,635,1,2,1,135,350,489,13,502,0,O-116-48-02-07-03
KABALE,RUBANDA CTY WEST,IKUMBA,NYARUHANGA,RUBANDA MIXED P/S,493,1,1,2,69,263,336,45,381,0,O-116-48-02-07-04
KABALE,RUBANDA CTY WEST,IKUMBA,NYARUHANGA,HAKIRONDORONDO,415,0,0,0,21,255,276,63,339,0,O-116-48-02-07-05
KABALE,RUBANDA CTY WEST,MUKO,BUTARE,RUREMBO,706,0,0,1,11,687,699,2,701,0,O-116-48-03-01-01
KABALE,RUBANDA CTY WEST,MUKO,BUTARE,BUGARAMA,698,1,0,3,86,524,614,5,619,0,O-116-48-03-01-02
KABALE,RUBANDA CTY WEST,MUKO,BUTARE,BISHAKI,511,2,0,6,54,384,446,15,461,0,O-116-48-03-01-03
KABALE,RUBANDA CTY WEST,MUKO,BUTARE,MURUKORO I,656,1,0,3,135,387,526,0,526,0,O-116-48-03-01-04
KABALE,RUBANDA CTY WEST,MUKO,BUTARE,MURUKORO II,502,1,1,3,126,297,428,11,439,0,O-116-48-03-01-05
KABALE,RUBANDA CTY WEST,MUKO,BUTARE,IGABIRO,664,3,1,2,36,596,638,20,658,0,O-116-48-03-01-06
KABALE,RUBANDA CTY WEST,MUKO,IKAMIRO,IKAMIRO I,735,2,1,2,90,457,552,93,645,0,O-116-48-03-02-01
KABALE,RUBANDA CTY WEST,MUKO,IKAMIRO,IKAMIRO II,714,2,0,1,93,401,497,78,575,0,O-116-48-03-02-02
KABALE,RUBANDA CTY WEST,MUKO,IKAMIRO,IKAMIRO III,572,2,0,3,90,399,494,6,500,0,O-116-48-03-02-03
KABALE,RUBANDA CTY WEST,MUKO,IKAMIRO,IKAMIRO IV,366,0,1,3,22,263,289,20,309,0,O-116-48-03-02-04
KABALE,RUBANDA CTY WEST,MUKO,KAARA,KAKANGAGA,549,2,2,5,37,414,460,10,470,0,O-116-48-03-03-01
KABALE,RUBANDA CTY WEST,MUKO,KAARA,KAARA P. SCHOOL,619,2,1,0,47,362,412,105,517,0,O-116-48-03-03-02
KABALE,RUBANDA CTY WEST,MUKO,KAARA,RWABURARO,549,0,1,0,38,370,409,62,471,0,O-116-48-03-03-03
KABALE,RUBANDA CTY WEST,MUKO,KAARA,NSANJARE T. C,691,1,0,1,61,455,518,68,586,0,O-116-48-03-03-04
KABALE,RUBANDA CTY WEST,MUKO,KABERE,MUKIBAYA P. SCHOOL,665,1,0,2,89,360,452,108,560,0,O-116-48-03-04-01
KABALE,RUBANDA CTY WEST,MUKO,KABERE,KABURARA P. SCHOOL,524,1,1,3,66,384,455,18,473,0,O-116-48-03-04-02
KABALE,RUBANDA CTY WEST,MUKO,KARENGYERE,KARENGYERE I,425,0,0,1,23,264,288,72,360,0,O-116-48-03-05-01
KABALE,RUBANDA CTY WEST,MUKO,KARENGYERE,KARENGYERE IV,170,0,0,0,43,92,135,15,150,0,O-116-48-03-05-02
KABALE,RUBANDA CTY WEST,MUKO,KARENGYERE,KARENGYERE II,406,0,0,0,31,256,287,59,346,0,O-116-48-03-05-03
KABALE,RUBANDA CTY WEST,MUKO,KARENGYERE,KARENGYERE III,313,1,0,0,52,160,213,42,255,0,O-116-48-03-05-04
KABALE,RUBANDA CTY WEST,MUKO,KARENGYERE,MUKO MARKET,488,1,1,0,88,275,365,14,379,0,O-116-48-03-05-05
KABALE,RUBANDA CTY WEST,MUKO,KYENYI,KYENYI I,744,2,1,1,65,444,513,102,615,0,O-116-48-03-06-01
KABALE,RUBANDA CTY WEST,MUKO,KYENYI,KYENYI II,728,2,0,1,115,388,506,103,609,0,O-116-48-03-06-02
KABALE,RUBANDA CTY WEST,MUKO,NYARURAMBI,NYARURAMBI P. SCHOOL,362,2,0,0,48,200,250,34,284,0,O-116-48-03-07-01
KABALE,RUBANDA CTY WEST,MUKO,NYARURAMBI,BURINDI P. SCHOOL/BWINDI,734,1,0,0,140,450,591,6,597,0,O-116-48-03-07-02
KABALE,RUBANDA CTY WEST,MUKO,NYARURAMBI,KISHAKI P. SCHOOL,525,3,1,3,46,339,392,34,426,0,O-116-48-03-07-03
KABALE,RUBANDA CTY WEST,MUKO,NYARURAMBI,BUGUNGA C. SCHOOL,637,4,0,2,56,452,514,20,534,0,O-116-48-03-07-04
KABALE,RUBANDA CTY WEST,MUKO,NYARURAMBI,MUKO HEALTH CENTER,378,0,0,0,38,269,307,30,337,0,O-116-48-03-07-05
KABALE,RUBANDA CTY WEST,MUKO,NYARURAMBI,AFRICARE OFFICES,232,0,0,0,13,180,193,4,197,0,O-116-48-03-07-06
KABALE,RUKIGA COUNTY,BUKINDA,KANDAGO,KANDAGO I,372,1,0,1,76,219,297,16,313,0,O-120-49-01-01-01
KABALE,RUKIGA COUNTY,BUKINDA,KANDAGO,KANDAGO II,594,3,0,4,191,271,469,36,505,0,O-120-49-01-01-02
KABALE,RUKIGA COUNTY,BUKINDA,KANDAGO,KANDAGO III,320,0,0,0,97,137,234,24,258,0,O-120-49-01-01-03
KABALE,RUKIGA COUNTY,BUKINDA,KARORWA,NYAKASIRU P. SCHOOL,561,0,1,2,170,256,429,27,456,0,O-120-49-01-02-01
KABALE,RUKIGA COUNTY,BUKINDA,KARORWA,AHAKIMUNYU,509,1,0,0,131,240,372,46,418,0,O-120-49-01-02-02
KABALE,RUKIGA COUNTY,BUKINDA,KARORWA,KARORWA P/S,419,1,0,0,109,180,290,46,336,0,O-120-49-01-02-03
KABALE,RUKIGA COUNTY,BUKINDA,KYERERO,KYERERO I,506,1,0,1,148,290,440,1,441,0,O-120-49-01-03-01
KABALE,RUKIGA COUNTY,BUKINDA,KYERERO,KYERERO II,553,1,1,3,127,321,453,5,458,0,O-120-49-01-03-02
KABALE,RUKIGA COUNTY,BUKINDA,KYERERO,KYERERO III,518,1,0,0,85,336,422,26,448,0,O-120-49-01-03-03
KABALE,RUKIGA COUNTY,BUKINDA,MUHANGA,MUHANGA OLD MARKET,802,1,0,0,257,304,562,41,603,0,O-120-49-01-04-01
KABALE,RUKIGA COUNTY,BUKINDA,MUHANGA,KITABURAZA S,569,0,0,2,152,296,450,12,462,0,O-120-49-01-04-02
KABALE,RUKIGA COUNTY,BUKINDA,MUHANGA,RUTOBO MARKET,559,0,0,0,145,281,426,40,466,0,O-120-49-01-04-03
KABALE,RUKIGA COUNTY,BUKINDA,MUHANGA,NYEIKUNAMA PRIMARY SCHOOL,142,0,0,0,37,77,114,11,125,0,O-120-49-01-04-04
KABALE,RUKIGA COUNTY,BUKINDA,NYABIREREMA,AHAKASHIJA,537,0,0,2,128,296,426,20,446,0,O-120-49-01-05-01
KABALE,RUKIGA COUNTY,BUKINDA,NYABIREREMA,AHAKATARE - NYABIREREMA,704,1,0,0,246,287,534,0,534,0,O-120-49-01-05-02
KABALE,RUKIGA COUNTY,BUKINDA,NYABIREREMA,KAKATUNDA,594,0,0,1,212,206,419,19,438,0,O-120-49-01-05-03
KABALE,RUKIGA COUNTY,BUKINDA,NYABIREREMA,KABAARE,360,1,0,1,108,162,272,28,300,0,O-120-49-01-05-04
KABALE,RUKIGA COUNTY,BUKINDA,NYAKASIRU,KARUBANDA,655,1,0,0,163,300,464,83,547,0,O-120-49-01-06-01
KABALE,RUKIGA COUNTY,BUKINDA,NYAKASIRU,RYABIRENGYE P. SCHOOL,686,1,0,2,209,281,493,54,547,0,O-120-49-01-06-02
KABALE,RUKIGA COUNTY,KAMWEZI,KASHEKYE,NGANGO,814,0,0,1,53,754,808,1,809,0,O-120-49-02-01-01
KABALE,RUKIGA COUNTY,KAMWEZI,KASHEKYE,KASHEKYE PARISH HQRS/MURUK,638,0,0,1,95,523,619,6,625,0,O-120-49-02-01-02
KABALE,RUKIGA COUNTY,KAMWEZI,KASHEKYE,NYAKIHANGA PRIMARY SCHOOL,768,0,0,1,95,523,619,6,625,0,O-120-49-02-01-03
KABALE,RUKIGA COUNTY,KAMWEZI,KIBANDA,KATUNGU P. SCHOOL,685,0,0,0,15,320,335,22,357,0,O-120-49-02-02-01
KABALE,RUKIGA COUNTY,KAMWEZI,KIBANDA,KAKAMBA C.O.U,781,0,0,0,30,621,651,23,674,0,O-120-49-02-02-02
KABALE,RUKIGA COUNTY,KAMWEZI,KIBANDA,KINYAMOZI P. SCHOOL,554,2,0,1,76,410,489,9,498,0,O-120-49-02-02-03
KABALE,RUKIGA COUNTY,KAMWEZI,KIBANDA,KIBANDA PARISH HQRS,504,1,0,0,29,379,409,46,455,0,O-120-49-02-02-04
KABALE,RUKIGA COUNTY,KAMWEZI,KIBANDA,KIBANDA PRIMARY SCHOOL,358,0,0,0,15,320,335,22,357,0,O-120-49-02-02-05
KABALE,RUKIGA COUNTY,KAMWEZI,KIGARA,KACUCU P. SCHOOL,540,0,1,0,65,363,429,19,448,0,O-120-49-02-03-01
KABALE,RUKIGA COUNTY,KAMWEZI,KIGARA,KAMWEZI MARKET,562,1,0,0,103,331,435,7,442,0,O-120-49-02-03-02
KABALE,RUKIGA COUNTY,KAMWEZI,KIGARA,KAMWEZI DISPENSARY,536,0,0,1,83,334,418,9,427,0,O-120-49-02-03-03
KABALE,RUKIGA COUNTY,KAMWEZI,KIGARA,KAMWEZI PRIMARY SCHOOL,580,0,0,0,55,323,378,73,451,0,O-120-49-02-03-04
KABALE,RUKIGA COUNTY,KAMWEZI,KIGARA,KIGARA PRIMARY SCHOOL,305,0,0,0,30,247,277,8,285,0,O-120-49-02-03-05
KABALE,RUKIGA COUNTY,KAMWEZI,KYABUHANGWA,KASHEKYE P. SCHOOL,446,0,0,2,61,264,327,5,332,0,O-120-49-02-04-01
KABALE,RUKIGA COUNTY,KAMWEZI,KYABUHANGWA,RUNONI P. SCHOOL,574,1,0,1,55,423,480,3,483,0,O-120-49-02-04-02
KABALE,RUKIGA COUNTY,KAMWEZI,KYABUHANGWA,AHAKIGANO,600,0,0,1,100,305,406,88,494,0,O-120-49-02-04-03
KABALE,RUKIGA COUNTY,KAMWEZI,KYABUHANGWA,KYABUHANGWA P. SCHOOL,332,1,0,0,53,203,257,36,293,0,O-120-49-02-04-04
KABALE,RUKIGA COUNTY,KAMWEZI,KYOGO,KYOGO PARISH HQRS,625,0,0,0,136,356,492,3,495,0,O-120-49-02-05-01
KABALE,RUKIGA COUNTY,KAMWEZI,KYOGO,BWIRAMBERE P.G,515,1,0,0,91,321,413,3,416,0,O-120-49-02-05-02
KABALE,RUKIGA COUNTY,KAMWEZI,KYOGO,KATARAMABARE C,238,0,0,0,50,141,191,1,192,0,O-120-49-02-05-03
KABALE,RUKIGA COUNTY,KAMWEZI,RWENYANGYE,OMUNKOLE P. SCHOOL,629,1,0,1,143,341,486,4,490,0,O-120-49-02-06-01
KABALE,RUKIGA COUNTY,KAMWEZI,RWENYANGYE,RWENYONZA P. SCHOOL,526,0,1,0,144,233,378,28,406,0,O-120-49-02-06-02
KABALE,RUKIGA COUNTY,KASHAMBYA,BUCHUNDURA,KITOJO P. SCHOOL,670,1,0,1,115,341,458,49,507,0,O-120-49-03-01-01
KABALE,RUKIGA COUNTY,KASHAMBYA,BUCHUNDURA,KYEHINDE P. SCHOOL,303,1,0,0,74,119,194,43,237,0,O-120-49-03-01-02
KABALE,RUKIGA COUNTY,KASHAMBYA,BUCHUNDURA,RUHONWA P. SCHOOL,448,3,0,4,129,182,318,43,361,0,O-120-49-03-01-03
KABALE,RUKIGA COUNTY,KASHAMBYA,BUCHUNDURA,MUKYOGO,261,0,1,1,48,151,201,19,220,0,O-120-49-03-01-04
KABALE,RUKIGA COUNTY,KASHAMBYA,KAFUNJO,KANYABUGUNGA P. SCHOOL,611,1,0,0,65,377,443,35,478,0,O-120-49-03-02-01
KABALE,RUKIGA COUNTY,KASHAMBYA,KAFUNJO,BUCHUNDURA P. SCHOOL,572,3,0,0,88,318,409,29,438,0,O-120-49-03-02-02
KABALE,RUKIGA COUNTY,KASHAMBYA,KAFUNJO,HAKIBATI,325,0,0,0,27,205,232,19,251,0,O-120-49-03-02-03
KABALE,RUKIGA COUNTY,KASHAMBYA,KITANGA,RUKIGA P. SCHOOL,464,2,1,0,129,243,375,19,394,0,O-120-49-03-03-01
KABALE,RUKIGA COUNTY,KASHAMBYA,KITANGA,KITANGA P. SCHOOL,728,0,1,1,159,368,529,32,561,0,O-120-49-03-03-02
KABALE,RUKIGA COUNTY,KASHAMBYA,KITANGA,AHABWERA,594,1,0,1,156,296,454,7,461,0,O-120-49-03-03-03
KABALE,RUKIGA COUNTY,KASHAMBYA,KITANGA,KABATERA,519,3,0,3,98,315,419,31,450,0,O-120-49-03-03-04
KABALE,RUKIGA COUNTY,KASHAMBYA,KITUNGA,NGOMA P. SCHOOL,394,0,0,1,67,220,288,41,329,0,O-120-49-03-04-01
KABALE,RUKIGA COUNTY,KASHAMBYA,KITUNGA,HAKISHENYI,396,4,0,1,92,190,287,17,304,0,O-120-49-03-04-02
KABALE,RUKIGA COUNTY,KASHAMBYA,KITUNGA,HABUBARE/RWENGONGO,356,1,0,0,85,163,249,36,285,0,O-120-49-03-04-03
KABALE,RUKIGA COUNTY,KASHAMBYA,KITUNGA,RUYUMBU P/SCHOOL,362,0,0,2,76,204,282,18,300,0,O-120-49-03-04-04
KABALE,RUKIGA COUNTY,KASHAMBYA,NYAKASHEBEYA,NYAKASHEBEYA I,606,5,0,1,118,356,480,1,481,0,O-120-49-03-05-01
KABALE,RUKIGA COUNTY,KASHAMBYA,NYAKASHEBEYA,NYAKASHEBEYA II,653,2,0,1,132,341,476,41,517,0,O-120-49-03-05-02
KABALE,RUKIGA COUNTY,KASHAMBYA,NYAKASHEBEYA,NYAKASHEBEYA III,257,1,0,0,50,173,224,12,236,0,O-120-49-03-05-03
KABALE,RUKIGA COUNTY,KASHAMBYA,RUTENGYE,RUTENGYE I,621,2,0,1,129,288,420,37,457,0,O-120-49-03-06-01
KABALE,RUKIGA COUNTY,KASHAMBYA,RUTENGYE,RUTENGYE II,543,2,3,1,81,332,419,0,419,0,O-120-49-03-06-02
KABALE,RUKIGA COUNTY,KASHAMBYA,RUTENGYE,RUTENGYE III,671,1,0,0,106,375,482,42,524,0,O-120-49-03-06-03
KABALE,RUKIGA COUNTY,KASHAMBYA,RUTENGYE,RUTENGYE IV,408,1,0,0,42,259,302,21,323,0,O-120-49-03-06-04
KABALE,RUKIGA COUNTY,RWAMUCUCU,BURIME,RWEMPISI P. SCHOOL,439,0,0,0,108,249,357,3,360,0,O-120-49-04-01-01
KABALE,RUKIGA COUNTY,RWAMUCUCU,BURIME,AHAMUNYINYA P. SCHOOL,557,2,0,0,116,330,448,9,457,0,O-120-49-04-01-02
KABALE,RUKIGA COUNTY,RWAMUCUCU,IBUMBA,IBUMBA I/IBUMBA P. SCHOOL,611,5,0,0,106,309,420,58,478,0,O-120-49-04-02-01
KABALE,RUKIGA COUNTY,RWAMUCUCU,IBUMBA,IBUMBA II/IBUMBA DISPENSARY,484,3,0,2,160,206,371,3,374,0,O-120-49-04-02-02
KABALE,RUKIGA COUNTY,RWAMUCUCU,IBUMBA,IBUMBA III/NYAMPIKYE,546,0,0,0,130,293,423,6,429,0,O-120-49-04-02-03
KABALE,RUKIGA COUNTY,RWAMUCUCU,KITOJO,NYAKARAMBI P. SCHOOL,599,2,1,1,201,263,468,38,506,0,O-120-49-04-03-01
KABALE,RUKIGA COUNTY,RWAMUCUCU,KITOJO,GOMBOLOLA HQRS A,245,0,0,0,65,147,212,13,225,0,O-120-49-04-03-02
KABALE,RUKIGA COUNTY,RWAMUCUCU,KITOJO,RWAMUCUCU S/C B,594,0,0,1,224,259,484,22,506,0,O-120-49-04-03-03
KABALE,RUKIGA COUNTY,RWAMUCUCU,KITOJO,KABIRIZI C.O.U,471,0,0,1,133,257,391,13,404,0,O-120-49-04-03-04
KABALE,RUKIGA COUNTY,RWAMUCUCU,MPARO,RUKIGA COUNTY HQRS,420,0,1,0,182,129,312,21,333,0,O-120-49-04-04-01
KABALE,RUKIGA COUNTY,RWAMUCUCU,MPARO,KIHANGA BOYS SCHOOL,680,2,1,1,198,272,474,43,517,0,O-120-49-04-04-02
KABALE,RUKIGA COUNTY,RWAMUCUCU,MPARO,KIHANGA P.G,478,3,3,0,207,159,372,25,397,0,O-120-49-04-04-03
KABALE,RUKIGA COUNTY,RWAMUCUCU,NOOZI,KASOONI P. SCHOOL,449,1,0,0,149,233,383,6,389,0,O-120-49-04-05-01
KABALE,RUKIGA COUNTY,RWAMUCUCU,NOOZI,HAMWARO,337,0,1,0,111,140,252,21,273,0,O-120-49-04-05-02
KABALE,RUKIGA COUNTY,RWAMUCUCU,NOOZI,NOOZI PARISH HQRS,635,3,1,1,191,314,510,3,513,0,O-120-49-04-05-03
KABALE,RUKIGA COUNTY,RWAMUCUCU,NOOZI,RUKIRI T. CENTRE,665,5,0,3,176,353,537,15,552,0,O-120-49-04-05-04
KABALE,RUKIGA COUNTY,RWAMUCUCU,NYAKAGABAGABA,KIHOREZO P.GROUND,489,1,0,0,145,258,404,27,431,0,O-120-49-04-06-01
KABALE,RUKIGA COUNTY,RWAMUCUCU,NYAKAGABAGABA,KIRUNDWE P.GROUND,504,0,0,0,142,246,388,32,420,0,O-120-49-04-06-02
KABALE,RUKIGA COUNTY,RWAMUCUCU,NYAKAGABAGABA,KAMUTUNGU P. SCHOOL,337,0,0,1,43,226,270,9,279,0,O-120-49-04-06-03
KABALE,RUKIGA COUNTY,RWAMUCUCU,NYARURAMBI,SHOOKO P. SCHOOL,639,0,0,0,285,171,456,48,504,0,O-120-49-04-07-01
KABALE,RUKIGA COUNTY,RWAMUCUCU,NYARURAMBI,MURAMBI P. SCHOOL I,410,0,0,0,118,177,295,30,325,0,O-120-49-04-07-02
KABALE,RUKIGA COUNTY,RWAMUCUCU,NYARURAMBI,MURAMBI PRIMARY SCHOOL II,387,0,0,0,85,180,265,29,294,0,O-120-49-04-07-03
KABAROLE,BUNYANGABU COUNTY,BUHEESI,KABAHANGO,KABAHANGO A,509,1,2,3,12,358,376,17,393,0,O-122-51-01-01-01
KABAROLE,BUNYANGABU COUNTY,BUHEESI,KABAHANGO,KABAHANGO B,447,0,1,3,13,285,302,15,317,0,O-122-51-01-01-02
KABAROLE,BUNYANGABU COUNTY,BUHEESI,KABAHANGO,KIGAYA TRADING CENTRE,514,2,1,1,16,352,372,22,394,0,O-122-51-01-01-03
KABAROLE,BUNYANGABU COUNTY,BUHEESI,KABAHANGO,LYEMBAIRE A,447,0,2,0,21,320,343,11,354,0,O-122-51-01-01-04
KABAROLE,BUNYANGABU COUNTY,BUHEESI,KABAHANGO,LYEMBAIRE B,511,1,0,2,16,368,387,9,396,0,O-122-51-01-01-05
KABAROLE,BUNYANGABU COUNTY,BUHEESI,KIBOTA,BUKIKA,870,2,1,5,84,582,674,4,678,0,O-122-51-01-02-01
KABAROLE,BUNYANGABU COUNTY,BUHEESI,KIBOTA,KIBOOTA,801,3,1,6,24,583,617,25,642,0,O-122-51-01-02-02
KABAROLE,BUNYANGABU COUNTY,BUHEESI,KIBOTA,MABALE,662,8,1,7,316,106,438,20,458,0,O-122-51-01-02-03
KABAROLE,BUNYANGABU COUNTY,BUHEESI,KIBOTA,MITANDA SEC. SCHOOL,503,2,1,7,320,74,404,8,412,0,O-122-51-01-02-04
KABAROLE,BUNYANGABU COUNTY,BUHEESI,KIYOMBYA,HAPIIDA,571,0,0,0,32,452,484,1,485,0,O-122-51-01-03-01
KABAROLE,BUNYANGABU COUNTY,BUHEESI,KIYOMBYA,KINYANSINGA PRIMARY SCHOOL,522,2,1,0,26,385,414,6,420,0,O-122-51-01-03-02
KABAROLE,BUNYANGABU COUNTY,BUHEESI,KIYOMBYA,KIYOMBYA HEALTH CENTRE,644,2,1,3,30,447,483,22,505,0,O-122-51-01-03-03
KABAROLE,BUNYANGABU COUNTY,BUHEESI,KIYOMBYA,KYANGABUKAMA TRADING CENT,536,0,1,1,15,414,431,8,439,0,O-122-51-01-03-04
KABAROLE,BUNYANGABU COUNTY,BUHEESI,NYAMISEKE,MAHOMA,414,1,1,2,20,302,326,9,335,0,O-122-51-01-04-01
KABAROLE,BUNYANGABU COUNTY,BUHEESI,NYAMISEKE,NGANYWAKI,393,0,0,2,17,277,296,5,301,0,O-122-51-01-04-02
KABAROLE,BUNYANGABU COUNTY,BUHEESI,NYAMISEKE,NYAMISEKE HAKELEZIA,410,0,0,3,20,264,287,8,295,0,O-122-51-01-04-03
KABAROLE,BUNYANGABU COUNTY,BUHEESI,NYAMISEKE,RWEBIJOKA,815,3,0,6,38,521,568,2,570,0,O-122-51-01-04-04
KABAROLE,BUNYANGABU COUNTY,BUHEESI,RWENSENENE,BUHEESI SUBCOUNTY,409,2,1,4,31,257,295,18,313,0,O-122-51-01-05-01
KABAROLE,BUNYANGABU COUNTY,BUHEESI,RWENSENENE,HAMWANI,612,0,0,0,35,329,364,76,440,0,O-122-51-01-05-02
KABAROLE,BUNYANGABU COUNTY,BUHEESI,RWENSENENE,KIRYANTAMA PRIMARY SCHOOL,359,0,0,3,14,263,280,10,290,0,O-122-51-01-05-03
KABAROLE,BUNYANGABU COUNTY,BUHEESI,RWENSENENE,KITINI CENTRE,240,0,0,2,3,194,199,4,203,0,O-122-51-01-05-04
KABAROLE,BUNYANGABU COUNTY,BUHEESI,RWENSENENE,RWENSENENE,626,0,1,6,41,368,416,5,421,0,O-122-51-01-05-05
KABAROLE,BUNYANGABU COUNTY,KIBIITO,BUKARA,BUKARA C. O. U.,683,7,0,10,175,311,503,17,520,0,O-122-51-02-01-01
KABAROLE,BUNYANGABU COUNTY,KIBIITO,BUKARA,BUKARA PARISH HQRS,627,1,1,1,6,480,489,5,494,0,O-122-51-02-01-02
KABAROLE,BUNYANGABU COUNTY,KIBIITO,BUKARA,BUKURUNGU TRADING CENTRE,685,0,0,0,19,467,486,30,516,0,O-122-51-02-01-03
KABAROLE,BUNYANGABU COUNTY,KIBIITO,BUKARA,RWANGIMBA HOT SPRING CENTR,321,1,2,2,199,23,227,4,231,0,O-122-51-02-01-04
KABAROLE,BUNYANGABU COUNTY,KIBIITO,KABAALE,BWENJOJO TRADING CENTRE,557,0,1,2,43,330,376,14,390,0,O-122-51-02-02-01
KABAROLE,BUNYANGABU COUNTY,KIBIITO,KABAALE,KABAALE TRADING CENTRE,700,2,0,4,55,374,435,58,493,0,O-122-51-02-02-02
KABAROLE,BUNYANGABU COUNTY,KIBIITO,KABAALE,KASUNGANYANJA HEALTH UNIT,665,0,1,0,33,363,397,63,460,0,O-122-51-02-02-03
KABAROLE,BUNYANGABU COUNTY,KIBIITO,KABAALE,KYAMUKUBE (KITONZI),364,0,0,0,45,221,266,19,285,0,O-122-51-02-02-04
KABAROLE,BUNYANGABU COUNTY,KIBIITO,KABAALE,MUGOMA PRIMARY SCHOOL,399,1,0,5,37,233,276,22,298,0,O-122-51-02-02-05
KABAROLE,BUNYANGABU COUNTY,KIBIITO,KABAALE,MUGOMA TR. CENTRE,575,0,2,1,86,321,410,11,421,0,O-122-51-02-02-06
KABAROLE,BUNYANGABU COUNTY,KIBIITO,KABAALE,PAULO'S PLACE,457,1,0,4,17,341,363,6,369,0,O-122-51-02-02-07
KABAROLE,BUNYANGABU COUNTY,KIBIITO,KABONERO,BUSAMBA I/ BUSAMBA II (BUSAMB,557,2,0,1,22,318,343,9,352,0,O-122-51-02-03-01
KABAROLE,BUNYANGABU COUNTY,KIBIITO,KABONERO,KABONERO/ KITUNGA (KABONER,593,0,0,1,35,375,411,3,414,0,O-122-51-02-03-02
KABAROLE,BUNYANGABU COUNTY,KIBIITO,KABONERO,NSORORO/ MUTITI (ST. ADOLF CH,541,2,0,0,35,307,344,61,405,0,O-122-51-02-03-03
KABAROLE,BUNYANGABU COUNTY,KIBIITO,KABONERO,NYAMBA/ KABALEBI (NYAMBA MA,643,2,0,2,68,375,447,2,449,0,O-122-51-02-03-04
KABAROLE,BUNYANGABU COUNTY,KIBIITO,KABONERO,RWANO/ KINYAMUKONGO (RWAN,442,0,0,2,17,293,312,28,340,0,O-122-51-02-03-05
KABAROLE,BUNYANGABU COUNTY,KIBIITO,KIBIITO,KABANDA TRADING CENTRE,465,0,0,2,46,268,316,60,376,0,O-122-51-02-04-01
KABAROLE,BUNYANGABU COUNTY,KIBIITO,KIBIITO,KIBIITO COUNTY HQRS,330,0,0,1,29,166,196,14,210,0,O-122-51-02-04-02
KABAROLE,BUNYANGABU COUNTY,KIBIITO,KIBIITO,KIBIITO SECONDARY SCHOOL,410,1,0,0,30,233,264,1,265,0,O-122-51-02-04-03
KABAROLE,BUNYANGABU COUNTY,KIBIITO,KIBIITO,LATE DAVID'S COMPOUND,379,2,0,2,32,238,274,6,280,0,O-122-51-02-04-04
KABAROLE,BUNYANGABU COUNTY,KIBIITO,KIBIITO,MAKUNE BAR COMPOUND,569,0,0,3,35,381,419,12,431,0,O-122-51-02-04-05
KABAROLE,BUNYANGABU COUNTY,KIBIITO,KIBIITO,NKIMBIRI TRADING CENTRE,480,0,0,1,19,294,314,42,356,0,O-122-51-02-04-06
KABAROLE,BUNYANGABU COUNTY,KIBIITO,KIBIITO,RWENGARA TRADING CENTRE,801,2,0,7,28,504,541,13,554,0,O-122-51-02-04-07
KABAROLE,BUNYANGABU COUNTY,KIBIITO,KIBIITO,BUBWIKA TRADING CENTRE,608,1,1,1,39,323,365,29,394,0,O-122-51-02-04-08
KABAROLE,BUNYANGABU COUNTY,KIBIITO,KIBIITO,KIBIITO TRADING CENTRE,529,0,0,2,64,230,296,5,301,0,O-122-51-02-04-09
KABAROLE,BUNYANGABU COUNTY,KIBIITO,MUJUNJU,BUGABU TRADING CENTRE,668,3,0,1,19,315,338,92,430,0,O-122-51-02-05-01
KABAROLE,BUNYANGABU COUNTY,KIBIITO,MUJUNJU,MUJUNJU PRIMARY SCHOOL,495,0,0,4,47,251,302,45,347,0,O-122-51-02-05-02
KABAROLE,BUNYANGABU COUNTY,KIBIITO,MUJUNJU,MUJUNJU TRADING CENRE,572,1,1,5,57,316,380,21,401,0,O-122-51-02-05-03
KABAROLE,BUNYANGABU COUNTY,KIBIITO,MUJUNJU,NSONGYA TRADING CENTRE,347,2,1,3,35,237,278,7,285,0,O-122-51-02-05-04
KABAROLE,BUNYANGABU COUNTY,KISOMORO,KICUUCU,BUGABU TRADING CENTRE,603,0,0,3,20,468,491,3,494,0,O-122-51-03-01-01
KABAROLE,BUNYANGABU COUNTY,KISOMORO,KICUUCU,BUSIITA PRIMARY SCHOOL,495,1,0,3,13,341,358,12,370,0,O-122-51-03-01-02
KABAROLE,BUNYANGABU COUNTY,KISOMORO,KICUUCU,KICUUCU A,747,0,0,3,46,524,573,6,579,0,O-122-51-03-01-03
KABAROLE,BUNYANGABU COUNTY,KISOMORO,KICUUCU,KICUUCU B,401,0,0,0,17,285,302,3,305,0,O-122-51-03-01-04
KABAROLE,BUNYANGABU COUNTY,KISOMORO,KICUUCU,KITUMBA CATHOLIC CHURCH,688,2,0,2,28,509,541,14,555,0,O-122-51-03-01-05
KABAROLE,BUNYANGABU COUNTY,KISOMORO,KISOMORO,BUNAIGA PRIMARY SCHOOL A,392,4,1,3,204,44,256,15,271,0,O-122-51-03-02-01
KABAROLE,BUNYANGABU COUNTY,KISOMORO,KISOMORO,BUNAIGA PRIMARY SCHOOL B,235,3,1,4,94,45,147,6,153,0,O-122-51-03-02-02
KABAROLE,BUNYANGABU COUNTY,KISOMORO,KISOMORO,KABATA TRADING CENTRE,497,0,1,3,29,329,362,17,379,0,O-122-51-03-02-03
KABAROLE,BUNYANGABU COUNTY,KISOMORO,KISOMORO,KARUGAYA PRIMARY SCHOOL,616,4,0,5,292,131,432,18,450,0,O-122-51-03-02-04
KABAROLE,BUNYANGABU COUNTY,KISOMORO,KISOMORO,KISOMORO PRIMARY SCHOOL,335,1,1,0,21,247,270,5,275,0,O-122-51-03-02-05
KABAROLE,BUNYANGABU COUNTY,KISOMORO,KISOMORO,NYAKIGUMBA TRADING CENTRE,874,3,1,4,77,462,547,20,567,0,O-122-51-03-02-06
KABAROLE,BUNYANGABU COUNTY,KISOMORO,LYAMABWA,KAHONDO TRADING CENTRE,444,1,1,1,12,325,340,4,344,0,O-122-51-03-03-01
KABAROLE,BUNYANGABU COUNTY,KISOMORO,LYAMABWA,KARAMBI PARISH HQRS,722,0,1,5,42,480,528,12,540,0,O-122-51-03-03-02
KABAROLE,BUNYANGABU COUNTY,KISOMORO,LYAMABWA,KYAMUHEMBA PRIMARY SCHOOL,446,0,1,1,23,280,305,50,355,0,O-122-51-03-03-03
KABAROLE,BUNYANGABU COUNTY,KISOMORO,LYAMABWA,LEO TINKASIIMIRE'S PLACE A,583,2,0,3,37,379,421,24,445,0,O-122-51-03-03-04
KABAROLE,BUNYANGABU COUNTY,KISOMORO,LYAMABWA,LEO TINKASIIMIRE'S PLACE B,332,0,0,3,18,234,255,10,265,0,O-122-51-03-03-05
KABAROLE,BUNYANGABU COUNTY,KISOMORO,LYAMABWA,NYABUHUKA,323,0,0,1,9,255,265,1,266,0,O-122-51-03-03-06
KABAROLE,BUNYANGABU COUNTY,KISOMORO,RUBONA,KYAMUKUBE TRADING CENTRE A,641,7,1,3,272,179,462,22,484,0,O-122-51-03-04-01
KABAROLE,BUNYANGABU COUNTY,KISOMORO,RUBONA,KYAMUKUBE TRADING CENTRE B,665,6,2,13,325,98,444,24,468,0,O-122-51-03-04-02
KABAROLE,BUNYANGABU COUNTY,KISOMORO,RUBONA,RUBONA P. 5 (PLAY GROUND),491,1,0,2,43,348,394,10,404,0,O-122-51-03-04-03
KABAROLE,BUNYANGABU COUNTY,KISOMORO,RUBONA,RUBONA PRIMARY SCHOOL,676,2,1,5,68,424,500,12,512,0,O-122-51-03-04-04
KABAROLE,BUNYANGABU COUNTY,KISOMORO,RUBONA,RUBONA SENIOR SEC. SCHOOL,621,1,1,5,76,399,482,10,492,0,O-122-51-03-04-05
KABAROLE,BUNYANGABU COUNTY,RWIIMI,KADINDIMO,KADINDIMO TRADING CENTRE,378,3,1,2,46,192,244,10,254,0,O-122-51-04-01-01
KABAROLE,BUNYANGABU COUNTY,RWIIMI,KADINDIMO,KAKINGA TRADING CENTRE,658,1,1,0,47,424,473,9,482,0,O-122-51-04-01-02
KABAROLE,BUNYANGABU COUNTY,RWIIMI,KADINDIMO,RUBARIKA,522,2,0,3,19,371,395,13,408,0,O-122-51-04-01-03
KABAROLE,BUNYANGABU COUNTY,RWIIMI,KADINDIMO,RWANGOGA BAR,552,1,0,2,31,373,407,7,414,0,O-122-51-04-01-04
KABAROLE,BUNYANGABU COUNTY,RWIIMI,KADINDIMO,KAJUMIRO TRADING CENTER,240,0,0,1,25,159,185,9,194,0,O-122-51-04-01-05
KABAROLE,BUNYANGABU COUNTY,RWIIMI,KAINA,KAINA TRADING CENTRE,556,0,0,4,39,365,408,14,422,0,O-122-51-04-02-01
KABAROLE,BUNYANGABU COUNTY,RWIIMI,KAINA,NTAMBI PRIMARY SCHOOL,537,1,0,3,15,350,369,5,374,0,O-122-51-04-02-02
KABAROLE,BUNYANGABU COUNTY,RWIIMI,KAINA,NTARABAYANA P. SCHOOL,427,6,0,1,34,267,308,9,317,0,O-122-51-04-02-03
KABAROLE,BUNYANGABU COUNTY,RWIIMI,KAKOOGA,KAKOOGA PRIMARY SCHOOL,608,2,0,3,61,372,438,24,462,0,O-122-51-04-03-01
KABAROLE,BUNYANGABU COUNTY,RWIIMI,KAKOOGA,MUKETABURE TRADING CENTRE,435,0,1,5,32,239,277,22,299,0,O-122-51-04-03-02
KABAROLE,BUNYANGABU COUNTY,RWIIMI,KAKOOGA,RUBALIKA CHURCH SCHOOL,533,1,1,0,40,274,316,12,328,0,O-122-51-04-03-03
KABAROLE,BUNYANGABU COUNTY,RWIIMI,RWIMI,GATYANGA T. C.,573,2,0,7,228,132,369,14,383,0,O-122-51-04-04-01
KABAROLE,BUNYANGABU COUNTY,RWIIMI,RWIMI,KABURAISOKE RC I MEETING CEN,698,3,1,1,69,366,440,22,462,0,O-122-51-04-04-02
KABAROLE,BUNYANGABU COUNTY,RWIIMI,RWIMI,KAGORO T. C.,410,1,0,1,28,249,279,17,296,0,O-122-51-04-04-03
KABAROLE,BUNYANGABU COUNTY,RWIIMI,RWIMI,KYAKATABAAZI P. S.,631,2,0,2,40,377,421,9,430,0,O-122-51-04-04-04
KABAROLE,BUNYANGABU COUNTY,RWIIMI,RWIMI,NYABWINA CHURCH,563,6,0,7,161,213,387,12,399,0,O-122-51-04-04-05
KABAROLE,BUNYANGABU COUNTY,RWIIMI,RWIMI,RWIMI P. S. B,690,2,1,5,76,272,356,5,361,0,O-122-51-04-04-06
KABAROLE,BUNYANGABU COUNTY,RWIIMI,RWIMI,RWIMI P. S. A,498,0,0,0,41,293,334,8,342,0,O-122-51-04-04-07
KABAROLE,BUNYANGABU COUNTY,RWIIMI,RWIMI,RWIMI P. S. C,383,0,0,0,35,207,242,8,250,0,O-122-51-04-04-08
HOIMA,BUHAGUZI COUNTY,BUGAMBE,BUGAMBE,KANIGIRO,783,7,1,6,70,534,618,32,650,0,O-128-29-01-01-01
HOIMA,BUHAGUZI COUNTY,BUGAMBE,BUGAMBE,MAIRIRWE,282,2,1,1,34,191,229,7,236,0,O-128-29-01-01-02
HOIMA,BUHAGUZI COUNTY,BUGAMBE,BUGAMBE,KYAKIRUUBE,184,3,1,0,25,131,160,3,163,0,O-128-29-01-01-03
HOIMA,BUHAGUZI COUNTY,BUGAMBE,BUGAMBE,MUHWIJU,301,0,2,2,15,265,284,5,289,0,O-128-29-01-01-04
HOIMA,BUHAGUZI COUNTY,BUGAMBE,KATANGA,KYABASEKE,806,7,4,4,178,390,583,0,583,0,O-128-29-01-02-01
HOIMA,BUHAGUZI COUNTY,BUGAMBE,KATANGA,IBAMBIRO A (A-C),595,8,1,3,123,259,394,20,414,0,O-128-29-01-02-02
HOIMA,BUHAGUZI COUNTY,BUGAMBE,KATANGA,IBAMBIRO B,1004,9,2,8,76,635,730,18,748,0,O-128-29-01-02-03
HOIMA,BUHAGUZI COUNTY,BUGAMBE,KATANGA,IBAMBIRO A (D-N),548,8,1,1,85,259,354,25,379,0,O-128-29-01-02-04
HOIMA,BUHAGUZI COUNTY,BUGAMBE,KATANGA,IBAMBIRO A(O-Z),708,1,2,7,197,228,435,15,450,0,O-128-29-01-02-05
HOIMA,BUHAGUZI COUNTY,BUGAMBE,NYARUGABU,NYARUGABU P/S,417,3,0,1,29,291,324,19,343,0,O-128-29-01-03-01
HOIMA,BUHAGUZI COUNTY,BUGAMBE,NYARUGABU,KIDUUMA,638,1,2,1,93,404,501,15,516,0,O-128-29-01-03-02
HOIMA,BUHAGUZI COUNTY,BUGAMBE,NYARUGABU,KITONDORA,423,2,0,2,62,310,376,12,388,0,O-128-29-01-03-03
HOIMA,BUHAGUZI COUNTY,BUGAMBE,NYARUGABU,KIRISA P/S,477,1,0,1,36,347,385,24,409,0,O-128-29-01-03-04
HOIMA,BUHAGUZI COUNTY,BUGAMBE,NYARUGABU,KYAKABALE P/S,330,0,0,1,19,278,298,10,308,0,O-128-29-01-03-05
HOIMA,BUHAGUZI COUNTY,BUGAMBE,RUGUSE,KYAKAJAKA,509,4,0,2,42,362,410,17,427,0,O-128-29-01-04-01
HOIMA,BUHAGUZI COUNTY,BUGAMBE,RUGUSE,RUGUSE P/S,975,6,0,1,91,703,801,20,821,0,O-128-29-01-04-02
HOIMA,BUHAGUZI COUNTY,BUGAMBE,RUGUSE,KYAKASORO,548,2,0,2,52,401,457,20,477,0,O-128-29-01-04-03
HOIMA,BUHAGUZI COUNTY,BUGAMBE,RUGUSE,BUJUGU,547,1,1,4,37,442,485,1,486,0,O-128-29-01-04-04
HOIMA,BUHAGUZI COUNTY,BUHIMBA,KINOGOZI,KISENYI P/S,637,3,6,2,73,374,458,46,504,0,O-128-29-02-01-01
HOIMA,BUHAGUZI COUNTY,BUHIMBA,KINOGOZI,KINOGOZI P/S,461,1,4,1,84,253,343,24,367,0,O-128-29-02-01-02
HOIMA,BUHAGUZI COUNTY,BUHIMBA,KINOGOZI,NGOMA P/S (NGOGOMA),609,2,0,0,39,488,529,2,531,0,O-128-29-02-01-03
HOIMA,BUHAGUZI COUNTY,BUHIMBA,KINOGOZI,KIGARAMA P/S,522,1,1,0,84,351,437,18,455,0,O-128-29-02-01-04
HOIMA,BUHAGUZI COUNTY,BUHIMBA,KINOGOZI,KABAALE,408,4,1,2,52,255,314,15,329,0,O-128-29-02-01-05
HOIMA,BUHAGUZI COUNTY,BUHIMBA,KYABATALYA,BUHIMBA S/C,652,5,0,3,89,380,477,20,497,0,O-128-29-02-02-01
HOIMA,BUHAGUZI COUNTY,BUHIMBA,KYABATALYA,BUHIMBA DISP,783,8,4,0,119,442,573,13,586,0,O-128-29-02-02-02
HOIMA,BUHAGUZI COUNTY,BUHIMBA,KYABATALYA,KIKOBOZA P/S,709,4,2,0,106,478,590,4,594,0,O-128-29-02-02-03
HOIMA,BUHAGUZI COUNTY,BUHIMBA,KYABATALYA,KIBARURA P/S,608,5,1,3,63,461,533,3,536,0,O-128-29-02-02-04
HOIMA,BUHAGUZI COUNTY,BUHIMBA,MUSAIJAMUKURU EA,BUJALYA (A-KA),428,1,0,0,34,313,348,10,358,0,O-128-29-02-03-01
HOIMA,BUHAGUZI COUNTY,BUHIMBA,MUSAIJAMUKURU EA,KIHABWEMI,633,4,3,1,39,409,456,19,475,0,O-128-29-02-03-02
HOIMA,BUHAGUZI COUNTY,BUHIMBA,MUSAIJAMUKURU EA,MUSAIJAMUKURU EAST,424,6,1,1,23,324,355,7,362,0,O-128-29-02-03-03
HOIMA,BUHAGUZI COUNTY,BUHIMBA,MUSAIJAMUKURU EA,BUJALYA (KE-Z),439,0,0,0,45,288,333,19,352,0,O-128-29-02-03-04
HOIMA,BUHAGUZI COUNTY,BUHIMBA,MUSAIJAMUKURU WE,KIGAAYA P/S,632,1,0,2,46,436,485,7,492,0,O-128-29-02-04-01
HOIMA,BUHAGUZI COUNTY,BUHIMBA,MUSAIJAMUKURU WE,KAKOOGE,455,1,0,0,83,302,386,9,395,0,O-128-29-02-04-02
HOIMA,BUHAGUZI COUNTY,BUHIMBA,MUSAIJAMUKURU WE,IBANDA A,676,2,4,2,61,450,519,12,531,0,O-128-29-02-04-03
HOIMA,BUHAGUZI COUNTY,BUHIMBA,MUSAIJAMUKURU WE,IBANDA B,522,1,0,0,35,385,421,10,431,0,O-128-29-02-04-04
HOIMA,BUHAGUZI COUNTY,BUHIMBA,RUHUNGA,KITOOLE P/S,661,5,0,4,54,471,534,19,553,0,O-128-29-02-05-01
HOIMA,BUHAGUZI COUNTY,BUHIMBA,RUHUNGA,RUHUNGA (A-KE),448,5,1,3,28,315,352,11,363,0,O-128-29-02-05-02
HOIMA,BUHAGUZI COUNTY,BUHIMBA,RUHUNGA,RWEMPARAKI,375,1,0,3,20,281,305,11,316,0,O-128-29-02-05-03
HOIMA,BUHAGUZI COUNTY,BUHIMBA,RUHUNGA,RUHUNGA (KI-Z),511,2,0,3,26,342,373,8,381,0,O-128-29-02-05-04
HOIMA,BUHAGUZI COUNTY,KABWOYA,BUBOGO,BUBOGO,507,4,0,1,25,369,399,11,410,0,O-128-29-03-01-01
HOIMA,BUHAGUZI COUNTY,KABWOYA,BUBOGO,KABWOYA T/C,775,2,2,2,71,495,572,17,589,0,O-128-29-03-01-02
HOIMA,BUHAGUZI COUNTY,KABWOYA,BUBOGO,KIHOOKO,286,2,1,0,27,170,200,7,207,0,O-128-29-03-01-03
HOIMA,BUHAGUZI COUNTY,KABWOYA,BUBOGO,KYAMUGOBE(A-L),616,3,1,1,32,389,426,4,430,0,O-128-29-03-01-04
HOIMA,BUHAGUZI COUNTY,KABWOYA,BUBOGO,KYAMUGOBE (M-Z),540,2,0,0,16,341,359,13,372,0,O-128-29-03-01-05
HOIMA,BUHAGUZI COUNTY,KABWOYA,IGWANJURA,KITOOKE,517,2,0,3,37,320,362,12,374,0,O-128-29-03-02-01
HOIMA,BUHAGUZI COUNTY,KABWOYA,IGWANJURA,RWENTAHI P/S,517,3,0,0,32,313,348,7,355,0,O-128-29-03-02-02
HOIMA,BUHAGUZI COUNTY,KABWOYA,IGWANJURA,AKASOMORO P/S,381,2,1,3,20,222,248,22,270,0,O-128-29-03-02-03
HOIMA,BUHAGUZI COUNTY,KABWOYA,IGWANJURA,MAAYA (A-L),466,2,1,0,30,206,239,5,244,0,O-128-29-03-02-04
HOIMA,BUHAGUZI COUNTY,KABWOYA,IGWANJURA,MAAYA (M-Z),429,1,4,1,41,223,270,9,279,0,O-128-29-03-02-05
HOIMA,BUHAGUZI COUNTY,KABWOYA,KASEETA,HOHWA CATHOLIC CHURCH,754,14,6,11,59,371,461,8,469,0,O-128-29-03-03-01
HOIMA,BUHAGUZI COUNTY,KABWOYA,KASEETA,NYANSEKE P/S (A-KA),487,11,3,3,47,246,310,8,318,0,O-128-29-03-03-02
HOIMA,BUHAGUZI COUNTY,KABWOYA,KASEETA,NYANSEKE P/S (KE-Z),509,5,1,4,38,289,337,20,357,0,O-128-29-03-03-03
HOIMA,BUHAGUZI COUNTY,KABWOYA,KIMBUGU,KISAARU P/S,819,6,2,3,54,404,469,28,497,0,O-128-29-03-04-01
HOIMA,BUHAGUZI COUNTY,KABWOYA,KIMBUGU,KARAMA P/S (A-L),361,2,0,1,20,151,174,0,174,0,O-128-29-03-04-02
HOIMA,BUHAGUZI COUNTY,KABWOYA,KIMBUGU,KARAMA P/S (M-Z),489,3,0,5,30,284,322,8,330,0,O-128-29-03-04-03
HOIMA,BUHAGUZI COUNTY,KABWOYA,KIMBUGU,KARAMA OUTSIDE Q.GUARD,555,0,3,2,23,300,328,4,332,0,O-128-29-03-04-04
HOIMA,BUHAGUZI COUNTY,KABWOYA,NKONDO,NKONDO,460,8,0,2,124,96,230,0,230,0,O-128-29-03-05-01
HOIMA,BUHAGUZI COUNTY,KABWOYA,NKONDO,NYAWAIGA P/S,620,4,3,2,39,319,367,4,371,0,O-128-29-03-05-02
HOIMA,BUHAGUZI COUNTY,KABWOYA,NKONDO,KYEHORO,655,4,0,5,80,180,269,5,274,0,O-128-29-03-05-03
HOIMA,BUHAGUZI COUNTY,KIZIRANFUMBI,BULIMYA,KIKUUBE P/S,766,1,1,4,100,484,590,18,608,0,O-128-29-04-01-01
HOIMA,BUHAGUZI COUNTY,KIZIRANFUMBI,BULIMYA,RUMOGI P/S,395,4,0,4,47,268,323,14,337,0,O-128-29-04-01-02
HOIMA,BUHAGUZI COUNTY,KIZIRANFUMBI,BULIMYA,MUKABARA P/S,648,7,1,7,62,416,493,18,511,0,O-128-29-04-01-03
HOIMA,BUHAGUZI COUNTY,KIZIRANFUMBI,BULIMYA,SIR TITO P/S,723,2,0,2,141,386,531,23,554,0,O-128-29-04-01-04
HOIMA,BUHAGUZI COUNTY,KIZIRANFUMBI,BULIMYA,KAMUSUNSI P/S,630,2,2,4,78,424,510,17,527,0,O-128-29-04-01-05
HOIMA,BUHAGUZI COUNTY,KIZIRANFUMBI,BULIMYA,KISAMBO P/S,354,1,1,3,39,244,288,28,316,0,O-128-29-04-01-06
HOIMA,BUHAGUZI COUNTY,KIZIRANFUMBI,KIDOMA,WAMBABYA,448,3,4,2,52,256,317,14,331,0,O-128-29-04-02-01
HOIMA,BUHAGUZI COUNTY,KIZIRANFUMBI,KIDOMA,KYAKATEMBA,477,2,0,3,36,379,420,5,425,0,O-128-29-04-02-02
HOIMA,BUHAGUZI COUNTY,KIZIRANFUMBI,KIDOMA,RUSAKA P/S,586,5,1,3,55,436,500,16,516,0,O-128-29-04-02-03
HOIMA,BUHAGUZI COUNTY,KIZIRANFUMBI,KIDOMA,KIHANGA CATHOLIC CHURCH,443,0,0,3,40,314,357,11,368,0,O-128-29-04-02-04
HOIMA,BUHAGUZI COUNTY,KIZIRANFUMBI,MUNTEME,MUTEME P/S,603,5,5,1,59,375,445,10,455,0,O-128-29-04-03-01
HOIMA,BUHAGUZI COUNTY,KIZIRANFUMBI,MUNTEME,KAIGO P/S,658,4,0,4,79,471,558,12,570,0,O-128-29-04-03-02
HOIMA,BUHAGUZI COUNTY,KIZIRANFUMBI,MUNTEME,KAISWAZA P/S,745,5,5,7,63,493,573,10,583,0,O-128-29-04-03-03
HOIMA,BUHAGUZI COUNTY,KIZIRANFUMBI,MUNTEME,KAJOGA T/C,233,0,1,0,9,202,212,2,214,0,O-128-29-04-03-04
HOIMA,BUHAGUZI COUNTY,KYANGWALI,BUHUKA,NSONGA CHURCH,978,4,0,9,112,381,506,16,522,0,O-128-29-05-01-01
HOIMA,BUHAGUZI COUNTY,KYANGWALI,BUHUKA,KIINA T/C,289,1,1,2,35,202,241,2,243,0,O-128-29-05-01-02
HOIMA,BUHAGUZI COUNTY,KYANGWALI,BUHUKA,KYENYANJA,200,4,0,1,26,42,73,6,79,0,O-128-29-05-01-03
HOIMA,BUHAGUZI COUNTY,KYANGWALI,BUTOOLE,BUTOOLE,1045,2,3,6,15,491,517,30,547,0,O-128-29-05-02-01
HOIMA,BUHAGUZI COUNTY,KYANGWALI,BUTOOLE,NSOZI,349,0,0,0,7,186,193,11,204,0,O-128-29-05-02-02
HOIMA,BUHAGUZI COUNTY,KYANGWALI,BUTOOLE,MAHAMBA (A-L),526,3,0,2,9,302,316,9,325,0,O-128-29-05-02-03
HOIMA,BUHAGUZI COUNTY,KYANGWALI,BUTOOLE,KYARUJUMBA,548,2,2,2,25,311,342,27,369,0,O-128-29-05-02-04
HOIMA,BUHAGUZI COUNTY,KYANGWALI,BUTOOLE,MBURARA,586,5,1,4,16,403,429,14,443,0,O-128-29-05-02-05
HOIMA,BUHAGUZI COUNTY,KYANGWALI,BUTOOLE,MAHAMBA (M-Z),636,3,0,3,8,362,376,16,392,0,O-128-29-05-02-06
HOIMA,BUHAGUZI COUNTY,KYANGWALI,BUTOOLE,KYARUSHESHYA P/S,465,0,0,1,6,432,439,3,442,0,O-128-29-05-02-07
HOIMA,BUHAGUZI COUNTY,KYANGWALI,KASONGA,BUKINDA (A-L),717,0,3,2,52,415,472,12,484,0,O-128-29-05-03-01
HOIMA,BUHAGUZI COUNTY,KYANGWALI,KASONGA,KASONGA HQRS,690,8,1,4,48,398,459,19,478,0,O-128-29-05-03-02
HOIMA,BUHAGUZI COUNTY,KYANGWALI,KASONGA,BUKINDA (M-Z),803,2,2,5,47,471,527,25,552,0,O-128-29-05-03-03
HOIMA,BUHAGUZI COUNTY,KYANGWALI,KYANGWALI,NGOMA (A-M),381,1,0,5,17,213,236,9,245,0,O-128-29-05-04-01
HOIMA,BUHAGUZI COUNTY,KYANGWALI,KYANGWALI,KITUTI MKT,541,2,1,2,22,350,377,9,386,0,O-128-29-05-04-02
HOIMA,BUHAGUZI COUNTY,KYANGWALI,KYANGWALI,KYANGWALI T/C,615,1,0,1,17,444,463,8,471,0,O-128-29-05-04-03
HOIMA,BUHAGUZI COUNTY,KYANGWALI,KYANGWALI,NGOMA (N-Z),349,1,1,2,17,199,220,14,234,0,O-128-29-05-04-04
HOIMA,BUHAGUZI COUNTY,KYANGWALI,KYANGWALI,RWENSAMBYA,555,3,2,0,19,188,212,5,217,0,O-128-29-05-04-05
HOIMA,BUHAGUZI COUNTY,KYANGWALI,KYANGWALI,HANGA T/C,512,7,2,6,18,289,322,11,333,0,O-128-29-05-04-06
HOIMA,BUHAGUZI COUNTY,KYANGWALI,KYANGWALI,NYANSENGE,522,4,3,6,29,371,413,7,420,0,O-128-29-05-04-07
HOIMA,BUHAGUZI COUNTY,KYANGWALI,KYANGWALI,KYANGWALI OUTSIDE GUARD,450,2,11,0,36,375,424,6,430,0,O-128-29-05-04-08
KIRUHURA,KAZO COUNTY,BUREMBA,BUGUTSYO,KIBWERA [A - L],552,3,1,2,55,283,344,5,349,0,O-130-141-01-01-01
KIRUHURA,KAZO COUNTY,BUREMBA,BUGUTSYO,KAKONI,750,3,0,1,66,470,540,12,552,0,O-130-141-01-01-02
KIRUHURA,KAZO COUNTY,BUREMBA,BUGUTSYO,KIBWERA [M - Z],457,1,1,0,47,247,296,8,304,0,O-130-141-01-01-03
KIRUHURA,KAZO COUNTY,BUREMBA,KIBINGO,KABINGO,459,1,0,1,40,408,450,5,455,0,O-130-141-01-02-01
KIRUHURA,KAZO COUNTY,BUREMBA,KIBINGO,KISHORORO,657,0,0,0,69,427,496,13,509,0,O-130-141-01-02-02
KIRUHURA,KAZO COUNTY,BUREMBA,KIJOOHA,KYABAHURA,812,4,2,4,120,455,585,7,592,0,O-130-141-01-03-01
KIRUHURA,KAZO COUNTY,BUREMBA,KIJOOHA,MIRAMBI,374,4,1,1,61,248,315,2,317,0,O-130-141-01-03-02
KIRUHURA,KAZO COUNTY,BUREMBA,KIJOOHA,BUREMBA [A - L],540,1,0,3,47,299,350,5,355,0,O-130-141-01-03-03
KIRUHURA,KAZO COUNTY,BUREMBA,KIJOOHA,KIJOOHA,657,3,1,1,70,373,448,10,458,0,O-130-141-01-03-04
KIRUHURA,KAZO COUNTY,BUREMBA,KIJOOHA,BUREMBA [M - Z],515,1,1,2,75,406,485,5,490,0,O-130-141-01-03-05
KIRUHURA,KAZO COUNTY,BUREMBA,KITAMBA,RYESINDIZI,295,1,0,0,43,179,223,27,250,0,O-130-141-01-04-01
KIRUHURA,KAZO COUNTY,BUREMBA,KITAMBA,MATAABA,183,0,0,0,1,179,180,2,182,0,O-130-141-01-04-02
KIRUHURA,KAZO COUNTY,BUREMBA,KITAMBA,KITAMBA,669,1,3,0,57,390,451,7,458,0,O-130-141-01-04-03
KIRUHURA,KAZO COUNTY,BUREMBA,KITAMBA,NGOMBA,657,4,0,1,28,620,653,3,656,0,O-130-141-01-04-04
KIRUHURA,KAZO COUNTY,BUREMBA,NKUNGU,KIGAAGA / NYAMUSHOJWA,345,2,0,1,30,300,333,7,340,0,O-130-141-01-05-01
KIRUHURA,KAZO COUNTY,BUREMBA,NKUNGU,NKUNGU,753,5,1,1,105,349,461,5,466,0,O-130-141-01-05-02
KIRUHURA,KAZO COUNTY,BUREMBA,NKUNGU,OMUNTEBE,503,2,1,2,80,367,452,2,454,0,O-130-141-01-05-03
KIRUHURA,KAZO COUNTY,BUREMBA,NKUNGU,KAGARAMIRA,694,3,1,2,128,447,581,5,586,0,O-130-141-01-05-04
KIRUHURA,KAZO COUNTY,BUREMBA,NKUNGU,NYONDO,336,0,1,0,68,180,249,1,250,0,O-130-141-01-05-05
KIRUHURA,KAZO COUNTY,BUREMBA,NKUNGU,OMUNTEBE II,502,1,1,3,83,373,461,10,471,0,O-130-141-01-05-06
KIRUHURA,KAZO COUNTY,BUREMBA,NKUNGU,KAMUSENENE,398,0,0,0,59,181,240,4,244,0,O-130-141-01-05-07
KIRUHURA,KAZO COUNTY,BUREMBA,NSHUNGA,RUCUMU,331,4,0,5,54,236,299,2,301,0,O-130-141-01-06-01
KIRUHURA,KAZO COUNTY,BUREMBA,NSHUNGA,NSUNGA PARISH HQRS,776,4,0,0,55,453,512,1,513,0,O-130-141-01-06-02
KIRUHURA,KAZO COUNTY,BUREMBA,NSHUNGA,KATARAZA,552,3,1,0,76,301,381,1,382,0,O-130-141-01-06-03
KIRUHURA,KAZO COUNTY,BUREMBA,NSHUNGA,KAZUZYA,449,0,3,2,27,345,377,2,379,0,O-130-141-01-06-04
KIRUHURA,KAZO COUNTY,BURUNGA,BURUNGA,BURUNGA,577,5,0,0,26,539,570,3,573,0,O-130-141-02-01-01
KIRUHURA,KAZO COUNTY,BURUNGA,BURUNGA,BUYAGA,303,0,0,1,11,288,300,0,300,0,O-130-141-02-01-02
KIRUHURA,KAZO COUNTY,BURUNGA,BURUNGA,KIRINGA P/S,124,0,0,0,0,122,122,1,123,0,O-130-141-02-01-03
KIRUHURA,KAZO COUNTY,BURUNGA,KIGUMA,KIGUMA,527,0,0,0,0,517,517,0,517,0,O-130-141-02-02-01
KIRUHURA,KAZO COUNTY,BURUNGA,KIGUMA,KISHEBASHEBE,219,0,0,0,0,218,218,1,219,0,O-130-141-02-02-02
KIRUHURA,KAZO COUNTY,BURUNGA,KIGUMA,MWITANUNGI,247,0,0,0,0,243,243,0,243,0,O-130-141-02-02-03
KIRUHURA,KAZO COUNTY,BURUNGA,MAGONDO,MAGONDO P/S,621,0,0,0,19,579,598,2,600,0,O-130-141-02-03-01
KIRUHURA,KAZO COUNTY,BURUNGA,MAGONDO,KENWA,425,0,0,1,25,396,422,1,423,0,O-130-141-02-03-02
KIRUHURA,KAZO COUNTY,BURUNGA,MAGONDO,BUHEMBE,546,0,1,0,27,479,507,3,510,0,O-130-141-02-03-03
KIRUHURA,KAZO COUNTY,BURUNGA,MAGONDO,RWABIHERA PRI. SCHOOL,326,1,1,0,12,298,312,13,325,0,O-130-141-02-03-04
KIRUHURA,KAZO COUNTY,BURUNGA,RWIGI,RWIIGI,673,0,0,0,1,668,669,4,673,0,O-130-141-02-04-01
KIRUHURA,KAZO COUNTY,BURUNGA,RWIGI,BYABASIITA PRI. SCHOOL,279,1,0,0,5,229,235,27,262,0,O-130-141-02-04-02
KIRUHURA,KAZO COUNTY,KANONI,ENGARI,SYA A,577,2,0,2,14,457,475,3,478,0,O-130-141-03-01-01
KIRUHURA,KAZO COUNTY,KANONI,ENGARI,RWEMIKYENKYE PRI. SCHOOL,638,2,2,4,72,362,442,1,443,0,O-130-141-03-01-02
KIRUHURA,KAZO COUNTY,KANONI,ENGARI,ENGARI,724,1,1,2,39,681,724,0,724,0,O-130-141-03-01-03
KIRUHURA,KAZO COUNTY,KANONI,ENGARI,SYA B,509,1,1,1,37,401,441,9,450,0,O-130-141-03-01-04
KIRUHURA,KAZO COUNTY,KANONI,KAICUMU,KAICUMU,786,0,4,2,98,470,574,0,574,0,O-130-141-03-02-01
KIRUHURA,KAZO COUNTY,KANONI,KAICUMU,NSHESHE,390,3,0,0,35,335,373,3,376,0,O-130-141-03-02-02
KIRUHURA,KAZO COUNTY,KANONI,KITONGORE,KITONGORE 1,394,0,0,1,50,227,278,5,283,0,O-130-141-03-03-01
KIRUHURA,KAZO COUNTY,KANONI,KITONGORE,KITONGORE 2,294,0,1,1,31,171,204,8,212,0,O-130-141-03-03-02
KIRUHURA,KAZO COUNTY,KANONI,KITONGORE,KITONGORE 3,350,3,1,0,44,194,242,3,245,0,O-130-141-03-03-03
KIRUHURA,KAZO COUNTY,KANONI,KITONGORE,KITONGORE 4,236,0,0,1,35,154,190,6,196,0,O-130-141-03-03-04
KIRUHURA,KAZO COUNTY,KANONI,KITONGORE,KITONGORE PARISH HQRS,736,7,1,0,72,463,543,1,544,0,O-130-141-03-03-05
KIRUHURA,KAZO COUNTY,KANONI,KYENGANDO,KYENGANDO 1,430,1,0,4,30,386,421,0,421,0,O-130-141-03-04-01
KIRUHURA,KAZO COUNTY,KANONI,KYENGANDO,KYENGANDO 2,792,5,4,2,117,600,728,0,728,0,O-130-141-03-04-02
KIRUHURA,KAZO COUNTY,KANONI,KYENGANDO,KYENGANDO 3,622,0,0,0,11,218,229,2,231,0,O-130-141-03-04-03
KIRUHURA,KAZO COUNTY,KANONI,KYENGANDO,KITONGORE,421,1,0,4,50,320,375,5,380,0,O-130-141-03-04-04
KIRUHURA,KAZO COUNTY,KANONI,MBOGO,KIGUSHA,272,0,0,1,36,193,230,6,236,0,O-130-141-03-05-01
KIRUHURA,KAZO COUNTY,KANONI,MBOGO,MBOGO TC,590,2,0,2,46,531,581,4,585,0,O-130-141-03-05-02
KIRUHURA,KAZO COUNTY,KANONI,MBOGO,KARITUTSI,333,4,1,2,27,295,329,0,329,0,O-130-141-03-05-03
KIRUHURA,KAZO COUNTY,KANONI,MBOGO,BISHOZI,305,2,0,1,21,239,263,5,268,0,O-130-141-03-05-04
KIRUHURA,KAZO COUNTY,KANONI,MBOGO,AKATI,178,0,0,0,8,151,159,7,166,0,O-130-141-03-05-05
KIRUHURA,KAZO COUNTY,KANONI,NYARUBANGA,KANONI T/C,468,1,0,2,36,273,312,10,322,0,O-130-141-03-06-01
KIRUHURA,KAZO COUNTY,KANONI,NYARUBANGA,NYABIHERERE I,486,0,0,0,37,438,475,9,484,0,O-130-141-03-06-02
KIRUHURA,KAZO COUNTY,KANONI,NYARUBANGA,BYERIMA,344,1,0,0,36,250,287,5,292,0,O-130-141-03-06-03
KIRUHURA,KAZO COUNTY,KANONI,NYARUBANGA,RWAKAHAYA TC,654,4,1,1,90,550,646,4,650,0,O-130-141-03-06-04
KIRUHURA,KAZO COUNTY,KANONI,NYARUBANGA,BWAGONGA P/S,653,2,0,5,65,478,550,12,562,0,O-130-141-03-06-05
KIRUHURA,KAZO COUNTY,KANONI,NYARUBANGA,NYARUBANGA,236,0,0,1,49,159,209,1,210,0,O-130-141-03-06-06
KIRUHURA,KAZO COUNTY,KANONI,NYARUBANGA,RWAKAHAYA P/S,278,0,0,1,44,166,211,4,215,0,O-130-141-03-06-07
KIRUHURA,KAZO COUNTY,KANONI,RWEMENGO,RWEMIGINA,386,3,0,0,21,345,369,5,374,0,O-130-141-03-07-01
KIRUHURA,KAZO COUNTY,KANONI,RWEMENGO,RWEMENGO,353,1,0,0,12,309,322,14,336,0,O-130-141-03-07-02
KIRUHURA,KAZO COUNTY,KANONI,RWEMENGO,KATAGYENGYERA,375,1,1,2,36,267,307,18,325,0,O-130-141-03-07-03
KIRUHURA,KAZO COUNTY,KAZO,IBAARE,RWETUMA MOSQUE,275,0,0,0,47,219,266,4,270,0,O-130-141-04-01-01
KIRUHURA,KAZO COUNTY,KAZO,IBAARE,AKENGYEYA,399,2,0,1,50,280,333,5,338,0,O-130-141-04-01-02
KIRUHURA,KAZO COUNTY,KAZO,IBAARE,AKASHAYI / IBAARE I,405,0,0,0,30,371,401,0,401,0,O-130-141-04-01-03
KIRUHURA,KAZO COUNTY,KAZO,IBAARE,OBWENGAARA,383,1,2,2,54,320,379,0,379,0,O-130-141-04-01-04
KIRUHURA,KAZO COUNTY,KAZO,KAYANGA,NYAMAMBO,527,2,1,1,30,465,499,7,506,0,O-130-141-04-02-01
KIRUHURA,KAZO COUNTY,KAZO,KAYANGA,KITENGYETO P/S,141,0,0,0,0,137,137,0,137,0,O-130-141-04-02-02
KIRUHURA,KAZO COUNTY,KAZO,KAYANGA,KASHENYI P/S,517,0,0,2,11,341,354,15,369,0,O-130-141-04-02-03
KIRUHURA,KAZO COUNTY,KAZO,KAZO,KYABAHURA P/S,767,1,1,1,64,429,496,1,497,0,O-130-141-04-03-01
KIRUHURA,KAZO COUNTY,KAZO,KAZO,KAZO P/S,645,0,0,0,50,541,591,6,597,0,O-130-141-04-03-02
KIRUHURA,KAZO COUNTY,KAZO,KAZO,GABARUNGI,543,3,1,2,25,433,464,13,477,0,O-130-141-04-03-03
KIRUHURA,KAZO COUNTY,KAZO,KAZO,AKASHONDA,466,0,0,0,35,336,371,13,384,0,O-130-141-04-03-04
KIRUHURA,KAZO COUNTY,KAZO,KAZO,RWABOONYO P/S,378,0,0,1,15,358,374,1,375,0,O-130-141-04-03-05
KIRUHURA,KAZO COUNTY,KAZO,KAZO,RUZINGA,482,0,3,2,21,360,386,4,390,0,O-130-141-04-03-06
KIRUHURA,KAZO COUNTY,KAZO,KYAMPANGARA,KYAMPANGARA,715,1,1,3,90,354,449,6,455,0,O-130-141-04-04-01
KIRUHURA,KAZO COUNTY,KAZO,KYAMPANGARA,OBUZINGA,303,2,0,2,42,177,223,2,225,0,O-130-141-04-04-02
KIRUHURA,KAZO COUNTY,KAZO,KYAMPANGARA,IBAARE II P/S,473,0,1,2,38,322,363,24,387,0,O-130-141-04-04-03
KIRUHURA,KAZO COUNTY,KAZO,KYAMPANGARA,NYUNGU,277,0,0,0,35,158,193,8,201,0,O-130-141-04-04-04
KIRUHURA,KAZO COUNTY,KAZO,MBABA,MBABA,649,1,5,2,40,577,625,8,633,0,O-130-141-04-05-01
KIRUHURA,KAZO COUNTY,KAZO,MBABA,NYAKINOMBE,460,4,0,1,3,410,418,10,428,0,O-130-141-04-05-02
KIRUHURA,KAZO COUNTY,KAZO,MBABA,KABATANAGI,268,0,1,1,38,153,193,9,202,0,O-130-141-04-05-03
KIRUHURA,KAZO COUNTY,KAZO,MBABA,BUTERANIRO,170,0,0,0,12,123,135,3,138,0,O-130-141-04-05-04
KIRUHURA,KAZO COUNTY,KAZO,NTAMBAZI,RWAMUNUMA A,704,0,0,2,82,604,688,14,702,0,O-130-141-04-06-01
KIRUHURA,KAZO COUNTY,KAZO,NTAMBAZI,RWAMUNUMA B,346,0,0,3,16,233,252,8,260,0,O-130-141-04-06-02
KIRUHURA,KAZO COUNTY,KAZO,NTAMBAZI,KYANTUMA,591,1,0,1,56,356,414,5,419,0,O-130-141-04-06-03
KIRUHURA,KAZO COUNTY,KAZO,NTAMBAZI,KIGARAMA,427,4,0,0,43,270,317,3,320,0,O-130-141-04-06-04
KIRUHURA,KAZO COUNTY,KAZO,RWAMURUNGA,RWAMURANGA,381,0,0,0,6,370,376,5,381,0,O-130-141-04-07-01
KIRUHURA,KAZO COUNTY,KAZO,RWAMURUNGA,KYEJU,397,0,0,0,8,381,389,2,391,0,O-130-141-04-07-02
KIRUHURA,KAZO COUNTY,KAZO,RWAMURUNGA,MIRAMA,309,1,0,0,16,287,304,1,305,0,O-130-141-04-07-03
KIRUHURA,KAZO COUNTY,RWEMIKOMA,BUGARIHE,BUGARIHE,705,0,0,0,11,652,663,23,686,0,O-130-141-05-01-01
KIRUHURA,KAZO COUNTY,RWEMIKOMA,BUGARIHE,RWAKAKUNGU,578,0,0,0,6,437,443,1,444,0,O-130-141-05-01-02
KIRUHURA,KAZO COUNTY,RWEMIKOMA,KIJUMA,KIJUMA,647,0,0,0,3,628,631,5,636,0,O-130-141-05-02-01
KIRUHURA,KAZO COUNTY,RWEMIKOMA,KIJUMA,KASHUNGA,315,0,0,0,0,283,283,0,283,0,O-130-141-05-02-02
KIRUHURA,KAZO COUNTY,RWEMIKOMA,KIJUMA,KYENTUREGYE,546,0,0,0,4,539,543,0,543,0,O-130-141-05-02-03
KIRUHURA,KAZO COUNTY,RWEMIKOMA,MIGINA,MIGINA [A - L],609,4,0,1,15,497,517,68,585,0,O-130-141-05-03-01
KIRUHURA,KAZO COUNTY,RWEMIKOMA,MIGINA,AKATONGORE PRI. SCHOOL,540,0,3,1,35,397,436,0,436,0,O-130-141-05-03-02
KIRUHURA,KAZO COUNTY,RWEMIKOMA,MIGINA,KIKONI,450,0,0,1,49,385,435,3,438,0,O-130-141-05-03-03
KIRUHURA,KAZO COUNTY,RWEMIKOMA,MIGINA,MIGINA [M - Z],517,0,0,0,15,441,456,0,456,0,O-130-141-05-03-04
KIRUHURA,KAZO COUNTY,RWEMIKOMA,RWEMIKOMA,MUKURU C.O.U,70,0,0,0,0,69,69,0,69,0,O-130-141-05-04-01
KIRUHURA,KAZO COUNTY,RWEMIKOMA,RWEMIKOMA,RWEMIKOMA PRI. SCHOOL [A - L],583,1,0,1,41,510,553,2,555,0,O-130-141-05-04-02
KIRUHURA,KAZO COUNTY,RWEMIKOMA,RWEMIKOMA,BISYA,514,1,0,0,12,496,509,3,512,0,O-130-141-05-04-03
KIRUHURA,KAZO COUNTY,RWEMIKOMA,RWEMIKOMA,KARIBA,287,0,0,0,1,267,268,1,269,0,O-130-141-05-04-04
KIRUHURA,KAZO COUNTY,RWEMIKOMA,RWEMIKOMA,RWEMIKOMA PRI. SCHOOL [M - Z],548,0,0,1,51,320,372,3,375,0,O-130-141-05-04-05
MBARARA,RWAMPARA,BUGAMBA,KABARAMA,KABARAMA 1,651,6,2,2,72,421,503,7,510,0,O-131-143-01-01-01
MBARARA,RWAMPARA,BUGAMBA,KABARAMA,KABARAMA 2,586,0,1,0,76,289,366,40,406,0,O-131-143-01-01-02
MBARARA,RWAMPARA,BUGAMBA,KABARAMA,KABARAMA 3,682,1,1,3,100,407,512,39,551,0,O-131-143-01-01-03
MBARARA,RWAMPARA,BUGAMBA,KABARAMA,KABARAMA 4,331,0,0,1,28,190,219,37,256,0,O-131-143-01-01-04
MBARARA,RWAMPARA,BUGAMBA,KAMOMO,KAMOMO 1,674,1,0,1,42,459,503,15,518,0,O-131-143-01-02-01
MBARARA,RWAMPARA,BUGAMBA,KAMOMO,KAMOMO 2,607,0,0,0,62,417,479,15,494,0,O-131-143-01-02-02
MBARARA,RWAMPARA,BUGAMBA,KIBINGO,KIBINGO 1,739,4,0,3,45,462,514,65,579,0,O-131-143-01-03-01
MBARARA,RWAMPARA,BUGAMBA,KIBINGO,KIBINGO 2,392,0,0,3,33,277,313,1,314,0,O-131-143-01-03-02
MBARARA,RWAMPARA,BUGAMBA,KIBINGO,KIBINGO 3,245,0,0,1,34,147,182,24,206,0,O-131-143-01-03-03
MBARARA,RWAMPARA,BUGAMBA,KIBINGO,NYARUTEME T/C,317,0,0,1,46,219,266,26,292,0,O-131-143-01-03-04
MBARARA,RWAMPARA,BUGAMBA,KITOJO,KITOJO 1,380,1,0,0,16,246,263,49,312,0,O-131-143-01-04-01
MBARARA,RWAMPARA,BUGAMBA,KITOJO,KITOJO 2,457,0,0,0,14,314,328,30,358,0,O-131-143-01-04-02
MBARARA,RWAMPARA,BUGAMBA,NGUGO,NGUGO 1,761,2,0,3,70,415,490,65,555,0,O-131-143-01-05-01
MBARARA,RWAMPARA,BUGAMBA,NGUGO,NGUGO 2,686,4,1,1,88,398,492,11,503,0,O-131-143-01-05-02
MBARARA,RWAMPARA,BUGAMBA,NGUGO,NGUGO 3,737,1,0,2,80,451,534,28,562,0,O-131-143-01-05-03
MBARARA,RWAMPARA,BUGAMBA,NYARUHANDAGAZI,NYARUHANDAGAZI 1,747,0,0,4,71,483,558,9,567,0,O-131-143-01-06-01
MBARARA,RWAMPARA,BUGAMBA,NYARUHANDAGAZI,NYARUHANDAGAZI 2,672,0,1,0,116,352,469,81,550,0,O-131-143-01-06-02
MBARARA,RWAMPARA,BUGAMBA,NYARUHANDAGAZI,NYARUHANDAGAZI 3,498,2,0,1,96,241,340,56,396,0,O-131-143-01-06-03
MBARARA,RWAMPARA,BUGAMBA,NYARUHANDAGAZI,BUSHORO / MUTSIBIKA,349,0,0,1,42,195,238,45,283,0,O-131-143-01-06-04
MBARARA,RWAMPARA,BUGAMBA,RWEIBOGO,RWEIBOGO I,619,0,1,2,93,377,473,6,479,0,O-131-143-01-07-01
MBARARA,RWAMPARA,BUGAMBA,RWEIBOGO,RWEIBOGO 2,699,5,1,3,119,391,519,15,534,0,O-131-143-01-07-02
MBARARA,RWAMPARA,BUGAMBA,RWEIBOGO,RWEIBOGO 3,382,1,1,1,29,274,306,13,319,0,O-131-143-01-07-03
MBARARA,RWAMPARA,BUGAMBA,RWEIBOGO,RWEIBOGO 4,237,0,0,0,20,162,182,18,200,0,O-131-143-01-07-04
MBARARA,RWAMPARA,MWIZI,BUSHWERE,BUSHWERE 1,270,1,0,3,24,209,237,11,248,0,O-131-143-02-01-01
MBARARA,RWAMPARA,MWIZI,BUSHWERE,BUSHWERE 2,626,2,1,1,65,439,508,13,521,0,O-131-143-02-01-02
MBARARA,RWAMPARA,MWIZI,BUSHWERE,BUSHWERE 3,367,2,0,0,43,199,244,67,311,0,O-131-143-02-01-03
MBARARA,RWAMPARA,MWIZI,BUSHWERE,BUSHWERE 4,274,2,1,0,7,173,183,41,224,0,O-131-143-02-01-04
MBARARA,RWAMPARA,MWIZI,BUSHWERE,KIKUNDA,454,2,3,0,23,357,385,5,390,0,O-131-143-02-01-05
MBARARA,RWAMPARA,MWIZI,BUSHWERE,BUHUNGYE,540,1,0,1,57,381,440,31,471,0,O-131-143-02-01-06
MBARARA,RWAMPARA,MWIZI,KIGAAGA,KIGAAGA 1,652,1,0,2,72,465,540,1,541,0,O-131-143-02-02-01
MBARARA,RWAMPARA,MWIZI,KIGAAGA,KIGAAGA 2,658,1,0,1,125,402,529,5,534,0,O-131-143-02-02-02
MBARARA,RWAMPARA,MWIZI,KIGAAGA,KIGAAGA 3,467,0,0,0,120,273,393,5,398,0,O-131-143-02-02-03
MBARARA,RWAMPARA,MWIZI,NGOMA,NGOMA 1,804,0,0,0,52,450,502,128,630,0,O-131-143-02-03-01
MBARARA,RWAMPARA,MWIZI,NGOMA,NGOMA 2,704,3,0,4,71,441,519,33,552,0,O-131-143-02-03-02
MBARARA,RWAMPARA,MWIZI,NGOMA,NGOMA 3,677,1,0,2,63,356,422,92,514,0,O-131-143-02-03-03
MBARARA,RWAMPARA,MWIZI,NGOMA,NGOMA 4,261,0,0,0,24,195,219,10,229,0,O-131-143-02-03-04
MBARARA,RWAMPARA,MWIZI,RUKARABO,RUKARABO 1,445,1,1,1,62,317,382,7,389,0,O-131-143-02-04-01
MBARARA,RWAMPARA,MWIZI,RUKARABO,RUKARABO 2,430,2,0,2,53,232,289,61,350,0,O-131-143-02-04-02
MBARARA,RWAMPARA,MWIZI,RUKARABO,RUKARABO 3,400,0,0,0,30,288,318,58,376,0,O-131-143-02-04-03
MBARARA,RWAMPARA,MWIZI,RUKARABO,RUKARABO,305,1,0,0,49,232,282,8,290,0,O-131-143-02-04-04
MBARARA,RWAMPARA,MWIZI,RYAMIYONGA,RWAMIYONGA 1,684,3,0,3,100,461,567,3,570,0,O-131-143-02-05-01
MBARARA,RWAMPARA,MWIZI,RYAMIYONGA,RWAMIYONGA 2,663,1,0,1,89,429,520,11,531,0,O-131-143-02-05-02
MBARARA,RWAMPARA,MWIZI,RYAMIYONGA,RWAMIYONGA 3,382,0,2,0,65,239,306,7,313,0,O-131-143-02-05-03
MBARARA,RWAMPARA,MWIZI,RYAMIYONGA,KIHANGIRE,160,1,0,1,40,105,147,8,155,0,O-131-143-02-05-04
MBARARA,RWAMPARA,NDEIJA,BUJAGA,BUJAGA 1,800,1,0,0,179,369,549,8,557,0,O-131-143-03-01-01
MBARARA,RWAMPARA,NDEIJA,BUJAGA,KASHURO STAFF HQRS,181,0,0,0,31,94,125,29,154,0,O-131-143-03-01-02
MBARARA,RWAMPARA,NDEIJA,BUJAGA,BUJAGA 2,483,0,1,1,80,235,317,47,364,0,O-131-143-03-01-03
MBARARA,RWAMPARA,NDEIJA,KAKIGANI,KAKIGANI 1,554,1,0,0,179,238,418,11,429,0,O-131-143-03-02-01
MBARARA,RWAMPARA,NDEIJA,KAKIGANI,KAKIGANI 2,539,1,0,1,94,349,445,42,487,0,O-131-143-03-02-02
MBARARA,RWAMPARA,NDEIJA,KAKIGANI,KAKIGANI 3,494,0,1,1,73,385,460,2,462,0,O-131-143-03-02-03
MBARARA,RWAMPARA,NDEIJA,KIBARE,KIBAARE 1,646,2,0,0,99,318,419,117,536,0,O-131-143-03-03-01
MBARARA,RWAMPARA,NDEIJA,KIBARE,KIBAARE 2,541,9,0,1,68,352,430,11,441,0,O-131-143-03-03-02
MBARARA,RWAMPARA,NDEIJA,KIBARE,KIBAARE 3,245,0,0,0,41,144,185,26,211,0,O-131-143-03-03-03
MBARARA,RWAMPARA,NDEIJA,KIBARE,KIBAARE 4,403,0,2,0,59,262,323,9,332,0,O-131-143-03-03-04
MBARARA,RWAMPARA,NDEIJA,KONGORO,KONGORO,453,1,0,1,70,242,314,59,373,0,O-131-143-03-04-01
MBARARA,RWAMPARA,NDEIJA,KONGORO,NYAKATUGUNDA P/S,321,1,0,2,60,164,227,32,259,0,O-131-143-03-04-02
MBARARA,RWAMPARA,NDEIJA,NDEIJA-MULAGO,NDEIJA-MULAGO 1,323,0,0,0,45,194,239,42,281,0,O-131-143-03-05-01
MBARARA,RWAMPARA,NDEIJA,NDEIJA-MULAGO,NDEIJA-MULAGO 2,475,0,0,3,63,280,346,0,346,0,O-131-143-03-05-02
MBARARA,RWAMPARA,NDEIJA,NDEIJA-MULAGO,NDEIJA-MULAGO 3,341,1,0,0,70,187,258,3,261,0,O-131-143-03-05-03
MBARARA,RWAMPARA,NDEIJA,NDEIJA-MULAGO,KASHURO,256,0,0,0,23,135,158,46,204,0,O-131-143-03-05-04
MBARARA,RWAMPARA,NDEIJA,NYAKAIKARA,NYAKAIKARA I,393,0,1,1,87,195,284,26,310,0,O-131-143-03-06-01
MBARARA,RWAMPARA,NDEIJA,NYAKAIKARA,NYAKAIKARA II,729,1,0,1,79,454,535,69,604,0,O-131-143-03-06-02
MBARARA,RWAMPARA,NDEIJA,NYEIHANGA,NYAIHANGA 1,532,0,2,1,96,299,398,26,424,0,O-131-143-03-07-01
MBARARA,RWAMPARA,NDEIJA,NYEIHANGA,NYAIHANGA 2,787,2,0,0,177,403,582,9,591,0,O-131-143-03-07-02
MBARARA,RWAMPARA,NDEIJA,RWENSINGA,RWENSINGA 1,680,1,0,0,83,486,570,1,571,0,O-131-143-03-08-01
MBARARA,RWAMPARA,NDEIJA,RWENSINGA,RWENSINGA 2,700,0,2,0,101,418,521,35,556,0,O-131-143-03-08-02
MBARARA,RWAMPARA,NYAKAYOJO,BUGASHE,BUGASHE PRI. SCHOOL,488,0,0,0,115,284,399,10,409,0,O-131-143-04-01-01
MBARARA,RWAMPARA,NYAKAYOJO,BUGASHE,KIBONA PLAYGROUND,673,0,0,7,88,463,558,8,566,0,O-131-143-04-01-02
MBARARA,RWAMPARA,NYAKAYOJO,BUGASHE,KIBAYA MIXED PRI. SCHOOL,690,1,0,1,60,509,571,5,576,0,O-131-143-04-01-03
MBARARA,RWAMPARA,NYAKAYOJO,KATOJO,NGAARA PRI. SCHOOL,794,1,1,1,127,412,542,51,593,0,O-131-143-04-02-01
MBARARA,RWAMPARA,NYAKAYOJO,KATOJO,RWARIIRE PRI. SCHOOL,573,0,0,0,89,247,336,65,401,0,O-131-143-04-02-02
MBARARA,RWAMPARA,NYAKAYOJO,KATOJO,KAKUKUURU PRI. SCHOOL,693,1,0,1,109,380,491,8,499,0,O-131-143-04-02-03
MBARARA,RWAMPARA,NYAKAYOJO,KATOJO,KIBINGO C.O.U,545,0,0,0,56,333,389,31,420,0,O-131-143-04-02-04
MBARARA,RWAMPARA,NYAKAYOJO,KICHWAMBA,KICHWAMBA PRI. SCHOOL,444,0,0,0,24,324,348,29,377,0,O-131-143-04-03-01
MBARARA,RWAMPARA,NYAKAYOJO,KICHWAMBA,KANTANDA / KEISHAZI,615,0,0,2,64,365,431,69,500,0,O-131-143-04-03-02
MBARARA,RWAMPARA,NYAKAYOJO,KICHWAMBA,MUTUKURA / KARENGYE,558,1,0,0,41,463,505,48,553,0,O-131-143-04-03-03
MBARARA,RWAMPARA,NYAKAYOJO,KICHWAMBA,KAMBABA PRI. SCHOOL,459,1,1,0,45,310,357,24,381,0,O-131-143-04-03-04
MBARARA,RWAMPARA,NYAKAYOJO,NYARUBUNGO II,KATUKURU P/S,765,1,0,3,131,344,479,33,512,0,O-131-143-04-04-01
MBARARA,RWAMPARA,NYAKAYOJO,NYARUBUNGO II,KAGAAGA P/S,445,0,0,2,47,277,326,40,366,0,O-131-143-04-04-02
MBARARA,RWAMPARA,NYAKAYOJO,NYARUBUNGO II,IBAARE C.O.U,412,2,0,0,91,209,302,1,303,0,O-131-143-04-04-03
MBARARA,RWAMPARA,NYAKAYOJO,NYARUBUNGO II,RWAKWEZI C.O.U,624,1,0,1,98,362,462,11,473,0,O-131-143-04-04-04
MBARARA,RWAMPARA,NYAKAYOJO,NYARUBUNGO II,KARAMBI CATHOLIC CHURCH,217,0,0,1,11,188,200,4,204,0,O-131-143-04-04-05
MBARARA,RWAMPARA,NYAKAYOJO,NYARUBUNGO II,KINYAZA P/S,281,0,0,1,51,189,241,0,241,0,O-131-143-04-04-06
MBARARA,RWAMPARA,NYAKAYOJO,RUKINDO,NYAKAYOJO SEN. SEC. SCHOOL,663,1,2,0,85,352,440,5,445,0,O-131-143-04-05-01
MBARARA,RWAMPARA,NYAKAYOJO,RUKINDO,RUKUNDO PRI. SCHOOL,370,0,0,1,50,176,227,4,231,0,O-131-143-04-05-02
MBARARA,RWAMPARA,NYAKAYOJO,RUKINDO,NYAKAKONI CATHOLIC CHURCH,650,1,0,1,103,347,452,11,463,0,O-131-143-04-05-03
MBARARA,RWAMPARA,NYAKAYOJO,RUKINDO,KAGANDO C.O.U,484,0,0,0,52,420,472,6,478,0,O-131-143-04-05-04
MBARARA,RWAMPARA,NYAKAYOJO,RUKINDO,NYAMIYAGA,233,0,0,0,30,149,179,14,193,0,O-131-143-04-05-05
MBARARA,RWAMPARA,NYAKAYOJO,RWAKISHAKIZI,NYAKAYOJO S/COUNTY HQRS,395,0,1,0,57,208,266,2,268,0,O-131-143-04-06-01
MBARARA,RWAMPARA,NYAKAYOJO,RWAKISHAKIZI,KIBINGO P.T.C,586,1,1,1,84,366,453,8,461,0,O-131-143-04-06-02
MBARARA,RWAMPARA,NYAKAYOJO,RWAKISHAKIZI,NYAKAYOJO S/COUNTY HQRS,359,0,2,0,60,195,257,20,277,0,O-131-143-04-06-03
MBARARA,RWAMPARA,NYAKAYOJO,RWAKISHAKIZI,RWAKISHAKIIZI P/S,518,1,0,0,109,268,378,0,378,0,O-131-143-04-06-04
MBARARA,RWAMPARA,NYAKAYOJO,RWAKISHAKIZI,KAGASHA C.O.U,259,0,0,0,42,142,184,30,214,0,O-131-143-04-06-05
MBARARA,RWAMPARA,RUGANDO,KITUNGURU,KITUNGURU I,625,0,0,1,39,331,371,88,459,0,O-131-143-05-01-01
MBARARA,RWAMPARA,RUGANDO,KITUNGURU,KITUNGURU 2,587,1,1,1,137,262,402,6,408,0,O-131-143-05-01-02
MBARARA,RWAMPARA,RUGANDO,KITUNGURU,KITUNGURU 3,527,1,1,1,95,335,433,11,444,0,O-131-143-05-01-03
MBARARA,RWAMPARA,RUGANDO,KITUNGURU,KITUNGURU 4,716,3,1,1,81,456,542,13,555,0,O-131-143-05-01-04
MBARARA,RWAMPARA,RUGANDO,MIRAMA,MIRAMA 1,607,2,0,0,73,289,364,43,407,0,O-131-143-05-02-01
MBARARA,RWAMPARA,RUGANDO,MIRAMA,MIRAMA 2,397,0,0,0,63,189,252,39,291,0,O-131-143-05-02-02
MBARARA,RWAMPARA,RUGANDO,MIRAMA,MIRAMA 3,625,1,0,2,113,326,442,4,446,0,O-131-143-05-02-03
MBARARA,RWAMPARA,RUGANDO,NYABIKUNGU,NYABIKUNGU 1,659,0,0,0,63,483,546,27,573,0,O-131-143-05-03-01
MBARARA,RWAMPARA,RUGANDO,NYABIKUNGU,NYABIKUNGU 2,544,0,1,1,53,346,401,18,419,0,O-131-143-05-03-02
MBARARA,RWAMPARA,RUGANDO,NYABIKUNGU,NYABIKUNGU 3,345,3,0,0,69,174,246,36,282,0,O-131-143-05-03-03
MBARARA,RWAMPARA,RUGANDO,NYABIKUNGU,NYABIKUNGU 4,549,2,3,0,130,234,369,82,451,0,O-131-143-05-03-04
MBARARA,RWAMPARA,RUGANDO,NYAKABAARE,NYAKABARE 1,388,1,0,3,54,295,353,4,357,0,O-131-143-05-04-01
MBARARA,RWAMPARA,RUGANDO,NYAKABAARE,NYAKABARE 2,496,6,1,1,67,292,367,6,373,0,O-131-143-05-04-02
MBARARA,RWAMPARA,RUGANDO,NYAKABAARE,NYAKABARE 3,535,4,0,0,89,321,414,14,428,0,O-131-143-05-04-03
MBARARA,RWAMPARA,RUGANDO,NYARUBUNGO,NYARUBUNGO 1,514,0,0,0,75,268,343,2,345,0,O-131-143-05-05-01
MBARARA,RWAMPARA,RUGANDO,NYARUBUNGO,NYARUBUNGO 2,571,1,1,1,139,299,441,4,445,0,O-131-143-05-05-02
MBARARA,RWAMPARA,RUGANDO,NYARUBUNGO,NYARUBUNGO 3,565,0,2,1,68,367,438,4,442,0,O-131-143-05-05-03
MBARARA,RWAMPARA,RUGANDO,NYARUBUNGO,NYARUBUNGO 4,625,5,0,2,94,390,491,15,506,0,O-131-143-05-05-04
KAMWENGE,KITAGWENDA COUNTY,KICHECHE,BUJUMIRO,KENGEYA,687,7,1,4,37,456,505,14,519,0,O-132-54-01-01-01
KAMWENGE,KITAGWENDA COUNTY,KICHECHE,BUJUMIRO,BUJUMIRO/ KANYAMBURARA,513,2,2,2,29,376,411,16,427,0,O-132-54-01-01-02
KAMWENGE,KITAGWENDA COUNTY,KICHECHE,BUJUMIRO,KANYAMBURARA,396,1,2,4,16,276,299,18,317,0,O-132-54-01-01-03
KAMWENGE,KITAGWENDA COUNTY,KICHECHE,BWERA,BARYANIKA P. SCHOOL,742,0,1,1,59,519,580,6,586,0,O-132-54-01-02-01
KAMWENGE,KITAGWENDA COUNTY,KICHECHE,BWERA,BUKYANSUNGWE P. S.,570,0,0,1,36,424,461,9,470,0,O-132-54-01-02-02
KAMWENGE,KITAGWENDA COUNTY,KICHECHE,BWERA,KINYUNGU T. C.,591,4,0,3,13,459,479,3,482,0,O-132-54-01-02-03
KAMWENGE,KITAGWENDA COUNTY,KICHECHE,KAGAZI,NYARUHANDA/ KIKONDO,760,3,2,1,46,565,617,10,627,0,O-132-54-01-03-01
KAMWENGE,KITAGWENDA COUNTY,KICHECHE,KAGAZI,KIYAGARA/KABUJOGERA,642,2,2,0,66,419,489,12,501,0,O-132-54-01-03-02
KAMWENGE,KITAGWENDA COUNTY,KICHECHE,KAGAZI,KAGAZI/ KYAKANUGA,722,1,0,6,76,471,554,17,571,0,O-132-54-01-03-03
KAMWENGE,KITAGWENDA COUNTY,KICHECHE,KAGAZI,NYARITOOMA,384,1,0,6,70,191,268,6,274,0,O-132-54-01-03-04
KAMWENGE,KITAGWENDA COUNTY,KICHECHE,KAKASI,KIHUMURO P. SCHOOL,387,0,0,0,7,290,297,16,313,0,O-132-54-01-04-01
KAMWENGE,KITAGWENDA COUNTY,KICHECHE,KAKASI,RUGARAMA T. CENTRE,675,2,0,2,32,493,529,14,543,0,O-132-54-01-04-02
KAMWENGE,KITAGWENDA COUNTY,KICHECHE,KAKASI,IRYANGABI T. C.,579,2,1,4,58,402,467,6,473,0,O-132-54-01-04-03
KAMWENGE,KITAGWENDA COUNTY,KICHECHE,KAKASI,KASISA T. C.,700,0,0,1,23,572,596,5,601,0,O-132-54-01-04-04
KAMWENGE,KITAGWENDA COUNTY,KICHECHE,KAKASI,KITAKA T.C. KITOOMA,264,1,0,1,10,218,230,10,240,0,O-132-54-01-04-05
KAMWENGE,KITAGWENDA COUNTY,KICHECHE,KAKASI,KANYWAMBOGO II T.C,428,2,1,2,17,325,347,12,359,0,O-132-54-01-04-06
KAMWENGE,KITAGWENDA COUNTY,KICHECHE,KANTOZI,KANTOZI/ RUHIGA,609,1,1,2,46,445,495,9,504,0,O-132-54-01-05-01
KAMWENGE,KITAGWENDA COUNTY,KICHECHE,KANTOZI,KANTOZI P. SCHOOL,694,3,2,0,57,569,631,1,632,0,O-132-54-01-05-02
KAMWENGE,KITAGWENDA COUNTY,KICHECHE,KANTOZI,BUNENA TRADING CENTRE,514,3,2,2,54,318,379,16,395,0,O-132-54-01-05-03
KAMWENGE,KITAGWENDA COUNTY,KICHECHE,KIGOTO,KATETE,776,2,6,1,74,535,618,21,639,0,O-132-54-01-06-01
KAMWENGE,KITAGWENDA COUNTY,KICHECHE,KIGOTO,KIBUMBI,624,1,0,5,38,423,467,18,485,0,O-132-54-01-06-02
KAMWENGE,KITAGWENDA COUNTY,KICHECHE,KIGOTO,KAYANGA,708,6,0,5,31,557,599,8,607,0,O-132-54-01-06-03
KAMWENGE,KITAGWENDA COUNTY,KICHECHE,NYABIHOKO,NYABUGANDO/MPANA,621,2,0,4,49,395,450,18,468,0,O-132-54-01-07-01
KAMWENGE,KITAGWENDA COUNTY,KICHECHE,NYABIHOKO,NYABIHOKO/KATANDURA,484,0,0,1,23,353,377,2,379,0,O-132-54-01-07-02
KAMWENGE,KITAGWENDA COUNTY,KICHECHE,NYABIHOKO,KAREERE T.C,388,0,2,0,32,285,319,2,321,0,O-132-54-01-07-03
KAMWENGE,KITAGWENDA COUNTY,KICHECHE,NYAKASHENYI,BUHANDA,325,0,1,1,34,235,271,4,275,0,O-132-54-01-08-01
KAMWENGE,KITAGWENDA COUNTY,KICHECHE,NYAKASHENYI,NYAKASHENYI,664,2,1,3,35,483,524,20,544,0,O-132-54-01-08-02
KAMWENGE,KITAGWENDA COUNTY,KICHECHE,NYAKASHENYI,RUBONA,780,2,0,2,22,605,631,6,637,0,O-132-54-01-08-03
KAMWENGE,KITAGWENDA COUNTY,KICHECHE,RUHUNGA,NYABIKAMBA,501,2,0,1,21,375,399,0,399,0,O-132-54-01-09-01
KAMWENGE,KITAGWENDA COUNTY,KICHECHE,RUHUNGA,KYAMYAMIROMBA,372,1,0,2,25,286,314,11,325,0,O-132-54-01-09-02
KAMWENGE,KITAGWENDA COUNTY,KICHECHE,RUHUNGA,KYEGANYWA,632,1,0,4,18,478,501,13,514,0,O-132-54-01-09-03
KAMWENGE,KITAGWENDA COUNTY,MAHYORO,BUKURUNGU,NYAMIZO I/KABALE I,573,4,0,2,61,362,429,4,433,0,O-132-54-02-01-01
KAMWENGE,KITAGWENDA COUNTY,MAHYORO,BUKURUNGU,NYAMIZO II/KABALE II,784,3,1,6,57,574,641,9,650,0,O-132-54-02-01-02
KAMWENGE,KITAGWENDA COUNTY,MAHYORO,KITONZI,KYENDANGARA,537,2,0,8,19,289,318,12,330,0,O-132-54-02-02-01
KAMWENGE,KITAGWENDA COUNTY,MAHYORO,KITONZI,NYANGA,790,1,1,3,30,590,625,5,630,0,O-132-54-02-02-02
KAMWENGE,KITAGWENDA COUNTY,MAHYORO,KITONZI,KYENDANGARA/OMUKARERE,599,4,2,3,63,311,383,12,395,0,O-132-54-02-02-03
KAMWENGE,KITAGWENDA COUNTY,MAHYORO,MAHYORO,BUBALE,558,3,5,4,66,285,363,26,389,0,O-132-54-02-03-01
KAMWENGE,KITAGWENDA COUNTY,MAHYORO,MAHYORO,KANYABIKERE A,623,6,0,5,53,369,433,7,440,0,O-132-54-02-03-02
KAMWENGE,KITAGWENDA COUNTY,MAHYORO,MAHYORO,KYAMUBINGA/KYETANDA/KATEHE,803,7,0,6,89,402,504,38,542,0,O-132-54-02-03-03
KAMWENGE,KITAGWENDA COUNTY,MAHYORO,MAHYORO,NYAKASURATI/KADOODO,646,3,0,6,54,413,476,9,485,0,O-132-54-02-03-04
KAMWENGE,KITAGWENDA COUNTY,MAHYORO,MAHYORO,RWETUMA,650,0,0,7,49,381,437,7,444,0,O-132-54-02-03-05
KAMWENGE,KITAGWENDA COUNTY,MAHYORO,NYAKASURA,LYENGOMA I,603,0,3,6,30,415,454,17,471,0,O-132-54-02-04-01
KAMWENGE,KITAGWENDA COUNTY,MAHYORO,NYAKASURA,NYAKASURA T. C.,661,0,0,2,49,445,496,10,506,0,O-132-54-02-04-02
KAMWENGE,KITAGWENDA COUNTY,MAHYORO,NYAKASURA,IHUNGA,614,3,0,7,38,485,533,9,542,0,O-132-54-02-04-03
KAMWENGE,KITAGWENDA COUNTY,MAHYORO,NYAKERA,NYAKERA,846,4,0,9,62,764,839,0,839,0,O-132-54-02-05-01
KAMWENGE,KITAGWENDA COUNTY,NTARA,KABALE,KABATIMBO,362,3,0,2,36,248,289,9,298,0,O-132-54-03-01-01
KAMWENGE,KITAGWENDA COUNTY,NTARA,KABALE,KABALE,573,3,1,14,34,411,463,0,463,0,O-132-54-03-01-02
KAMWENGE,KITAGWENDA COUNTY,NTARA,KABALE,MUGOMBWA,296,1,0,3,24,213,241,10,251,0,O-132-54-03-01-03
KAMWENGE,KITAGWENDA COUNTY,NTARA,KABALE,KYANDEMA,423,1,0,3,67,257,328,6,334,0,O-132-54-03-01-04
KAMWENGE,KITAGWENDA COUNTY,NTARA,KABALE,NYAMUKOIJO,400,1,1,4,64,249,319,10,329,0,O-132-54-03-01-05
KAMWENGE,KITAGWENDA COUNTY,NTARA,KICHWAMBA,KICHWAMBA C.O.U,475,0,0,0,41,371,412,3,415,0,O-132-54-03-02-01
KAMWENGE,KITAGWENDA COUNTY,NTARA,KICHWAMBA,KABURAISOKE,612,2,0,2,56,418,478,16,494,0,O-132-54-03-02-02
KAMWENGE,KITAGWENDA COUNTY,NTARA,KICHWAMBA,RWENTUUHA,443,0,0,0,54,293,347,3,350,0,O-132-54-03-02-03
KAMWENGE,KITAGWENDA COUNTY,NTARA,KICHWAMBA,NYAKATERAMIRE CHURCH SCH,463,1,0,2,46,303,352,5,357,0,O-132-54-03-02-04
KAMWENGE,KITAGWENDA COUNTY,NTARA,KICHWAMBA,KANGORA P/S,201,1,1,0,16,131,149,3,152,0,O-132-54-03-02-05
KAMWENGE,KITAGWENDA COUNTY,NTARA,NTARA,KITONZI,690,2,0,2,40,450,494,10,504,0,O-132-54-03-03-01
KAMWENGE,KITAGWENDA COUNTY,NTARA,NTARA,KIRYANGO,550,2,2,8,56,308,376,22,398,0,O-132-54-03-03-02
KAMWENGE,KITAGWENDA COUNTY,NTARA,NTARA,NTARA,683,4,1,8,76,415,504,16,520,0,O-132-54-03-03-03
KAMWENGE,KITAGWENDA COUNTY,NTARA,NTARA,KIBANGA,470,1,0,3,26,315,345,20,365,0,O-132-54-03-03-04
KAMWENGE,KITAGWENDA COUNTY,NTARA,NTARA,KYOTAMUSANA,473,3,2,3,47,336,391,5,396,0,O-132-54-03-03-05
KAMWENGE,KITAGWENDA COUNTY,NTARA,RUGARAMA,RWENTUHA,262,1,0,1,20,190,212,7,219,0,O-132-54-03-04-01
KAMWENGE,KITAGWENDA COUNTY,NTARA,RUGARAMA,KARUBUGUMA,233,0,0,0,10,88,98,3,101,0,O-132-54-03-04-02
KAMWENGE,KITAGWENDA COUNTY,NTARA,RUGARAMA,RUGARAMA,252,0,0,1,31,141,173,7,180,0,O-132-54-03-04-03
KAMWENGE,KITAGWENDA COUNTY,NTARA,RUGARAMA,KURUBUGUMA P/S,498,0,1,6,39,358,404,6,410,0,O-132-54-03-04-04
KAMWENGE,KITAGWENDA COUNTY,NTARA,RUGARAMA,NYAKACHWAMBA P/S,564,4,0,1,56,373,434,10,444,0,O-132-54-03-04-05
KAMWENGE,KITAGWENDA COUNTY,NTARA,RUGARAMA,KARERE T.C,306,0,0,0,16,241,257,9,266,0,O-132-54-03-04-06
KAMWENGE,KITAGWENDA COUNTY,NTARA,RUGARAMA,RWENTUHA P/S,186,0,0,0,15,131,146,6,152,0,O-132-54-03-04-07
KAMWENGE,KITAGWENDA COUNTY,NYABBANI,KANARA,KASAKI T.C,236,0,0,0,7,191,198,7,205,0,O-132-54-04-01-01
KAMWENGE,KITAGWENDA COUNTY,NYABBANI,KANARA,NGOMA PRIMARY SCHOOL,560,1,2,3,58,364,428,6,434,0,O-132-54-04-01-02
KAMWENGE,KITAGWENDA COUNTY,NYABBANI,KANARA,KANARA P SCHOOL,498,3,0,2,16,338,359,6,365,0,O-132-54-04-01-03
KAMWENGE,KITAGWENDA COUNTY,NYABBANI,KANARA,KANARA T. CENTRE,440,2,0,0,18,272,292,24,316,0,O-132-54-04-01-04
KAMWENGE,KITAGWENDA COUNTY,NYABBANI,KANARA,KANYEGARAMIRE,527,0,0,1,26,367,394,11,405,0,O-132-54-04-01-05
KAMWENGE,KITAGWENDA COUNTY,NYABBANI,KANARA,KIGARAMA C.O.U,551,6,0,6,38,330,380,25,405,0,O-132-54-04-01-06
KAMWENGE,KITAGWENDA COUNTY,NYABBANI,NGANIKO,NGANIKO A,713,0,0,3,60,428,491,19,510,0,O-132-54-04-02-01
KAMWENGE,KITAGWENDA COUNTY,NYABBANI,NGANIKO,KAROKARUNGI,459,0,0,0,50,288,338,5,343,0,O-132-54-04-02-02
KAMWENGE,KITAGWENDA COUNTY,NYABBANI,NGANIKO,KAMAYENJE A,522,1,1,3,38,326,369,7,376,0,O-132-54-04-02-03
KAMWENGE,KITAGWENDA COUNTY,NYABBANI,NGANIKO,RWESIGIRE,789,0,0,5,89,506,600,10,610,0,O-132-54-04-02-04
KAMWENGE,KITAGWENDA COUNTY,NYABBANI,NGANIKO,NGANIKO C.O.U,387,2,1,2,40,202,247,5,252,0,O-132-54-04-02-05
KAMWENGE,KITAGWENDA COUNTY,NYABBANI,RWENJAZA,NYARURAMBI,716,3,0,7,24,522,556,11,567,0,O-132-54-04-03-01
KAMWENGE,KITAGWENDA COUNTY,NYABBANI,RWENJAZA,NYAMABARE,597,7,1,6,22,418,454,15,469,0,O-132-54-04-03-02
KAMWENGE,KITAGWENDA COUNTY,NYABBANI,RWENJAZA,RWENJAZA A,570,0,3,0,46,309,358,11,369,0,O-132-54-04-03-03
KAMWENGE,KITAGWENDA COUNTY,NYABBANI,RWENJAZA,RUKINGA B P/S,517,1,1,3,25,362,392,24,416,0,O-132-54-04-03-04
KAMWENGE,KITAGWENDA COUNTY,NYABBANI,RWENJAZA,RWENJAZA B,668,2,1,5,38,389,435,16,451,0,O-132-54-04-03-05
KAMWENGE,KITAGWENDA COUNTY,NYABBANI,RWENJAZA,RUTOMA C.O.U,324,0,6,4,21,221,252,6,258,0,O-132-54-04-03-06
KAMWENGE,KITAGWENDA COUNTY,NYABBANI,RWENKUBEBE,KAMAYENJE A,485,1,1,3,34,287,326,13,339,0,O-132-54-04-04-01
KAMWENGE,KITAGWENDA COUNTY,NYABBANI,RWENKUBEBE,RWEMIRAMA,637,3,0,2,49,378,432,12,444,0,O-132-54-04-04-02
KAMWENGE,KITAGWENDA COUNTY,NYABBANI,RWENKUBEBE,NYABBANI,784,2,1,2,71,488,564,10,574,0,O-132-54-04-04-03
KAMWENGE,KITAGWENDA COUNTY,NYABBANI,RWENKUBEBE,KAROKARUNGI,324,1,0,3,40,169,213,3,216,0,O-132-54-04-04-04
KAMWENGE,KITAGWENDA COUNTY,NYABBANI,RWENKUBEBE,ST JUDE RWEMIRAMA,411,0,0,5,32,268,305,10,315,0,O-132-54-04-04-05
KAMWENGE,KITAGWENDA COUNTY,NYABBANI,RWENSHAMA,KEKOBO T. C. A.,709,0,0,1,19,474,494,6,500,0,O-132-54-04-05-01
KAMWENGE,KITAGWENDA COUNTY,NYABBANI,RWENSHAMA,KAGARAMA T. CENTRE,711,0,0,2,15,532,549,42,591,0,O-132-54-04-05-02
KAMWENGE,KITAGWENDA COUNTY,NYABBANI,RWENSHAMA,RWENSHAMA P. SCHOOL,435,1,1,1,17,278,298,2,300,0,O-132-54-04-05-03
KAMWENGE,KITAGWENDA COUNTY,NYABBANI,RWENSHAMA,KEKOBO T. CENTRE,588,2,1,4,15,426,448,12,460,0,O-132-54-04-05-04
KAMWENGE,KITAGWENDA COUNTY,NYABBANI,RWENSHAMA,KAMUGANGUZI T.C,569,1,0,4,22,320,347,12,359,0,O-132-54-04-05-05
IGANGA,KIGULU COUNTY NORTH,NABITENDE,BUGONO,BUGONO T/CENTRE,709,3,1,5,164,258,431,39,470,0,O-7-38-01-01-01
IGANGA,KIGULU COUNTY NORTH,NABITENDE,BUGONO,NABINYONYI CENTRE,321,2,0,4,81,140,227,14,241,0,O-7-38-01-01-02
IGANGA,KIGULU COUNTY NORTH,NABITENDE,ITANDA,BUVULE T/CENTRE,660,1,0,5,135,304,445,2,447,0,O-7-38-01-02-01
IGANGA,KIGULU COUNTY NORTH,NABITENDE,ITANDA,BUWEIRA PR/SCHOOL,445,2,0,7,88,169,266,21,287,0,O-7-38-01-02-02
IGANGA,KIGULU COUNTY NORTH,NABITENDE,ITANDA,A MUZIRA'S PLACE,262,1,2,1,63,79,146,10,156,0,O-7-38-01-02-03
IGANGA,KIGULU COUNTY NORTH,NABITENDE,ITANDA,KINU P/S,398,4,0,1,60,212,277,4,281,0,O-7-38-01-02-04
IGANGA,KIGULU COUNTY NORTH,NABITENDE,KABIRA_ITUBA,ITUBA HEALTH CENTRE,601,3,1,1,95,295,395,15,410,0,O-7-38-01-03-01
IGANGA,KIGULU COUNTY NORTH,NABITENDE,KABIRA_ITUBA,KABIRA P/SCH A,387,2,0,0,104,144,250,26,276,0,O-7-38-01-03-02
IGANGA,KIGULU COUNTY NORTH,NABITENDE,KABIRA_ITUBA,KABIRA P/SCH B,666,2,0,2,94,329,427,15,442,0,O-7-38-01-03-03
IGANGA,KIGULU COUNTY NORTH,NABITENDE,KASAMBIKA,KASAMBIKA P/SCH,611,2,3,8,50,383,446,9,455,0,O-7-38-01-04-01
IGANGA,KIGULU COUNTY NORTH,NABITENDE,KASAMBIKA,BUWEREMPE PR/SCHOOL,359,0,0,0,0,0,0,0,0,1,O-7-38-01-04-02
IGANGA,KIGULU COUNTY NORTH,NABITENDE,KASAMBIKA,KADUYU'S PLACE,373,3,0,4,48,203,258,12,270,0,O-7-38-01-04-03
IGANGA,KIGULU COUNTY NORTH,NABITENDE,NABITENDE,NABITENDE S/C HQRS,442,1,0,0,56,232,289,5,294,0,O-7-38-01-05-01
IGANGA,KIGULU COUNTY NORTH,NABITENDE,NABITENDE,NABITENDE P/SCH,638,1,3,2,90,317,413,17,430,0,O-7-38-01-05-02
IGANGA,KIGULU COUNTY NORTH,NABITENDE,NABITENDE,KABUTE'S PLACE,678,2,3,7,87,334,433,27,460,0,O-7-38-01-05-03
IGANGA,KIGULU COUNTY NORTH,NABITENDE,NALUKO,NALUKO P/SCH,706,6,2,5,113,293,419,30,449,0,O-7-38-01-06-01
IGANGA,KIGULU COUNTY NORTH,NABITENDE,NALUKO,DHEYONGERA'S PLACE A,247,0,1,0,34,130,165,10,175,0,O-7-38-01-06-02
IGANGA,KIGULU COUNTY NORTH,NABITENDE,NALUKO,DHEYONGERA'S PLACE B,178,2,0,0,27,87,116,11,127,0,O-7-38-01-06-03
IGANGA,KIGULU COUNTY NORTH,NAMBALE,KIDAAGO_NABITEND,NABITENDE COFFEE FAC (A-M),748,3,0,1,190,281,475,21,496,0,O-7-38-02-01-01
IGANGA,KIGULU COUNTY NORTH,NAMBALE,KIDAAGO_NABITEND,NABITENDE COFFEE FAC B,751,3,4,4,112,343,466,20,486,0,O-7-38-02-01-02
IGANGA,KIGULU COUNTY NORTH,NAMBALE,KIDAAGO_NABITEND,KASOKOSO RAILWAY LINE A,305,0,2,0,36,155,193,9,202,0,O-7-38-02-01-03
IGANGA,KIGULU COUNTY NORTH,NAMBALE,KIDAAGO_NABITEND,KASOKOSO RAIL/LINE B,470,3,0,3,33,262,301,17,318,0,O-7-38-02-01-04
IGANGA,KIGULU COUNTY NORTH,NAMBALE,KIDAAGO_NABITEND,NABITENDE COFFEE FAC (N-Z),605,2,1,1,95,276,375,18,393,0,O-7-38-02-01-05
IGANGA,KIGULU COUNTY NORTH,NAMBALE,MUIRA,NSIMBA'S PLACE,789,1,4,2,81,452,540,0,540,0,O-7-38-02-02-01
IGANGA,KIGULU COUNTY NORTH,NAMBALE,MUIRA,MUIRA P/SCH,529,1,2,2,70,212,287,70,357,0,O-7-38-02-02-02
IGANGA,KIGULU COUNTY NORTH,NAMBALE,MUIRA,KYAMWAMI MOSQUE,342,4,0,3,41,219,267,12,279,0,O-7-38-02-02-03
IGANGA,KIGULU COUNTY NORTH,NAMBALE,NAIBIRI,NAIBIRI PRIMARY SCH,703,2,2,3,109,359,475,22,497,0,O-7-38-02-03-01
IGANGA,KIGULU COUNTY NORTH,NAMBALE,NAIBIRI,BUKWANGA P/SCH,453,2,0,2,87,229,320,6,326,0,O-7-38-02-03-02
IGANGA,KIGULU COUNTY NORTH,NAMBALE,NAIBIRI,KAZIGO MOSQUE,512,3,0,1,71,297,372,17,389,0,O-7-38-02-03-03
IGANGA,KIGULU COUNTY NORTH,NAMBALE,NAIBIRI,KAZIGO KASOKOSO,285,0,0,2,21,197,220,11,231,0,O-7-38-02-03-04
IGANGA,KIGULU COUNTY NORTH,NAMBALE,NAIBIRI,BULANDA CHURCH,616,2,2,0,86,287,377,35,412,0,O-7-38-02-03-05
IGANGA,KIGULU COUNTY NORTH,NAMBALE,NAMBALE,NKOFU MILLERS,555,3,4,3,63,284,357,20,377,0,O-7-38-02-04-01
IGANGA,KIGULU COUNTY NORTH,NAMBALE,NAMBALE,IRENZI P/SCH,774,5,5,5,103,322,440,15,455,0,O-7-38-02-04-02
IGANGA,KIGULU COUNTY NORTH,NAMBALE,NAMBALE,NAMBALE SUBCOUNTY CENTRE,672,2,2,2,76,286,368,42,410,0,O-7-38-02-04-03
IGANGA,KIGULU COUNTY NORTH,NAMBALE,NASUTI,NASUTI P/SCH (A-M),523,1,0,0,124,165,290,9,299,0,O-7-38-02-05-01
IGANGA,KIGULU COUNTY NORTH,NAMBALE,NASUTI,KUNYA'S PLACE A,278,0,1,1,32,131,165,5,170,0,O-7-38-02-05-02
IGANGA,KIGULU COUNTY NORTH,NAMBALE,NASUTI,NABUKONE T/CENTRE (A-M),886,7,2,4,133,379,525,30,555,0,O-7-38-02-05-03
IGANGA,KIGULU COUNTY NORTH,NAMBALE,NASUTI,NASUTI P/S (N-Z),390,2,1,6,66,140,215,10,225,0,O-7-38-02-05-04
IGANGA,KIGULU COUNTY NORTH,NAMBALE,NASUTI,KUNYA'S PLACE B,558,3,1,2,111,248,365,19,384,0,O-7-38-02-05-05
IGANGA,KIGULU COUNTY NORTH,NAMBALE,NASUTI,NABUKONE T/CENTRE(N-Z),433,1,1,6,55,219,282,10,292,0,O-7-38-02-05-06
IGANGA,KIGULU COUNTY NORTH,NAMUNGALWE,BULUMWAKI,BULUMWAKI CHURCH OF UGAND,541,2,0,0,76,293,371,3,374,0,O-7-38-03-01-01
IGANGA,KIGULU COUNTY NORTH,NAMUNGALWE,BULUMWAKI,WAGODO P/SCH,537,2,2,0,61,241,306,49,355,0,O-7-38-03-01-02
IGANGA,KIGULU COUNTY NORTH,NAMUNGALWE,BULUMWAKI,NSINZE T/CENTRE,498,2,1,2,124,169,298,15,313,0,O-7-38-03-01-03
IGANGA,KIGULU COUNTY NORTH,NAMUNGALWE,MWENDANFUKO,BULANGA TR/CENTRE A,377,2,0,3,82,161,248,8,256,0,O-7-38-03-02-01
IGANGA,KIGULU COUNTY NORTH,NAMUNGALWE,MWENDANFUKO,BULANGA T/CENTRE B,265,0,0,1,40,130,171,10,181,0,O-7-38-03-02-02
IGANGA,KIGULU COUNTY NORTH,NAMUNGALWE,MWENDANFUKO,BULANGA T/CENTRE A(N-Z),334,2,0,1,56,132,191,12,203,0,O-7-38-03-02-03
IGANGA,KIGULU COUNTY NORTH,NAMUNGALWE,NAMUNGALWE,NAMUNGALWE T/CENTRE (A-M),850,4,0,1,219,311,535,16,551,0,O-7-38-03-03-01
IGANGA,KIGULU COUNTY NORTH,NAMUNGALWE,NAMUNGALWE,KIGULU SECONDARY SCHOOL,433,2,0,2,78,179,261,15,276,0,O-7-38-03-03-02
IGANGA,KIGULU COUNTY NORTH,NAMUNGALWE,NAMUNGALWE,KAWETE MARKET (A-M),442,0,0,3,66,198,267,9,276,0,O-7-38-03-03-03
IGANGA,KIGULU COUNTY NORTH,NAMUNGALWE,NAMUNGALWE,NAMUNGALWE T/CENTRE (N-Z),592,2,1,1,95,233,332,19,351,0,O-7-38-03-03-04
IGANGA,KIGULU COUNTY NORTH,NAMUNGALWE,NAMUNGALWE,KAWETE MARKET (N-Z),353,0,0,3,39,170,212,0,212,0,O-7-38-03-03-05
IGANGA,KIGULU COUNTY NORTH,NAMUNGALWE,NAMUNKANAGA,NAMUNKANAGA P/S,635,1,1,5,111,277,395,12,407,0,O-7-38-03-04-01
IGANGA,KIGULU COUNTY NORTH,NAMUNGALWE,NAMUNKANAGA,NAMUNKANAGA T/CENTRE,612,0,2,1,133,230,366,14,380,0,O-7-38-03-04-02
IGANGA,KIGULU COUNTY NORTH,NAMUNGALWE,NAMUNKESU,NAMUNKESU COOP SOCIETY,677,1,2,1,129,256,389,29,418,0,O-7-38-03-05-01
IGANGA,KIGULU COUNTY NORTH,NAMUNGALWE,NAMUNKESU,BUBOGO T/CENTRE (A-M),497,2,1,5,102,184,294,9,303,0,O-7-38-03-05-02
IGANGA,KIGULU COUNTY NORTH,NAMUNGALWE,NAMUNKESU,NABIKOTE PR/SCHOOL,682,2,3,3,76,343,427,0,427,0,O-7-38-03-05-03
IGANGA,KIGULU COUNTY NORTH,NAMUNGALWE,NAMUNKESU,BUBOGO T/CENTRE (N-Z),474,4,1,2,72,225,304,8,312,0,O-7-38-03-05-04
IGANGA,KIGULU COUNTY NORTH,NAMUNGALWE,NAMUNSALA,NAMUNSALA PR/SCHOOL,290,0,0,0,48,128,176,7,183,0,O-7-38-03-06-01
IGANGA,KIGULU COUNTY NORTH,NAMUNGALWE,NAMUNSALA,NAISANGA P/S (A-M),410,3,0,6,117,172,298,10,308,0,O-7-38-03-06-02
IGANGA,KIGULU COUNTY NORTH,NAMUNGALWE,NAMUNSALA,NAISANGA (N-Z),377,0,0,4,68,141,213,11,224,0,O-7-38-03-06-03
IGANGA,KIGULU COUNTY NORTH,NAMUNGALWE,NAWANSEGA,KABUKO P/S A,491,4,0,2,64,251,321,17,338,0,O-7-38-03-07-01
IGANGA,KIGULU COUNTY NORTH,NAMUNGALWE,NAWANSEGA,KABUKO PR/SCHOOL B,641,1,2,6,93,295,397,17,414,0,O-7-38-03-07-02
IGANGA,KIGULU COUNTY NORTH,NAWANDALA,BUGONGO,NAWANDALA PR/SCHOOL A,304,0,0,1,45,159,205,13,218,0,O-7-38-04-01-01
IGANGA,KIGULU COUNTY NORTH,NAWANDALA,BUGONGO,BUGONGO T/C I,696,2,0,5,70,364,441,40,481,0,O-7-38-04-01-02
IGANGA,KIGULU COUNTY NORTH,NAWANDALA,BUGONGO,OLD MARKET A,556,2,0,0,50,348,400,9,409,0,O-7-38-04-01-03
IGANGA,KIGULU COUNTY NORTH,NAWANDALA,BUGONGO,BUGONGO T/C II,341,0,1,1,33,234,269,6,275,0,O-7-38-04-01-04
IGANGA,KIGULU COUNTY NORTH,NAWANDALA,BUGONGO,NAWANDALA P/S B,645,4,0,4,75,353,436,23,459,0,O-7-38-04-01-05
IGANGA,KIGULU COUNTY NORTH,NAWANDALA,BUGONGO,NAWANGAIZA / KASOKOSO,500,3,1,5,62,269,340,17,357,0,O-7-38-04-01-06
IGANGA,KIGULU COUNTY NORTH,NAWANDALA,KIWANYI,KIWANYI PR/SCHOOL,554,2,0,0,65,271,338,58,396,0,O-7-38-04-02-01
IGANGA,KIGULU COUNTY NORTH,NAWANDALA,KIWANYI,BUKAIGO T/CENTRE,520,1,1,2,91,255,350,21,371,0,O-7-38-04-02-02
IGANGA,KIGULU COUNTY NORTH,NAWANDALA,KYENDABAWALA,KABULI PRIMARY SCHOOL,409,2,2,4,46,268,322,0,322,0,O-7-38-04-03-01
IGANGA,KIGULU COUNTY NORTH,NAWANDALA,KYENDABAWALA,BUGAMBO KASOKOSO,448,1,4,1,47,213,266,75,341,0,O-7-38-04-03-02
IGANGA,KIGULU COUNTY NORTH,NAWANDALA,KYENDABAWALA,NABIKAMBA'S PLACE,381,1,1,0,32,262,296,4,300,0,O-7-38-04-03-03
IGANGA,KIGULU COUNTY NORTH,NAWANDALA,NAMUSIISI,NAMUSIISI PR. SCHOOL,502,4,2,2,70,263,341,0,341,0,O-7-38-04-04-01
IGANGA,KIGULU COUNTY NORTH,NAWANDALA,NAMUSIISI,MALOBI P/S,597,4,0,0,96,325,425,13,438,0,O-7-38-04-04-02
IGANGA,KIGULU COUNTY NORTH,NAWANDALA,NAMUSIISI,NAMUSIIS T/C,423,2,4,6,33,234,279,7,286,0,O-7-38-04-04-03
IGANGA,KIGULU COUNTY NORTH,NAWANDALA,NAWANGAIZA,KIRINGA PR/SCHOOL A,472,0,4,0,57,269,330,11,341,0,O-7-38-04-05-01
IGANGA,KIGULU COUNTY NORTH,NAWANDALA,NAWANGAIZA,KIRINGA PR/SCHOOL B,489,2,1,1,62,252,318,14,332,0,O-7-38-04-05-02
IGANGA,KIGULU COUNTY NORTH,NAWANDALA,NAWANGAIZA,KIRINGA PR/SCHOOL C,295,2,2,2,19,205,230,8,238,0,O-7-38-04-05-03
IGANGA,KIGULU COUNTY SOUTH,BULAMAGI,BUKOYO,WALUGOGO P/S A,686,0,3,1,125,166,295,18,313,0,O-7-39-01-01-01
IGANGA,KIGULU COUNTY SOUTH,BULAMAGI,BUKOYO,WALUGOGO PRIMARY SCH. B,683,2,1,2,130,237,372,5,377,0,O-7-39-01-01-02
IGANGA,KIGULU COUNTY SOUTH,BULAMAGI,BUKOYO,NAWANSINGE CENTRE,548,1,1,1,88,274,365,25,390,0,O-7-39-01-01-03
IGANGA,KIGULU COUNTY SOUTH,BULAMAGI,BUKOYO,BUDWEGE P/S,459,1,1,0,70,235,307,0,307,0,O-7-39-01-01-04
IGANGA,KIGULU COUNTY SOUTH,BULAMAGI,BULAMAGI,BULAMAGI ROAD JUNCTION,514,2,2,0,92,273,369,8,377,0,O-7-39-01-02-01
IGANGA,KIGULU COUNTY SOUTH,BULAMAGI,BULAMAGI,BUBAKA P/S,498,3,1,0,64,219,287,79,366,0,O-7-39-01-02-02
IGANGA,KIGULU COUNTY SOUTH,BULAMAGI,BULOWOZA,WALUKUMBA KASAMBYA,177,1,1,0,49,81,132,16,148,0,O-7-39-01-03-01
IGANGA,KIGULU COUNTY SOUTH,BULAMAGI,BULOWOZA,WAIBI'S PLACE,571,0,1,1,123,211,336,52,388,0,O-7-39-01-03-02
IGANGA,KIGULU COUNTY SOUTH,BULAMAGI,BULOWOZA,KASOLO MOSQUE,468,0,0,1,107,135,243,47,290,0,O-7-39-01-03-03
IGANGA,KIGULU COUNTY SOUTH,BULAMAGI,BULOWOZA,KASOLO METHODIST CHURCH,451,2,2,3,112,171,290,7,297,0,O-7-39-01-03-04
IGANGA,KIGULU COUNTY SOUTH,BULAMAGI,BULOWOZA,MADHIGANDERE CENTRE,395,0,0,0,113,145,258,0,258,0,O-7-39-01-03-05
IGANGA,KIGULU COUNTY SOUTH,BULAMAGI,BUNYIRO,BUNYIRO PR/SCHOOL A,547,1,1,0,107,201,310,47,357,0,O-7-39-01-04-01
IGANGA,KIGULU COUNTY SOUTH,BULAMAGI,BUNYIRO,BUNYIIRO P/S B,534,5,1,1,90,186,283,9,292,0,O-7-39-01-04-02
IGANGA,KIGULU COUNTY SOUTH,BULAMAGI,BUNYIRO,BUWOLOMERA P/S,719,3,0,2,112,301,418,52,470,0,O-7-39-01-04-03
IGANGA,KIGULU COUNTY SOUTH,BULAMAGI,BWANALIRA,BULAMAGI S/COUNTY HQTRS,473,3,2,0,83,239,327,6,333,0,O-7-39-01-05-01
IGANGA,KIGULU COUNTY SOUTH,BULAMAGI,BWANALIRA,BUWASA P/S,251,1,1,4,76,105,187,3,190,0,O-7-39-01-05-02
IGANGA,KIGULU COUNTY SOUTH,BULAMAGI,BWANALIRA,KINAWANSWA P/S,588,3,0,1,155,227,386,58,444,0,O-7-39-01-05-03
IGANGA,KIGULU COUNTY SOUTH,BULAMAGI,BWANALIRA,BUYUBU CATHOLIC CHURCH,403,1,1,1,99,182,284,23,307,0,O-7-39-01-05-04
IGANGA,KIGULU COUNTY SOUTH,BULAMAGI,IWAWU,NTINDA CENTRE A,468,2,1,1,107,176,287,7,294,0,O-7-39-01-06-01
IGANGA,KIGULU COUNTY SOUTH,BULAMAGI,IWAWU,NTINDA CENTRE B,683,3,2,0,125,271,401,54,455,0,O-7-39-01-06-02
IGANGA,KIGULU COUNTY SOUTH,BULAMAGI,IWAWU,NTINDA CENTRE C,567,3,1,1,93,299,397,3,400,0,O-7-39-01-06-03
IGANGA,KIGULU COUNTY SOUTH,BULAMAGI,IWAWU,KYEMEIRE CENTRE,611,0,2,0,125,184,311,74,385,0,O-7-39-01-06-04
IGANGA,KIGULU COUNTY SOUTH,BULAMAGI,IWAWU,NAMASOGA CENTRE,377,2,2,2,87,141,234,45,279,0,O-7-39-01-06-05
IGANGA,KIGULU COUNTY SOUTH,BULAMAGI,IWAWU,NTINDA FELLOWSHIP CHURCH,230,0,0,2,69,98,169,6,175,0,O-7-39-01-06-06
IGANGA,KIGULU COUNTY SOUTH,BULAMAGI,MAGOGO,MAGOGO P/S,766,2,0,0,108,323,433,46,479,0,O-7-39-01-07-01
IGANGA,KIGULU COUNTY SOUTH,BULAMAGI,MAGOGO,BUKONKO TRADING CENTRE,599,3,0,2,127,275,407,17,424,0,O-7-39-01-07-02
IGANGA,KIGULU COUNTY SOUTH,BULAMAGI,MAGOGO,LWERERA CENTRE A,500,1,0,1,124,216,342,17,359,0,O-7-39-01-07-03
IGANGA,KIGULU COUNTY SOUTH,BULAMAGI,MAGOGO,LWERERA CENTRE B,341,0,0,2,92,151,245,5,250,0,O-7-39-01-07-04
IGANGA,KIGULU COUNTY SOUTH,BULAMAGI,NAWANYINGI,NAWANYINGI P/S,462,1,0,0,110,172,283,27,310,0,O-7-39-01-08-01
IGANGA,KIGULU COUNTY SOUTH,BULAMAGI,NAWANYINGI,MAWAGALA P/S/ A,521,0,0,0,39,292,331,6,337,0,O-7-39-01-08-02
IGANGA,KIGULU COUNTY SOUTH,BULAMAGI,NAWANYINGI,MAWAGALA P/S B,438,0,2,0,36,193,231,9,240,0,O-7-39-01-08-03
IGANGA,KIGULU COUNTY SOUTH,BULAMAGI,NAWANYINGI,NAWANKONGE PS (A-M),592,0,0,2,102,255,359,7,366,0,O-7-39-01-08-04
IGANGA,KIGULU COUNTY SOUTH,BULAMAGI,NAWANYINGI,NAWANKOGE P/S (N-Z),292,1,0,1,29,131,162,20,182,0,O-7-39-01-08-05
IGANGA,KIGULU COUNTY SOUTH,IGANGA TOWN C.,BAGUMBA,IGANGA HIGH SCHOOL(A-L),897,1,1,2,206,185,395,39,434,0,O-7-39-02-01-01
IGANGA,KIGULU COUNTY SOUTH,IGANGA TOWN C.,BAGUMBA,MOONLIGHT CINEMA HALL (A-M),333,1,0,0,131,71,203,1,204,0,O-7-39-02-01-02
IGANGA,KIGULU COUNTY SOUTH,IGANGA TOWN C.,BAGUMBA,IGAMBA PR/SCHOOL (A-L),792,2,1,2,192,175,372,5,377,0,O-7-39-02-01-03
IGANGA,KIGULU COUNTY SOUTH,IGANGA TOWN C.,BAGUMBA,GOODSHED /ST,569,1,0,0,95,166,262,0,262,0,O-7-39-02-01-04
IGANGA,KIGULU COUNTY SOUTH,IGANGA TOWN C.,BAGUMBA,IGANGA HIGH SCHOOL (M),339,0,1,0,86,81,168,2,170,0,O-7-39-02-01-05
IGANGA,KIGULU COUNTY SOUTH,IGANGA TOWN C.,BAGUMBA,IGANGA HIGH SCHOOL (N-Z),806,2,0,0,166,195,363,7,370,0,O-7-39-02-01-06
IGANGA,KIGULU COUNTY SOUTH,IGANGA TOWN C.,BAGUMBA,MOONLIGHT CINEMA HALL (N-Z),442,3,1,0,131,92,227,5,232,0,O-7-39-02-01-07
IGANGA,KIGULU COUNTY SOUTH,IGANGA TOWN C.,BAGUMBA,IGAMBA PR/SCHOOL(M-Z),540,1,0,0,95,166,262,0,262,0,O-7-39-02-01-08
IGANGA,KIGULU COUNTY SOUTH,IGANGA TOWN C.,BAGUMBA,IGANGA R/WAY STATION,370,0,1,2,78,112,193,1,194,0,O-7-39-02-01-09
IGANGA,KIGULU COUNTY SOUTH,IGANGA TOWN C.,BULIGO,TREASURY HALL,973,2,1,0,187,179,369,6,375,0,O-7-39-02-02-01
IGANGA,KIGULU COUNTY SOUTH,IGANGA TOWN C.,BULIGO,BULOLO RD BABTIST CHURCH,758,0,0,0,144,143,287,5,292,0,O-7-39-02-02-02
IGANGA,KIGULU COUNTY SOUTH,IGANGA TOWN C.,BULIGO,BUNYA MARKET (A-M),739,1,0,1,183,171,356,15,371,0,O-7-39-02-02-03
IGANGA,KIGULU COUNTY SOUTH,IGANGA TOWN C.,BULIGO,WABEGHA'S PLACE(A-M),610,3,0,3,162,190,358,8,366,0,O-7-39-02-02-04
IGANGA,KIGULU COUNTY SOUTH,IGANGA TOWN C.,BULIGO,BUNYA MARKET (N-Z),590,1,0,0,94,190,285,9,294,0,O-7-39-02-02-05
IGANGA,KIGULU COUNTY SOUTH,IGANGA TOWN C.,BULIGO,WABEGHA'S PLACE (N-Z),481,1,0,0,101,125,227,8,235,0,O-7-39-02-02-06
IGANGA,KIGULU COUNTY SOUTH,IGANGA TOWN C.,BULIGO,IGANGA CHILDREN'S CENTRE,551,0,3,0,107,130,240,1,241,0,O-7-39-02-02-07
IGANGA,KIGULU COUNTY SOUTH,IGANGA TOWN C.,KASO KOSO,MUSLIM HALL A,559,2,1,0,182,112,297,1,298,0,O-7-39-02-03-01
IGANGA,KIGULU COUNTY SOUTH,IGANGA TOWN C.,KASO KOSO,MUSLIM HALL B,629,0,0,0,217,118,335,9,344,0,O-7-39-02-03-02
IGANGA,KIGULU COUNTY SOUTH,IGANGA TOWN C.,KASO KOSO,KASOKOSO P/S A(A-L),1000,4,1,0,320,172,497,0,497,0,O-7-39-02-03-03
IGANGA,KIGULU COUNTY SOUTH,IGANGA TOWN C.,KASO KOSO,KASOKOSO P/S (M-NAK),764,1,2,0,186,150,339,0,339,0,O-7-39-02-03-04
IGANGA,KIGULU COUNTY SOUTH,IGANGA TOWN C.,KASO KOSO,SULTAN'S PLACE A,964,2,4,0,285,225,516,2,518,0,O-7-39-02-03-05
IGANGA,KIGULU COUNTY SOUTH,IGANGA TOWN C.,KASO KOSO,KASOKOSO P/S (NAL-Z),801,1,0,2,210,146,359,1,360,0,O-7-39-02-03-06
IGANGA,KIGULU COUNTY SOUTH,IGANGA TOWN C.,KASO KOSO,SULTAN'S PLACE (N-Z),672,2,0,1,171,181,355,5,360,0,O-7-39-02-03-07
IGANGA,KIGULU COUNTY SOUTH,IGANGA TOWN C.,NAKAVULE,IGANGA HOSPITAL (A-K),860,1,1,1,224,249,476,10,486,0,O-7-39-02-04-01
IGANGA,KIGULU COUNTY SOUTH,IGANGA TOWN C.,NAKAVULE,UMOJA HOTEL (A-M),1176,7,1,0,334,220,562,9,571,0,O-7-39-02-04-02
IGANGA,KIGULU COUNTY SOUTH,IGANGA TOWN C.,NAKAVULE,GIFT PRIMARY SCHOOL,702,2,0,0,187,194,383,0,383,0,O-7-39-02-04-03
IGANGA,KIGULU COUNTY SOUTH,IGANGA TOWN C.,NAKAVULE,IGANGA HOSPITAL (L-M),528,1,1,0,150,133,285,1,286,0,O-7-39-02-04-04
IGANGA,KIGULU COUNTY SOUTH,IGANGA TOWN C.,NAKAVULE,IGANGA HOSPITAL (N-N),750,2,0,1,136,243,382,22,404,0,O-7-39-02-04-05
IGANGA,KIGULU COUNTY SOUTH,IGANGA TOWN C.,NAKAVULE,IGANGA HOSPITAL (O-Z),354,1,0,1,82,98,182,3,185,0,O-7-39-02-04-06
IGANGA,KIGULU COUNTY SOUTH,IGANGA TOWN C.,NAKAVULE,UMOJA HOTEL (N-Z),807,1,1,2,163,166,333,1,334,0,O-7-39-02-04-07
IGANGA,KIGULU COUNTY SOUTH,IGANGA TOWN C.,NKONO WARD,KALIRO ROAD,950,2,1,0,218,246,467,1,468,0,O-7-39-02-05-01
IGANGA,KIGULU COUNTY SOUTH,IGANGA TOWN C.,NKONO WARD,IGANGA TOWN COUNCIL OFFICES,905,2,1,0,206,201,410,4,414,0,O-7-39-02-05-02
IGANGA,KIGULU COUNTY SOUTH,IGANGA TOWN C.,NKONO WARD,IGANGA TOWNSHIP P/S,807,2,1,1,181,222,407,0,407,0,O-7-39-02-05-03
IGANGA,KIGULU COUNTY SOUTH,IGANGA TOWN C.,NKONO WARD,WILBER'S PLACE (A-M),580,2,0,0,190,118,310,0,310,0,O-7-39-02-05-04
IGANGA,KIGULU COUNTY SOUTH,IGANGA TOWN C.,NKONO WARD,MAGIDU'S PLACE,956,3,2,1,204,271,481,6,487,0,O-7-39-02-05-05
IGANGA,KIGULU COUNTY SOUTH,IGANGA TOWN C.,NKONO WARD,WILBER'S PLACE (N-Z),443,0,1,0,90,152,243,0,243,0,O-7-39-02-05-06
IGANGA,KIGULU COUNTY SOUTH,NAKALAMA,BUKAYE,BUKAYE CO-OP SOCIETY,580,2,3,1,145,218,369,30,399,0,O-7-39-03-01-01
IGANGA,KIGULU COUNTY SOUTH,NAKALAMA,BUKAYE,BUDALI PRIMARY SCHOOL,704,0,2,1,170,321,494,11,505,0,O-7-39-03-01-02
IGANGA,KIGULU COUNTY SOUTH,NAKALAMA,BUKAYE,NAMPIRIKA MOSQUE,731,5,0,3,268,158,434,16,450,0,O-7-39-03-01-03
IGANGA,KIGULU COUNTY SOUTH,NAKALAMA,BUKAYE,NAMPIRIKA BOREHOLE,402,2,2,0,90,133,227,47,274,0,O-7-39-03-01-04
IGANGA,KIGULU COUNTY SOUTH,NAKALAMA,BUKOONA,BUKOONA P/S(A-M),418,1,4,1,86,197,289,8,297,0,O-7-39-03-02-01
IGANGA,KIGULU COUNTY SOUTH,NAKALAMA,BUKOONA,NAMUDUNDI P/S A,614,0,1,1,80,288,370,43,413,0,O-7-39-03-02-02
IGANGA,KIGULU COUNTY SOUTH,NAKALAMA,BUKOONA,KAKONGOKA CHURCH A,472,2,0,1,75,270,348,14,362,0,O-7-39-03-02-03
IGANGA,KIGULU COUNTY SOUTH,NAKALAMA,BUKOONA,KAKONGOKA CHURCH B,399,1,2,4,48,206,261,11,272,0,O-7-39-03-02-04
IGANGA,KIGULU COUNTY SOUTH,NAKALAMA,BUKOONA,NAMUDUNDI P/S B,343,0,0,4,27,243,274,8,282,0,O-7-39-03-02-05
IGANGA,KIGULU COUNTY SOUTH,NAKALAMA,BUKOONA,BUKOONA P/S (N-Z),308,0,0,3,51,152,206,6,212,0,O-7-39-03-02-06
IGANGA,KIGULU COUNTY SOUTH,NAKALAMA,BUSEYI,BUSEYI CHURCH OF UGANDA,873,3,3,3,261,289,559,7,566,0,O-7-39-03-03-01
IGANGA,KIGULU COUNTY SOUTH,NAKALAMA,BUSEYI,BUSEYI ADVENTIST CHURCH,477,0,2,1,101,187,291,14,305,0,O-7-39-03-03-02
IGANGA,KIGULU COUNTY SOUTH,NAKALAMA,BUSEYI,BUSEYI MOSQUE,441,2,0,2,85,152,241,11,252,0,O-7-39-03-03-03
IGANGA,KIGULU COUNTY SOUTH,NAKALAMA,NAKALAMA,NAKALAMA P/S (A-M),700,4,1,1,173,244,423,2,425,0,O-7-39-03-04-01
IGANGA,KIGULU COUNTY SOUTH,NAKALAMA,NAKALAMA,BUKYAYE RAILWAY POST,683,2,3,3,156,206,370,106,476,0,O-7-39-03-04-02
IGANGA,KIGULU COUNTY SOUTH,NAKALAMA,NAKALAMA,NABIRYE MARKET,442,3,1,1,106,132,243,42,285,0,O-7-39-03-04-03
IGANGA,KIGULU COUNTY SOUTH,NAKALAMA,NAKALAMA,BUKOBOLI CENTRE,567,6,0,6,109,213,334,15,349,0,O-7-39-03-04-04
IGANGA,KIGULU COUNTY SOUTH,NAKALAMA,NAKALAMA,BUTAAMA CENTRE,274,0,0,1,62,116,179,6,185,0,O-7-39-03-04-05
IGANGA,KIGULU COUNTY SOUTH,NAKALAMA,NAKALAMA,NAKALAMA MOSQUE (N-Z),567,3,6,1,96,204,310,12,322,0,O-7-39-03-04-06
IGANGA,KIGULU COUNTY SOUTH,NAKIGO,BULUBANDI,BULUBANDI CENTRE (A-M),564,3,1,2,155,180,341,9,350,0,O-7-39-04-01-01
IGANGA,KIGULU COUNTY SOUTH,NAKIGO,BULUBANDI,BUGABWE P/S,648,1,0,1,144,239,385,27,412,0,O-7-39-04-01-02
IGANGA,KIGULU COUNTY SOUTH,NAKIGO,BULUBANDI,NANDEKULA BOREHOLE,757,2,3,3,184,275,467,18,485,0,O-7-39-04-01-03
IGANGA,KIGULU COUNTY SOUTH,NAKIGO,BULUBANDI,BULUBANDI CENTRE (N-Z),487,2,3,0,91,159,255,13,268,0,O-7-39-04-01-04
IGANGA,KIGULU COUNTY SOUTH,NAKIGO,BUNYAMA,NAKIGO COUNTY CENTRE A,559,0,1,1,150,244,396,11,407,0,O-7-39-04-02-01
IGANGA,KIGULU COUNTY SOUTH,NAKIGO,BUNYAMA,NAKIGO COUNTY CENTRE B,604,3,5,5,154,197,364,9,373,0,O-7-39-04-02-02
IGANGA,KIGULU COUNTY SOUTH,NAKIGO,BUNYAMA,BUKWAYA P/S,559,3,1,2,127,245,378,7,385,0,O-7-39-04-02-03
IGANGA,KIGULU COUNTY SOUTH,NAKIGO,BUSOWOBI,NAKIGO S/COUNTY HQTRS (A-M),428,3,0,3,137,146,289,4,293,0,O-7-39-04-03-01
IGANGA,KIGULU COUNTY SOUTH,NAKIGO,BUSOWOBI,NABITOVU P/S,607,2,0,2,130,191,325,56,381,0,O-7-39-04-03-02
IGANGA,KIGULU COUNTY SOUTH,NAKIGO,BUSOWOBI,BUSOWOBI P/S (A-M),492,1,2,0,158,191,352,16,368,0,O-7-39-04-03-03
IGANGA,KIGULU COUNTY SOUTH,NAKIGO,BUSOWOBI,NAKIGO S/COUNTY HQTRS (N-Z),276,0,1,0,68,105,174,1,175,0,O-7-39-04-03-04
IGANGA,KIGULU COUNTY SOUTH,NAKIGO,BUSOWOBI,BUSOWOBI P/S (N-Z),491,2,0,3,101,182,288,7,295,0,O-7-39-04-03-05
IGANGA,KIGULU COUNTY SOUTH,NAKIGO,KIBIRA,BULUZA TRADING CENTRE,525,1,1,0,157,173,332,0,332,0,O-7-39-04-04-01
IGANGA,KIGULU COUNTY SOUTH,NAKIGO,KIBIRA,KABIRA T/CENTRE A,568,2,1,2,172,210,387,6,393,0,O-7-39-04-04-02
IGANGA,KIGULU COUNTY SOUTH,NAKIGO,KIBIRA,KABIRA T/CENTRE B,366,2,0,1,98,146,247,22,269,0,O-7-39-04-04-03
IGANGA,KIGULU COUNTY SOUTH,NAKIGO,WAIRAMA,WAIRAMA TRADING CENTRE,753,6,2,4,186,247,445,16,461,0,O-7-39-04-05-01
IGANGA,KIGULU COUNTY SOUTH,NAKIGO,WAIRAMA,NAKISENYI PRIMARY SCHOOL,435,0,3,2,74,215,294,10,304,0,O-7-39-04-05-02
IGANGA,KIGULU COUNTY SOUTH,NAKIGO,WAIRAMA,KAKOMBO P/S,482,0,1,1,139,205,346,12,358,0,O-7-39-04-05-03
JINJA,BUTEMBE COUNTY,BUSEDDE,BUGOBYA,NAMASIGA I,342,1,0,1,76,148,226,36,262,0,O-8-41-01-01-01
JINJA,BUTEMBE COUNTY,BUSEDDE,BUGOBYA,NAMASIGA II,634,2,5,2,101,296,406,20,426,0,O-8-41-01-01-02
JINJA,BUTEMBE COUNTY,BUSEDDE,BUGOBYA,NABIRAMA I,586,1,3,0,88,267,359,59,418,0,O-8-41-01-01-03
JINJA,BUTEMBE COUNTY,BUSEDDE,BUGOBYA,NABIRAMA II,232,0,0,0,29,129,158,14,172,0,O-8-41-01-01-04
JINJA,BUTEMBE COUNTY,BUSEDDE,BUGOBYA,NAMAZALA/NAKATI/LUKONKO,373,1,1,2,68,149,221,27,248,0,O-8-41-01-01-05
JINJA,BUTEMBE COUNTY,BUSEDDE,ITAKAIBOLU,ITAKAIBOLU/KASITA,425,3,0,0,89,178,270,2,272,0,O-8-41-01-02-01
JINJA,BUTEMBE COUNTY,BUSEDDE,ITAKAIBOLU,KASOZI/WALUMBUGU,559,0,1,2,96,195,294,46,340,0,O-8-41-01-02-02
JINJA,BUTEMBE COUNTY,BUSEDDE,ITAKAIBOLU,KIGALAGALA I,595,2,0,6,142,253,403,10,413,0,O-8-41-01-02-03
JINJA,BUTEMBE COUNTY,BUSEDDE,ITAKAIBOLU,KIGALAGALA II,260,0,1,0,59,117,177,3,180,0,O-8-41-01-02-04
JINJA,BUTEMBE COUNTY,BUSEDDE,ITAKAIBOLU,NAMATOLO/MPAMBWE,489,1,1,0,52,241,295,29,324,0,O-8-41-01-02-05
JINJA,BUTEMBE COUNTY,BUSEDDE,KISASI,NAMAGANGA I,367,1,1,2,80,185,269,2,271,0,O-8-41-01-03-01
JINJA,BUTEMBE COUNTY,BUSEDDE,KISASI,NAMAGANGA II,518,1,0,1,93,230,325,32,357,0,O-8-41-01-03-02
JINJA,BUTEMBE COUNTY,BUSEDDE,KISASI,IRERA,420,2,1,3,63,210,279,14,293,0,O-8-41-01-03-03
JINJA,BUTEMBE COUNTY,BUSEDDE,KISASI,NABULAGALA,316,0,0,4,34,175,213,11,224,0,O-8-41-01-03-04
JINJA,BUTEMBE COUNTY,BUSEDDE,KISASI,KAKUBA,663,2,2,3,108,335,450,15,465,0,O-8-41-01-03-05
JINJA,BUTEMBE COUNTY,BUSEDDE,NALINAIBI,NALINAIBI I,576,2,2,2,70,300,376,37,413,0,O-8-41-01-04-01
JINJA,BUTEMBE COUNTY,BUSEDDE,NALINAIBI,NALINAIBI II,210,0,0,0,40,101,141,2,143,0,O-8-41-01-04-02
JINJA,BUTEMBE COUNTY,BUSEDDE,NALINAIBI,NTINDA I,483,0,0,0,65,278,343,6,349,0,O-8-41-01-04-03
JINJA,BUTEMBE COUNTY,BUSEDDE,NALINAIBI,NTINDA II,500,0,1,6,48,296,351,9,360,0,O-8-41-01-04-04
JINJA,BUTEMBE COUNTY,BUSEDDE,NALINAIBI,LWINO,86,0,0,0,17,45,62,5,67,0,O-8-41-01-04-05
JINJA,BUTEMBE COUNTY,BUSEDDE,NAMBITAMBALA,NABITAMBALA TC,594,1,2,1,125,242,371,38,409,0,O-8-41-01-05-01
JINJA,BUTEMBE COUNTY,BUSEDDE,NAMBITAMBALA,KISIRIRA,621,1,3,4,196,232,436,6,442,0,O-8-41-01-05-02
JINJA,BUTEMBE COUNTY,BUSEDDE,NAMBITAMBALA,BWIDHABWANGU,570,2,2,0,67,321,392,14,406,0,O-8-41-01-05-03
JINJA,BUTEMBE COUNTY,BUSEDDE,NAMBITAMBALA,BUSIGE,449,0,4,2,53,280,339,2,341,0,O-8-41-01-05-04
JINJA,BUTEMBE COUNTY,BUSEDDE,NAMBITAMBALA,NABIWAWULO TC,195,4,0,0,38,93,135,7,142,0,O-8-41-01-05-05
JINJA,BUTEMBE COUNTY,KAKIRA,KAKIRA TC,SINGLE QUARTER/BANGLOW,444,0,4,0,178,115,297,3,300,0,O-8-41-02-01-01
JINJA,BUTEMBE COUNTY,KAKIRA,KAKIRA TC,NYANZA/40/POSTAL/SECURITY,293,0,1,0,89,52,142,3,145,0,O-8-41-02-01-02
JINJA,BUTEMBE COUNTY,KAKIRA,KAKIRA TC,KABYAZA/RAILWAY/MABATI/SAMI,425,4,3,1,169,98,275,4,279,0,O-8-41-02-01-03
JINJA,BUTEMBE COUNTY,KAKIRA,KAKIRA TC,LINE KUBWA A,333,2,6,1,180,50,239,2,241,0,O-8-41-02-01-04
JINJA,BUTEMBE COUNTY,KAKIRA,KAKIRA TC,LINE KUBWA B,265,1,1,1,136,34,173,4,177,0,O-8-41-02-01-05
JINJA,BUTEMBE COUNTY,KAKIRA,KAKIRA TC,MAJI-MAZUR/1-TEN,150,0,2,0,52,46,100,1,101,0,O-8-41-02-01-06
JINJA,BUTEMBE COUNTY,KAKIRA,KAKIRA TC,GG3/FF1/LINYA,360,0,1,0,128,68,197,3,200,0,O-8-41-02-01-07
JINJA,BUTEMBE COUNTY,KAKIRA,KAKIRA TC,NTINKALU/GO-1,232,0,1,0,70,45,116,11,127,0,O-8-41-02-01-08
JINJA,BUTEMBE COUNTY,KAKIRA,KALONGO,CHICO/KARANTINI/SAFI/MOTAFALI,368,1,1,1,97,101,201,7,208,0,O-8-41-02-02-01
JINJA,BUTEMBE COUNTY,KAKIRA,KALONGO,TEREGO PR SCHOOL,683,3,0,2,287,163,455,21,476,0,O-8-41-02-02-02
JINJA,BUTEMBE COUNTY,KAKIRA,KALONGO,Q-6/BUKASA/KIRINYA,289,1,1,0,101,24,127,6,133,0,O-8-41-02-02-03
JINJA,BUTEMBE COUNTY,KAKIRA,KALONGO,MUTAI,181,1,0,0,65,34,100,8,108,0,O-8-41-02-02-04
JINJA,BUTEMBE COUNTY,KAKIRA,KALONGO,KOROKOTO,240,0,1,0,138,26,165,3,168,0,O-8-41-02-02-05
JINJA,BUTEMBE COUNTY,KAKIRA,KALONGO,KYENDA/K.H.A.7,249,0,0,1,60,85,146,13,159,0,O-8-41-02-02-06
JINJA,BUTEMBE COUNTY,KAKIRA,MAWOITO TC,KABEMBE/KAGOGWA,651,3,3,2,167,239,414,31,445,0,O-8-41-02-03-01
JINJA,BUTEMBE COUNTY,KAKIRA,MAWOITO TC,MAWOITO A (A-M),489,1,1,2,160,129,293,14,307,0,O-8-41-02-03-02
JINJA,BUTEMBE COUNTY,KAKIRA,MAWOITO TC,POLOTA (A-M),656,3,4,1,206,135,349,4,353,0,O-8-41-02-03-03
JINJA,BUTEMBE COUNTY,KAKIRA,MAWOITO TC,MARKET,350,0,1,1,107,84,193,4,197,0,O-8-41-02-03-04
JINJA,BUTEMBE COUNTY,KAKIRA,MAWOITO TC,MAWOITO (A-M),472,0,1,4,133,109,247,12,259,0,O-8-41-02-03-05
JINJA,BUTEMBE COUNTY,KAKIRA,MAWOITO TC,MAWOITO B (N-Z),367,1,1,3,138,91,234,4,238,0,O-8-41-02-03-06
JINJA,BUTEMBE COUNTY,KAKIRA,MAWOITO TC,POLOTA (N-Z),535,0,5,0,131,134,270,4,274,0,O-8-41-02-03-07
JINJA,BUTEMBE COUNTY,KAKIRA,MAWOITO TC,SCHOOL,523,0,2,0,146,97,245,5,250,0,O-8-41-02-03-08
JINJA,BUTEMBE COUNTY,KAKIRA,MAWOITO TC,MAWOITO (N-Z),374,2,3,1,96,95,197,6,203,0,O-8-41-02-03-09
JINJA,BUTEMBE COUNTY,KAKIRA,WAIRAKA,WAIRAKA A,512,1,0,3,140,171,315,6,321,0,O-8-41-02-04-01
JINJA,BUTEMBE COUNTY,KAKIRA,WAIRAKA,WALUMBE/NALUBALE,531,6,1,1,159,181,348,14,362,0,O-8-41-02-04-02
JINJA,BUTEMBE COUNTY,KAKIRA,WAIRAKA,WAIRAKA CENTRAL/WAIRAKA B/N,773,3,3,3,214,282,505,8,513,0,O-8-41-02-04-03
JINJA,BUTEMBE COUNTY,KAKIRA,WAIRAKA,NAMAZIBA/KINYORO/WAIRAKA CO,602,4,1,1,149,184,339,15,354,0,O-8-41-02-04-04
JINJA,BUTEMBE COUNTY,MAFUBIRA,BUGEMBE,WANYAMA EAST A,689,4,4,1,204,169,382,6,388,0,O-8-41-03-01-01
JINJA,BUTEMBE COUNTY,MAFUBIRA,BUGEMBE,WANYAMA WEST A,697,1,3,0,183,166,353,6,359,0,O-8-41-03-01-02
JINJA,BUTEMBE COUNTY,MAFUBIRA,BUGEMBE,KATENDE EAST A,878,4,0,0,255,220,479,12,491,0,O-8-41-03-01-03
JINJA,BUTEMBE COUNTY,MAFUBIRA,BUGEMBE,KATENDE EAST B,555,2,3,1,136,130,272,7,279,0,O-8-41-03-01-04
JINJA,BUTEMBE COUNTY,MAFUBIRA,BUGEMBE,KATWE A,384,0,0,0,103,123,226,2,228,0,O-8-41-03-01-05
JINJA,BUTEMBE COUNTY,MAFUBIRA,BUGEMBE,KATWE B,231,0,0,0,78,70,148,1,149,0,O-8-41-03-01-06
JINJA,BUTEMBE COUNTY,MAFUBIRA,BUGEMBE,BUDUMBULI A,710,3,3,0,200,184,390,10,400,0,O-8-41-03-01-07
JINJA,BUTEMBE COUNTY,MAFUBIRA,BUGEMBE,BUDUMBULI B,755,3,0,0,240,160,403,8,411,0,O-8-41-03-01-08
JINJA,BUTEMBE COUNTY,MAFUBIRA,BUGEMBE,BUDUMBULI C,1014,3,3,1,333,242,582,12,594,0,O-8-41-03-01-09
JINJA,BUTEMBE COUNTY,MAFUBIRA,BUGEMBE,BUDUMBULI D,581,1,5,2,199,142,349,2,351,0,O-8-41-03-01-10
JINJA,BUTEMBE COUNTY,MAFUBIRA,BUGEMBE,BUDUMBULI E,639,0,1,0,194,123,318,39,357,0,O-8-41-03-01-11
JINJA,BUTEMBE COUNTY,MAFUBIRA,BUGEMBE,BUDUMBULI F,461,2,1,0,127,92,222,4,226,0,O-8-41-03-01-12
JINJA,BUTEMBE COUNTY,MAFUBIRA,BUGEMBE,NAKANYONYI A,670,2,1,0,187,221,411,3,414,0,O-8-41-03-01-13
JINJA,BUTEMBE COUNTY,MAFUBIRA,BUGEMBE,WANYAMA EAST B,339,0,2,1,87,95,185,3,188,0,O-8-41-03-01-14
JINJA,BUTEMBE COUNTY,MAFUBIRA,BUGEMBE,WANYAMA WEST B,498,2,2,0,125,143,272,9,281,0,O-8-41-03-01-15
JINJA,BUTEMBE COUNTY,MAFUBIRA,BUGEMBE,KATENDE WEST,482,0,4,2,131,141,278,2,280,0,O-8-41-03-01-16
JINJA,BUTEMBE COUNTY,MAFUBIRA,BUGEMBE,BUDUMBULI G,381,0,1,1,100,69,171,10,181,0,O-8-41-03-01-17
JINJA,BUTEMBE COUNTY,MAFUBIRA,BUGEMBE,NAKANYONYI B,346,0,2,0,77,90,169,23,192,0,O-8-41-03-01-18
JINJA,BUTEMBE COUNTY,MAFUBIRA,BUWEKULA,WAKITAKA MOSQUE A,690,3,1,4,242,184,434,21,455,0,O-8-41-03-02-01
JINJA,BUTEMBE COUNTY,MAFUBIRA,BUWEKULA,WAKITAKA B/MAUTA,292,0,0,0,87,109,196,3,199,0,O-8-41-03-02-02
JINJA,BUTEMBE COUNTY,MAFUBIRA,BUWEKULA,ST. JUDE BUWEKULA,488,0,0,0,134,197,331,4,335,0,O-8-41-03-02-03
JINJA,BUTEMBE COUNTY,MAFUBIRA,BUWEKULA,KAINOGOGA,374,0,0,0,119,148,267,14,281,0,O-8-41-03-02-04
JINJA,BUTEMBE COUNTY,MAFUBIRA,BUWEKULA,WAKITAKA MOSQUE B,323,0,0,1,86,95,182,6,188,0,O-8-41-03-02-05
JINJA,BUTEMBE COUNTY,MAFUBIRA,BUWENDA TC,WAKALENGE,276,1,0,2,58,127,188,5,193,0,O-8-41-03-03-01
JINJA,BUTEMBE COUNTY,MAFUBIRA,BUWENDA TC,KAITABAWALA,584,1,3,3,180,220,407,2,409,0,O-8-41-03-03-02
JINJA,BUTEMBE COUNTY,MAFUBIRA,BUWENDA TC,IDHOGOLO/BUTIKI,653,9,2,2,148,297,458,16,474,0,O-8-41-03-03-03
JINJA,BUTEMBE COUNTY,MAFUBIRA,BUWENDA TC,BUTIKI,441,1,1,1,108,198,309,9,318,0,O-8-41-03-03-04
JINJA,BUTEMBE COUNTY,MAFUBIRA,BUWENDA TC,BUWENDA A,627,2,1,5,164,227,399,63,462,0,O-8-41-03-03-05
JINJA,BUTEMBE COUNTY,MAFUBIRA,BUWENDA TC,BUWENDA B,641,4,1,2,161,279,447,17,464,0,O-8-41-03-03-06
JINJA,BUTEMBE COUNTY,MAFUBIRA,MAFUBIRA,MAFUBIRA 1,933,1,0,1,294,266,562,20,582,0,O-8-41-03-04-01
JINJA,BUTEMBE COUNTY,MAFUBIRA,MAFUBIRA,MAFUBIRA 2,888,2,3,0,249,274,528,10,538,0,O-8-41-03-04-02
JINJA,BUTEMBE COUNTY,MAFUBIRA,MAFUBIRA,MAFUBIRA 3 A,370,1,0,1,99,87,188,1,189,0,O-8-41-03-04-03
JINJA,BUTEMBE COUNTY,MAFUBIRA,MAFUBIRA,KAYUNGA A,520,0,3,2,166,165,336,11,347,0,O-8-41-03-04-04
JINJA,BUTEMBE COUNTY,MAFUBIRA,MAFUBIRA,KYAMAGWA,519,1,1,1,142,190,335,12,347,0,O-8-41-03-04-05
JINJA,BUTEMBE COUNTY,MAFUBIRA,MAFUBIRA,SEKABUSOLO,456,5,0,2,120,112,239,0,239,0,O-8-41-03-04-06
JINJA,BUTEMBE COUNTY,MAFUBIRA,MAFUBIRA,MAKENKE/KITOVU,441,1,1,2,149,109,262,24,286,0,O-8-41-03-04-07
JINJA,BUTEMBE COUNTY,MAFUBIRA,MAFUBIRA,MAFUBIRA 3 C,580,2,0,2,154,158,316,2,318,0,O-8-41-03-04-08
JINJA,BUTEMBE COUNTY,MAFUBIRA,MAFUBIRA,KAYUNGA B,309,1,0,0,71,104,176,9,185,0,O-8-41-03-04-09
JINJA,BUTEMBE COUNTY,MAFUBIRA,NAMULESA,NAMULESA A,705,5,6,2,203,190,406,5,411,0,O-8-41-03-05-01
JINJA,BUTEMBE COUNTY,MAFUBIRA,NAMULESA,NAMULESA B,657,2,5,1,226,169,403,7,410,0,O-8-41-03-05-02
JINJA,BUTEMBE COUNTY,MAFUBIRA,NAMULESA,NAMULESA C,625,3,1,3,174,201,382,4,386,0,O-8-41-03-05-03
JINJA,BUTEMBE COUNTY,MAFUBIRA,NAMULESA,WABULENGA,632,1,1,4,172,232,410,9,419,0,O-8-41-03-05-04
JINJA,BUTEMBE COUNTY,MAFUBIRA,NAMULESA,LWANDA (A - M),463,1,0,0,84,206,291,4,295,0,O-8-41-03-05-05
JINJA,BUTEMBE COUNTY,MAFUBIRA,NAMULESA,LWANDA B/ISIKWE,407,0,1,4,64,171,240,4,244,0,O-8-41-03-05-06
JINJA,BUTEMBE COUNTY,MAFUBIRA,NAMULESA,NAKABANGO A,639,3,3,4,151,233,394,20,414,0,O-8-41-03-05-07
JINJA,BUTEMBE COUNTY,MAFUBIRA,NAMULESA,NAKABANGO B,668,3,2,2,132,266,405,29,434,0,O-8-41-03-05-08
JINJA,BUTEMBE COUNTY,MAFUBIRA,NAMULESA,LWANDA (N - Z),346,1,1,0,61,134,197,19,216,0,O-8-41-03-05-09
JINJA,BUTEMBE COUNTY,MAFUBIRA,WANYANGE,WANYANGE LAKE A,601,3,1,1,193,196,394,8,402,0,O-8-41-03-06-01
JINJA,BUTEMBE COUNTY,MAFUBIRA,WANYANGE,WANYANGE CENTRAL,697,3,1,3,188,224,419,5,424,0,O-8-41-03-06-02
JINJA,BUTEMBE COUNTY,MAFUBIRA,WANYANGE,WANYANGE HILL I,638,2,3,0,176,205,386,10,396,0,O-8-41-03-06-03
JINJA,BUTEMBE COUNTY,MAFUBIRA,WANYANGE,WANYANGE LAKE II,656,1,1,1,188,208,399,7,406,0,O-8-41-03-06-04
JINJA,BUTEMBE COUNTY,MAFUBIRA,WANYANGE,WANYANGE HILL II,515,2,1,1,136,181,321,7,328,0,O-8-41-03-06-05
JINJA,BUTEMBE COUNTY,MAFUBIRA,WANYANGE,MUSIIMA,460,5,2,0,114,226,347,8,355,0,O-8-41-03-06-06
JINJA,BUTEMBE COUNTY,MAFUBIRA,WANYANGE,KALUNGAMI,249,0,2,1,47,124,174,5,179,0,O-8-41-03-06-07
JINJA,JINJA MUNIC. EAST,JINJA EAST,CENTRAL JINJA EAST,ALLIDINA I/M.ST P/S,442,1,1,1,174,90,267,6,273,0,O-8-43-01-01-01
JINJA,JINJA MUNIC. EAST,JINJA EAST,CENTRAL JINJA EAST,ALLIDINA II/M.ST P/S,447,0,0,0,187,110,297,11,308,0,O-8-43-01-01-02
JINJA,JINJA MUNIC. EAST,JINJA EAST,CENTRAL JINJA EAST,ALLIDINA III/M.ST P/S,484,5,2,0,211,114,332,1,333,0,O-8-43-01-01-03
JINJA,JINJA MUNIC. EAST,JINJA EAST,CENTRAL JINJA EAST,ALLIDINA IV/M.ST P/S,307,0,2,0,107,95,204,1,205,0,O-8-43-01-01-04
JINJA,JINJA MUNIC. EAST,JINJA EAST,CENTRAL JINJA EAST,ALLIDINA V/M.ST P/S,587,2,2,1,168,77,250,4,254,0,O-8-43-01-01-05
JINJA,JINJA MUNIC. EAST,JINJA EAST,CENTRAL JINJA EAST,ALLIDINA VI/M.ST P/S,422,0,1,0,188,102,291,7,298,0,O-8-43-01-01-06
JINJA,JINJA MUNIC. EAST,JINJA EAST,CENTRAL JINJA EAST,MAIN STREET EAST,446,1,1,0,163,116,281,7,288,0,O-8-43-01-01-07
JINJA,JINJA MUNIC. EAST,JINJA EAST,CENTRAL JINJA EAST,SPIRE ROAD 1-A,787,7,0,4,351,158,520,7,527,0,O-8-43-01-01-08
JINJA,JINJA MUNIC. EAST,JINJA EAST,CENTRAL JINJA EAST,OBOJA ROAD,766,2,4,1,328,157,492,4,496,0,O-8-43-01-01-09
JINJA,JINJA MUNIC. EAST,JINJA EAST,CENTRAL JINJA EAST,IGANGA ROAD I/TOWN HALL,429,0,0,1,176,91,268,4,272,0,O-8-43-01-01-10
JINJA,JINJA MUNIC. EAST,JINJA EAST,CENTRAL JINJA EAST,SPIRE ROAD 2/KIRINYA ROAD,801,1,3,1,460,126,591,8,599,0,O-8-43-01-01-11
JINJA,JINJA MUNIC. EAST,JINJA EAST,CENTRAL JINJA EAST,IGANGA ROAD II/TOWN HALL,432,1,2,2,165,92,262,4,266,0,O-8-43-01-01-12
JINJA,JINJA MUNIC. EAST,JINJA EAST,CENTRAL JINJA EAST,LUBAS ROAD 1,472,1,1,0,177,138,317,8,325,0,O-8-43-01-01-13
JINJA,JINJA MUNIC. EAST,JINJA EAST,CENTRAL JINJA EAST,LUBAS ROAD 2,420,0,0,2,158,100,260,6,266,0,O-8-43-01-01-14
JINJA,JINJA MUNIC. EAST,JINJA EAST,CENTRAL JINJA EAST,SPIRE ROAD 1-B,251,2,0,0,105,45,152,3,155,0,O-8-43-01-01-15
JINJA,JINJA MUNIC. EAST,JINJA EAST,OLD BOMA,RIPON,343,4,5,1,115,72,197,1,198,0,O-8-43-01-02-01
JINJA,JINJA MUNIC. EAST,JINJA EAST,OLD BOMA,LOCO,751,1,5,0,273,133,412,16,428,0,O-8-43-01-02-02
JINJA,JINJA MUNIC. EAST,JINJA EAST,OLD BOMA,KIRINYA PRISON,250,0,0,0,85,53,138,5,143,0,O-8-43-01-02-03
JINJA,JINJA MUNIC. EAST,JINJA EAST,OLD BOMA,GRANT/KYAGWE,813,2,3,1,290,173,469,4,473,0,O-8-43-01-02-04
JINJA,JINJA MUNIC. EAST,JINJA EAST,OLD BOMA,NILE CRESENT,242,1,2,0,91,55,149,2,151,0,O-8-43-01-02-05
JINJA,JINJA MUNIC. EAST,WALUKUBA/MASESE,MASESE,MASESE 1 A,930,3,3,2,206,186,400,30,430,0,O-8-43-02-01-01
JINJA,JINJA MUNIC. EAST,WALUKUBA/MASESE,MASESE,MASESE 1 B (A-L),455,1,1,0,110,105,217,27,244,0,O-8-43-02-01-02
JINJA,JINJA MUNIC. EAST,WALUKUBA/MASESE,MASESE,KISIMA PRI. S CHOOL,515,3,0,2,128,137,270,3,273,0,O-8-43-02-01-03
JINJA,JINJA MUNIC. EAST,WALUKUBA/MASESE,MASESE,MASESE/DANIDA 1,767,2,1,1,213,88,305,81,386,0,O-8-43-02-01-04
JINJA,JINJA MUNIC. EAST,WALUKUBA/MASESE,MASESE,MASESE/DANIDA 2,852,0,2,1,249,191,443,58,501,0,O-8-43-02-01-05
JINJA,JINJA MUNIC. EAST,WALUKUBA/MASESE,MASESE,MASESE 3 A,708,1,2,1,151,98,253,81,334,0,O-8-43-02-01-06
JINJA,JINJA MUNIC. EAST,WALUKUBA/MASESE,MASESE,MASESE 3 B,610,1,0,2,117,107,227,63,290,0,O-8-43-02-01-07
JINJA,JINJA MUNIC. EAST,WALUKUBA/MASESE,MASESE,MASESE 1 D,482,2,3,1,144,79,229,12,241,0,O-8-43-02-01-08
JINJA,JINJA MUNIC. EAST,WALUKUBA/MASESE,MASESE,MASESE 1 C,462,2,0,2,48,161,213,25,238,0,O-8-43-02-01-09
JINJA,JINJA MUNIC. EAST,WALUKUBA/MASESE,MASESE,MASESE/DANIDA 3,448,2,1,0,164,39,206,27,233,0,O-8-43-02-01-10
JINJA,JINJA MUNIC. EAST,WALUKUBA/MASESE,MASESE,MASESE 3 C,368,2,5,0,100,36,143,26,169,0,O-8-43-02-01-11
JINJA,JINJA MUNIC. EAST,WALUKUBA/MASESE,MASESE,MASESE 1 B (M-Z),527,1,2,1,141,123,268,1,269,0,O-8-43-02-01-12
JINJA,JINJA MUNIC. EAST,WALUKUBA/MASESE,WALUKUBA EAST,CHURCH VILLAGE,694,0,8,5,289,156,458,37,495,0,O-8-43-02-02-01
JINJA,JINJA MUNIC. EAST,WALUKUBA/MASESE,WALUKUBA EAST,POLICE WING,746,3,6,1,258,209,477,6,483,0,O-8-43-02-02-02
JINJA,JINJA MUNIC. EAST,WALUKUBA/MASESE,WALUKUBA EAST,SCHOOL VILLAGE,632,1,3,0,225,159,388,9,397,0,O-8-43-02-02-03
JINJA,JINJA MUNIC. EAST,WALUKUBA/MASESE,WALUKUBA EAST,NTEGE VILLAGE,376,2,0,1,114,127,244,8,252,0,O-8-43-02-02-04
JINJA,JINJA MUNIC. EAST,WALUKUBA/MASESE,WALUKUBA EAST,CENTRAL/STEEL,568,3,3,2,201,165,374,39,413,0,O-8-43-02-02-05
JINJA,JINJA MUNIC. EAST,WALUKUBA/MASESE,WALUKUBA WEST,WICO/IDA,736,2,0,5,287,133,427,55,482,0,O-8-43-02-03-01
JINJA,JINJA MUNIC. EAST,WALUKUBA/MASESE,WALUKUBA WEST,ZABEF,736,1,4,3,270,170,448,4,452,0,O-8-43-02-03-02
JINJA,JINJA MUNIC. EAST,WALUKUBA/MASESE,WALUKUBA WEST,JROP,518,1,1,1,191,122,316,27,343,0,O-8-43-02-03-03
JINJA,JINJA MUNIC. EAST,WALUKUBA/MASESE,WALUKUBA WEST,BABU/RAILWAY,781,3,3,2,275,179,462,5,467,0,O-8-43-02-03-04
JINJA,JINJA MUNIC. EAST,WALUKUBA/MASESE,WALUKUBA WEST,MATERNITY,643,0,1,0,216,162,379,6,385,0,O-8-43-02-03-05
JINJA,JINJA MUNIC. EAST,WALUKUBA/MASESE,WALUKUBA WEST,KLMN,466,0,0,2,141,114,257,28,285,0,O-8-43-02-03-06
JINJA,JINJA MUNIC. EAST,WALUKUBA/MASESE,WALUKUBA WEST,WORKS,127,0,0,0,46,33,79,3,82,0,O-8-43-02-03-07
JINJA,JINJA MUNICIPALITY WEST,JINJA CENTRAL,CENTRAL JINJA WES,GABULA 1/KAKINDU,887,8,5,2,279,226,520,3,523,0,O-8-44-01-01-01
JINJA,JINJA MUNICIPALITY WEST,JINJA CENTRAL,CENTRAL JINJA WES,GABULA 2/KAKINDU,474,4,4,5,175,124,312,0,312,0,O-8-44-01-01-02
JINJA,JINJA MUNICIPALITY WEST,JINJA CENTRAL,CENTRAL JINJA WES,MAIN STREET WEST/NARAMBHAI,633,2,4,3,209,161,379,7,386,0,O-8-44-01-01-03
JINJA,JINJA MUNICIPALITY WEST,JINJA CENTRAL,CENTRAL JINJA WES,RIPON/NILE I (A-L),629,3,5,3,185,125,321,4,325,0,O-8-44-01-01-04
JINJA,JINJA MUNICIPALITY WEST,JINJA CENTRAL,CENTRAL JINJA WES,RIPON/NILE II,397,2,3,2,96,72,175,2,177,0,O-8-44-01-01-05
JINJA,JINJA MUNICIPALITY WEST,JINJA CENTRAL,CENTRAL JINJA WES,RIPON/NILE I (M-Z),430,2,4,2,117,91,216,4,220,0,O-8-44-01-01-06
JINJA,JINJA MUNICIPALITY WEST,JINJA CENTRAL,MAGGWA,MVULE I/PMM S.S,785,2,1,2,234,150,389,4,393,0,O-8-44-01-02-01
JINJA,JINJA MUNICIPALITY WEST,JINJA CENTRAL,MAGGWA,MVULE II/PMM S.S,478,2,0,1,134,112,249,0,249,0,O-8-44-01-02-02
JINJA,JINJA MUNICIPALITY WEST,JINJA CENTRAL,MAGGWA,MADHIVANI I/MAGURA P/S,640,2,3,3,215,150,373,7,380,0,O-8-44-01-02-03
JINJA,JINJA MUNICIPALITY WEST,JINJA CENTRAL,MAGGWA,MADHIVANI II/MAGURA P/S,515,4,1,4,157,128,294,8,302,0,O-8-44-01-02-04
JINJA,JINJA MUNICIPALITY WEST,JINJA CENTRAL,MAGGWA,GOKHALE I/ALLIANCE,426,0,2,1,137,105,245,0,245,0,O-8-44-01-02-05
JINJA,JINJA MUNICIPALITY WEST,JINJA CENTRAL,MAGGWA,GOKHALE II/ALLIANCE,482,6,3,6,147,121,283,3,286,0,O-8-44-01-02-06
JINJA,JINJA MUNICIPALITY WEST,JINJA CENTRAL,MAGGWA,NIZAM I/JINJA S.S,746,1,1,2,258,169,431,9,440,0,O-8-44-01-02-07
JINJA,JINJA MUNICIPALITY WEST,JINJA CENTRAL,MAGGWA,NIZAM II/JINJA S.S,524,2,3,0,159,128,292,3,295,0,O-8-44-01-02-08
JINJA,JINJA MUNICIPALITY WEST,JINJA CENTRAL,MAGGWA,MVULE 3,572,2,4,0,172,122,300,4,304,0,O-8-44-01-02-09
JINJA,JINJA MUNICIPALITY WEST,KIMAKA /MPUMUDDE,KIMAKA,KIMAKA I,699,2,1,2,217,199,421,11,432,0,O-8-44-02-01-01
JINJA,JINJA MUNICIPALITY WEST,KIMAKA /MPUMUDDE,KIMAKA,AMBERCOURT A (A-L),444,3,1,0,164,87,255,6,261,0,O-8-44-02-01-02
JINJA,JINJA MUNICIPALITY WEST,KIMAKA /MPUMUDDE,KIMAKA,AMBERCOURT B/MULCO,783,4,7,3,253,189,456,1,457,0,O-8-44-02-01-03
JINJA,JINJA MUNICIPALITY WEST,KIMAKA /MPUMUDDE,KIMAKA,KIMAKA II,383,0,3,0,90,111,204,12,216,0,O-8-44-02-01-04
JINJA,JINJA MUNICIPALITY WEST,KIMAKA /MPUMUDDE,KIMAKA,AMBERCOURT A (M-Z),571,0,2,0,195,147,344,2,346,0,O-8-44-02-01-05
JINJA,JINJA MUNICIPALITY WEST,KIMAKA /MPUMUDDE,LUBAGA,KAMULI ROAD II,412,0,2,1,93,111,207,11,218,0,O-8-44-02-02-01
JINJA,JINJA MUNICIPALITY WEST,KIMAKA /MPUMUDDE,LUBAGA,POLICE / LUBAGA,998,3,3,0,324,183,513,9,522,0,O-8-44-02-02-02
JINJA,JINJA MUNICIPALITY WEST,KIMAKA /MPUMUDDE,LUBAGA,KAMULI ROAD I,750,4,2,5,214,201,426,11,437,0,O-8-44-02-02-03
JINJA,JINJA MUNICIPALITY WEST,KIMAKA /MPUMUDDE,LUBAGA,COMMERCIAL UPLAND,774,1,4,0,245,267,517,7,524,0,O-8-44-02-02-04
JINJA,JINJA MUNICIPALITY WEST,KIMAKA /MPUMUDDE,LUBAGA,POLICE GROUND (A-D),691,3,0,1,125,226,355,5,360,0,O-8-44-02-02-05
JINJA,JINJA MUNICIPALITY WEST,KIMAKA /MPUMUDDE,LUBAGA,POLICE GROUND (E-L),625,1,0,1,68,189,259,8,267,0,O-8-44-02-02-06
JINJA,JINJA MUNICIPALITY WEST,KIMAKA /MPUMUDDE,LUBAGA,POLICE GROUND (M-N),743,2,0,2,102,300,406,8,414,0,O-8-44-02-02-07
JINJA,JINJA MUNICIPALITY WEST,KIMAKA /MPUMUDDE,LUBAGA,POLICE GROUND (O-Z),727,0,1,1,132,156,290,6,296,0,O-8-44-02-02-08
JINJA,JINJA MUNICIPALITY WEST,KIMAKA /MPUMUDDE,MPUMUDDE,MARKET ZONE A/B,672,1,1,0,304,149,455,5,460,0,O-8-44-02-03-01
JINJA,JINJA MUNICIPALITY WEST,KIMAKA /MPUMUDDE,MPUMUDDE,MPUMUDDE WEST B/C,540,3,4,0,269,103,379,12,391,0,O-8-44-02-03-02
JINJA,JINJA MUNICIPALITY WEST,KIMAKA /MPUMUDDE,MPUMUDDE,NATIONAL HOUSING/WEST A,572,2,4,1,226,170,403,3,406,0,O-8-44-02-03-03
JINJA,JINJA MUNICIPALITY WEST,KIMAKA /MPUMUDDE,NALUFENYA,NALUFENYA A,649,1,4,2,199,174,380,8,388,0,O-8-44-02-04-01
JINJA,JINJA MUNICIPALITY WEST,KIMAKA /MPUMUDDE,NALUFENYA,NALUFENYA B1,406,3,4,2,138,100,247,3,250,0,O-8-44-02-04-02
JINJA,JINJA MUNICIPALITY WEST,KIMAKA /MPUMUDDE,NALUFENYA,NALUFENYA B 2,488,2,3,2,158,145,310,6,316,0,O-8-44-02-04-03
JINJA,KAGOMA COUNTY,BUDONDO,BUWAGI (KAKYOMYA,BUWAGI,768,0,2,1,159,374,536,14,550,0,O-8-42-01-01-01
JINJA,KAGOMA COUNTY,BUDONDO,BUWAGI (KAKYOMYA,KYOMYA I,613,4,1,1,164,169,339,104,443,0,O-8-42-01-01-02
JINJA,KAGOMA COUNTY,BUDONDO,BUWAGI (KAKYOMYA,KYOMYA II,548,2,0,1,137,172,312,57,369,0,O-8-42-01-01-03
JINJA,KAGOMA COUNTY,BUDONDO,BUWAGI (KAKYOMYA,KAGERA,614,0,1,1,101,263,366,54,420,0,O-8-42-01-01-04
JINJA,KAGOMA COUNTY,BUDONDO,BUWAGI (KAKYOMYA,BULEBA,490,0,0,1,95,237,333,30,363,0,O-8-42-01-01-05
JINJA,KAGOMA COUNTY,BUDONDO,BUWAGI (KAKYOMYA,BUWAGI-IBUNGU,743,3,2,2,172,292,471,9,480,0,O-8-42-01-01-06
JINJA,KAGOMA COUNTY,BUDONDO,BUWAGI (KAKYOMYA,KIDIOPE,260,1,0,4,37,149,191,10,201,0,O-8-42-01-01-07
JINJA,KAGOMA COUNTY,BUDONDO,IVUNAMBA,KIVUBUKA,749,2,9,3,153,285,452,77,529,0,O-8-42-01-02-01
JINJA,KAGOMA COUNTY,BUDONDO,IVUNAMBA,KIVUBUKA/KAZINGA,573,2,1,3,137,238,381,35,416,0,O-8-42-01-02-02
JINJA,KAGOMA COUNTY,BUDONDO,IVUNAMBA,IVUNAMBA I,270,1,1,2,70,112,186,8,194,0,O-8-42-01-02-03
JINJA,KAGOMA COUNTY,BUDONDO,IVUNAMBA,IVUNAMBA II,251,2,1,1,53,107,164,19,183,0,O-8-42-01-02-04
JINJA,KAGOMA COUNTY,BUDONDO,IVUNAMBA,BUDHAGALI,575,1,4,3,133,261,402,16,418,0,O-8-42-01-02-05
JINJA,KAGOMA COUNTY,BUDONDO,IVUNAMBA,KYABIRWA,697,3,2,2,134,285,426,64,490,0,O-8-42-01-02-06
JINJA,KAGOMA COUNTY,BUTAGAYA,BUDIMA,KIWAGAMA/NAKASEGETE,527,2,1,1,156,183,343,8,351,0,O-8-42-02-01-01
JINJA,KAGOMA COUNTY,BUTAGAYA,BUDIMA,KABEMBE,580,1,0,1,126,266,394,13,407,0,O-8-42-02-01-02
JINJA,KAGOMA COUNTY,BUTAGAYA,BUDIMA,BUDIIMA,518,4,2,1,181,162,350,6,356,0,O-8-42-02-01-03
JINJA,KAGOMA COUNTY,BUTAGAYA,BUDIMA,BUWUMA,747,2,1,2,118,367,490,14,504,0,O-8-42-02-01-04
JINJA,KAGOMA COUNTY,BUTAGAYA,LUBANI,LUBANI,571,4,1,2,162,194,363,4,367,0,O-8-42-02-02-01
JINJA,KAGOMA COUNTY,BUTAGAYA,LUBANI,NAMWENDWA,644,6,0,4,131,282,423,18,441,0,O-8-42-02-02-02
JINJA,KAGOMA COUNTY,BUTAGAYA,LUBANI,NDIWANSI,315,1,3,1,68,129,202,11,213,0,O-8-42-02-02-03
JINJA,KAGOMA COUNTY,BUTAGAYA,LUBANI,KIBUNDAIRE,627,2,2,2,133,266,405,15,420,0,O-8-42-02-02-04
JINJA,KAGOMA COUNTY,BUTAGAYA,NAKAKULWE (KISOZI),NAKAKULWE,666,3,0,3,172,275,453,8,461,0,O-8-42-02-03-01
JINJA,KAGOMA COUNTY,BUTAGAYA,NAKAKULWE (KISOZI),IWOLOLO,513,3,3,3,82,269,360,16,376,0,O-8-42-02-03-02
JINJA,KAGOMA COUNTY,BUTAGAYA,NAKAKULWE (KISOZI),BUWALA I,433,2,0,4,58,230,294,15,309,0,O-8-42-02-03-03
JINJA,KAGOMA COUNTY,BUTAGAYA,NAKAKULWE (KISOZI),BUWALA II,424,1,1,2,52,225,281,10,291,0,O-8-42-02-03-04
JINJA,KAGOMA COUNTY,BUTAGAYA,NAKAKULWE (KISOZI),LUMULI I,566,2,0,2,118,249,371,21,392,0,O-8-42-02-03-05
JINJA,KAGOMA COUNTY,BUTAGAYA,NAKAKULWE (KISOZI),LUMULI II,427,4,0,2,85,194,285,17,302,0,O-8-42-02-03-06
JINJA,KAGOMA COUNTY,BUTAGAYA,NAMAGERA,NAWANGOMA MOSQUE,448,4,3,2,112,173,294,25,319,0,O-8-42-02-04-01
JINJA,KAGOMA COUNTY,BUTAGAYA,NAMAGERA,MPUMWIRE II,597,1,1,2,71,310,385,10,395,0,O-8-42-02-04-02
JINJA,KAGOMA COUNTY,BUTAGAYA,NAMAGERA,BUTAGAYA S/C HQTRS,424,1,0,1,67,186,255,21,276,0,O-8-42-02-04-03
JINJA,KAGOMA COUNTY,BUTAGAYA,NAMAGERA,MABIRA-LUBIRA,539,1,1,1,113,266,382,8,390,0,O-8-42-02-04-04
JINJA,KAGOMA COUNTY,BUTAGAYA,NAMAGERA,NAMAGERA I,597,2,1,2,122,247,374,9,383,0,O-8-42-02-04-05
JINJA,KAGOMA COUNTY,BUTAGAYA,NAMAGERA,NAMAGERA II,550,2,2,0,104,222,330,17,347,0,O-8-42-02-04-06
JINJA,KAGOMA COUNTY,BUTAGAYA,NAMAGERA,MPUMWIRE P/S,321,0,0,1,91,123,215,15,230,0,O-8-42-02-04-07
JINJA,KAGOMA COUNTY,BUTAGAYA,NAWAMPANDA,NAWAMPANDA I,396,1,0,0,74,167,242,7,249,0,O-8-42-02-05-01
JINJA,KAGOMA COUNTY,BUTAGAYA,NAWAMPANDA,NAWAMPANDA II,419,2,1,0,93,212,308,7,315,0,O-8-42-02-05-02
JINJA,KAGOMA COUNTY,BUTAGAYA,NAWAMPANDA,BUSOWOKO TC,461,0,5,3,62,240,310,10,320,0,O-8-42-02-05-03
JINJA,KAGOMA COUNTY,BUTAGAYA,NAWAMPANDA,NABUKOSI,619,1,0,0,96,307,404,8,412,0,O-8-42-02-05-04
JINJA,KAGOMA COUNTY,BUTAGAYA,NAWAMPANDA,BUBUGO,716,2,0,3,145,346,496,13,509,0,O-8-42-02-05-05
JINJA,KAGOMA COUNTY,BUTAGAYA,WANSIIMBA,WANSIMBA I,581,1,1,1,117,262,382,14,396,0,O-8-42-02-06-01
JINJA,KAGOMA COUNTY,BUTAGAYA,WANSIIMBA,WANSIMBA II,575,1,1,2,111,262,377,6,383,0,O-8-42-02-06-02
JINJA,KAGOMA COUNTY,BUTAGAYA,WANSIIMBA,BUTAGAYA,533,2,2,1,82,307,394,20,414,0,O-8-42-02-06-03
JINJA,KAGOMA COUNTY,BUTAGAYA,WANSIIMBA,KITENGENSA,360,0,1,0,41,199,241,6,247,0,O-8-42-02-06-04
JINJA,KAGOMA COUNTY,BUTAGAYA,WANSIIMBA,KIRANGA SOCIETY,440,1,1,0,74,185,261,19,280,0,O-8-42-02-06-05
JINJA,KAGOMA COUNTY,BUTAGAYA,WANSIIMBA,KASAMBYA CHURCH,311,1,0,1,47,150,199,7,206,0,O-8-42-02-06-06
JINJA,KAGOMA COUNTY,BUWENGE,BUWEERA,BRIGHT LIGHT PRI. SCHOOL,557,5,2,3,147,216,373,18,391,0,O-8-42-03-01-01
JINJA,KAGOMA COUNTY,BUWENGE,BUWEERA,YUKA,393,0,0,1,148,98,247,13,260,0,O-8-42-03-01-02
JINJA,KAGOMA COUNTY,BUWENGE,BUWEERA,BUWERA,687,2,5,1,201,232,441,9,450,0,O-8-42-03-01-03
JINJA,KAGOMA COUNTY,BUWENGE,BUWEERA,NKONDO PRI SCHOOL,583,2,4,1,133,229,369,5,374,0,O-8-42-03-01-04
JINJA,KAGOMA COUNTY,BUWENGE,KAGOMA,KANYALE 1,382,3,0,0,111,183,297,18,315,0,O-8-42-03-02-01
JINJA,KAGOMA COUNTY,BUWENGE,KAGOMA,MUTAI 2,531,1,1,1,89,161,253,4,257,0,O-8-42-03-02-02
JINJA,KAGOMA COUNTY,BUWENGE,KAGOMA,MUTAI 3,364,0,0,1,112,101,214,10,224,0,O-8-42-03-02-03
JINJA,KAGOMA COUNTY,BUWENGE,KAGOMA,MUTAI 4,505,4,2,4,165,141,316,9,325,0,O-8-42-03-02-04
JINJA,KAGOMA COUNTY,BUWENGE,KAGOMA,KAGOMA 1,637,5,1,1,114,314,435,9,444,0,O-8-42-03-02-05
JINJA,KAGOMA COUNTY,BUWENGE,KAGOMA,BUWOLERO CHURCH,679,2,1,4,121,270,398,14,412,0,O-8-42-03-02-06
JINJA,KAGOMA COUNTY,BUWENGE,KAGOMA,NAMALERE I,773,3,1,3,191,256,454,17,471,0,O-8-42-03-02-07
JINJA,KAGOMA COUNTY,BUWENGE,KAGOMA,NAMALERE CENTRAL,683,0,1,1,159,240,401,11,412,0,O-8-42-03-02-08
JINJA,KAGOMA COUNTY,BUWENGE,KAGOMA,KANYALE 2,281,0,0,1,39,104,144,14,158,0,O-8-42-03-02-09
JINJA,KAGOMA COUNTY,BUWENGE,KAGOMA,MAKOTA,267,0,1,0,49,102,152,2,154,0,O-8-42-03-02-10
JINJA,KAGOMA COUNTY,BUWENGE,KAIIRA,MAWOITO A,429,1,1,4,118,171,295,10,305,0,O-8-42-03-03-01
JINJA,KAGOMA COUNTY,BUWENGE,KAIIRA,MAWOITO STANDARD ACADEMY,501,0,1,4,95,204,304,4,308,0,O-8-42-03-03-02
JINJA,KAGOMA COUNTY,BUWENGE,KAIIRA,MAWOITO C,340,0,2,2,78,142,224,9,233,0,O-8-42-03-03-03
JINJA,KAGOMA COUNTY,BUWENGE,KAIIRA,MUWANGI,562,1,1,1,128,233,364,13,377,0,O-8-42-03-03-04
JINJA,KAGOMA COUNTY,BUWENGE,KAIIRA,KAIRA/BUTAGANA,512,3,2,1,147,219,372,7,379,0,O-8-42-03-03-05
JINJA,KAGOMA COUNTY,BUWENGE,KITANABA,ISIRI PRI. SCHOOL,365,0,3,1,78,170,252,5,257,0,O-8-42-03-04-01
JINJA,KAGOMA COUNTY,BUWENGE,KITANABA,MPUNGWE A,273,1,1,2,54,156,214,2,216,0,O-8-42-03-04-02
JINJA,KAGOMA COUNTY,BUWENGE,KITANABA,IDOOME,385,2,0,4,79,189,274,6,280,0,O-8-42-03-04-03
JINJA,KAGOMA COUNTY,BUWENGE,KITANABA,KITANABA,541,2,1,2,141,222,368,12,380,0,O-8-42-03-04-04
JINJA,KAGOMA COUNTY,BUWENGE,KITANABA,MPUNGWE B,276,1,0,1,47,133,182,8,190,0,O-8-42-03-04-05
JINJA,KAGOMA COUNTY,BUWENGE,KITANABA,BUSIA C.O.U,242,0,2,0,42,117,161,4,165,0,O-8-42-03-04-06
JINJA,KAGOMA COUNTY,BUWENGE,MAGAMAGA,MUGULUKA A,528,0,2,1,122,210,335,8,343,0,O-8-42-03-05-01
JINJA,KAGOMA COUNTY,BUWENGE,MAGAMAGA,MUGULUKA B,589,4,0,3,144,203,354,17,371,0,O-8-42-03-05-02
JINJA,KAGOMA COUNTY,BUWENGE,MAGAMAGA,IGOMBE,702,3,2,3,157,320,485,7,492,0,O-8-42-03-05-03
JINJA,KAGOMA COUNTY,BUWENGE,MAGAMAGA,BUWANGA S/C HQRS,773,0,0,2,181,281,464,8,472,0,O-8-42-03-05-04
JINJA,KAGOMA COUNTY,BUWENGE,MAGAMAGA,KAGOMA P/S,256,0,0,0,33,147,180,4,184,0,O-8-42-03-05-05
JINJA,KAGOMA COUNTY,BUWENGE,MAGAMAGA,BUTANGALA A,636,3,1,3,116,262,385,33,418,0,O-8-42-03-05-06
JINJA,KAGOMA COUNTY,BUWENGE,MAGAMAGA,BUTANGALAMOSQUE,588,2,0,1,101,264,368,18,386,0,O-8-42-03-05-07
JINJA,KAGOMA COUNTY,BUWENGE,MAGAMAGA,KALEBERA,448,1,0,3,153,155,312,14,326,0,O-8-42-03-05-08
JINJA,KAGOMA COUNTY,BUWENGE TC,BUWENGE EAST,BUWENGE EAST A,516,1,1,0,123,179,304,6,310,0,O-8-42-04-01-01
JINJA,KAGOMA COUNTY,BUWENGE TC,BUWENGE EAST,BUWENGE EAST B,504,0,0,5,115,177,297,8,305,0,O-8-42-04-01-02
JINJA,KAGOMA COUNTY,BUWENGE TC,BUWENGE NORTH,BUWENGE NORTH A,620,2,0,3,218,148,371,7,378,0,O-8-42-04-02-01
JINJA,KAGOMA COUNTY,BUWENGE TC,BUWENGE NORTH,BUSIA WEST,257,2,0,0,49,134,185,4,189,0,O-8-42-04-02-02
JINJA,KAGOMA COUNTY,BUWENGE TC,BUWENGE NORTH,BUSIA CENTRAL NORTH,422,0,0,0,89,135,224,8,232,0,O-8-42-04-02-03
JINJA,KAGOMA COUNTY,BUWENGE TC,BUWENGE NORTH,BUWENGE NORTH B,385,1,0,0,92,128,221,1,222,0,O-8-42-04-02-04
JINJA,KAGOMA COUNTY,BUWENGE TC,BUWENGE SOUTH,BUWENGE SOUTH (A-L),568,2,2,2,180,125,311,5,316,0,O-8-42-04-03-01
JINJA,KAGOMA COUNTY,BUWENGE TC,BUWENGE SOUTH,KYERINDA NORTH SOUTH,695,8,0,1,174,243,426,8,434,0,O-8-42-04-03-02
JINJA,KAGOMA COUNTY,BUWENGE TC,BUWENGE SOUTH,BUWENGE SOUTH C,305,1,0,0,74,67,142,3,145,0,O-8-42-04-03-03
JINJA,KAGOMA COUNTY,BUWENGE TC,BUWENGE SOUTH,BUWENGE SOUTH (M-NAL),533,1,0,2,146,144,293,3,296,0,O-8-42-04-03-04
JINJA,KAGOMA COUNTY,BUWENGE TC,BUWENGE SOUTH,BUWENGE SOUTH (NAM-Z),461,0,0,1,124,120,245,10,255,0,O-8-42-04-03-05
JINJA,KAGOMA COUNTY,BUWENGE TC,BUWENGE WEST,BUWENGE WEST A,814,4,1,3,267,190,465,4,469,0,O-8-42-04-04-01
JINJA,KAGOMA COUNTY,BUWENGE TC,BUWENGE WEST,BUWENGE BWASE,426,1,1,2,144,122,270,4,274,0,O-8-42-04-04-02
JINJA,KAGOMA COUNTY,BUWENGE TC,BUWENGE WEST,BUWENGE WEST B,415,0,0,0,113,106,219,3,222,0,O-8-42-04-04-03
JINJA,KAGOMA COUNTY,BUYENGO,BULUNGO,BUDHOBYA/LWANYAMA,634,3,5,0,190,160,358,57,415,0,O-8-42-05-01-01
JINJA,KAGOMA COUNTY,BUYENGO,BULUNGO,NAKITOKOLO / BUSEGULA,542,3,4,2,137,272,418,8,426,0,O-8-42-05-01-02
JINJA,KAGOMA COUNTY,BUYENGO,BULUNGO,KAYALWE AB,633,0,0,3,162,275,440,3,443,0,O-8-42-05-01-03
JINJA,KAGOMA COUNTY,BUYENGO,BULUNGO,BULAMA A&B,442,0,4,0,39,249,292,19,311,0,O-8-42-05-01-04
JINJA,KAGOMA COUNTY,BUYENGO,BUTAMIRA,MUSISI/NAMATA,621,2,1,3,237,213,456,4,460,0,O-8-42-05-02-01
JINJA,KAGOMA COUNTY,BUYENGO,BUTAMIRA,NAWAMBOGA/BUKOLOBOZA,356,1,1,0,116,141,259,8,267,0,O-8-42-05-02-02
JINJA,KAGOMA COUNTY,BUYENGO,BUTAMIRA,BUNGONGWE/KITUMBUGULU,543,2,1,1,131,147,282,74,356,0,O-8-42-05-02-03
JINJA,KAGOMA COUNTY,BUYENGO,BUTAMIRA,LWITAMAKOLI/BUBANDA VILLAGE,552,1,0,4,140,232,377,4,381,0,O-8-42-05-02-04
JINJA,KAGOMA COUNTY,BUYENGO,BUWABUZI,BUYENGO/NAKIYUKA,609,0,1,0,96,275,372,28,400,0,O-8-42-05-03-01
JINJA,KAGOMA COUNTY,BUYENGO,BUWABUZI,KAMIGO,699,3,3,3,204,284,497,14,511,0,O-8-42-05-03-02
JINJA,KAGOMA COUNTY,BUYENGO,BUWABUZI,INTERNATIONAL FELLOWSHIP CH,689,4,0,5,165,328,502,30,532,0,O-8-42-05-03-03
JINJA,KAGOMA COUNTY,BUYENGO,BUWABUZI,LWAMBOGO,457,1,1,4,120,193,319,11,330,0,O-8-42-05-03-04
JINJA,KAGOMA COUNTY,BUYENGO,IZIRU,NAKAJO,487,0,0,1,60,136,197,53,250,0,O-8-42-05-04-01
JINJA,KAGOMA COUNTY,BUYENGO,IZIRU,BUKYEYUNE,598,0,1,1,208,206,416,7,423,0,O-8-42-05-04-02
JINJA,KAGOMA COUNTY,BUYENGO,IZIRU,KAKAIRE HEALTH CENTRE,613,2,1,1,137,223,364,23,387,0,O-8-42-05-04-03
JINJA,KAGOMA COUNTY,BUYENGO,IZIRU,NABITOSI/BUKASAMI,478,0,0,1,120,191,312,31,343,0,O-8-42-05-04-04
JINJA,KAGOMA COUNTY,BUYENGO,IZIRU,MBALE/MATEME,380,0,0,1,86,152,239,26,265,0,O-8-42-05-04-05
JINJA,KAGOMA COUNTY,BUYENGO,IZIRU,NAKAJO PRI. SCHOOL,364,0,0,1,60,136,197,53,250,0,O-8-42-05-04-06
JINJA,KAGOMA COUNTY,BUYENGO,IZIRU,NABULAGALA TC,162,1,0,1,33,60,95,7,102,0,O-8-42-05-04-07
JINJA,KAGOMA COUNTY,KIBIBI,IVUNAMBA,NAKANYONYI C.O.U,707,3,2,0,183,222,410,62,472,0,O-8-42-06-01-01
JINJA,KAGOMA COUNTY,KIBIBI,IVUNAMBA,KIZINGA,570,3,1,5,168,230,407,8,415,0,O-8-42-06-01-02
JINJA,KAGOMA COUNTY,KIBIBI,IVUNAMBA,KIBIBI I,557,4,2,0,149,171,326,50,376,0,O-8-42-06-01-03
JINJA,KAGOMA COUNTY,KIBIBI,IVUNAMBA,KIBIBI II,731,0,1,2,162,248,413,55,468,0,O-8-42-06-01-04
JINJA,KAGOMA COUNTY,KIBIBI,IVUNAMBA,KIBIBI III,431,1,2,0,99,120,222,58,280,0,O-8-42-06-01-05
JINJA,KAGOMA COUNTY,KIBIBI,IVUNAMBA,BUKOSE SOCIETY,373,1,0,3,73,148,225,48,273,0,O-8-42-06-01-06
JINJA,KAGOMA COUNTY,KIBIBI,NAMIZI,KABOWA,563,1,1,4,168,257,431,14,445,0,O-8-42-06-02-01
JINJA,KAGOMA COUNTY,KIBIBI,NAMIZI,BUYALA A,486,2,0,0,165,121,288,51,339,0,O-8-42-06-02-02
JINJA,KAGOMA COUNTY,KIBIBI,NAMIZI,BUYALA B (A - M),549,2,2,0,165,195,364,27,391,0,O-8-42-06-02-03
JINJA,KAGOMA COUNTY,KIBIBI,NAMIZI,NAMIZI EAST,507,2,4,2,110,160,278,49,327,0,O-8-42-06-02-04
JINJA,KAGOMA COUNTY,KIBIBI,NAMIZI,NAMIZI WEST,589,4,6,0,164,192,366,37,403,0,O-8-42-06-02-05
JINJA,KAGOMA COUNTY,KIBIBI,NAMIZI,BUYALA C,270,2,0,1,58,62,123,24,147,0,O-8-42-06-02-06
JINJA,KAGOMA COUNTY,KIBIBI,NAMIZI,BUYALA B (N - Z),428,2,0,0,118,151,271,4,275,0,O-8-42-06-02-07
JINJA,KAGOMA COUNTY,KIBIBI,NAMIZI,NAMIZI CENTRAL,501,0,0,0,110,176,286,52,338,0,O-8-42-06-02-08
JINJA,KAGOMA COUNTY,KIBIBI,NAWANGOMA,NAWONGOMA,490,3,2,1,76,263,345,39,384,0,O-8-42-06-03-01
JINJA,KAGOMA COUNTY,KIBIBI,NAWANGOMA,LUKOLO I,508,1,0,1,195,158,355,10,365,0,O-8-42-06-03-02
JINJA,KAGOMA COUNTY,KIBIBI,NAWANGOMA,LUKOLO II,594,2,2,1,175,195,375,3,378,0,O-8-42-06-03-03
JINJA,KAGOMA COUNTY,KIBIBI,NAWANGOMA,NSUBE I,461,1,1,0,113,189,304,44,348,0,O-8-42-06-03-04
JINJA,KAGOMA COUNTY,KIBIBI,NAWANGOMA,NSUBE II,288,3,1,0,44,127,175,19,194,0,O-8-42-06-03-05
JINJA,KAGOMA COUNTY,KIBIBI,NAWANGOMA,BUFULA,767,6,3,1,150,312,472,78,550,0,O-8-42-06-03-06
KAMULI,BUGABULA COUNTY NORTH,BALAWOLI,BALAWOLI,BALAWOLI P/S,561,5,0,1,76,271,353,8,361,0,O-13-70-01-01-01
KAMULI,BUGABULA COUNTY NORTH,BALAWOLI,BALAWOLI,BALAWOLI C CHURCH BALAWOLI,772,6,2,5,85,445,543,24,567,0,O-13-70-01-01-02
KAMULI,BUGABULA COUNTY NORTH,BALAWOLI,BALAWOLI,BUKABALE T.C,296,2,1,0,39,183,225,7,232,0,O-13-70-01-01-03
KAMULI,BUGABULA COUNTY NORTH,BALAWOLI,KAGUMBA,KAGUMBA P/S,592,1,2,6,24,343,376,34,410,0,O-13-70-01-02-01
KAMULI,BUGABULA COUNTY NORTH,BALAWOLI,KAGUMBA,KYAMATENDE T.C,613,3,3,7,60,307,380,31,411,0,O-13-70-01-02-02
KAMULI,BUGABULA COUNTY NORTH,BALAWOLI,KAGUMBA,BUGAGA T.C,296,2,0,1,18,197,218,5,223,0,O-13-70-01-02-03
KAMULI,BUGABULA COUNTY NORTH,BALAWOLI,KAGUMBA,BULEMEZI T.C,252,1,0,1,11,169,182,7,189,0,O-13-70-01-02-04
KAMULI,BUGABULA COUNTY NORTH,BALAWOLI,KASOLWE,NAMUSITA MARKET,690,1,1,3,65,394,464,20,484,0,O-13-70-01-03-01
KAMULI,BUGABULA COUNTY NORTH,BALAWOLI,KASOLWE,KIKUBI MARKET KIKUBI,397,2,0,2,22,264,290,12,302,0,O-13-70-01-03-02
KAMULI,BUGABULA COUNTY NORTH,BALAWOLI,KASOLWE,KASOLWE T C,475,0,0,1,48,324,373,5,378,0,O-13-70-01-03-03
KAMULI,BUGABULA COUNTY NORTH,BALAWOLI,KASOLWE,KASOLWE CATTLE DIP,380,1,0,2,39,235,277,1,278,0,O-13-70-01-03-04
KAMULI,BUGABULA COUNTY NORTH,BALAWOLI,KASOLWE,BULIMIRA P/S,264,1,1,4,23,162,191,14,205,0,O-13-70-01-03-05
KAMULI,BUGABULA COUNTY NORTH,BALAWOLI,KAWAGA,BUGUWA P/S,750,3,0,4,81,453,541,15,556,0,O-13-70-01-04-01
KAMULI,BUGABULA COUNTY NORTH,BALAWOLI,KAWAGA,BUTALAGE CENTRE,703,3,0,6,51,441,501,22,523,0,O-13-70-01-04-02
KAMULI,BUGABULA COUNTY NORTH,BALAWOLI,KAWAGA,KAWAGA P/S,489,4,1,0,34,253,292,73,365,0,O-13-70-01-04-03
KAMULI,BUGABULA COUNTY NORTH,BALAWOLI,KIBUYE,KIBUYE P/S,671,3,0,2,29,436,470,19,489,0,O-13-70-01-05-01
KAMULI,BUGABULA COUNTY NORTH,BALAWOLI,KIBUYE,NABITALO P/S,401,0,1,1,44,247,293,28,321,0,O-13-70-01-05-02
KAMULI,BUGABULA COUNTY NORTH,BALAWOLI,KIIGE,KIIGE P/S,446,5,1,4,21,289,320,21,341,0,O-13-70-01-06-01
KAMULI,BUGABULA COUNTY NORTH,BALAWOLI,KIIGE,BUGOBI T.C,288,0,0,0,14,189,203,9,212,0,O-13-70-01-06-02
KAMULI,BUGABULA COUNTY NORTH,BALAWOLI,KIIGE,IGANGA TRADING CENTRE IGANG,455,3,0,2,23,312,340,17,357,0,O-13-70-01-06-03
KAMULI,BUGABULA COUNTY NORTH,BALAWOLI,KIIGE,NAKABIRA TRADING CENTRE NAK,332,1,1,1,10,239,252,11,263,0,O-13-70-01-06-04
KAMULI,BUGABULA COUNTY NORTH,BALAWOLI,NABULENZI,NABULENZI PR/SCHOOL,466,4,3,2,17,322,348,24,372,0,O-13-70-01-07-01
KAMULI,BUGABULA COUNTY NORTH,BALAWOLI,NABULENZI,EDHIRUMAMWINO P/S NAWANTAL,738,0,0,2,63,480,545,14,559,0,O-13-70-01-07-02
KAMULI,BUGABULA COUNTY NORTH,BALAWOLI,NABULENZI,KAKUNYU T.C,227,0,0,0,13,163,176,14,190,0,O-13-70-01-07-03
KAMULI,BUGABULA COUNTY NORTH,BALAWOLI,NAMAIRA II,NAMAIRA P/SCHOOL,660,1,0,4,90,357,452,15,467,0,O-13-70-01-08-01
KAMULI,BUGABULA COUNTY NORTH,BALAWOLI,NAMAIRA II,NAMAIRA T.C,279,1,0,1,34,187,223,4,227,0,O-13-70-01-08-02
KAMULI,BUGABULA COUNTY NORTH,KAMULI T.C,KASOIGO,MOTHER KEVIN GIRLS HOSTEL,647,2,3,0,99,271,375,22,397,0,O-13-70-02-01-01
KAMULI,BUGABULA COUNTY NORTH,KAMULI T.C,KASOIGO,LUBAGA BOYS P/S,490,1,2,4,61,281,349,8,357,0,O-13-70-02-01-02
KAMULI,BUGABULA COUNTY NORTH,KAMULI T.C,KASOIGO,DISTRICT COUNCIL HALL,498,1,3,3,115,197,319,7,326,0,O-13-70-02-01-03
KAMULI,BUGABULA COUNTY NORTH,KAMULI T.C,MANDWA,KAMULI POST OFFICE,703,3,2,0,176,219,400,3,403,0,O-13-70-02-02-01
KAMULI,BUGABULA COUNTY NORTH,KAMULI T.C,MANDWA,DIARY,372,1,2,0,71,138,212,14,226,0,O-13-70-02-02-02
KAMULI,BUGABULA COUNTY NORTH,KAMULI T.C,MANDWA,ST. MARK CHURCH,268,1,0,0,56,91,148,1,149,0,O-13-70-02-02-03
KAMULI,BUGABULA COUNTY NORTH,KAMULI T.C,MULAMBA,SAZA,622,3,4,0,142,244,393,12,405,0,O-13-70-02-03-01
KAMULI,BUGABULA COUNTY NORTH,KAMULI T.C,MULAMBA,MUKASA'S DEMBE TREE - MPANG,558,3,3,1,115,237,359,10,369,0,O-13-70-02-03-02
KAMULI,BUGABULA COUNTY NORTH,KAMULI T.C,MUWEBWA,HAPPY HOURS P/S,695,6,1,0,150,257,414,8,422,0,O-13-70-02-04-01
KAMULI,BUGABULA COUNTY NORTH,KAMULI T.C,MUWEBWA,KML COPE SCHOOL,726,3,1,1,168,272,445,20,465,0,O-13-70-02-04-02
KAMULI,BUGABULA COUNTY NORTH,KAMULI T.C,MUWEBWA,KAMULI MOSQUE,238,3,1,0,56,90,150,0,150,0,O-13-70-02-04-03
KAMULI,BUGABULA COUNTY NORTH,NABWIGULU,BUWANUME,BUWANUME P/S,280,2,1,3,47,142,195,5,200,0,O-13-70-03-01-01
KAMULI,BUGABULA COUNTY NORTH,NABWIGULU,BUWANUME,NAMALEMBA BUWANUME,416,2,5,3,62,223,295,22,317,0,O-13-70-03-01-02
KAMULI,BUGABULA COUNTY NORTH,NABWIGULU,BUWANUME,BUZIBIRIRA P/S,615,5,0,2,94,328,429,19,448,0,O-13-70-03-01-03
KAMULI,BUGABULA COUNTY NORTH,NABWIGULU,BUWANUME,BUWANUME PARISH HQRS,263,0,1,0,46,145,192,35,227,0,O-13-70-03-01-04
KAMULI,BUGABULA COUNTY NORTH,NABWIGULU,BUWANUME,BUGULETE,301,1,1,2,32,184,220,10,230,0,O-13-70-03-01-05
KAMULI,BUGABULA COUNTY NORTH,NABWIGULU,BUWANUME,BUKATAMBALA,133,0,0,1,14,84,99,11,110,0,O-13-70-03-01-06
KAMULI,BUGABULA COUNTY NORTH,NABWIGULU,KAMULI,KAPULINSENI FACTORY,343,1,0,0,48,178,227,10,237,0,O-13-70-03-02-01
KAMULI,BUGABULA COUNTY NORTH,NABWIGULU,KAMULI,NAYENGA P/S,403,6,3,0,71,221,301,6,307,0,O-13-70-03-02-02
KAMULI,BUGABULA COUNTY NORTH,NABWIGULU,KAMULI,DISTRICT HQTRS,306,2,0,0,39,104,145,34,179,0,O-13-70-03-02-03
KAMULI,BUGABULA COUNTY NORTH,NABWIGULU,KAMULI,PARISH HQTRS,199,1,0,1,26,96,124,5,129,0,O-13-70-03-02-04
KAMULI,BUGABULA COUNTY NORTH,NABWIGULU,KAMULI-NAMWENDA,BULINDI MOSQUE,507,1,2,3,122,226,354,0,354,0,O-13-70-03-03-01
KAMULI,BUGABULA COUNTY NORTH,NABWIGULU,KAMULI-NAMWENDA,KYABAZINGA S.S.S,331,3,0,1,69,181,254,9,263,0,O-13-70-03-03-02
KAMULI,BUGABULA COUNTY NORTH,NABWIGULU,KAMULI-NAMWENDA,BUWUDA PRIMARY SCHOOL,221,0,0,1,33,127,161,7,168,0,O-13-70-03-03-03
KAMULI,BUGABULA COUNTY NORTH,NABWIGULU,KAMULI-NAMWENDA,BUFUMBA,313,0,0,2,66,162,230,6,236,0,O-13-70-03-03-04
KAMULI,BUGABULA COUNTY NORTH,NABWIGULU,KAMULI-NAMWENDA,BUKUNGU T/C,396,2,0,3,52,250,307,7,314,0,O-13-70-03-03-05
KAMULI,BUGABULA COUNTY NORTH,NABWIGULU,NABIRUMBA I,BWOKO P/S,758,3,2,1,127,384,517,11,528,0,O-13-70-03-04-01
KAMULI,BUGABULA COUNTY NORTH,NABWIGULU,NABIRUMBA I,BUSANA,495,4,1,0,53,293,351,10,361,0,O-13-70-03-04-02
KAMULI,BUGABULA COUNTY NORTH,NABWIGULU,NABIRUMBA II,NABIRUMBA P/S,312,1,1,1,54,160,217,5,222,0,O-13-70-03-05-01
KAMULI,BUGABULA COUNTY NORTH,NABWIGULU,NABIRUMBA II,BUGONDE,358,5,3,2,57,205,272,11,283,0,O-13-70-03-05-02
KAMULI,BUGABULA COUNTY NORTH,NABWIGULU,NABIRUMBA II,BULUTA,480,3,0,3,33,278,317,13,330,0,O-13-70-03-05-03
KAMULI,BUGABULA COUNTY NORTH,NABWIGULU,NABWIGULU,NABWIGULU GOMBOLOLA HQRS,648,3,1,1,84,358,447,25,472,0,O-13-70-03-06-01
KAMULI,BUGABULA COUNTY NORTH,NABWIGULU,NABWIGULU,KITAWULUZI HQRS BULANDA,518,3,0,4,60,315,382,24,406,0,O-13-70-03-06-02
KAMULI,BUGABULA COUNTY NORTH,NABWIGULU,NABWIGULU,CHURCH OF UGANDA BULONDO Z,190,1,0,1,13,132,147,7,154,0,O-13-70-03-06-03
KAMULI,BUGABULA COUNTY NORTH,NABWIGULU,NABWIGULU,BULONDO,283,3,1,1,28,198,231,15,246,0,O-13-70-03-06-04
KAMULI,BUGABULA COUNTY NORTH,NABWIGULU,NAKULYAKU,NAKULYAKU PRIMARY SCHOOL,488,2,1,0,69,274,346,14,360,0,O-13-70-03-07-01
KAMULI,BUGABULA COUNTY NORTH,NABWIGULU,NAKULYAKU,BUTEKANGA,855,1,4,4,130,447,586,33,619,0,O-13-70-03-07-02
KAMULI,BUGABULA COUNTY NORTH,NABWIGULU,NAKULYAKU,KANANAGE P/S,789,3,1,4,85,523,616,12,628,0,O-13-70-03-07-03
KAMULI,BUGABULA COUNTY NORTH,NABWIGULU,NAKULYAKU,BUSIBA,233,1,2,1,29,148,181,13,194,0,O-13-70-03-07-04
KAMULI,BUGABULA COUNTY NORTH,NABWIGULU,NAMUNYINGI,KABAMBA MPALA CHURCH NAMU,469,1,3,2,64,250,320,27,347,0,O-13-70-03-08-01
KAMULI,BUGABULA COUNTY NORTH,NABWIGULU,NAMUNYINGI,NAMUNYINGI PRIMARY SCH,401,2,0,2,45,223,272,6,278,0,O-13-70-03-08-02
KAMULI,BUGABULA COUNTY NORTH,NABWIGULU,NAMUNYINGI,KISIGE P/S,466,2,1,1,75,254,333,15,348,0,O-13-70-03-08-03
KAMULI,BUGABULA COUNTY NORTH,NAMASAGALI,BWIIZA,BUSAMBU PR/SCHOOL BUFUMBIR,384,1,1,0,44,172,218,54,272,0,O-13-70-04-01-01
KAMULI,BUGABULA COUNTY NORTH,NAMASAGALI,BWIIZA,MALUGULYA P/SCH BULIMIRA A,453,3,2,5,99,212,321,17,338,0,O-13-70-04-01-02
KAMULI,BUGABULA COUNTY NORTH,NAMASAGALI,BWIIZA,BWIIZA PRIMARY SCH BUSUWA,301,1,1,1,57,146,206,15,221,0,O-13-70-04-01-03
KAMULI,BUGABULA COUNTY NORTH,NAMASAGALI,BWIIZA,KAKINDU T CENTRE BUYEGO/BU,388,2,2,4,33,219,260,13,273,0,O-13-70-04-01-04
KAMULI,BUGABULA COUNTY NORTH,NAMASAGALI,BWIIZA,KASIMWE CENTRE BUNABIYO/BU,312,5,2,2,73,117,199,17,216,0,O-13-70-04-01-05
KAMULI,BUGABULA COUNTY NORTH,NAMASAGALI,BWIIZA,BUYENGO,203,4,0,1,10,133,148,17,165,0,O-13-70-04-01-06
KAMULI,BUGABULA COUNTY NORTH,NAMASAGALI,BWIIZA,BUGULU C.O.U,360,1,3,3,74,137,218,9,227,0,O-13-70-04-01-07
KAMULI,BUGABULA COUNTY NORTH,NAMASAGALI,KASOZI,KASOZI PRIMARY SCHOOL,162,0,0,0,25,67,92,1,93,0,O-13-70-04-02-01
KAMULI,BUGABULA COUNTY NORTH,NAMASAGALI,KASOZI,KASOZI CENTREP/SCH BUGOLE,619,4,1,4,59,262,330,102,432,0,O-13-70-04-02-02
KAMULI,BUGABULA COUNTY NORTH,NAMASAGALI,KASOZI,KAKANU PRIMARY SCH KAKANU,523,3,1,0,32,320,356,8,364,0,O-13-70-04-02-03
KAMULI,BUGABULA COUNTY NORTH,NAMASAGALI,KASOZI,MENGO P/S MENGO BUSANO,483,1,0,0,30,282,313,49,362,0,O-13-70-04-02-04
KAMULI,BUGABULA COUNTY NORTH,NAMASAGALI,KASOZI,KOLOLO HILL CENTRE,644,3,1,2,87,314,407,23,430,0,O-13-70-04-02-05
KAMULI,BUGABULA COUNTY NORTH,NAMASAGALI,KISAIKYE,KISAIKYE PRIMARY SCHOOL,634,1,3,4,50,351,409,33,442,0,O-13-70-04-03-01
KAMULI,BUGABULA COUNTY NORTH,NAMASAGALI,KISAIKYE,KAVULE P/S.,606,1,0,5,70,342,418,22,440,0,O-13-70-04-03-02
KAMULI,BUGABULA COUNTY NORTH,NAMASAGALI,KISAIKYE,NANSOLOLO SUB-GRADE SCHOO,578,8,2,7,58,215,290,96,386,0,O-13-70-04-03-03
KAMULI,BUGABULA COUNTY NORTH,NAMASAGALI,KISAIKYE,KADUNGU SUB-GRADE SCHOOL,360,3,2,4,68,193,270,9,279,0,O-13-70-04-03-04
KAMULI,BUGABULA COUNTY NORTH,NAMASAGALI,KISAIKYE,KAVULE P. S. (N-Z),444,0,0,0,25,269,294,14,308,0,O-13-70-04-03-05
KAMULI,BUGABULA COUNTY NORTH,NAMASAGALI,KISAIKYE,KITANIMWA CHURCH,123,0,0,0,8,85,93,5,98,0,O-13-70-04-03-06
KAMULI,BUGABULA COUNTY NORTH,NAMASAGALI,NAMASAGALI,KABANDA NAMASAGALI,431,0,1,2,86,200,289,7,296,0,O-13-70-04-04-01
KAMULI,BUGABULA COUNTY NORTH,NAMASAGALI,NAMASAGALI,KABANYOLO,366,2,3,1,78,150,234,18,252,0,O-13-70-04-04-02
KAMULI,BUGABULA SOUTH,BULOPA,BUKUTU,KAMIGO,656,3,4,2,86,321,416,53,469,0,O-13-71-01-01-01
KAMULI,BUGABULA SOUTH,BULOPA,BUKUTU,BUKUUTU P/SCHOOL A,515,1,2,4,103,230,340,14,354,0,O-13-71-01-01-02
KAMULI,BUGABULA SOUTH,BULOPA,BUKUTU,ST. MULUMBA P/S,323,2,0,3,47,181,233,14,247,0,O-13-71-01-01-03
KAMULI,BUGABULA SOUTH,BULOPA,BULOPA,BULOPA TOWN BUYEMBA,680,3,5,2,99,275,384,26,410,0,O-13-71-01-02-01
KAMULI,BUGABULA SOUTH,BULOPA,BULOPA,WANSALE PR/SCH BUKALIKU,434,1,1,2,61,232,297,14,311,0,O-13-71-01-02-02
KAMULI,BUGABULA SOUTH,BULOPA,BULOPA,KASAKA PR/SCH BUSUNSWA/BUL,634,3,2,1,74,360,440,22,462,0,O-13-71-01-02-03
KAMULI,BUGABULA SOUTH,BULOPA,MPAKITONI,MPAKITONYI,652,7,2,3,112,312,436,31,467,0,O-13-71-01-03-01
KAMULI,BUGABULA SOUTH,BULOPA,MPAKITONI,BUWOYA,546,0,0,0,67,315,382,11,393,0,O-13-71-01-03-02
KAMULI,BUGABULA SOUTH,BULOPA,MPAKITONI,TASAGA,378,0,0,3,41,246,290,20,310,0,O-13-71-01-03-03
KAMULI,BUGABULA SOUTH,BULOPA,NAGAMULI,NABABIRYE PRIMARY SCHOOL,677,2,3,5,85,321,416,25,441,0,O-13-71-01-04-01
KAMULI,BUGABULA SOUTH,BULOPA,NAGAMULI,KYAYUYA CENTRE KYATUYA,390,2,1,3,108,163,277,16,293,0,O-13-71-01-04-02
KAMULI,BUGABULA SOUTH,BULOPA,NAGWENYI,NAGWENYI PRIMARY SCHOOL,429,2,0,3,43,264,312,22,334,0,O-13-71-01-05-01
KAMULI,BUGABULA SOUTH,BUTANSI,BUGENYWA,BUSAMO CENTRE BUKULUBA,746,5,0,3,85,380,473,37,510,0,O-13-71-02-01-01
KAMULI,BUGABULA SOUTH,BUTANSI,BUGENYWA,BUTYAMO FREEDOM TREE BELEE,515,0,0,2,40,321,363,23,386,0,O-13-71-02-01-02
KAMULI,BUGABULA SOUTH,BUTANSI,BUGENYWA,BULONGO AT AUBE'S PLACE,847,5,3,5,101,470,584,12,596,0,O-13-71-02-01-03
KAMULI,BUGABULA SOUTH,BUTANSI,BUGENYWA,BUGALUKA CENTRE,467,3,0,4,48,287,342,10,352,0,O-13-71-02-01-04
KAMULI,BUGABULA SOUTH,BUTANSI,BUTANSI,KIWUNGU PR/SCH KIWUNGU,518,2,1,3,39,319,364,11,375,0,O-13-71-02-02-01
KAMULI,BUGABULA SOUTH,BUTANSI,BUTANSI,KIWUNGU CATHOLIC CHURCH,585,2,0,4,76,317,399,11,410,0,O-13-71-02-02-02
KAMULI,BUGABULA SOUTH,BUTANSI,BUTANSI,BUTANSI P/S,632,2,2,2,56,370,432,7,439,0,O-13-71-02-02-03
KAMULI,BUGABULA SOUTH,BUTANSI,NAIBOWA,NAIBOWA COMMUNITY CENTRE A,377,1,2,4,54,205,266,5,271,0,O-13-71-02-03-01
KAMULI,BUGABULA SOUTH,BUTANSI,NAIBOWA,NAIBOWA C.O.U P/S,482,3,0,1,101,224,329,5,334,0,O-13-71-02-03-02
KAMULI,BUGABULA SOUTH,BUTANSI,NAIBOWA,ST MULUMBA P/SCH BUTIMBO,254,1,2,2,89,132,226,6,232,0,O-13-71-02-03-03
KAMULI,BUGABULA SOUTH,BUTANSI,NAIBOWA,BUTIMBO MOSLEM P/S,320,2,0,1,36,156,195,1,196,0,O-13-71-02-03-04
KAMULI,BUGABULA SOUTH,BUTANSI,NALUWOLI,NABIRAMA PR/ SCH NABIRAMA,605,2,0,1,67,392,462,8,470,0,O-13-71-02-04-01
KAMULI,BUGABULA SOUTH,BUTANSI,NALUWOLI,NALUWOLI PR SCH NALUWOLI II,610,1,0,2,51,393,447,23,470,0,O-13-71-02-04-02
KAMULI,BUGABULA SOUTH,BUTANSI,NALUWOLI,NAKANYONYI PR/SCH NALUWOLI I,852,0,2,4,57,535,598,26,624,0,O-13-71-02-04-03
KAMULI,BUGABULA SOUTH,BUTANSI,NALUWOLI,BUTEGERE PR/SCHOOL NALUWO,654,1,1,1,90,374,467,25,492,0,O-13-71-02-04-04
KAMULI,BUGABULA SOUTH,KIDIKI,BUGONDHA,KIRUNDA,752,3,4,5,85,403,500,26,526,0,O-13-71-03-01-01
KAMULI,BUGABULA SOUTH,KIDIKI,BUGONDHA,KAYEMBE CENTRE BUKWANGA/B,549,2,2,1,70,313,388,15,403,0,O-13-71-03-01-02
KAMULI,BUGABULA SOUTH,KIDIKI,ISINGO,KIDIKI KASOKOSO A,444,1,5,1,76,270,353,12,365,0,O-13-71-03-02-01
KAMULI,BUGABULA SOUTH,KIDIKI,ISINGO,KIDIKI PRI BULONDO,651,2,5,3,119,355,484,26,510,0,O-13-71-03-02-02
KAMULI,BUGABULA SOUTH,KIDIKI,ISINGO,KIDIKI KASOKOSO B,561,1,8,0,76,319,404,25,429,0,O-13-71-03-02-03
KAMULI,BUGABULA SOUTH,KIDIKI,KYEEYA,KASOKOSO BUTOGO,510,1,1,0,41,316,359,23,382,0,O-13-71-03-03-01
KAMULI,BUGABULA SOUTH,KIDIKI,KYEEYA,KYEEYA PR/SCHOOL,358,2,2,6,36,236,282,3,285,0,O-13-71-03-03-02
KAMULI,BUGABULA SOUTH,KIDIKI,KYEEYA,KAKUNYU/BUGOBI,775,1,1,5,92,424,523,20,543,0,O-13-71-03-03-03
KAMULI,BUGABULA SOUTH,KIDIKI,KYEEYA,BUGOBI P/S,314,1,2,2,26,179,210,19,229,0,O-13-71-03-03-04
KAMULI,BUGABULA SOUTH,KIDIKI,MAKOKA,KINAWAMPERE CENTRE BUBUUPI,242,0,0,3,20,158,181,11,192,0,O-13-71-03-04-01
KAMULI,BUGABULA SOUTH,KIDIKI,MAKOKA,KINAWAMPERE PR SCHOOL BUG,513,3,2,3,89,272,369,18,387,0,O-13-71-03-04-02
KAMULI,BUGABULA SOUTH,KIDIKI,MAKOKA,MAKOKA PR SCHOOL BUKYABITA,511,1,1,2,54,282,340,13,353,0,O-13-71-03-04-03
KAMULI,BUGABULA SOUTH,KIDIKI,MAKOKA,MAKOKA C O U BUTAMIRIKE/BUKA,632,2,2,3,68,328,403,28,431,0,O-13-71-03-04-04
KAMULI,BUGABULA SOUTH,KIDIKI,NAMWENDWA,BUGOLE CENTRE,471,0,0,1,62,299,362,12,374,0,O-13-71-03-05-01
KAMULI,BUGABULA SOUTH,KIDIKI,NAMWENDWA,BUYINGO,720,2,5,5,117,372,501,30,531,0,O-13-71-03-05-02
KAMULI,BUGABULA SOUTH,KIDIKI,NAMWENDWA,NAMWENDWA TRADING CENTRE,845,0,4,1,196,333,534,16,550,0,O-13-71-03-05-03
KAMULI,BUGABULA SOUTH,KIDIKI,NDALIKE,NDALIKE P/SCHOOL,751,0,1,6,53,402,462,22,484,0,O-13-71-03-06-01
KAMULI,BUGABULA SOUTH,KIDIKI,NDALIKE,KISEGE P/S,434,2,4,3,52,273,334,12,346,0,O-13-71-03-06-02
KAMULI,BUGABULA SOUTH,KINU,BUGONDHA,KINU PR/SCHOOL,623,3,2,4,109,368,486,12,498,0,O-13-71-04-01-01
KAMULI,BUGABULA SOUTH,KINU,BUGONDHA,KINU NANVUNANO,501,3,0,0,111,285,399,8,407,0,O-13-71-04-01-02
KAMULI,BUGABULA SOUTH,KINU,BUGONDHA,GALINANDHA P/S,380,0,0,1,47,259,307,9,316,0,O-13-71-04-01-03
KAMULI,BUGABULA SOUTH,KITAYUNJWA,BUGANZA,BUYANDHA KASOKOSO BUYANDH,407,1,4,1,58,240,304,8,312,0,O-13-71-05-01-01
KAMULI,BUGABULA SOUTH,KITAYUNJWA,BUGANZA,NAMAIRA TRADING CENTRE,855,1,2,6,134,348,491,20,511,0,O-13-71-05-01-02
KAMULI,BUGABULA SOUTH,KITAYUNJWA,BUGANZA,BUGANZA P/SCH BUGANZA,684,2,1,4,81,381,469,30,499,0,O-13-71-05-01-03
KAMULI,BUGABULA SOUTH,KITAYUNJWA,BUGANZA,BUDHATEMWA PR.SCH. BUDHATE,599,4,0,1,74,346,425,6,431,0,O-13-71-05-01-04
KAMULI,BUGABULA SOUTH,KITAYUNJWA,BUGANZA,KABBALE PR.SCH.,542,5,1,0,68,287,361,25,386,0,O-13-71-05-01-05
KAMULI,BUGABULA SOUTH,KITAYUNJWA,BUSOTA,KABUKYE PR/SCH KABUKYE,636,4,1,1,76,369,451,35,486,0,O-13-71-05-02-01
KAMULI,BUGABULA SOUTH,KITAYUNJWA,BUSOTA,BUSOTA PRIMARY SCHOOL,598,2,3,0,112,278,395,20,415,0,O-13-71-05-02-02
KAMULI,BUGABULA SOUTH,KITAYUNJWA,BUSOTA,BUTABALA PRIMARY SCHOOL,548,1,1,2,129,243,376,14,390,0,O-13-71-05-02-03
KAMULI,BUGABULA SOUTH,KITAYUNJWA,BUSOTA,BUTABALA CATHOLIC CHURCH,297,0,1,0,49,146,196,2,198,0,O-13-71-05-02-04
KAMULI,BUGABULA SOUTH,KITAYUNJWA,BUTENDE,BUTENDE P/SCH NSIIMA,674,2,6,2,85,370,465,25,490,0,O-13-71-05-03-01
KAMULI,BUGABULA SOUTH,KITAYUNJWA,BUTENDE,MABIGONGERYA P/SCH BUGULU,472,1,0,0,67,262,330,11,341,0,O-13-71-05-03-02
KAMULI,BUGABULA SOUTH,KITAYUNJWA,BUTENDE,KINABEEYO CENTRE BUKUNDHUB,716,3,1,5,84,436,529,33,562,0,O-13-71-05-03-03
KAMULI,BUGABULA SOUTH,KITAYUNJWA,KITAYUNJWA,BWEBYA BULONDO NAKIMEGERE,403,2,2,3,68,248,323,4,327,0,O-13-71-05-04-01
KAMULI,BUGABULA SOUTH,KITAYUNJWA,KITAYUNJWA,BUWAIBALE KITAYUNJWA,437,3,2,7,89,209,310,17,327,0,O-13-71-05-04-02
KAMULI,BUGABULA SOUTH,KITAYUNJWA,KITAYUNJWA,NAMINAGE TR CENTRE NAMINAG,660,3,0,1,124,330,458,19,477,0,O-13-71-05-04-03
KAMULI,BUGABULA SOUTH,KITAYUNJWA,KITAYUNJWA,NAMINAGE PR SCHOOL NAMINAG,437,1,1,1,31,287,321,13,334,0,O-13-71-05-04-04
KAMULI,BUGABULA SOUTH,KITAYUNJWA,NAMAGANDA,NAMAGANDA RAILWAY STATION,746,2,1,2,125,375,505,23,528,0,O-13-71-05-05-01
KAMULI,BUGABULA SOUTH,KITAYUNJWA,NAMAGANDA,NAMAGANDA CATHOLIC CHURCH,534,0,3,3,104,250,360,42,402,0,O-13-71-05-05-02
KAMULI,BUGABULA SOUTH,KITAYUNJWA,NAMISAMBYA I,NAMISAMBYA P/S,785,2,2,0,106,426,536,32,568,0,O-13-71-05-06-01
KAMULI,BUGABULA SOUTH,KITAYUNJWA,NAMISAMBYA I,CLOVES MANGO TREE,343,0,4,0,31,193,228,16,244,0,O-13-71-05-06-02
KAMULI,BUGABULA SOUTH,KITAYUNJWA,NAMISAMBYA I,KIROBA PR SCHOOL KIROBA,590,7,1,5,91,311,415,22,437,0,O-13-71-05-06-03
KAMULI,BUGABULA SOUTH,KITAYUNJWA,NAMISAMBYA II,KITAYUNJWA S/C HQRS,387,1,1,1,38,219,260,9,269,0,O-13-71-05-07-01
KAMULI,BUGABULA SOUTH,KITAYUNJWA,NAMISAMBYA II,BUTERIMIRE PR.SCHOOL,540,1,2,0,63,265,331,31,362,0,O-13-71-05-07-02
KAMULI,BUGABULA SOUTH,KITAYUNJWA,NAMISAMBYA II,BUWAISWA PR.SCHOOL,576,2,0,6,78,331,417,4,421,0,O-13-71-05-07-03
KAMULI,BUGABULA SOUTH,KITAYUNJWA,NAMISAMBYA II,BUWAISWA T.C,331,2,1,0,22,191,216,12,228,0,O-13-71-05-07-04
KAMULI,BUGABULA SOUTH,KITAYUNJWA,NAWANGO,NAWANGO P/SCHOOL,445,0,0,5,70,230,305,10,315,0,O-13-71-05-08-01
KAMULI,BUGABULA SOUTH,KITAYUNJWA,NAWANGO,NAWANGO PR SCHOOL B,524,0,1,1,46,339,387,13,400,0,O-13-71-05-08-02
KAMULI,BUGABULA SOUTH,KITAYUNJWA,NAWANGO,KAYEMBE,772,0,1,0,83,416,500,28,528,0,O-13-71-05-08-03
KAMULI,BUGABULA SOUTH,KITAYUNJWA,NAWANGO,NAWANGO SCHEME,408,0,2,3,50,195,250,21,271,0,O-13-71-05-08-04
KAMULI,BUGABULA SOUTH,KITAYUNJWA,NAWANSASO,NAWANSASO TR CENTRE,626,5,3,2,85,337,432,27,459,0,O-13-71-05-09-01
KAMULI,BUGABULA SOUTH,KITAYUNJWA,NAWANSASO,KALIKULALI COURT YARD,398,4,3,6,52,224,289,21,310,0,O-13-71-05-09-02
KAMULI,BUGABULA SOUTH,KITAYUNJWA,NAWANSASO,KABANDA BOREHOLE,288,0,1,3,20,170,194,7,201,0,O-13-71-05-09-03
KAMULI,BUGABULA SOUTH,NAMWENDWA,BULANGE,BUTUYA,407,3,0,2,52,264,321,13,334,0,O-13-71-06-01-01
KAMULI,BUGABULA SOUTH,NAMWENDWA,BULANGE,BULANGE CENTRAL,520,1,0,1,67,338,407,5,412,0,O-13-71-06-01-02
KAMULI,BUGABULA SOUTH,NAMWENDWA,BULANGE,NDALI/BULONDO,452,1,0,2,75,263,341,10,351,0,O-13-71-06-01-03
KAMULI,BUGABULA SOUTH,NAMWENDWA,BULANGE,BUWOLOMERA,290,3,14,3,37,157,214,10,224,0,O-13-71-06-01-04
KAMULI,BUGABULA SOUTH,NAMWENDWA,BULOGO,BULOGO PR/SCHOOL,507,3,1,2,89,252,347,22,369,0,O-13-71-06-02-01
KAMULI,BUGABULA SOUTH,NAMWENDWA,BULOGO,NAKASERO T.C,646,2,0,0,71,396,469,10,479,0,O-13-71-06-02-02
KAMULI,BUGABULA SOUTH,NAMWENDWA,BULOGO,BULOGO PR/SCHOOL [N-Z],413,3,1,2,51,190,247,19,266,0,O-13-71-06-02-03
KAMULI,BUGABULA SOUTH,NAMWENDWA,ISINGO,ISINGO A NAMWENDWA,498,2,1,2,75,224,304,25,329,0,O-13-71-06-03-01
KAMULI,BUGABULA SOUTH,NAMWENDWA,ISINGO,KAYUNDO,533,1,1,1,90,319,412,16,428,0,O-13-71-06-03-02
KAMULI,BUZAAYA,BUGULUMBYA,BUGULUMBYA,BUGULUMBYA HQRS,408,2,0,1,30,159,192,37,229,0,O-13-73-01-01-01
KAMULI,BUZAAYA,BUGULUMBYA,BUGULUMBYA,BUGULUMBYA P/S,665,3,2,3,63,332,403,7,410,0,O-13-73-01-01-02
KAMULI,BUZAAYA,BUGULUMBYA,BUGULUMBYA,BUWOYA MOSLEM P/S,795,7,2,7,131,331,478,15,493,0,O-13-73-01-01-03
KAMULI,BUZAAYA,BUGULUMBYA,BUGULUMBYA,BUWOYA P/S,440,3,0,0,57,184,244,55,299,0,O-13-73-01-01-04
KAMULI,BUZAAYA,BUGULUMBYA,BUGULUMBYA,KATANUNI T.C,236,1,0,2,46,110,159,8,167,0,O-13-73-01-01-05
KAMULI,BUZAAYA,BUGULUMBYA,BUGULUMBYA,GUULE P/S,333,0,0,1,62,158,221,8,229,0,O-13-73-01-01-06
KAMULI,BUZAAYA,BUGULUMBYA,BUSANDHA,NAWANGOMA FOOTBALL GROUN,737,7,0,1,67,353,428,66,494,0,O-13-73-01-02-01
KAMULI,BUZAAYA,BUGULUMBYA,BUSANDHA,BUSANDHA FOOTBALL GROUND,513,0,0,0,62,197,259,57,316,0,O-13-73-01-02-02
KAMULI,BUZAAYA,BUGULUMBYA,BUSANDHA,BUSANDHA TR. CENTRE,571,3,0,3,53,329,388,9,397,0,O-13-73-01-02-03
KAMULI,BUZAAYA,BUGULUMBYA,BUSANDHA,BUSANDHA FOOTBALL GROUND B,348,2,1,1,41,186,231,2,233,0,O-13-73-01-02-04
KAMULI,BUZAAYA,BUGULUMBYA,BUSANDHA,BUSANDHA ISINWA,163,0,0,1,24,88,113,3,116,0,O-13-73-01-02-05
KAMULI,BUZAAYA,BUGULUMBYA,BUSANDHA,KIBUYE P/S,146,0,0,0,13,76,89,6,95,0,O-13-73-01-02-06
KAMULI,BUZAAYA,BUGULUMBYA,KASAMBIRA,KASAMBIRA SDA P/S,589,3,1,1,128,212,345,2,347,0,O-13-73-01-03-01
KAMULI,BUZAAYA,BUGULUMBYA,KASAMBIRA,KASAMBIRA P/SCHOOL -  BUBOG,528,1,3,2,109,231,346,17,363,0,O-13-73-01-03-02
KAMULI,BUZAAYA,BUGULUMBYA,KASAMBIRA,BUWANUME/BUGULUSI,459,2,2,2,78,239,323,10,333,0,O-13-73-01-03-03
KAMULI,BUZAAYA,BUGULUMBYA,KASAMBIRA,BUKYONZA P/SCHOOL - BUKYONZ,679,1,1,2,129,279,412,76,488,0,O-13-73-01-03-04
KAMULI,BUZAAYA,BUGULUMBYA,KASAMBIRA,KASAMBIRA S.D.A CHURCH,390,3,0,2,76,158,239,7,246,0,O-13-73-01-03-05
KAMULI,BUZAAYA,BUGULUMBYA,NAKIBUNGULYA,BUTALE P/SCHOOL,731,2,2,2,121,352,479,19,498,0,O-13-73-01-04-01
KAMULI,BUZAAYA,BUGULUMBYA,NAKIBUNGULYA,ST PETER NAKIBUNGULYA,512,3,1,3,92,217,316,63,379,0,O-13-73-01-04-02
KAMULI,BUZAAYA,BUGULUMBYA,NAKIBUNGULYA,NAKIBUNGULYA P/SCHOOL,466,3,1,2,116,204,326,15,341,0,O-13-73-01-04-03
KAMULI,BUZAAYA,BUGULUMBYA,NAWANENDE,NABIRAMA,535,0,1,3,40,342,386,8,394,0,O-13-73-01-05-01
KAMULI,BUZAAYA,BUGULUMBYA,NAWANENDE,NANKUNI,670,1,2,4,92,312,411,9,420,0,O-13-73-01-05-02
KAMULI,BUZAAYA,BUGULUMBYA,NAWANENDE,BUKOSE,369,0,1,0,67,155,223,34,257,0,O-13-73-01-05-03
KAMULI,BUZAAYA,BUGULUMBYA,NAWANENDE,BUSIIWA C.O.U,336,0,0,2,43,169,214,3,217,0,O-13-73-01-05-04
KAMULI,BUZAAYA,KISOZI,BUTEME,ST. JOSEPH P/SCHOOL,336,0,0,1,74,130,205,7,212,0,O-13-73-02-01-01
KAMULI,BUZAAYA,KISOZI,BUTEME,KISADHAKI P/SCH,668,5,1,6,184,254,450,11,461,0,O-13-73-02-01-02
KAMULI,BUZAAYA,KISOZI,KAKIRA,GAWOLE TRADING CENTRE,513,2,3,2,93,211,311,14,325,0,O-13-73-02-02-01
KAMULI,BUZAAYA,KISOZI,KAKIRA,KAZAANA/BUGOBI/KILANGIRA,526,1,3,2,61,289,356,7,363,0,O-13-73-02-02-02
KAMULI,BUZAAYA,KISOZI,KAKUNYU,BULAMUKA PR SCH BULAMUKA,399,1,1,1,71,193,267,15,282,0,O-13-73-02-03-01
KAMULI,BUZAAYA,KISOZI,KAKUNYU,KAKUNYU T C KAKUNYU,301,2,1,1,49,154,207,5,212,0,O-13-73-02-03-02
KAMULI,BUZAAYA,KISOZI,KAKUNYU,NAWANTALE P/S NAWANTALE,625,0,0,3,75,290,368,24,392,0,O-13-73-02-03-03
KAMULI,BUZAAYA,KISOZI,KAKUNYU,KITUBA LEPROSY AID POST KITU,285,1,3,1,29,147,181,7,188,0,O-13-73-02-03-04
KAMULI,BUZAAYA,KISOZI,KISOZI,KISOZI SDA PR. SCHOOL,621,1,2,4,48,336,391,13,404,0,O-13-73-02-04-01
KAMULI,BUZAAYA,KISOZI,KISOZI,ISIMBA P/S,720,1,0,2,106,257,366,2,368,0,O-13-73-02-04-02
KAMULI,BUZAAYA,KISOZI,KISOZI,KISOZI SUB-COUNTY HQRS NAIKE,670,2,3,2,83,293,383,14,397,0,O-13-73-02-04-03
KAMULI,BUZAAYA,KISOZI,KISOZI,NAMATOVU SUB-GRADE NAMATO,455,4,0,2,63,232,301,14,315,0,O-13-73-02-04-04
KAMULI,BUZAAYA,KISOZI,KISOZI,ST. GONZAGA CATHOLIC CHURC,283,0,0,0,34,163,197,3,200,0,O-13-73-02-04-05
KAMULI,BUZAAYA,KISOZI,KIYUNGA,IZANYIRO P.S. KIYUNGA I,626,4,2,4,87,293,390,18,408,0,O-13-73-02-05-01
KAMULI,BUZAAYA,KISOZI,KIYUNGA,IZANYIRO P.S. KIYUNGA II,487,2,0,1,61,273,337,15,352,0,O-13-73-02-05-02
KAMULI,BUZAAYA,KISOZI,KIYUNGA,BUGOOLO P.S. BUGOOLO,501,3,0,5,77,241,326,26,352,0,O-13-73-02-05-03
KAMULI,BUZAAYA,KISOZI,KIYUNGA,KIYUNGA T C BUDUULI,836,1,4,1,95,364,465,14,479,0,O-13-73-02-05-04
KAMULI,BUZAAYA,KISOZI,LWANYAMA,LWANYAMA PR. SCH. KALEMBE B.,523,1,1,1,75,239,317,18,335,0,O-13-73-02-06-01
KAMULI,BUZAAYA,KISOZI,LWANYAMA,LWANYAMA PR. SCHOOL,551,1,0,3,47,286,337,7,344,0,O-13-73-02-06-02
KAMULI,BUZAAYA,KISOZI,LWANYAMA,LUGADA/LUGADA,368,2,0,2,61,232,297,5,302,0,O-13-73-02-06-03
KAMULI,BUZAAYA,KISOZI,MAGOGO,MAGOGO SOCIETY,737,1,1,11,123,293,429,14,443,0,O-13-73-02-07-01
KAMULI,BUZAAYA,KISOZI,MAGOGO,MAGOGO P/SCH A,337,0,1,1,66,160,228,20,248,0,O-13-73-02-07-02
KAMULI,BUZAAYA,KISOZI,NAMAGANDA,NILE PR/ SCHOOL NABABIRYE,582,1,0,4,90,279,374,13,387,0,O-13-73-02-08-01
KAMULI,BUZAAYA,KISOZI,NAMAGANDA,KISOZI C.O.U. P.S. NAKABUGU,562,2,1,1,64,329,397,12,409,0,O-13-73-02-08-02
KAMULI,BUZAAYA,KISOZI,NAMAGANDA,NAMAGANDA T.C NAMAGANDA,451,1,1,1,125,165,293,8,301,0,O-13-73-02-08-03
KAMULI,BUZAAYA,KISOZI,NANKANDULO,NANKANDULO P/S NANKANDULO,650,5,0,5,101,316,427,12,439,0,O-13-73-02-09-01
KAMULI,BUZAAYA,KISOZI,NANKANDULO,TRADING CENTRE A,559,6,1,4,111,214,336,12,348,0,O-13-73-02-09-02
KAMULI,BUZAAYA,KISOZI,NANKANDULO,MATUUMU PR SCHOOL,574,4,0,4,67,228,303,12,315,0,O-13-73-02-09-03
KAMULI,BUZAAYA,KISOZI,NANKANDULO,NANKANDULO T/CENTRE B,368,4,0,0,59,188,251,12,263,0,O-13-73-02-09-04
KAMULI,BUZAAYA,KISOZI,NANKANDULO,NAKAATO BOREHOLE,352,0,1,2,58,169,230,6,236,0,O-13-73-02-09-05
KAMULI,BUZAAYA,MBULAMUTI,BUGONDHA,KISWA P/S,789,3,2,5,98,466,574,18,592,0,O-13-73-03-01-01
KAMULI,BUZAAYA,MBULAMUTI,BUGONDHA,MUKOKOTOKWA P/S,445,2,1,1,52,263,319,24,343,0,O-13-73-03-01-02
KAMULI,BUZAAYA,MBULAMUTI,BUGONDHA,BUGONDHA P/S,583,1,0,1,71,366,439,18,457,0,O-13-73-03-01-03
KAMULI,BUZAAYA,MBULAMUTI,BULUYA,RAILWAY STATION,589,4,0,3,118,239,364,9,373,0,O-13-73-03-02-01
KAMULI,BUZAAYA,MBULAMUTI,BULUYA,BULUYA HEALTH UNIT,411,2,1,0,56,234,293,9,302,0,O-13-73-03-02-02
KAMULI,BUZAAYA,MBULAMUTI,BULUYA,BUGULUSI P/SCHOOL,465,1,0,4,75,251,331,15,346,0,O-13-73-03-02-03
KAMULI,BUZAAYA,MBULAMUTI,BULUYA,KIWANYI T/C,431,2,0,1,51,236,290,8,298,0,O-13-73-03-02-04
KAMULI,BUZAAYA,MBULAMUTI,KIYUNGA,BUKAKANDE P/SCHOOL,422,2,2,0,82,134,220,66,286,0,O-13-73-03-03-01
KAMULI,BUZAAYA,MBULAMUTI,KIYUNGA,KIYUNGA PARISH CENTRE KIYUN,487,2,1,7,112,205,327,9,336,0,O-13-73-03-03-02
KAMULI,BUZAAYA,MBULAMUTI,KIYUNGA,NAKAKABALA P/S,648,0,1,4,95,326,426,22,448,0,O-13-73-03-03-03
KAMULI,BUZAAYA,MBULAMUTI,KIYUNGA,NABITAMA MUTENGU,204,1,1,0,19,119,140,4,144,0,O-13-73-03-03-04
KAMULI,BUZAAYA,MBULAMUTI,KIYUNGA,INTERNATIONAL FELLOWSHIP CH,338,1,0,0,116,120,237,4,241,0,O-13-73-03-03-05
KAMULI,BUZAAYA,MBULAMUTI,MBULAMUTI,MBALAMITI PRIMARY SCHOOL,632,6,0,5,94,322,427,20,447,0,O-13-73-03-04-01
KAMULI,BUZAAYA,MBULAMUTI,MBULAMUTI,NAKALANGA PRIMARY SCHOOL,273,0,2,1,40,152,195,9,204,0,O-13-73-03-04-02
KAMULI,BUZAAYA,MBULAMUTI,MBULAMUTI,BUFAKI TRADING CENTRE,443,2,0,5,61,259,327,15,342,0,O-13-73-03-04-03
KAMULI,BUZAAYA,MBULAMUTI,MBULAMUTI,LUGOLOIRE PR/SCH,622,3,0,5,108,312,428,19,447,0,O-13-73-03-04-04
KAMULI,BUZAAYA,MBULAMUTI,MBULAMUTI,ST PAUL'S SEC SCH MBULAMUTI,420,3,2,0,66,176,247,21,268,0,O-13-73-03-04-05
KAMULI,BUZAAYA,MBULAMUTI,MBULAMUTI,MBULAMUTI TOWN,689,4,0,0,130,305,439,19,458,0,O-13-73-03-04-06
KAMULI,BUZAAYA,NAWANYAGO,BUPADHENGO,BUKYONDA,663,2,3,3,114,283,405,22,427,0,O-13-73-04-01-01
KAMULI,BUZAAYA,NAWANYAGO,BUPADHENGO,BUPADHENGO T.C,586,2,1,0,118,264,385,20,405,0,O-13-73-04-01-02
KAMULI,BUZAAYA,NAWANYAGO,BUPADHENGO,BUPADHENGO P/S,592,1,0,1,67,303,372,5,377,0,O-13-73-04-01-03
KAMULI,BUZAAYA,NAWANYAGO,BUPADHENGO,ITUKULU P/S,610,2,0,1,146,259,408,19,427,0,O-13-73-04-01-04
KAMULI,BUZAAYA,NAWANYAGO,NAWANTUMBI,BUWAGI P/SCHOOL,771,0,0,1,114,354,469,24,493,0,O-13-73-04-02-01
KAMULI,BUZAAYA,NAWANYAGO,NAWANTUMBI,NAWANTUMBI TR CENTRE,426,2,1,1,71,225,300,8,308,0,O-13-73-04-02-02
KAMULI,BUZAAYA,NAWANYAGO,NAWANTUMBI,NALINAIBI P/S,661,3,1,5,170,254,433,28,461,0,O-13-73-04-02-03
KAMULI,BUZAAYA,NAWANYAGO,NAWANTUMBI,NAMULIKYA P/S,670,2,3,7,147,288,447,15,462,0,O-13-73-04-02-04
KAMULI,BUZAAYA,NAWANYAGO,NAWANYAGO,NAWANYAGO S/C HQTR,613,2,0,0,101,212,315,52,367,0,O-13-73-04-03-01
KAMULI,BUZAAYA,NAWANYAGO,NAWANYAGO,NAWANYAGO P/S II,753,2,0,1,120,328,451,4,455,0,O-13-73-04-03-02
KAMULI,BUZAAYA,NAWANYAGO,NAWANYAGO,BUKULUBE P/S IGUMYA,692,1,3,4,98,381,487,10,497,0,O-13-73-04-03-03
KAMULI,BUZAAYA,NAWANYAGO,NAWANYAGO,KAMULI GIRLS COLLEGE,705,7,0,1,136,279,423,23,446,0,O-13-73-04-03-04
KAMULI,BUZAAYA,NAWANYAGO,NAWANYAGO,BUSIMBE [DHAFA'S PLACE] BUSIM,319,2,3,1,67,150,223,3,226,0,O-13-73-04-03-05
KAMULI,BUZAAYA,WANKOLE,LULYAMBUZI,BUWALA P/SCH,806,6,1,0,76,404,487,12,499,0,O-13-73-05-01-01
KAMULI,BUZAAYA,WANKOLE,LULYAMBUZI,LULYAMBUZI PR SCH,675,2,4,2,40,388,436,7,443,0,O-13-73-05-01-02
KAMULI,BUZAAYA,WANKOLE,LULYAMBUZI,LUTEBE KASANDHA,538,1,2,2,44,329,378,1,379,0,O-13-73-05-01-03
KAMULI,BUZAAYA,WANKOLE,LULYAMBUZI,NAGADUDULA C.O.U,223,1,0,0,35,117,153,3,156,0,O-13-73-05-01-04
KAMULI,BUZAAYA,WANKOLE,LUZINGA,LUZINGA P/SCH,693,1,1,2,142,272,418,12,430,0,O-13-73-05-02-01
KAMULI,BUZAAYA,WANKOLE,LUZINGA,KIBETO P/S,626,0,3,5,95,235,338,24,362,0,O-13-73-05-02-02
KAMULI,BUZAAYA,WANKOLE,LUZINGA,BUKITIMBO PR/SCH,439,1,2,1,85,111,200,50,250,0,O-13-73-05-02-03
KAMULI,BUZAAYA,WANKOLE,LUZINGA,KIBETO C.O.U,384,1,0,0,48,157,206,21,227,0,O-13-73-05-02-04
KAMULI,BUZAAYA,WANKOLE,LUZINGA,LUZINGA GINNERY,343,2,0,0,69,151,222,28,250,0,O-13-73-05-02-05
KAMULI,BUZAAYA,WANKOLE,LUZINGA,BUBAALE,282,1,2,1,80,106,190,10,200,0,O-13-73-05-02-06
KAMULI,BUZAAYA,WANKOLE,WANKOLE,NAWANDYO BAGONZANVUMA,726,1,0,2,81,349,433,19,452,0,O-13-73-05-03-01
KAMULI,BUZAAYA,WANKOLE,WANKOLE,NAWANDYO NAKULABYE SUB - G,676,1,1,4,105,292,403,7,410,0,O-13-73-05-03-02
KAMULI,BUZAAYA,WANKOLE,WANKOLE,NAWANDYO TR CENTRE,668,1,0,3,61,209,274,15,289,0,O-13-73-05-03-03
KAMULI,BUZAAYA,WANKOLE,WANKOLE,WANKOLE P/S,630,2,0,2,84,283,371,7,378,0,O-13-73-05-03-04
KAMULI,BUZAAYA,WANKOLE,WANKOLE,NAWANDYO P/S,357,0,0,1,29,166,196,4,200,0,O-13-73-05-03-05
KAMULI,BUZAAYA,WANKOLE,WANKOLE,WANKOLE SDA CHURCH,134,0,0,2,12,62,76,0,76,0,O-13-73-05-03-06
KAPCHORWA,TINGEY COUNTY,CHEMA,CHEMA,CHEMA MARKET,337,2,0,1,152,111,266,19,285,0,O-14-76-01-01-01
KAPCHORWA,TINGEY COUNTY,CHEMA,CHEMA,KAKWEEN,363,1,1,2,66,216,286,16,302,0,O-14-76-01-01-02
KAPCHORWA,TINGEY COUNTY,CHEMA,CHEMA,TULOWO,466,3,5,1,165,168,342,46,388,0,O-14-76-01-01-03
KAPCHORWA,TINGEY COUNTY,CHEMA,CHEMOSONG,KAPKWATA,460,2,0,1,167,137,307,68,375,0,O-14-76-01-02-01
KAPCHORWA,TINGEY COUNTY,CHEMA,CHEMOSONG,CHESIYO,361,2,0,0,132,132,266,45,311,0,O-14-76-01-02-02
KAPCHORWA,TINGEY COUNTY,CHEMA,KAPKWAI,CHEPKUTWO,483,2,0,0,28,274,304,79,383,0,O-14-76-01-03-01
KAPCHORWA,TINGEY COUNTY,CHEMA,KAPKWAI,KETAKENGE,609,2,0,2,105,264,373,87,460,0,O-14-76-01-03-02
KAPCHORWA,TINGEY COUNTY,CHEMA,MUNARYA,CHEBONET,289,1,0,0,65,160,226,0,226,0,O-14-76-01-04-01
KAPCHORWA,TINGEY COUNTY,CHEMA,MUNARYA,SOSUR,571,4,2,2,103,303,414,73,487,0,O-14-76-01-04-02
KAPCHORWA,TINGEY COUNTY,CHEMA,MUNARYA,CHESOYEN,362,0,1,1,61,217,280,23,303,0,O-14-76-01-04-03
KAPCHORWA,TINGEY COUNTY,CHEMA,NGASIRE,KEWACHESIT,366,1,1,0,88,199,289,19,308,0,O-14-76-01-05-01
KAPCHORWA,TINGEY COUNTY,CHEMA,NGASIRE,NGASIRE PRIMARY SCHOOL,245,0,0,1,7,208,216,19,235,0,O-14-76-01-05-02
KAPCHORWA,TINGEY COUNTY,CHEMA,NGASIRE,LUTEI,193,0,0,0,18,119,137,27,164,0,O-14-76-01-05-03
KAPCHORWA,TINGEY COUNTY,KAPCHORWA T/C,BARAWA,BARAWA,388,1,4,0,93,169,267,37,304,0,O-14-76-02-01-01
KAPCHORWA,TINGEY COUNTY,KAPCHORWA T/C,BARAWA,CHEPSIKIROI,356,1,0,0,46,100,147,18,165,0,O-14-76-02-01-02
KAPCHORWA,TINGEY COUNTY,KAPCHORWA T/C,BARAWA,SOSHO,586,0,1,0,130,186,317,72,389,0,O-14-76-02-01-03
KAPCHORWA,TINGEY COUNTY,KAPCHORWA T/C,KAWOWO WARD,CHEMONGES SQUARE,607,1,0,1,98,246,346,63,409,0,O-14-76-02-02-01
KAPCHORWA,TINGEY COUNTY,KAPCHORWA T/C,KAWOWO WARD,GOVT LODGE,579,1,0,2,68,249,320,62,382,0,O-14-76-02-02-02
KAPCHORWA,TINGEY COUNTY,KAPCHORWA T/C,KAWOWO WARD,KISENYI,616,4,1,2,139,216,362,10,372,0,O-14-76-02-02-03
KAPCHORWA,TINGEY COUNTY,KAPCHORWA T/C,KAWOWO WARD,LONDON BRIDGE,375,2,0,0,57,164,223,33,256,0,O-14-76-02-02-04
KAPCHORWA,TINGEY COUNTY,KAPCHORWA T/C,KOKWOMURYA,KAPTOKWOI,209,1,0,0,46,100,147,18,165,0,O-14-76-02-03-01
KAPCHORWA,TINGEY COUNTY,KAPCHORWA T/C,KOKWOMURYA,KOKWOMURYA,253,2,1,0,42,144,189,14,203,0,O-14-76-02-03-02
KAPCHORWA,TINGEY COUNTY,KAPTANYA,KAPCHESOMBE,KAPCHESIY,563,1,1,0,75,333,410,65,475,0,O-14-76-03-01-01
KAPCHORWA,TINGEY COUNTY,KAPTANYA,KAPCHESOMBE,MUTYORU,530,3,0,0,70,240,313,73,386,0,O-14-76-03-01-02
KAPCHORWA,TINGEY COUNTY,KAPTANYA,KAPCHESOMBE,KAPLAK,259,2,0,0,37,183,222,23,245,0,O-14-76-03-01-03
KAPCHORWA,TINGEY COUNTY,KAPTANYA,KIRWOKO,KARASA,476,1,0,0,78,253,332,53,385,0,O-14-76-03-02-01
KAPCHORWA,TINGEY COUNTY,KAPTANYA,KIRWOKO,KASHABUL,521,1,0,0,78,253,332,53,385,0,O-14-76-03-02-02
KAPCHORWA,TINGEY COUNTY,KAPTANYA,KIRWOKO,SIRON P/S,350,1,0,0,32,229,262,35,297,0,O-14-76-03-02-03
KAPCHORWA,TINGEY COUNTY,KAPTANYA,KWOTI,KWEEN,466,0,0,1,57,339,397,18,415,0,O-14-76-03-03-01
KAPCHORWA,TINGEY COUNTY,KAPTANYA,KWOTI,KWONO,382,0,1,1,58,175,235,17,252,0,O-14-76-03-03-02
KAPCHORWA,TINGEY COUNTY,KAPTANYA,NGANGATA,CHEMUKUNG,521,2,0,1,122,202,327,96,423,0,O-14-76-03-04-01
KAPCHORWA,TINGEY COUNTY,KAPTANYA,NGANGATA,MARON,333,0,1,1,58,174,234,51,285,0,O-14-76-03-04-02
KAPCHORWA,TINGEY COUNTY,KAPTANYA,NGANGATA,NGANGATA,398,1,1,0,9,239,250,12,262,0,O-14-76-03-04-03
KAPCHORWA,TINGEY COUNTY,KAPTANYA,TUMBOBOI,KABUR,432,5,1,0,21,380,407,20,427,0,O-14-76-03-05-01
KAPCHORWA,TINGEY COUNTY,KAPTANYA,TUMBOBOI,KAPTOKWOI,356,3,0,0,43,198,244,60,304,0,O-14-76-03-05-02
KAPCHORWA,TINGEY COUNTY,KASEREM,AMUKUL,KABCHEBOKO,550,6,1,4,123,233,367,68,435,0,O-14-76-04-01-01
KAPCHORWA,TINGEY COUNTY,KASEREM,AMUKUL,KAPNANGORE,311,0,0,0,96,155,251,0,251,0,O-14-76-04-01-02
KAPCHORWA,TINGEY COUNTY,KASEREM,CHEBELAT,GIBUTONGO,597,3,0,1,47,431,482,14,496,0,O-14-76-04-02-01
KAPCHORWA,TINGEY COUNTY,KASEREM,CHEPTERECH,CHEPTERECH,319,0,0,0,71,170,241,25,266,0,O-14-76-04-03-01
KAPCHORWA,TINGEY COUNTY,KASEREM,KAMOKO,ROROK,360,4,0,0,99,169,272,13,285,0,O-14-76-04-04-01
KAPCHORWA,TINGEY COUNTY,KASEREM,KAPNARBABA,MALUKU,331,1,0,0,7,249,257,11,268,0,O-14-76-04-05-01
KAPCHORWA,TINGEY COUNTY,KASEREM,KAPTONO,KAPSIRIKWO,494,0,0,0,59,290,349,51,400,0,O-14-76-04-06-01
KAPCHORWA,TINGEY COUNTY,KASEREM,KATONGO,RUGONG,408,2,0,5,34,270,311,10,321,0,O-14-76-04-07-01
KAPCHORWA,TINGEY COUNTY,KASEREM,MARINY,BORON,708,7,0,3,131,372,513,77,590,0,O-14-76-04-08-01
KAPCHORWA,TINGEY COUNTY,KASEREM,SIRIMITYO,NGESI,487,1,2,2,77,258,340,45,385,0,O-14-76-04-09-01
KAPCHORWA,TINGEY COUNTY,KASEREM,WERE,KAPNATUWE,518,5,0,0,78,303,386,56,442,0,O-14-76-04-10-01
KAPCHORWA,TINGEY COUNTY,KAWOWO,CHEPTUYA,SUKUT,328,1,1,0,92,146,240,23,263,0,O-14-76-05-01-01
KAPCHORWA,TINGEY COUNTY,KAWOWO,CHEPTUYA,KWOMURON,302,2,0,3,97,136,238,14,252,0,O-14-76-05-01-02
KAPCHORWA,TINGEY COUNTY,KAWOWO,KAPCHELLA,MONDIN,470,0,1,0,73,235,309,56,365,0,O-14-76-05-02-01
KAPCHORWA,TINGEY COUNTY,KAWOWO,KAPCHELLA,REBERWO,352,2,0,1,106,156,265,40,305,0,O-14-76-05-02-02
KAPCHORWA,TINGEY COUNTY,KAWOWO,KOBIL,CHEKWANDA,497,3,0,2,107,216,328,76,404,0,O-14-76-05-03-01
KAPCHORWA,TINGEY COUNTY,KAWOWO,KOBIL,KANGURA,510,4,1,1,103,212,321,77,398,0,O-14-76-05-03-02
KAPCHORWA,TINGEY COUNTY,KAWOWO,KONGOWO,KAPKWEMBE,464,3,0,2,137,178,320,57,377,0,O-14-76-05-04-01
KAPCHORWA,TINGEY COUNTY,KAWOWO,KONGOWO,CHESABIT,440,3,1,1,124,186,315,47,362,0,O-14-76-05-04-02
KAPCHORWA,TINGEY COUNTY,KAWOWO,SANZARA,CHEMARE,240,0,0,0,30,165,195,6,201,0,O-14-76-05-05-01
KAPCHORWA,TINGEY COUNTY,KAWOWO,SANZARA,NAMAYIGA,213,1,0,1,21,118,141,21,162,0,O-14-76-05-05-02
KAPCHORWA,TINGEY COUNTY,KAWOWO,SENGWEL,KAPKWANJA,466,1,0,1,67,270,339,50,389,0,O-14-76-05-06-01
KAPCHORWA,TINGEY COUNTY,SIPI,CHEKWANDA,KOKWOSWEREI,256,0,0,0,52,121,173,16,189,0,O-14-76-06-01-01
KAPCHORWA,TINGEY COUNTY,SIPI,CHEKWANDA,KAMARAR,285,4,0,0,60,168,232,13,245,0,O-14-76-06-01-02
KAPCHORWA,TINGEY COUNTY,SIPI,GAMATUI,GAMATUI,461,3,1,0,87,196,287,39,326,0,O-14-76-06-02-01
KAPCHORWA,TINGEY COUNTY,SIPI,GAMATUI,KAMUSHA,445,1,0,0,46,259,306,0,306,0,O-14-76-06-02-02
KAPCHORWA,TINGEY COUNTY,SIPI,KABEYWA,KAPTOBOSWA,229,0,2,0,40,139,181,26,207,0,O-14-76-06-03-01
KAPCHORWA,TINGEY COUNTY,SIPI,KABEYWA,KOKWOMASEWE,421,3,2,1,35,366,407,6,413,0,O-14-76-06-03-02
KAPCHORWA,TINGEY COUNTY,SIPI,KAPKWIROK,PILAT,395,1,0,2,62,220,285,12,297,0,O-14-76-06-04-01
KAPCHORWA,TINGEY COUNTY,SIPI,KAPKWIROK,KAPKWIRWOK,349,0,2,0,39,199,240,25,265,0,O-14-76-06-04-02
KAPCHORWA,TINGEY COUNTY,SIPI,TANGWEN,TANGWEN,492,1,0,1,26,317,345,53,398,0,O-14-76-06-05-01
KAPCHORWA,TINGEY COUNTY,SIPI,TANGWEN,BUMUZAKI,469,2,1,4,41,277,325,44,369,0,O-14-76-06-05-02
KAPCHORWA,TINGEY COUNTY,SIPI,YEMBEK,KIMULI,524,0,0,3,39,349,391,38,429,0,O-14-76-06-06-01
KAPCHORWA,TINGEY COUNTY,TEGERES,KABAT,CHEPTILYAL,371,2,0,1,82,174,259,36,295,0,O-14-76-07-01-01
KAPCHORWA,TINGEY COUNTY,TEGERES,KABAT,KAPNYIKEW,409,2,0,1,140,129,272,57,329,0,O-14-76-07-01-02
KAPCHORWA,TINGEY COUNTY,TEGERES,KABAT,KAPTOROTWO,346,0,0,0,53,201,254,34,288,0,O-14-76-07-01-03
KAPCHORWA,TINGEY COUNTY,TEGERES,KAPENGURIA,KAPCHEKWARAI,646,2,0,0,83,368,453,74,527,0,O-14-76-07-02-01
KAPCHORWA,TINGEY COUNTY,TEGERES,KAPLELKO,KAPLELKO,357,4,0,0,82,182,268,9,277,0,O-14-76-07-03-01
KAPCHORWA,TINGEY COUNTY,TEGERES,KAPLELKO,CHEMUTARE,435,6,0,2,118,152,278,43,321,0,O-14-76-07-03-02
KAPCHORWA,TINGEY COUNTY,TEGERES,KAPTERET,BUROYEN,666,1,2,0,199,235,437,113,550,0,O-14-76-07-04-01
KAPCHORWA,TINGEY COUNTY,TEGERES,KAPTERET,KISITO,629,2,0,1,124,299,426,72,498,0,O-14-76-07-04-02
KAPCHORWA,TINGEY COUNTY,TEGERES,KUTUNG,KUTUNG PR/SCHOOL,579,2,0,1,145,238,386,85,471,0,O-14-76-07-05-01
KAPCHORWA,TINGEY COUNTY,TEGERES,KUTUNG,BUSAL,253,2,1,1,80,118,202,23,225,0,O-14-76-07-05-02
KAPCHORWA,TINGEY COUNTY,TEGERES,KUTUNG,CHELALMOI,292,2,1,1,53,142,199,63,262,0,O-14-76-07-05-03
KAPCHORWA,TINGEY COUNTY,TEGERES,TEGERES,KAPCHEBUT/KAMINY PR SCH,640,4,0,0,82,182,268,92,360,0,O-14-76-07-06-01
KAPCHORWA,TINGEY COUNTY,TEGERES,TUBAN,KAPTUL,369,3,1,1,80,149,234,75,309,0,O-14-76-07-07-01
KAPCHORWA,TINGEY COUNTY,TEGERES,TUBAN,KAPCHELLA,406,1,0,0,84,189,274,87,361,0,O-14-76-07-07-02
KUMI,KUMI COUNTY,ATUTUR,ABUBUR,ABUBUR,836,12,6,15,247,303,583,34,617,0,O-21-97-01-01-01
KUMI,KUMI COUNTY,ATUTUR,AKALABAI,AKALABAI,866,9,8,4,344,210,575,16,591,0,O-21-97-01-02-01
KUMI,KUMI COUNTY,ATUTUR,AKALABAI,TURUS,412,6,2,3,230,76,317,16,333,0,O-21-97-01-02-02
KUMI,KUMI COUNTY,ATUTUR,AKIBUI,AKIBUI,579,6,6,14,267,172,465,29,494,0,O-21-97-01-03-01
KUMI,KUMI COUNTY,ATUTUR,APAPAI,OSWAPAI,763,13,5,14,288,237,557,35,592,0,O-21-97-01-04-01
KUMI,KUMI COUNTY,ATUTUR,APUTON,APUTON,461,7,2,5,258,98,370,16,386,0,O-21-97-01-05-01
KUMI,KUMI COUNTY,ATUTUR,ARIET,ARIET,801,8,7,3,400,198,616,30,646,0,O-21-97-01-06-01
KUMI,KUMI COUNTY,ATUTUR,ATERAI,ATERAI P/S,783,5,2,7,352,179,545,25,570,0,O-21-97-01-07-01
KUMI,KUMI COUNTY,ATUTUR,ATUTUR,ATUTUR,1048,11,5,10,416,237,679,35,714,0,O-21-97-01-08-01
KUMI,KUMI COUNTY,ATUTUR,ATUTUR,ORAPADA-AACUNA,375,8,3,6,140,104,261,29,290,0,O-21-97-01-08-02
KUMI,KUMI COUNTY,ATUTUR,KAPOKINA,KALUNGAR,721,12,6,11,424,88,541,21,562,0,O-21-97-01-09-01
KUMI,KUMI COUNTY,ATUTUR,KAPOKINA,AKULONY,487,9,3,6,216,117,351,10,361,0,O-21-97-01-09-02
KUMI,KUMI COUNTY,ATUTUR,KELIM,KELIM,748,9,4,3,344,188,548,24,572,0,O-21-97-01-10-01
KUMI,KUMI COUNTY,KANYUM,AJUKET,AJUKET,885,10,4,11,547,71,643,41,684,0,O-21-97-02-01-01
KUMI,KUMI COUNTY,KANYUM,AKISIM,AKISIM,473,5,1,7,300,66,379,15,394,0,O-21-97-02-02-01
KUMI,KUMI COUNTY,KANYUM,ARIET,ARIET A [KADENGELE],535,10,2,8,276,90,386,10,396,0,O-21-97-02-03-01
KUMI,KUMI COUNTY,KANYUM,ARIET,ARIET B,560,10,2,3,214,67,296,18,314,0,O-21-97-02-03-02
KUMI,KUMI COUNTY,KANYUM,KACHA,KAALA,525,5,5,1,251,65,327,20,347,0,O-21-97-02-04-01
KUMI,KUMI COUNTY,KANYUM,KAJAMAKA,KAJAMAKA A,794,16,3,3,358,220,600,23,623,0,O-21-97-02-05-01
KUMI,KUMI COUNTY,KANYUM,KAJAMAKA,KAJAMAKA B,335,9,0,1,183,32,225,32,257,0,O-21-97-02-05-02
KUMI,KUMI COUNTY,KANYUM,KAMACHA,KAMACHA,789,8,4,6,307,212,537,35,572,0,O-21-97-02-06-01
KUMI,KUMI COUNTY,KANYUM,KANYUM,KANYUMU,831,14,6,11,425,137,593,31,624,0,O-21-97-02-07-01
KUMI,KUMI COUNTY,KANYUM,KATILEKORI,KATILEKORI,1041,21,13,21,416,221,692,39,731,0,O-21-97-02-08-01
KUMI,KUMI COUNTY,KANYUM,KOGILI,KOGIL [MOSQUE] A,560,8,3,5,255,126,397,15,412,0,O-21-97-02-09-01
KUMI,KUMI COUNTY,KANYUM,OJIE,OJIE,536,11,2,5,305,55,378,29,407,0,O-21-97-02-10-01
KUMI,KUMI COUNTY,KANYUM,OKEITO,OKEITO,486,9,4,9,217,118,357,20,377,0,O-21-97-02-11-01
KUMI,KUMI COUNTY,KANYUM,OKEITO,AUKOT,243,3,4,5,105,43,160,9,169,0,O-21-97-02-11-02
KUMI,KUMI COUNTY,KANYUM,OLIMAI,OLIMAI,779,13,5,9,388,175,590,10,600,0,O-21-97-02-12-01
KUMI,KUMI COUNTY,KANYUM,OLUMOT,OLUMOT,767,11,1,5,401,164,582,16,598,0,O-21-97-02-13-01
KUMI,KUMI COUNTY,KANYUM,OMURANG,OMURANG,807,15,5,15,457,74,566,39,605,0,O-21-97-02-14-01
KUMI,KUMI COUNTY,KUMI,AGOLITOM,AGOLITOM,772,11,2,13,258,271,555,25,580,0,O-21-97-03-01-01
KUMI,KUMI COUNTY,KUMI,AGULE,AGULE,789,13,13,22,297,226,571,23,594,0,O-21-97-03-02-01
KUMI,KUMI COUNTY,KUMI,AMEJEI,AMEJEI,739,6,2,7,442,78,535,38,573,0,O-21-97-03-03-01
KUMI,KUMI COUNTY,KUMI,ASINGE,ASINGE,824,6,2,6,287,270,571,23,594,0,O-21-97-03-04-01
KUMI,KUMI COUNTY,KUMI,KABATA,KABATA,1008,14,7,7,645,72,745,22,767,0,O-21-97-03-05-01
KUMI,KUMI COUNTY,KUMI,KUMI,KUMI,471,7,5,5,152,112,281,29,310,0,O-21-97-03-06-01
KUMI,KUMI COUNTY,KUMI,OKOUBA,OKOUBA 1,335,3,1,4,191,38,237,9,246,0,O-21-97-03-07-01
KUMI,KUMI COUNTY,KUMI,OKOUBA,OKOUBA 2,778,17,5,13,260,203,498,48,546,0,O-21-97-03-07-02
KUMI,KUMI COUNTY,KUMI,OLUNGIA,OLUNGIA,625,8,3,2,312,144,469,27,496,0,O-21-97-03-08-01
KUMI,KUMI COUNTY,KUMI,OLUPE,OLUPE,658,6,4,9,357,62,438,44,482,0,O-21-97-03-09-01
KUMI,KUMI COUNTY,KUMI,OMATENGA,OMATENGA,473,12,1,11,158,204,386,15,401,0,O-21-97-03-10-01
KUMI,KUMI COUNTY,KUMI,OMOLOKONYO,OMULOKONYO,758,15,14,11,375,136,551,29,580,0,O-21-97-03-11-01
KUMI,KUMI COUNTY,KUMI,OOGORIA,OOGORIA,353,8,2,9,122,140,281,15,296,0,O-21-97-03-12-01
KUMI,KUMI COUNTY,KUMI,OTIPE,OTIPE,726,14,12,18,352,110,506,71,577,0,O-21-97-03-13-01
KUMI,KUMI COUNTY,KUMI TC,BAZAAR,BAZAAR,1080,2,10,0,465,223,700,5,705,0,O-21-97-04-01-01
KUMI,KUMI COUNTY,KUMI TC,BAZAAR,ANGOPET,606,2,6,5,234,120,367,14,381,0,O-21-97-04-01-02
KUMI,KUMI COUNTY,KUMI TC,BOMA,BOMA NORTH,646,1,1,4,208,130,344,12,356,0,O-21-97-04-02-01
KUMI,KUMI COUNTY,KUMI TC,BOMA,BOMA SOUTH,333,5,2,5,88,124,224,5,229,0,O-21-97-04-02-02
KUMI,KUMI COUNTY,KUMI TC,KANYUM WARD,KANYUMU A,505,6,2,2,201,72,283,14,297,0,O-21-97-04-03-01
KUMI,KUMI COUNTY,KUMI TC,KANYUM WARD,AGOOS,399,5,1,0,154,80,240,20,260,0,O-21-97-04-03-02
KUMI,KUMI COUNTY,KUMI TC,KANYUM WARD,KANYUMU B,393,2,1,0,191,55,249,8,257,0,O-21-97-04-03-03
KUMI,KUMI COUNTY,KUMI TC,TANK,TANK,685,3,4,1,290,137,435,14,449,0,O-21-97-04-04-01
KUMI,KUMI COUNTY,KUMI TC,TANK,OSIODA,289,1,4,0,110,56,171,12,183,0,O-21-97-04-04-02
KUMI,KUMI COUNTY,MUKONGORO,AGARIA ISLAND,AGARIA,495,1,1,2,320,48,372,9,381,0,O-21-97-05-01-01
KUMI,KUMI COUNTY,MUKONGORO,AKADOT,AKADOT,693,3,2,3,393,100,501,2,503,0,O-21-97-05-02-01
KUMI,KUMI COUNTY,MUKONGORO,KABUKOL,KABUKOL,728,5,0,4,443,124,576,13,589,0,O-21-97-05-03-01
KUMI,KUMI COUNTY,MUKONGORO,KACHOBOI,KACHABOI P/S,624,7,8,5,309,81,410,14,424,0,O-21-97-05-04-01
KUMI,KUMI COUNTY,MUKONGORO,KADAMI,KADAMI,804,4,2,6,514,78,604,27,631,0,O-21-97-05-05-01
KUMI,KUMI COUNTY,MUKONGORO,KADERUN,KADERUN,850,6,5,4,502,73,590,50,640,0,O-21-97-05-06-01
KUMI,KUMI COUNTY,MUKONGORO,KAJAMAKA,KAJAMAKA A,560,9,1,5,324,69,408,8,416,0,O-21-97-05-07-01
KUMI,KUMI COUNTY,MUKONGORO,KAJAMAKA,KAJAMAKA B,292,4,1,3,162,26,196,20,216,0,O-21-97-05-07-02
KUMI,KUMI COUNTY,MUKONGORO,KAKURES,KAKURES A,938,19,5,9,402,177,612,43,655,0,O-21-97-05-08-01
KUMI,KUMI COUNTY,MUKONGORO,KODOKOTO,KANYAMUTAMU,816,15,6,13,364,142,540,41,581,0,O-21-97-05-09-01
KUMI,KUMI COUNTY,MUKONGORO,MUKONGORO,MUKONGORO A,809,6,2,3,292,179,482,18,500,0,O-21-97-05-10-01
KUMI,KUMI COUNTY,MUKONGORO,MUKONGORO,MUKONGORO B,708,7,2,6,312,134,461,21,482,0,O-21-97-05-10-02
KUMI,KUMI COUNTY,MUKONGORO,OGOSOI,OGOSOI,541,9,1,0,347,50,407,28,435,0,O-21-97-05-11-01
KUMI,KUMI COUNTY,MUKONGORO,OLADOT,OLADOT,849,9,4,4,501,133,651,14,665,0,O-21-97-05-12-01
KUMI,KUMI COUNTY,MUKONGORO,OLEICO,OLEICO,682,4,0,3,415,89,511,36,547,0,O-21-97-05-13-01
KUMI,KUMI COUNTY,MUKONGORO,OMEREIN,OMEREIN,860,6,0,10,402,190,608,25,633,0,O-21-97-05-14-01
KUMI,KUMI COUNTY,MUKONGORO,ONYAKELLO,ONYAKELLO,1132,16,5,25,465,250,761,109,870,0,O-21-97-05-15-01
KUMI,KUMI COUNTY,MUKONGORO,OSOPOTOIT,OSOPOTOIT,558,6,2,5,332,88,433,19,452,0,O-21-97-05-16-01
KUMI,KUMI COUNTY,NYERO,AGUURUT,AGUURUT,1144,7,6,8,391,399,811,30,841,0,O-21-97-06-01-01
KUMI,KUMI COUNTY,NYERO,ALIGOI,ALIGOI,705,6,4,5,426,105,546,23,569,0,O-21-97-06-02-01
KUMI,KUMI COUNTY,NYERO,ARIET,ARIET A,630,3,2,8,285,122,420,42,462,0,O-21-97-06-03-01
KUMI,KUMI COUNTY,NYERO,ARIET,ARIET B,738,0,1,2,382,193,578,18,596,0,O-21-97-06-03-02
KUMI,KUMI COUNTY,NYERO,KALAPATA,KALAPATA A,648,8,3,8,386,72,477,24,501,0,O-21-97-06-04-01
KUMI,KUMI COUNTY,NYERO,KALAPATA,KALAPATA B,641,13,4,5,331,41,394,62,456,0,O-21-97-06-04-02
KUMI,KUMI COUNTY,NYERO,KAMENYA,KAMENYA,643,6,1,7,344,138,496,22,518,0,O-21-97-06-05-01
KUMI,KUMI COUNTY,NYERO,KODIKE,KODIKE,840,9,5,5,452,121,592,40,632,0,O-21-97-06-06-01
KUMI,KUMI COUNTY,NYERO,MORUITA,MORUITA,906,16,3,6,475,158,658,41,699,0,O-21-97-06-07-01
KUMI,KUMI COUNTY,NYERO,NYERO,NYERO,1205,9,10,12,634,119,784,55,839,0,O-21-97-06-08-01
KUMI,KUMI COUNTY,NYERO,ODIPAI,ODIPAI,875,20,3,9,432,213,677,23,700,0,O-21-97-06-09-01
KUMI,KUMI COUNTY,NYERO,OGOOMA,OGOOMA,811,10,2,4,407,86,509,23,532,0,O-21-97-06-10-01
KUMI,KUMI COUNTY,ONGINO,AAKUM,AAKUM,343,8,2,7,131,102,250,10,260,0,O-21-97-07-01-01
KUMI,KUMI COUNTY,ONGINO,AAKUM,AKUORO (A-H),540,10,2,12,163,133,320,19,339,0,O-21-97-07-01-02
KUMI,KUMI COUNTY,ONGINO,AAKUM,AKUORO (I-Z),339,3,7,1,111,87,209,17,226,0,O-21-97-07-01-03
KUMI,KUMI COUNTY,ONGINO,AKIDE,AKIDE,710,14,5,7,288,109,423,32,455,0,O-21-97-07-02-01
KUMI,KUMI COUNTY,ONGINO,ASINGE,ASINGE,90,1,0,0,36,20,57,3,60,0,O-21-97-07-03-01
KUMI,KUMI COUNTY,ONGINO,CHEELE,CHEELE,649,12,2,18,259,173,464,24,488,0,O-21-97-07-04-01
KUMI,KUMI COUNTY,ONGINO,KACELAKWENY,KACHALAKWENY,198,7,3,1,92,31,134,25,159,0,O-21-97-07-05-01
KUMI,KUMI COUNTY,ONGINO,KACHABOI,KACHABOI,646,7,3,4,271,182,467,20,487,0,O-21-97-07-06-01
KUMI,KUMI COUNTY,ONGINO,KACHABOI,ATWAMARE,599,6,1,3,178,256,444,16,460,0,O-21-97-07-06-02
KUMI,KUMI COUNTY,ONGINO,KANAPA,KANAPA,742,13,10,9,296,173,501,48,549,0,O-21-97-07-07-01
KUMI,KUMI COUNTY,ONGINO,KAPASAK,KAPASAK A,494,10,2,6,206,121,345,24,369,0,O-21-97-07-08-01
KUMI,KUMI COUNTY,ONGINO,KAPASAK,KAPASAK B,275,1,2,2,100,69,174,15,189,0,O-21-97-07-08-02
KUMI,KUMI COUNTY,ONGINO,KAPOLIN,KAJAMAKA,456,9,1,6,261,66,343,27,370,0,O-21-97-07-09-01
KUMI,KUMI COUNTY,ONGINO,KODUKULU,KODUKULU,526,8,6,2,256,101,373,8,381,0,O-21-97-07-10-01
KUMI,KUMI COUNTY,ONGINO,KONGURA,KONGURA,621,11,2,9,328,95,445,29,474,0,O-21-97-07-11-01
KUMI,KUMI COUNTY,ONGINO,MORUPEDED,MORUPEDED,469,6,4,10,226,118,364,11,375,0,O-21-97-07-12-01
KUMI,KUMI COUNTY,ONGINO,OBOTIA,OBOTIA A,211,5,1,5,76,59,146,9,155,0,O-21-97-07-13-01
KUMI,KUMI COUNTY,ONGINO,OBOTIA,OBOTIA B,507,16,3,9,211,114,353,16,369,0,O-21-97-07-13-02
KUMI,KUMI COUNTY,ONGINO,ONGINO,ONGINO,803,9,1,7,365,171,553,46,599,0,O-21-97-07-14-01
KUMI,KUMI COUNTY,ONGINO,OSEERA,OSEERA,687,7,4,10,243,204,468,17,485,0,O-21-97-07-15-01
KUMI,KUMI COUNTY,ONGINO,OSEERA,AADUKA,520,5,3,7,153,220,388,17,405,0,O-21-97-07-15-02
KUMI,KUMI COUNTY,ONGINO,TISAI ISLAND,TISAI,153,2,1,0,45,44,92,5,97,0,O-21-97-07-16-01
MBALE,BUNGOKHO CTY NORTH,BUFUMBO,BUBYANGU,BUKWAGA T.C. A,401,0,0,2,179,73,254,7,261,0,O-26-131-01-01-01
MBALE,BUNGOKHO CTY NORTH,BUFUMBO,BUBYANGU,WAMBEWO T.C,526,0,0,0,0,0,0,0,0,1,O-26-131-01-01-02
MBALE,BUNGOKHO CTY NORTH,BUFUMBO,BUBYANGU,BUSIKOSO P/S,600,1,1,1,279,318,600,0,600,0,O-26-131-01-01-03
MBALE,BUNGOKHO CTY NORTH,BUFUMBO,BUBYANGU,BUNABIGUBO G.C.S,611,1,2,4,396,201,604,0,604,0,O-26-131-01-01-04
MBALE,BUNGOKHO CTY NORTH,BUFUMBO,BUBYANGU,MABALAGAYE,434,2,1,1,269,128,401,11,412,0,O-26-131-01-01-05
MBALE,BUNGOKHO CTY NORTH,BUFUMBO,BUBYANGU,IMAM HUSSEIN P/S,866,5,1,1,314,117,438,6,444,0,O-26-131-01-01-06
MBALE,BUNGOKHO CTY NORTH,BUFUMBO,BUBYANGU,LWASINZI T/C,183,5,1,3,120,45,174,5,179,0,O-26-131-01-01-07
MBALE,BUNGOKHO CTY NORTH,BUFUMBO,BUBYANGU,NABIBI T/C,428,0,0,1,183,240,424,4,428,0,O-26-131-01-01-08
MBALE,BUNGOKHO CTY NORTH,BUFUMBO,BUMADANDA,BUBYANGU P/S,581,2,0,1,205,104,312,0,312,0,O-26-131-01-02-01
MBALE,BUNGOKHO CTY NORTH,BUFUMBO,BUMADANDA,LUSEMENTA T.C,309,2,1,3,128,124,258,2,260,0,O-26-131-01-02-02
MBALE,BUNGOKHO CTY NORTH,BUFUMBO,BUMADANDA,BUMADANDA P/S,418,1,5,1,156,199,362,15,377,0,O-26-131-01-02-03
MBALE,BUNGOKHO CTY NORTH,BUFUMBO,BUMADANDA,MACHESE,477,4,1,6,278,137,426,24,450,0,O-26-131-01-02-04
MBALE,BUNGOKHO CTY NORTH,BUFUMBO,JEWA,BUFUMBO S/C HQTRS,789,8,6,5,427,333,779,10,789,0,O-26-131-01-03-01
MBALE,BUNGOKHO CTY NORTH,BUFUMBO,JEWA,JEWA T/C,575,2,3,4,319,247,575,0,575,0,O-26-131-01-03-02
MBALE,BUNGOKHO CTY NORTH,BUFUMBO,JEWA,JEWA PR. SCH.,393,3,1,3,266,113,386,7,393,0,O-26-131-01-03-03
MBALE,BUNGOKHO CTY NORTH,BUFUMBO,JEWA,NKUNSI PR. SCH.,646,3,3,4,393,225,628,16,644,0,O-26-131-01-03-04
MBALE,BUNGOKHO CTY NORTH,BUFUMBO,JEWA,NALUWERERE,515,3,0,0,313,179,495,18,513,0,O-26-131-01-03-05
MBALE,BUNGOKHO CTY NORTH,BUFUMBO,KAMA,BUZALANGIZO,375,1,0,2,181,108,292,3,295,0,O-26-131-01-04-01
MBALE,BUNGOKHO CTY NORTH,BUFUMBO,KAMA,KAMA G.C.S,554,3,0,6,179,163,351,6,357,0,O-26-131-01-04-02
MBALE,BUNGOKHO CTY NORTH,BUFUMBO,KAMA,KAMA PRIMARY SCH,784,2,3,3,219,197,424,8,432,0,O-26-131-01-04-03
MBALE,BUNGOKHO CTY NORTH,BUKONDE,BULWETA,MUSOLA T.C.,529,2,4,1,195,142,344,12,356,0,O-26-131-02-01-01
MBALE,BUNGOKHO CTY NORTH,BUKONDE,BULWETA,BULWETA PR. SCH A,647,3,10,4,242,183,442,0,442,0,O-26-131-02-01-02
MBALE,BUNGOKHO CTY NORTH,BUKONDE,BULWETA,MAHALWE T/C,343,2,3,1,154,147,307,2,309,0,O-26-131-02-01-03
MBALE,BUNGOKHO CTY NORTH,BUKONDE,BULWETA,BUKONDE S.S,755,1,5,1,282,245,534,15,549,0,O-26-131-02-01-04
MBALE,BUNGOKHO CTY NORTH,BUKONDE,BULWETA,BUWAMWANGU PR. SCH B,396,0,0,1,156,154,311,5,316,0,O-26-131-02-01-05
MBALE,BUNGOKHO CTY NORTH,BUKONDE,BULWETA,BUMALUNDA P/S,301,2,3,0,144,94,243,8,251,0,O-26-131-02-01-06
MBALE,BUNGOKHO CTY NORTH,BUKONDE,BUMULUYA,IKOKO T/C,465,3,1,0,294,133,431,12,443,0,O-26-131-02-02-01
MBALE,BUNGOKHO CTY NORTH,BUKONDE,BUMULUYA,MAKOSI T/C,352,2,1,0,142,99,244,6,250,0,O-26-131-02-02-02
MBALE,BUNGOKHO CTY NORTH,BUKONDE,BUMULUYA,MITUMBA T.C.,518,1,1,2,225,98,327,12,339,0,O-26-131-02-02-03
MBALE,BUNGOKHO CTY NORTH,BUKONDE,BUMULUYA,BUFUMBO DISP.,732,4,0,4,315,172,495,9,504,0,O-26-131-02-02-04
MBALE,BUNGOKHO CTY NORTH,BUKONDE,BUMULUYA,WADAMUKA STAGE,441,0,1,1,274,113,389,8,397,0,O-26-131-02-02-05
MBALE,BUNGOKHO CTY NORTH,BUKONDE,BUMULUYA,BUMULUYA PR. SCHOOL,495,1,0,4,204,128,337,11,348,0,O-26-131-02-02-06
MBALE,BUNGOKHO CTY NORTH,BUKONDE,LWASO,LWASO GCS,881,5,1,3,303,230,542,23,565,0,O-26-131-02-03-01
MBALE,BUNGOKHO CTY NORTH,BUKONDE,LWASO,KIKUYU TC,670,8,2,4,203,177,394,25,419,0,O-26-131-02-03-02
MBALE,BUNGOKHO CTY NORTH,BUKONDE,LWASO,MAGADA PR/SCH,599,1,2,1,178,168,350,17,367,0,O-26-131-02-03-03
MBALE,BUNGOKHO CTY NORTH,BUKONDE,LWASO,KATEL T/C,352,1,1,1,165,105,273,4,277,0,O-26-131-02-03-04
MBALE,BUNGOKHO CTY NORTH,BUKONDE,LWASO,MITUBA T/C,422,4,1,1,142,187,335,5,340,0,O-26-131-02-03-05
MBALE,BUNGOKHO CTY NORTH,NAKALOKE,KIREKA,KADEBEDE T/C,223,0,0,0,0,0,0,0,0,1,O-26-131-03-01-01
MBALE,BUNGOKHO CTY NORTH,NAKALOKE,KIREKA,KIREKA CENTRAL,695,5,4,5,199,215,428,1,429,0,O-26-131-03-01-02
MBALE,BUNGOKHO CTY NORTH,NAKALOKE,KIREKA,KIREKA MILE SIX,479,2,1,2,239,126,370,14,384,0,O-26-131-03-01-03
MBALE,BUNGOKHO CTY NORTH,NAKALOKE,KIREKA,KIREKA MILE SIX MOSQUE,352,2,0,2,110,77,191,0,191,0,O-26-131-03-01-04
MBALE,BUNGOKHO CTY NORTH,NAKALOKE,NAKALOKE,NAKALOKE T.C,928,4,2,1,303,170,480,22,502,0,O-26-131-03-02-01
MBALE,BUNGOKHO CTY NORTH,NAKALOKE,NAKALOKE,NANDALA T/C,434,1,1,1,125,132,260,8,268,0,O-26-131-03-02-02
MBALE,BUNGOKHO CTY NORTH,NAKALOKE,NAKALOKE,NAKALOKE S/C HQRS,1117,4,1,1,291,228,525,9,534,0,O-26-131-03-02-03
MBALE,BUNGOKHO CTY NORTH,NAKALOKE,NAKALOKE,KOLONYI PR. SCH. I,622,4,1,2,142,187,336,44,380,0,O-26-131-03-02-04
MBALE,BUNGOKHO CTY NORTH,NAKALOKE,NAKALOKE,KOLONYI PR SCH II,358,3,1,2,68,121,195,8,203,0,O-26-131-03-02-05
MBALE,BUNGOKHO CTY NORTH,NAKALOKE,NAKALOKE,BWANA CHURCH B,641,4,5,10,190,239,448,0,448,0,O-26-131-03-02-06
MBALE,BUNGOKHO CTY NORTH,NAKALOKE,NAKALOKE,WAIMBYA,436,2,2,1,147,145,297,18,315,0,O-26-131-03-02-07
MBALE,BUNGOKHO CTY NORTH,NAKALOKE,NAKALOKE,HAJJI NKOKO MOSQUE,536,1,0,1,131,128,261,11,272,0,O-26-131-03-02-08
MBALE,BUNGOKHO CTY NORTH,NAKALOKE,NAMABASA,NAMUNSI CORNER GROUND I,715,6,0,1,212,182,401,3,404,0,O-26-131-03-03-01
MBALE,BUNGOKHO CTY NORTH,NAKALOKE,NAMABASA,NAMUNSI CORNER GROUND II,589,1,1,2,152,162,318,14,332,0,O-26-131-03-03-02
MBALE,BUNGOKHO CTY NORTH,NAKALOKE,NAMABASA,WAZEMBA PR. SCH. A,711,4,1,3,153,163,324,17,341,0,O-26-131-03-03-03
MBALE,BUNGOKHO CTY NORTH,NAKALOKE,NAMABASA,BUSAJJA BWANKUBA PR SCHOOL,675,0,1,4,238,167,410,7,417,0,O-26-131-03-03-04
MBALE,BUNGOKHO CTY NORTH,NAKALOKE,NAMABASA,NAMABASA T/C,471,3,3,0,118,137,261,21,282,0,O-26-131-03-03-05
MBALE,BUNGOKHO CTY NORTH,NAKALOKE,NAMABASA,DOKO MOSQUE,434,1,0,0,149,128,278,18,296,0,O-26-131-03-03-06
MBALE,BUNGOKHO CTY NORTH,NAKALOKE,NAMABASA,NAMUNSI CORNER GROUND III,752,2,0,2,180,134,318,30,348,0,O-26-131-03-03-07
MBALE,BUNGOKHO CTY NORTH,NAKALOKE,NAMABASA,SIRAJI MUNIRU MOSQUE,500,2,1,2,122,130,257,19,276,0,O-26-131-03-03-08
MBALE,BUNGOKHO CTY NORTH,NAKALOKE,NAMUNSI,DOKO KASANJA,528,0,3,4,195,138,340,23,363,0,O-26-131-03-04-01
MBALE,BUNGOKHO CTY NORTH,NAKALOKE,NAMUNSI,NAMUNSI PR SCH A,436,1,0,0,60,58,119,3,122,0,O-26-131-03-04-02
MBALE,BUNGOKHO CTY NORTH,NAKALOKE,NAMUNSI,NAMUNSI PR SCH B,628,1,3,2,223,135,364,13,377,0,O-26-131-03-04-03
MBALE,BUNGOKHO CTY NORTH,NAKALOKE,NAMUNSI,DOKO KASANJO B,386,3,2,0,127,115,247,11,258,0,O-26-131-03-04-04
MBALE,BUNGOKHO CTY NORTH,NAKALOKE,NAMUNSI,NAMUNSI PR SCH C,391,2,2,0,139,82,225,5,230,0,O-26-131-03-04-05
MBALE,BUNGOKHO CTY NORTH,NAKALOKE,NAMUNSI,NAMBULU T/C,601,2,2,2,206,161,373,5,378,0,O-26-131-03-04-06
MBALE,BUNGOKHO CTY NORTH,NAMANYONYI,AISA,UTC ELGON,452,1,2,3,81,118,205,4,209,0,O-26-131-04-01-01
MBALE,BUNGOKHO CTY NORTH,NAMANYONYI,AISA,MADARASA PR SCH,495,2,0,5,180,154,341,0,341,0,O-26-131-04-01-02
MBALE,BUNGOKHO CTY NORTH,NAMANYONYI,AISA,MBIKO TC,777,2,5,5,173,249,434,0,434,0,O-26-131-04-01-03
MBALE,BUNGOKHO CTY NORTH,NAMANYONYI,AISA,LUBEMBE P/S,511,3,4,5,52,266,330,12,342,0,O-26-131-04-01-04
MBALE,BUNGOKHO CTY NORTH,NAMANYONYI,AISA,MASANDA MOSQUE,277,1,1,1,107,79,189,8,197,0,O-26-131-04-01-05
MBALE,BUNGOKHO CTY NORTH,NAMANYONYI,NABWEYA,MAKUDUI,537,1,1,4,191,118,315,13,328,0,O-26-131-04-02-01
MBALE,BUNGOKHO CTY NORTH,NAMANYONYI,NABWEYA,KILULU,738,2,2,0,254,184,442,8,450,0,O-26-131-04-02-02
MBALE,BUNGOKHO CTY NORTH,NAMANYONYI,NABWEYA,NABUGOYA,520,1,0,1,191,111,304,4,308,0,O-26-131-04-02-03
MBALE,BUNGOKHO CTY NORTH,NAMANYONYI,NABWEYA,NANKOBE T.C,317,0,1,1,109,97,208,6,214,0,O-26-131-04-02-04
MBALE,BUNGOKHO CTY NORTH,NAMANYONYI,NABWEYA,NABWEYA TOP H/CENTRE,260,1,2,3,88,83,177,3,180,0,O-26-131-04-02-05
MBALE,BUNGOKHO CTY NORTH,NAMANYONYI,NABWEYA,KASANVU T.C,227,1,0,0,95,70,166,0,166,0,O-26-131-04-02-06
MBALE,BUNGOKHO CTY NORTH,NAMANYONYI,NAMAGUMBA,NAMENGO CATH CHURCH,492,2,0,3,159,156,320,14,334,0,O-26-131-04-03-01
MBALE,BUNGOKHO CTY NORTH,NAMANYONYI,NAMAGUMBA,NAMAGUMBA TC I,616,1,1,3,189,147,341,6,347,0,O-26-131-04-03-02
MBALE,BUNGOKHO CTY NORTH,NAMANYONYI,NAMAGUMBA,NAMAGUMBA TC II,322,1,0,1,91,94,187,3,190,0,O-26-131-04-03-03
MBALE,BUNGOKHO CTY NORTH,NAMANYONYI,NAMAGUMBA,NAMAGUMBA PR SCH,531,1,0,6,146,170,323,13,336,0,O-26-131-04-03-04
MBALE,BUNGOKHO CTY NORTH,NAMANYONYI,NKOMA,NAMANYONYI T.C.,543,1,3,4,175,166,349,17,366,0,O-26-131-04-04-01
MBALE,BUNGOKHO CTY NORTH,NAMANYONYI,NKOMA,KANIKWA CENTRE,448,1,1,1,147,98,248,8,256,0,O-26-131-04-04-02
MBALE,BUNGOKHO CTY NORTH,NAMANYONYI,NKOMA,NKOMA CENTRE,424,2,1,4,118,166,291,10,301,0,O-26-131-04-04-03
MBALE,BUNGOKHO CTY NORTH,NAMANYONYI,NKOMA,NANSU C.O.U,415,1,1,0,123,152,277,0,277,0,O-26-131-04-04-04
MBALE,BUNGOKHO CTY NORTH,NAMANYONYI,NKOMA,NDEGA P/S,284,2,0,1,196,55,254,4,258,0,O-26-131-04-04-05
MBALE,BUNGOKHO CTY NORTH,NAMANYONYI,NKOMA,NABUNYIRI,589,2,1,1,171,184,359,18,377,0,O-26-131-04-04-06
MBALE,BUNGOKHO CTY NORTH,WANALE,BUBETSYE,NABULWA T.C.,715,4,1,5,162,322,494,14,508,0,O-26-131-05-01-01
MBALE,BUNGOKHO CTY NORTH,WANALE,BUBETSYE,BUKHOBA PR. SCH (A-M),312,2,0,0,81,201,284,0,284,0,O-26-131-05-01-02
MBALE,BUNGOKHO CTY NORTH,WANALE,BUBETSYE,BUKHOBA T.C,766,2,2,6,106,340,456,21,477,0,O-26-131-05-01-03
MBALE,BUNGOKHO CTY NORTH,WANALE,BUBETSYE,BUNABWIRE P/S,383,3,3,2,78,248,334,6,340,0,O-26-131-05-01-04
MBALE,BUNGOKHO CTY NORTH,WANALE,BUDWALE,BUKINGALA PR SCH,694,4,2,0,155,485,646,32,678,0,O-26-131-05-02-01
MBALE,BUNGOKHO CTY NORTH,WANALE,BUDWALE,BUDWALE PR. SCH.,595,2,1,1,157,323,484,16,500,0,O-26-131-05-02-02
MBALE,BUNGOKHO CTY NORTH,WANALE,BUDWALE,BORDER T.C.,393,1,0,1,173,90,265,8,273,0,O-26-131-05-02-03
MBALE,BUNGOKHO CTY NORTH,WANALE,BUDWALE,WADADA T/C,366,0,0,0,0,0,0,0,0,1,O-26-131-05-02-04
MBALE,BUNGOKHO CTY NORTH,WANALE,BUDWALE,NTUMBI CENTRE,224,3,0,2,59,128,192,3,195,0,O-26-131-05-02-05
MBALE,BUNGOKHO CTY NORTH,WANALE,BUDWALE,MISI T/C,518,0,0,0,168,133,301,4,305,0,O-26-131-05-02-06
MBALE,BUNGOKHO CTY NORTH,WANALE,BUSHIWUYO,BUBENTSYE PR. SCH,468,1,1,0,142,168,312,0,312,0,O-26-131-05-03-01
MBALE,BUNGOKHO CTY NORTH,WANALE,BUSHIWUYO,BUNAWIRE PR/SCH,512,5,1,5,156,218,385,0,385,0,O-26-131-05-03-02
MBALE,BUNGOKHO CTY NORTH,WANALE,BUSHIWUYO,BUKIWUYU PR.SCH,866,0,0,4,273,201,478,19,497,0,O-26-131-05-03-03
MBALE,BUNGOKHO CTY SOUTH,BUKHIENDE,BUMUTSOPA,WAPONDO T/C,136,1,0,2,17,101,121,4,125,0,O-26-132-01-01-01
MBALE,BUNGOKHO CTY SOUTH,BUKHIENDE,BUMUTSOPA,BUTSESOOLI GCS,890,6,1,5,197,375,584,37,621,0,O-26-132-01-01-02
MBALE,BUNGOKHO CTY SOUTH,BUKHIENDE,BUMUTSOPA,BUKHAKOSI PRI. SCHOOL,506,2,1,3,138,189,333,24,357,0,O-26-132-01-01-03
MBALE,BUNGOKHO CTY SOUTH,BUKHIENDE,BUNASHIMOLO,MULATSI PR. SCH. A,314,0,3,0,102,115,220,14,234,0,O-26-132-01-02-01
MBALE,BUNGOKHO CTY SOUTH,BUKHIENDE,BUNASHIMOLO,MULATSI PR. SCH. B,536,2,0,2,129,231,364,33,397,0,O-26-132-01-02-02
MBALE,BUNGOKHO CTY SOUTH,BUKHIENDE,BUNASHIMOLO,MASABA CLUB,646,4,3,1,211,234,453,13,466,0,O-26-132-01-02-03
MBALE,BUNGOKHO CTY SOUTH,BUKHIENDE,BUNASHIMOLO,BUNASHIMOLO CLUB A,446,4,1,7,154,156,322,31,353,0,O-26-132-01-02-04
MBALE,BUNGOKHO CTY SOUTH,BUKHIENDE,BUNASHIMOLO,BUNASHIMOLO CLUB B,305,1,0,0,94,108,203,6,209,0,O-26-132-01-02-05
MBALE,BUNGOKHO CTY SOUTH,BUKHIENDE,BUNASHIMOLO,BUMAENA T/C,542,2,3,3,189,184,381,17,398,0,O-26-132-01-02-06
MBALE,BUNGOKHO CTY SOUTH,BUKHIENDE,BUNASHIMOLO,POSTA,281,0,1,2,68,133,204,6,210,0,O-26-132-01-02-07
MBALE,BUNGOKHO CTY SOUTH,BUKHIENDE,BURUKURU,TUBEYI PR. SCH.,568,4,1,1,161,178,345,21,366,0,O-26-132-01-03-01
MBALE,BUNGOKHO CTY SOUTH,BUKHIENDE,BURUKURU,BURUKURU PR. SCH. A,895,1,4,3,306,301,615,22,637,0,O-26-132-01-03-02
MBALE,BUNGOKHO CTY SOUTH,BUKHIENDE,BURUKURU,BURUKURU PR. SCH. B,896,3,2,9,233,220,467,27,494,0,O-26-132-01-03-03
MBALE,BUNGOKHO CTY SOUTH,BUKHIENDE,BURUKURU,BUYAKA T/C,410,3,2,1,155,112,273,17,290,0,O-26-132-01-03-04
MBALE,BUNGOKHO CTY SOUTH,BUKHIENDE,LUKHONGE,LUKHONGE GINNERY,337,2,0,2,101,146,251,24,275,0,O-26-132-01-04-01
MBALE,BUNGOKHO CTY SOUTH,BUKHIENDE,LUKHONGE,NABWEYE PR. SCH.,469,2,1,2,77,321,403,6,409,0,O-26-132-01-04-02
MBALE,BUNGOKHO CTY SOUTH,BUKHIENDE,LUKHONGE,NAMBWA PR. SCH.,509,1,0,1,95,259,356,32,388,0,O-26-132-01-04-03
MBALE,BUNGOKHO CTY SOUTH,BUKHIENDE,NAMAWANGA,NAMAWANGA GCS A,895,2,0,2,163,410,577,27,604,0,O-26-132-01-05-01
MBALE,BUNGOKHO CTY SOUTH,BUKHIENDE,NAMAWANGA,NAMAWANGA GCS B,292,0,0,0,56,158,214,11,225,0,O-26-132-01-05-02
MBALE,BUNGOKHO CTY SOUTH,BUKHIENDE,NAMAWANGA,WANINDA,452,2,0,0,88,224,314,20,334,0,O-26-132-01-05-03
MBALE,BUNGOKHO CTY SOUTH,BUNGOKHO,BUBIRABI,LWALERA,527,4,2,3,125,194,328,38,366,0,O-26-132-02-01-01
MBALE,BUNGOKHO CTY SOUTH,BUNGOKHO,BUBIRABI,NAKALAPA,677,7,0,6,96,381,490,3,493,0,O-26-132-02-01-02
MBALE,BUNGOKHO CTY SOUTH,BUNGOKHO,BUBIRABI,NATONDOME,732,1,2,4,156,324,487,20,507,0,O-26-132-02-01-03
MBALE,BUNGOKHO CTY SOUTH,BUNGOKHO,BUBIRABI,NASHIKHASO,908,3,4,3,232,370,612,13,625,0,O-26-132-02-01-04
MBALE,BUNGOKHO CTY SOUTH,BUNGOKHO,BUBIRABI,SAKIYA T/C,205,0,0,0,42,105,147,13,160,0,O-26-132-02-01-05
MBALE,BUNGOKHO CTY SOUTH,BUNGOKHO,BUBIRABI,NAMBALE T/C,235,0,0,2,46,129,177,8,185,0,O-26-132-02-01-06
MBALE,BUNGOKHO CTY SOUTH,BUNGOKHO,BUBIRABI,BUSHIKORI P/S,323,1,0,1,64,158,224,14,238,0,O-26-132-02-01-07
MBALE,BUNGOKHO CTY SOUTH,BUNGOKHO,BUKHUMWA,BUKHUMWA PR.SCH.,737,4,1,1,90,432,528,25,553,0,O-26-132-02-02-01
MBALE,BUNGOKHO CTY SOUTH,BUNGOKHO,BUKHUMWA,NAIKU PR SCH A,669,3,2,1,104,391,501,13,514,0,O-26-132-02-02-02
MBALE,BUNGOKHO CTY SOUTH,BUNGOKHO,BUKHUMWA,NASYERA PR. SCH. A,663,6,1,5,160,296,468,20,488,0,O-26-132-02-02-03
MBALE,BUNGOKHO CTY SOUTH,BUNGOKHO,BUKHUMWA,SIIRA HEALTH CENTRE,292,1,0,3,65,155,224,5,229,0,O-26-132-02-02-04
MBALE,BUNGOKHO CTY SOUTH,BUNGOKHO,BUMAGENI,BUWALULA G.C.S.,471,3,3,3,146,162,317,15,332,0,O-26-132-02-03-01
MBALE,BUNGOKHO CTY SOUTH,BUNGOKHO,BUMAGENI,NAMUKONGO,650,4,4,3,135,258,404,16,420,0,O-26-132-02-03-02
MBALE,BUNGOKHO CTY SOUTH,BUNGOKHO,BUMAGENI,NAMATSALE GCS,630,3,0,0,114,298,415,36,451,0,O-26-132-02-03-03
MBALE,BUNGOKHO CTY SOUTH,BUNGOKHO,BUMAGENI,NOOR ISLAMIC INST,424,2,0,0,73,157,232,3,235,0,O-26-132-02-03-04
MBALE,BUNGOKHO CTY SOUTH,BUNGOKHO,BUMAGENI,LWAMBOGO GCS,561,5,1,5,138,254,403,22,425,0,O-26-132-02-03-05
MBALE,BUNGOKHO CTY SOUTH,BUNGOKHO,BUMAGENI,KHAMOTO GCS,618,12,2,3,135,314,466,26,492,0,O-26-132-02-03-06
MBALE,BUNGOKHO CTY SOUTH,BUNGOKHO,BUMAGENI,NAMUKONGO CENTRE,197,0,1,2,53,85,141,16,157,0,O-26-132-02-03-07
MBALE,BUNGOKHO CTY SOUTH,BUNGOKHO,BUMAGENI,MANYONYI,384,1,4,1,65,157,228,10,238,0,O-26-132-02-03-08
MBALE,BUNGOKHO CTY SOUTH,BUNGOKHO,BUMAGENI,WAMBEWO T/C,240,3,1,3,47,114,168,14,182,0,O-26-132-02-03-09
MBALE,BUNGOKHO CTY SOUTH,BUNGOKHO,BUMAGENI,BUMAGENI (OUTSIDE Q.GUARD),947,0,0,0,67,227,294,8,302,0,O-26-132-02-03-10
MBALE,BUNGOKHO CTY SOUTH,BUNGOKHO,BUMAGENI,BUMAGENI (OUTSIDE Q.GUARD) B,513,0,0,0,53,211,264,3,267,0,O-26-132-02-03-11
MBALE,BUNGOKHO CTY SOUTH,BUNGOKHO,BUMBOBI,NAIKU PR. SCH. B,662,2,2,0,143,321,468,12,480,0,O-26-132-02-04-01
MBALE,BUNGOKHO CTY SOUTH,BUNGOKHO,BUMBOBI,NASYERA PR. SCH. B,691,6,2,3,170,327,508,23,531,0,O-26-132-02-04-02
MBALE,BUNGOKHO CTY SOUTH,BUNGOKHO,BUMBOBI,BUMBOBI PR. SCHOOL B,520,3,1,4,106,219,333,37,370,0,O-26-132-02-04-03
MBALE,BUNGOKHO CTY SOUTH,BUNGOKHO,BUMBOBI,BUMBOBI PR. SCHOOL A,598,5,1,2,217,166,391,15,406,0,O-26-132-02-04-04
MBALE,BUNGOKHO CTY SOUTH,BUNGOKHO,BUMBOBI,BUKHUMEKA T/C,369,1,1,0,123,160,285,17,302,0,O-26-132-02-04-05
MBALE,BUNGOKHO CTY SOUTH,BUSANO,BUSANO,BUFOOTO PR. SCHOOL,449,6,2,1,133,179,321,0,321,0,O-26-132-03-01-01
MBALE,BUNGOKHO CTY SOUTH,BUSANO,BUSANO,BUTSONGOLA PR. SCH.,596,1,1,1,163,243,409,6,415,0,O-26-132-03-01-02
MBALE,BUNGOKHO CTY SOUTH,BUSANO,BUSANO,BUKHANAKWA PR. SCH.,321,4,0,1,114,117,236,12,248,0,O-26-132-03-01-03
MBALE,BUNGOKHO CTY SOUTH,BUSANO,BUSANO,BUWANGWA P/S,393,2,2,2,118,161,285,8,293,0,O-26-132-03-01-04
MBALE,BUNGOKHO CTY SOUTH,BUSANO,BUSANO,MABALE T/C,432,2,0,2,211,105,320,12,332,0,O-26-132-03-01-05
MBALE,BUNGOKHO CTY SOUTH,BUSANO,BUYAKA,BUSANO DISP A,855,3,2,5,165,339,514,15,529,0,O-26-132-03-02-01
MBALE,BUNGOKHO CTY SOUTH,BUSANO,BUYAKA,BUSABULO P/SCH,448,2,1,4,121,171,299,21,320,0,O-26-132-03-02-02
MBALE,BUNGOKHO CTY SOUTH,BUSANO,BUYAKA,MUSOOLA T.C.,492,4,2,3,118,212,339,20,359,0,O-26-132-03-02-03
MBALE,BUNGOKHO CTY SOUTH,BUSIU,BUFUKHULA,BUSIU T.C.,570,2,9,1,190,161,363,6,369,0,O-26-132-04-01-01
MBALE,BUNGOKHO CTY SOUTH,BUSIU,BUFUKHULA,BUSIU S/C HQRS,643,7,1,0,117,233,358,99,457,0,O-26-132-04-01-02
MBALE,BUNGOKHO CTY SOUTH,BUSIU,BUFUKHULA,BULUSAMBO CATH.,317,3,2,1,78,118,202,4,206,0,O-26-132-04-01-03
MBALE,BUNGOKHO CTY SOUTH,BUSIU,BUFUKHULA,BUNANIMI CLUB,476,1,3,2,91,198,295,16,311,0,O-26-132-04-01-04
MBALE,BUNGOKHO CTY SOUTH,BUSIU,BUFUKHULA,MAKHONJE PR. SCH.,656,6,0,5,226,258,495,15,510,0,O-26-132-04-01-05
MBALE,BUNGOKHO CTY SOUTH,BUSIU,BUFUKHULA,MUNGOLO CENTRE,638,8,0,1,96,360,465,18,483,0,O-26-132-04-01-06
MBALE,BUNGOKHO CTY SOUTH,BUSIU,BUFUKHULA,BUWALASI C.O.U,383,0,2,1,99,174,276,7,283,0,O-26-132-04-01-07
MBALE,BUNGOKHO CTY SOUTH,BUSIU,BUFUKHULA,WAALE C.O.U,515,4,3,1,118,239,365,17,382,0,O-26-132-04-01-08
MBALE,BUNGOKHO CTY SOUTH,BUSIU,BUFUKHULA,NAMAKYE P/S,367,2,1,3,121,142,269,9,278,0,O-26-132-04-01-09
MBALE,BUNGOKHO CTY SOUTH,BUSIU,BUMASIKYE,BUKHAMUNYU PR/SCHOOL,549,4,2,1,179,193,379,10,389,0,O-26-132-04-02-01
MBALE,BUNGOKHO CTY SOUTH,BUSIU,BUMASIKYE,NAMWENULA PR/SCHOOL,743,4,4,4,198,327,537,13,550,0,O-26-132-04-02-02
MBALE,BUNGOKHO CTY SOUTH,BUSIU,BUMASIKYE,MAKUNDA PR. SCH.,463,2,1,1,76,243,323,9,332,0,O-26-132-04-02-03
MBALE,BUNGOKHO CTY SOUTH,BUSIU,BUMASIKYE,BUMASIKYE PR. SCH.,623,2,9,3,263,159,436,14,450,0,O-26-132-04-02-04
MBALE,BUNGOKHO CTY SOUTH,BUSIU,BUMASIKYE,WOKUKIRI PR. SCH.,420,1,1,2,130,129,263,19,282,0,O-26-132-04-02-05
MBALE,BUNGOKHO CTY SOUTH,BUSIU,BUMASIKYE,KIMWANGA MARKET,495,4,4,3,178,160,349,12,361,0,O-26-132-04-02-06
MBALE,BUNGOKHO CTY SOUTH,BUSIU,BUMASIKYE,NANGIRIMA APOSTOLIC CHURCH,327,2,1,1,148,66,218,13,231,0,O-26-132-04-02-07
MBALE,BUNGOKHO CTY SOUTH,BUSIU,BUMASIKYE,RAASA T/C,451,3,1,2,122,180,308,19,327,0,O-26-132-04-02-08
MBALE,BUNGOKHO CTY SOUTH,BUSIU,BUNAMBUTYE,LAMBO,691,2,4,1,168,296,471,17,488,0,O-26-132-04-03-01
MBALE,BUNGOKHO CTY SOUTH,BUSIU,BUNAMBUTYE,BUNAMBUTYE PR/SCH,550,4,5,3,178,189,379,20,399,0,O-26-132-04-03-02
MBALE,BUNGOKHO CTY SOUTH,BUSIU,BUNAMBUTYE,MUSESE PRIMARY SCHOOL A-N,397,3,2,2,108,195,310,10,320,0,O-26-132-04-03-03
MBALE,BUNGOKHO CTY SOUTH,BUSIU,BUNAMBUTYE,ANGALIA SOCIAL CENTRE,464,0,2,0,91,248,341,32,373,0,O-26-132-04-03-04
MBALE,BUNGOKHO CTY SOUTH,BUSIU,BUNAMBUTYE,MUSESE PRIMARY SCHOOL N-Z,386,2,2,0,73,116,193,16,209,0,O-26-132-04-03-05
MBALE,BUNGOKHO CTY SOUTH,BUSOBA,BUMASIKYE,MAAHANGA/NABUMALI BDG. PR. S,632,4,1,0,172,224,401,9,410,0,O-26-132-05-01-01
MBALE,BUNGOKHO CTY SOUTH,BUSOBA,BUMASIKYE,MAAHANGA/NABUMALI BDG PR S,141,2,1,0,50,43,96,2,98,0,O-26-132-05-01-02
MBALE,BUNGOKHO CTY SOUTH,BUSOBA,BUMASIKYE,MURUBA T/C,569,2,3,2,86,281,374,9,383,0,O-26-132-05-01-03
MBALE,BUNGOKHO CTY SOUTH,BUSOBA,BUMASIKYE,MAAKO A,335,3,0,1,80,133,217,21,238,0,O-26-132-05-01-04
MBALE,BUNGOKHO CTY SOUTH,BUSOBA,BUMASIKYE,MAAKO B,731,5,2,6,194,247,454,37,491,0,O-26-132-05-01-05
MBALE,BUNGOKHO CTY SOUTH,BUSOBA,BUMASIKYE,BUMUYELERO PR SCH,799,1,0,1,235,331,568,0,568,0,O-26-132-05-01-06
MBALE,BUNGOKHO CTY SOUTH,BUSOBA,BUMASIKYE,MASIKYE G.C.S,519,0,1,3,124,241,369,14,383,0,O-26-132-05-01-07
MBALE,BUNGOKHO CTY SOUTH,BUSOBA,BUMASIKYE,NABIRI P/S,419,2,1,1,80,204,288,7,295,0,O-26-132-05-01-08
MBALE,BUNGOKHO CTY SOUTH,BUSOBA,BUMASIKYE,KHATWELATWELA,376,2,0,3,95,157,257,7,264,0,O-26-132-05-01-09
MBALE,BUNGOKHO CTY SOUTH,BUSOBA,BUNAMBUTYE,NABUMALI CORNER A,656,3,2,5,233,200,443,21,464,0,O-26-132-05-02-01
MBALE,BUNGOKHO CTY SOUTH,BUSOBA,BUNAMBUTYE,BUSOBA P/S,505,2,4,5,162,176,349,15,364,0,O-26-132-05-02-02
MBALE,BUNGOKHO CTY SOUTH,BUSOBA,BUNAMBUTYE,NABUMALI BDG. PR SCH.,700,4,5,2,159,269,439,23,462,0,O-26-132-05-02-03
MBALE,BUNGOKHO CTY SOUTH,BUSOBA,BUNAMBUTYE,SHITULWA G.C.S.,598,2,0,1,93,305,401,18,419,0,O-26-132-05-02-04
MBALE,BUNGOKHO CTY SOUTH,BUSOBA,BUNAMBUTYE,BUMULAHA,274,2,0,1,56,141,200,5,205,0,O-26-132-05-02-05
MBALE,BUNGOKHO CTY SOUTH,BUSOBA,BUNANIMI,MAYEKHE,663,5,2,6,218,262,493,7,500,0,O-26-132-05-03-01
MBALE,BUNGOKHO CTY SOUTH,BUSOBA,BUNANIMI,WOTSONGOLE,632,1,2,0,258,205,466,18,484,0,O-26-132-05-03-02
MBALE,BUNGOKHO CTY SOUTH,BUSOBA,BUNANIMI,MAKAI,480,4,0,4,129,184,321,28,349,0,O-26-132-05-03-03
MBALE,BUNGOKHO CTY SOUTH,BUSOBA,BUNANIMI,LWANGOLI,513,4,0,2,100,269,375,0,375,0,O-26-132-05-03-04
MBALE,BUNGOKHO CTY SOUTH,BUSOBA,BUNANIMI,NAMSHISYO,740,3,0,3,237,290,533,6,539,0,O-26-132-05-03-05
MBALE,BUNGOKHO CTY SOUTH,BUSOBA,BUNANIMI,SEKERERE,313,2,1,0,81,153,237,6,243,0,O-26-132-05-03-06
MBALE,BUNGOKHO CTY SOUTH,BUSOBA,BUNANIMI,BULOLERO,619,1,0,3,199,255,458,26,484,0,O-26-132-05-03-07
MBALE,BUNGOKHO CTY SOUTH,BUSOBA,BUNANIMI,LWANGOLI II,342,2,0,3,86,129,220,22,242,0,O-26-132-05-03-08
MBALE,BUNGOKHO CTY SOUTH,NAMBALE,BUKASAKYA,BUGEMA CENTRE,755,0,1,2,207,232,442,4,446,0,O-26-132-06-01-01
MBALE,BUNGOKHO CTY SOUTH,NAMBALE,BUKASAKYA,BUGEMA A,648,0,4,0,167,264,435,16,451,0,O-26-132-06-01-02
MBALE,BUNGOKHO CTY SOUTH,NAMBALE,BUKASAKYA,BUGEMA B,678,2,2,2,247,200,453,36,489,0,O-26-132-06-01-03
MBALE,BUNGOKHO CTY SOUTH,NAMBALE,BUKASAKYA,MUNKAGA,596,1,1,0,227,146,375,9,384,0,O-26-132-06-01-04
MBALE,BUNGOKHO CTY SOUTH,NAMBALE,BUKASAKYA,MARALE,852,3,2,4,234,278,521,25,546,0,O-26-132-06-01-05
MBALE,BUNGOKHO CTY SOUTH,NAMBALE,BUKASAKYA,GRAVE NURSERY SCHOOL,458,0,0,1,111,131,243,7,250,0,O-26-132-06-01-06
MBALE,BUNGOKHO CTY SOUTH,NAMBALE,BUKASAKYA,MPALE MBAYA,348,0,0,1,92,106,199,0,199,0,O-26-132-06-01-07
MBALE,BUNGOKHO CTY SOUTH,NAMBALE,BUMBOYI,BUMBOI PR. SCH.,546,0,0,0,0,0,0,0,0,1,O-26-132-06-02-01
MBALE,BUNGOKHO CTY SOUTH,NAMBALE,BUMBOYI,KIDOBO G.C.S.,630,1,4,1,211,208,425,13,438,0,O-26-132-06-02-02
MBALE,BUNGOKHO CTY SOUTH,NAMBALE,BUMBOYI,MALONGO PR. SCH.,704,1,3,5,236,275,520,12,532,0,O-26-132-06-02-03
MBALE,BUNGOKHO CTY SOUTH,NAMBALE,BUMBOYI,MUSENE'S PLACE,230,3,1,1,65,80,150,8,158,0,O-26-132-06-02-04
MBALE,BUNGOKHO CTY SOUTH,NAMBALE,BUMUTOTO,NAWUYO,888,1,3,0,239,189,432,0,432,0,O-26-132-06-03-01
MBALE,BUNGOKHO CTY SOUTH,NAMBALE,BUMUTOTO,NAWUYO PR. SCH. B (A-M),684,1,1,0,211,200,413,21,434,0,O-26-132-06-03-02
MBALE,BUNGOKHO CTY SOUTH,NAMBALE,BUMUTOTO,NAWUYO PR. SCH. A (N-Z),802,3,4,0,180,169,356,8,364,0,O-26-132-06-03-03
MBALE,BUNGOKHO CTY SOUTH,NAMBALE,BUMUTOTO,BUNAMWANI C.O.U,696,3,2,2,241,213,461,28,489,0,O-26-132-06-03-04
MBALE,BUNGOKHO CTY SOUTH,NAMBALE,BUMUTOTO,BUMUTOTO TC A,545,0,0,0,0,0,0,0,0,1,O-26-132-06-03-05
MBALE,BUNGOKHO CTY SOUTH,NAMBALE,BUMUTOTO,NAWUYO CATHOLIC CHURCH,510,1,0,0,162,141,304,0,304,0,O-26-132-06-03-06
MBALE,BUNGOKHO CTY SOUTH,NAMBALE,BUMUTOTO,BUKASAKYA PR. SCH. A,650,2,3,0,200,214,419,13,432,0,O-26-132-06-03-07
MBALE,BUNGOKHO CTY SOUTH,NAMBALE,BUMUTOTO,WAKALANGA'S PLACE,402,2,2,1,147,138,290,8,298,0,O-26-132-06-03-08
MBALE,BUNGOKHO CTY SOUTH,NAMBALE,BUMUTOTO,NAWUYO PR. SCH. B (N-Z),1076,1,3,2,222,229,457,10,467,0,O-26-132-06-03-09
MBALE,BUNGOKHO CTY SOUTH,NAMBALE,MOONI,SHIKUNGA G.C.S,572,3,2,0,166,172,343,48,391,0,O-26-132-06-04-01
MBALE,BUNGOKHO CTY SOUTH,NAMBALE,MOONI,WASIKE'S T/C,266,0,0,0,99,69,168,2,170,0,O-26-132-06-04-02
MBALE,BUNGOKHO CTY SOUTH,NAMBALE,MOONI,BULUJELE,522,0,1,1,142,182,326,16,342,0,O-26-132-06-04-03
MBALE,BUNGOKHO CTY SOUTH,NAMBALE,ZABANYANYA,DOKO,877,2,0,2,266,270,540,17,557,0,O-26-132-06-05-01
MBALE,BUNGOKHO CTY SOUTH,NAMBALE,ZABANYANYA,MUSOTO A,888,7,1,2,325,174,509,22,531,0,O-26-132-06-05-02
MBALE,BUNGOKHO CTY SOUTH,NAMBALE,ZABANYANYA,GREEN PASTURES S.S,658,2,1,2,198,166,369,6,375,0,O-26-132-06-05-03
MBALE,BUNGOKHO CTY SOUTH,NAMBALE,ZABANYANYA,BUGEMA 'C',770,5,2,4,196,250,457,25,482,0,O-26-132-06-05-04
MBALE,BUNGOKHO CTY SOUTH,NAMBALE,ZABANYANYA,MUSOTO B (N-Z),706,6,3,4,171,165,349,26,375,0,O-26-132-06-05-05
MBALE,BUNGOKHO CTY SOUTH,NAMBALE,ZABANYANYA,KIBINIKO C.O.U,455,3,0,2,125,178,308,17,325,0,O-26-132-06-05-06
MBALE,MBALE MUNICIPALITY,INDUSTRIAL BOROUGH,MALUKHU,WAMBWA PR/SCH,718,0,6,2,228,147,383,25,408,0,O-26-134-01-01-01
MBALE,MBALE MUNICIPALITY,INDUSTRIAL BOROUGH,MALUKHU,MITTI NURSERY,706,2,5,2,208,162,379,17,396,0,O-26-134-01-01-02
MBALE,MBALE MUNICIPALITY,INDUSTRIAL BOROUGH,MALUKHU,MALUKU HALL,807,1,2,1,236,143,383,0,383,0,O-26-134-01-01-03
MBALE,MBALE MUNICIPALITY,INDUSTRIAL BOROUGH,MALUKHU,MANAFA HIGH SCHOOL,719,0,3,0,227,111,341,7,348,0,O-26-134-01-01-04
MBALE,MBALE MUNICIPALITY,INDUSTRIAL BOROUGH,MALUKHU,FOREST NURSERY OUTSIDE GUA,323,0,0,0,17,43,60,1,61,0,O-26-134-01-01-05
MBALE,MBALE MUNICIPALITY,INDUSTRIAL BOROUGH,MASABA,STADIUM 'B',260,2,0,1,76,36,115,1,116,0,O-26-134-01-02-01
MBALE,MBALE MUNICIPALITY,INDUSTRIAL BOROUGH,MASABA,STADIUM 'A',742,0,2,1,197,167,367,2,369,0,O-26-134-01-02-02
MBALE,MBALE MUNICIPALITY,INDUSTRIAL BOROUGH,MASABA,G.R.C. STATION,650,1,2,2,253,138,396,8,404,0,O-26-134-01-02-03
MBALE,MBALE MUNICIPALITY,INDUSTRIAL BOROUGH,MASABA,HAMBA STORES,506,0,2,1,119,110,232,6,238,0,O-26-134-01-02-04
MBALE,MBALE MUNICIPALITY,INDUSTRIAL BOROUGH,MASABA,G.R.C. STATION B,246,1,1,1,43,37,83,0,83,0,O-26-134-01-02-05
MBALE,MBALE MUNICIPALITY,INDUSTRIAL BOROUGH,NAMATALA,NAMATALA PR SCH A {A-H},584,2,0,0,118,94,214,20,234,0,O-26-134-01-03-01
MBALE,MBALE MUNICIPALITY,INDUSTRIAL BOROUGH,NAMATALA,NAMATALA PR. SCH. 'B',1055,4,3,0,227,149,383,0,383,0,O-26-134-01-03-02
MBALE,MBALE MUNICIPALITY,INDUSTRIAL BOROUGH,NAMATALA,AGAKHAN PR. SCH. I (A-LOB),763,2,1,2,203,147,355,8,363,0,O-26-134-01-03-03
MBALE,MBALE MUNICIPALITY,INDUSTRIAL BOROUGH,NAMATALA,AGAKHAN PR. SCH. I (LOC - NAMB,774,2,0,0,209,150,361,20,381,0,O-26-134-01-03-04
MBALE,MBALE MUNICIPALITY,INDUSTRIAL BOROUGH,NAMATALA,SKIN & HIDES HALL A,762,1,2,0,207,189,399,5,404,0,O-26-134-01-03-05
MBALE,MBALE MUNICIPALITY,INDUSTRIAL BOROUGH,NAMATALA,SKINS & HIDES HALL B,727,2,2,1,188,159,352,19,371,0,O-26-134-01-03-06
MBALE,MBALE MUNICIPALITY,INDUSTRIAL BOROUGH,NAMATALA,CATHOLIC CHURCH NAMATALA (A,693,2,1,0,164,154,321,12,333,0,O-26-134-01-03-07
MBALE,MBALE MUNICIPALITY,INDUSTRIAL BOROUGH,NAMATALA,CHURCH OF UG. NAMATALA,712,3,1,2,203,195,404,8,412,0,O-26-134-01-03-08
MBALE,MBALE MUNICIPALITY,INDUSTRIAL BOROUGH,NAMATALA,AGAKHAN PR. SCH. I (NAM-Z),781,3,1,1,221,144,370,9,379,0,O-26-134-01-03-09
MBALE,MBALE MUNICIPALITY,INDUSTRIAL BOROUGH,NAMATALA,CATHOLIC CHURCH NAMATALA (N,849,2,1,1,281,208,493,10,503,0,O-26-134-01-03-10
MBALE,MBALE MUNICIPALITY,INDUSTRIAL BOROUGH,NAMATALA,NAMATALA PR SCH A {I-N},643,0,1,1,133,101,236,14,250,0,O-26-134-01-03-11
MBALE,MBALE MUNICIPALITY,INDUSTRIAL BOROUGH,NAMATALA,NAMATALA PR SCH A {O-Z},443,0,1,1,122,58,182,4,186,0,O-26-134-01-03-12
MBALE,MBALE MUNICIPALITY,INDUSTRIAL BOROUGH,NAMATALA,SHARIF JAFFAR GROUND,382,3,0,0,98,82,183,14,197,0,O-26-134-01-03-13
MBALE,MBALE MUNICIPALITY,INDUSTRIAL BOROUGH,NAMATALA,RADIO UGANDA GROUND,405,3,0,1,79,79,162,6,168,0,O-26-134-01-03-14
MBALE,MBALE MUNICIPALITY,INDUSTRIAL BOROUGH,SOUTH CENTRAL,LORRY PARK A {A-M},1069,0,1,0,271,100,372,14,386,0,O-26-134-01-04-01
MBALE,MBALE MUNICIPALITY,INDUSTRIAL BOROUGH,SOUTH CENTRAL,NABUYONGA PR/SCHOOL,1116,3,3,0,368,146,520,7,527,0,O-26-134-01-04-02
MBALE,MBALE MUNICIPALITY,INDUSTRIAL BOROUGH,SOUTH CENTRAL,LORRY PARK B,317,0,2,0,213,101,316,0,316,0,O-26-134-01-04-03
MBALE,MBALE MUNICIPALITY,INDUSTRIAL BOROUGH,SOUTH CENTRAL,POLICE GROUND,1106,2,2,1,315,160,480,2,482,0,O-26-134-01-04-04
MBALE,MBALE MUNICIPALITY,INDUSTRIAL BOROUGH,SOUTH CENTRAL,BILAL MOSQUE,755,0,3,1,244,141,389,2,391,0,O-26-134-01-04-05
MBALE,MBALE MUNICIPALITY,INDUSTRIAL BOROUGH,SOUTH CENTRAL,LORRY PARK A {N-Z},545,0,0,0,199,65,264,3,267,0,O-26-134-01-04-06
MBALE,MBALE MUNICIPALITY,INDUSTRIAL BOROUGH,SOUTH CENTRAL,ST. ANDREWS C.O.U,503,1,2,0,186,74,263,5,268,0,O-26-134-01-04-07
MBALE,MBALE MUNICIPALITY,NORTHERN BOROUGH,IU-IU,ISLAMIC UNIVERSITY A,824,3,1,1,281,103,389,4,393,0,O-26-134-02-01-01
MBALE,MBALE MUNICIPALITY,NORTHERN BOROUGH,NABIYONGA,NKOMA SECONDARY SCH. A,366,2,3,0,102,32,139,2,141,0,O-26-134-02-02-01
MBALE,MBALE MUNICIPALITY,NORTHERN BOROUGH,NABIYONGA,NKOMA POLICE I,496,3,1,0,139,76,219,9,228,0,O-26-134-02-02-02
MBALE,MBALE MUNICIPALITY,NORTHERN BOROUGH,NABIYONGA,BUYONJO P/S,547,0,2,0,166,83,251,0,251,0,O-26-134-02-02-03
MBALE,MBALE MUNICIPALITY,NORTHERN BOROUGH,NABIYONGA,NKOMA POLICE II,439,4,1,3,102,83,193,9,202,0,O-26-134-02-02-04
MBALE,MBALE MUNICIPALITY,NORTHERN BOROUGH,NABIYONGA,MAGAZI HOSTEL,489,0,4,0,115,88,207,7,214,0,O-26-134-02-02-05
MBALE,MBALE MUNICIPALITY,NORTHERN BOROUGH,NAMAKWEKWE,MIDLAND,528,1,2,0,189,76,268,4,272,0,O-26-134-02-03-01
MBALE,MBALE MUNICIPALITY,NORTHERN BOROUGH,NAMAKWEKWE,LINK ROAD,549,0,2,0,191,122,315,11,326,0,O-26-134-02-03-02
MBALE,MBALE MUNICIPALITY,NORTHERN BOROUGH,NAMAKWEKWE,SOCIAL CENTRE,755,0,2,1,236,141,380,4,384,0,O-26-134-02-03-03
MBALE,MBALE MUNICIPALITY,NORTHERN BOROUGH,NAMAKWEKWE,BULAGO,615,1,0,0,251,114,366,0,366,0,O-26-134-02-03-04
MBALE,MBALE MUNICIPALITY,NORTHERN BOROUGH,NAMAKWEKWE,MISSION ROAD,667,0,2,0,292,108,402,4,406,0,O-26-134-02-03-05
MBALE,MBALE MUNICIPALITY,NORTHERN BOROUGH,NAMAKWEKWE,MPUMUDDE,422,1,2,1,134,80,218,8,226,0,O-26-134-02-03-06
MBALE,MBALE MUNICIPALITY,NORTHERN BOROUGH,NAMAKWEKWE,CRISCO CHURCH,469,5,3,1,156,102,267,2,269,0,O-26-134-02-03-07
MBALE,MBALE MUNICIPALITY,NORTHERN BOROUGH,NAMAKWEKWE,MIDLAND B,466,0,1,0,159,88,248,1,249,0,O-26-134-02-03-08
MBALE,MBALE MUNICIPALITY,NORTHERN BOROUGH,NAMAKWEKWE,NAMAKWEKWE,434,0,1,1,127,106,235,1,236,0,O-26-134-02-03-09
MBALE,MBALE MUNICIPALITY,NORTHERN BOROUGH,NAMAKWEKWE,MUZAKI LILLIAN GROUND,575,1,0,1,202,126,330,5,335,0,O-26-134-02-03-10
MBALE,MBALE MUNICIPALITY,NORTHERN BOROUGH,NAMAKWEKWE,WAMBEYABEYA GROUND,581,1,0,0,188,156,345,7,352,0,O-26-134-02-03-11
MBALE,MBALE MUNICIPALITY,NORTHERN BOROUGH,NKOMA,NKOMA HIGH SCHOOL I,754,3,1,0,223,156,383,21,404,0,O-26-134-02-04-01
MBALE,MBALE MUNICIPALITY,NORTHERN BOROUGH,NKOMA,WANAMBWA P/S,561,1,2,0,189,105,297,4,301,0,O-26-134-02-04-02
MBALE,MBALE MUNICIPALITY,NORTHERN BOROUGH,NKOMA,NKOMA POLICE STATION,313,1,0,0,105,65,171,2,173,0,O-26-134-02-04-03
MBALE,MBALE MUNICIPALITY,NORTHERN BOROUGH,NKOMA,SENKULU CHURCH YARD,616,1,2,2,222,129,356,6,362,0,O-26-134-02-04-04
MBALE,MBALE MUNICIPALITY,NORTHERN BOROUGH,NKOMA,BUJOLOTO PRIMARY SCHOOL,787,3,3,3,266,175,450,4,454,0,O-26-134-02-04-05
MBALE,MBALE MUNICIPALITY,NORTHERN BOROUGH,NKOMA,NKOMA POLICE STATION A,626,2,2,0,156,117,277,4,281,0,O-26-134-02-04-06
MBALE,MBALE MUNICIPALITY,NORTHERN BOROUGH,NKOMA,NKOMA HIGH SCHOOL II,483,1,1,2,141,108,253,12,265,0,O-26-134-02-04-07
MBALE,MBALE MUNICIPALITY,NORTHERN BOROUGH,NKOMA,SCHOOL OF HYGIENE,388,1,1,1,101,83,187,2,189,0,O-26-134-02-04-08
MBALE,MBALE MUNICIPALITY,NORTHERN BOROUGH,NORTH CENTRAL,NORTH ROAD PR SCH I,538,2,1,0,190,124,317,1,318,0,O-26-134-02-05-01
MBALE,MBALE MUNICIPALITY,NORTHERN BOROUGH,NORTH CENTRAL,NORTH RD. PR/SCHOOL 2,760,1,5,0,237,164,407,3,410,0,O-26-134-02-05-02
MBALE,MBALE MUNICIPALITY,NORTHERN BOROUGH,NORTH CENTRAL,MBALE HOSPITAL,570,2,4,0,184,125,315,1,316,0,O-26-134-02-05-03
MBALE,MBALE MUNICIPALITY,NORTHERN BOROUGH,NORTH CENTRAL,SCHOOL OF CLINICAL OFFICERS,298,1,3,0,96,73,173,1,174,0,O-26-134-02-05-04
MBALE,MBALE MUNICIPALITY,WANALE BOROUGH,BOMA,FAIRWAY PR/SCHOOL I,542,0,4,0,162,130,296,4,300,0,O-26-134-03-01-01
MBALE,MBALE MUNICIPALITY,WANALE BOROUGH,BOMA,FAIRWAY PR/SCHOOL II,676,0,3,0,172,183,358,2,360,0,O-26-134-03-01-02
MBALE,MBALE MUNICIPALITY,WANALE BOROUGH,BUSAMAGA,BUSAMAGA PR/SCHOOL I,507,1,0,1,124,120,246,10,256,0,O-26-134-03-02-01
MBALE,MBALE MUNICIPALITY,WANALE BOROUGH,BUSAMAGA,BUSAMAGA PR/SCHOOL II,550,3,1,3,125,161,293,3,296,0,O-26-134-03-02-02
MBALE,MBALE MUNICIPALITY,WANALE BOROUGH,BUSAMAGA,BUSAMAGA PR/SCHOOL I B,370,2,1,0,127,85,215,0,215,0,O-26-134-03-02-03
MBALE,MBALE MUNICIPALITY,WANALE BOROUGH,BUSAMAGA,BUSAMAGA PR/SCHOOL II B,528,3,3,3,163,141,313,4,317,0,O-26-134-03-02-04
MBALE,MBALE MUNICIPALITY,WANALE BOROUGH,MOONI,NASHIBISO PR/SCHOOL I,610,2,3,2,214,130,351,15,366,0,O-26-134-03-03-01
MBALE,MBALE MUNICIPALITY,WANALE BOROUGH,MOONI,ZEWUI I,412,0,0,1,105,122,228,9,237,0,O-26-134-03-03-02
MBALE,MBALE MUNICIPALITY,WANALE BOROUGH,MOONI,NASHIBOSO PR. SCH A,600,0,0,1,185,126,312,2,314,0,O-26-134-03-03-03
MBALE,MBALE MUNICIPALITY,WANALE BOROUGH,MOONI,ZEWUI II,462,4,2,1,117,156,280,15,295,0,O-26-134-03-03-04
MBALE,MBALE MUNICIPALITY,WANALE BOROUGH,MOONI,NASHIBOSO PR. SCH B,499,0,0,0,154,155,309,3,312,0,O-26-134-03-03-05
PALLISA,PALLISA COUNTY,AGULE,AGULE,NYAGUO P/S,582,10,1,12,328,94,445,28,473,0,O-35-190-01-01-01
PALLISA,PALLISA COUNTY,AGULE,AKWAMORU,AKWAMORU VILLAGE,508,7,0,5,321,59,392,31,423,0,O-35-190-01-02-01
PALLISA,PALLISA COUNTY,AGULE,AKWAMORU,AUJABULE,474,15,2,4,219,106,346,18,364,0,O-35-190-01-02-02
PALLISA,PALLISA COUNTY,AGULE,AKWAMORU,KALEMEN,497,9,6,11,276,52,354,28,382,0,O-35-190-01-02-03
PALLISA,PALLISA COUNTY,AGULE,AKWAMORU,OKOIT'S MANGO TREE,235,8,3,1,141,27,180,5,185,0,O-35-190-01-02-04
PALLISA,PALLISA COUNTY,AGULE,CHELEKULA,CHELEKULA P S,571,2,3,4,371,65,445,11,456,0,O-35-190-01-03-01
PALLISA,PALLISA COUNTY,AGULE,CHELEKULA,OGENDA MANGO TREE,341,7,3,2,204,51,267,19,286,0,O-35-190-01-03-02
PALLISA,PALLISA COUNTY,AGULE,CHELEKULA,ADODOI TRADING CENTRE,870,7,5,9,494,43,558,20,578,0,O-35-190-01-03-03
PALLISA,PALLISA COUNTY,AGULE,MORUKOKUME,PASIA P S,537,5,7,5,298,87,402,10,412,0,O-35-190-01-04-01
PALLISA,PALLISA COUNTY,AGULE,ODUSAI,AGULE P/S,415,3,5,2,279,45,334,19,353,0,O-35-190-01-05-01
PALLISA,PALLISA COUNTY,AGULE,ODUSAI,ODUSAI P S,1024,7,3,16,579,117,722,37,759,0,O-35-190-01-05-02
PALLISA,PALLISA COUNTY,AGULE,ODUSAI,AGULE SCTY HQRS,252,3,2,1,122,43,171,10,181,0,O-35-190-01-05-03
PALLISA,PALLISA COUNTY,AGULE,ODUSAI,ADODIO,118,0,0,1,60,13,74,2,76,0,O-35-190-01-05-04
PALLISA,PALLISA COUNTY,AGULE,OKUNGURO,OIGOMOJONG,584,6,2,6,377,56,447,16,463,0,O-35-190-01-06-01
PALLISA,PALLISA COUNTY,AGULE,OKUNGURO,KACHINGA,453,5,1,8,285,41,340,25,365,0,O-35-190-01-06-02
PALLISA,PALLISA COUNTY,AGULE,OKUNGURO,OKUNGURO (N-Z) TRADING CENT,293,1,1,2,162,58,224,23,247,0,O-35-190-01-06-03
PALLISA,PALLISA COUNTY,AGULE,OKUNGURO,OKUNGURO (A-M) BOREHOLE,481,5,3,9,233,115,365,18,383,0,O-35-190-01-06-04
PALLISA,PALLISA COUNTY,APOPONG,ADAL,ADAL P S,671,7,0,7,392,57,463,22,485,0,O-35-190-02-01-01
PALLISA,PALLISA COUNTY,APOPONG,ADAL,AUJABULE,627,3,2,9,385,137,536,11,547,0,O-35-190-02-01-02
PALLISA,PALLISA COUNTY,APOPONG,ADAL,AMOTOT,174,0,3,3,98,54,158,4,162,0,O-35-190-02-01-03
PALLISA,PALLISA COUNTY,APOPONG,APOPONG,APOPONG P.S.,415,8,0,4,235,82,329,13,342,0,O-35-190-02-02-01
PALLISA,PALLISA COUNTY,APOPONG,APOPONG,KATUKEI P.S,506,4,4,3,208,126,345,19,364,0,O-35-190-02-02-02
PALLISA,PALLISA COUNTY,APOPONG,APOPONG,ANGOLOL,837,14,3,9,356,186,568,7,575,0,O-35-190-02-02-03
PALLISA,PALLISA COUNTY,APOPONG,APOPONG,KATUKEI FELLOWSHIP CHURCH,333,6,1,1,124,101,233,3,236,0,O-35-190-02-02-04
PALLISA,PALLISA COUNTY,APOPONG,APOPONG,NEW KALAPATU TRADING CENTR,369,2,1,5,206,59,273,14,287,0,O-35-190-02-02-05
PALLISA,PALLISA COUNTY,APOPONG,KAPALA,KAPALA P.S,536,14,1,8,277,133,433,17,450,0,O-35-190-02-03-01
PALLISA,PALLISA COUNTY,APOPONG,KAPALA,KADUMIRE,601,3,1,3,325,49,381,15,396,0,O-35-190-02-03-02
PALLISA,PALLISA COUNTY,APOPONG,KAPALA,OSIEPAI,536,8,2,2,365,32,409,12,421,0,O-35-190-02-03-03
PALLISA,PALLISA COUNTY,APOPONG,KAUKURA,KAUKURA P/S,736,7,5,7,412,134,565,4,569,0,O-35-190-02-04-01
PALLISA,PALLISA COUNTY,APOPONG,KAUKURA,RWATAMA,411,6,3,6,212,83,310,14,324,0,O-35-190-02-04-02
PALLISA,PALLISA COUNTY,APOPONG,OBWANAI,OBWANAI P/S,497,4,4,6,325,22,361,11,372,0,O-35-190-02-05-01
PALLISA,PALLISA COUNTY,APOPONG,OBWANAI,OBWANAI,394,5,2,1,221,52,281,6,287,0,O-35-190-02-05-02
PALLISA,PALLISA COUNTY,GOGONYO,AJEPET,AJEPETE G.C.S LTD,673,7,5,5,4,70,91,11,102,0,O-35-190-03-01-01
PALLISA,PALLISA COUNTY,GOGONYO,AJEPET,OBWANYAI CENTRAL,637,11,3,8,449,48,519,22,541,0,O-35-190-03-01-02
PALLISA,PALLISA COUNTY,GOGONYO,AJEPET,GOGONYO P.S,798,10,5,6,481,70,572,46,618,0,O-35-190-03-01-03
PALLISA,PALLISA COUNTY,GOGONYO,GOGONYO,AGURUR P.S.,613,13,3,3,314,117,450,24,474,0,O-35-190-03-02-01
PALLISA,PALLISA COUNTY,GOGONYO,GOGONYO,AKISIM LC COURT,286,2,0,1,127,101,231,1,232,0,O-35-190-03-02-02
PALLISA,PALLISA COUNTY,GOGONYO,GOGONYO,OBUTET P.S,700,8,8,5,245,197,463,32,495,0,O-35-190-03-02-03
PALLISA,PALLISA COUNTY,GOGONYO,GOGONYO,OPETA P.S,261,4,0,4,114,70,192,8,200,0,O-35-190-03-02-04
PALLISA,PALLISA COUNTY,GOGONYO,GOGONYO,AKISIM,528,17,1,6,298,112,434,16,450,0,O-35-190-03-02-05
PALLISA,PALLISA COUNTY,GOGONYO,KACHANGO,KACHANGO P.S,458,4,4,4,318,59,389,17,406,0,O-35-190-03-03-01
PALLISA,PALLISA COUNTY,GOGONYO,KACHANGO,KACHANGO STORES,321,8,0,4,232,8,252,6,258,0,O-35-190-03-03-02
PALLISA,PALLISA COUNTY,GOGONYO,KACHANGO,AKWORO P.S,648,12,5,11,411,97,536,20,556,0,O-35-190-03-03-03
PALLISA,PALLISA COUNTY,GOGONYO,KACHANGO,KAPALA MARKET,700,5,7,8,460,45,525,16,541,0,O-35-190-03-03-04
PALLISA,PALLISA COUNTY,GOGONYO,KACHANGO,ANGODI,260,0,1,2,156,41,200,7,207,0,O-35-190-03-03-05
PALLISA,PALLISA COUNTY,KAMEKE,AKISIM,OMALUTAN,462,4,2,8,287,72,373,18,391,0,O-35-190-04-01-01
PALLISA,PALLISA COUNTY,KAMEKE,AKISIM,AKISIMI CENTRAL,599,9,3,11,327,136,486,18,504,0,O-35-190-04-01-02
PALLISA,PALLISA COUNTY,KAMEKE,KAMEKE,KAMEKE P.S,714,10,4,20,266,247,547,43,590,0,O-35-190-04-02-01
PALLISA,PALLISA COUNTY,KAMEKE,KAMEKE,OMURWOKA P.S,469,5,1,15,240,122,383,17,400,0,O-35-190-04-02-02
PALLISA,PALLISA COUNTY,KAMEKE,KAMEKE,OMURKWOKA MVULE TREE,474,17,4,7,267,81,376,25,401,0,O-35-190-04-02-03
PALLISA,PALLISA COUNTY,KAMEKE,NYAKOI,NYAKOI TRADING CENTRE,308,3,2,5,199,68,277,8,285,0,O-35-190-04-03-01
PALLISA,PALLISA COUNTY,KAMEKE,NYAKOI,NYAKOI OGASIAN P.S,664,7,0,6,471,56,540,20,560,0,O-35-190-04-03-02
PALLISA,PALLISA COUNTY,KAMEKE,NYAKOI,KAMEKE SCTY HQRS,661,10,1,27,223,224,485,21,506,0,O-35-190-04-03-03
PALLISA,PALLISA COUNTY,KAMEKE,OBOLISO,OOKE TREE,694,6,1,6,458,118,589,23,612,0,O-35-190-04-04-01
PALLISA,PALLISA COUNTY,KAMEKE,OBOLISO,AMUSUGUT MVULE,208,2,0,2,127,54,185,17,202,0,O-35-190-04-04-02
PALLISA,PALLISA COUNTY,KAMEKE,OBOLISO,OBOLISO,461,9,1,6,296,67,379,13,392,0,O-35-190-04-04-03
PALLISA,PALLISA COUNTY,KAMEKE,OKISIRAN,AGURUR KAM P.S,710,5,3,8,386,107,509,22,531,0,O-35-190-04-05-01
PALLISA,PALLISA COUNTY,KAMEKE,OKISIRAN,OKISIRAN T/C,367,1,4,2,200,90,297,4,301,0,O-35-190-04-05-02
PALLISA,PALLISA COUNTY,KAMEKE,OKISIRAN,OKISIRAN P.S,324,3,1,1,224,37,266,7,273,0,O-35-190-04-05-03
PALLISA,PALLISA COUNTY,KAMEKE,OPADOI,OPADOI P.S,597,2,2,9,413,66,492,22,514,0,O-35-190-04-06-01
PALLISA,PALLISA COUNTY,KAMEKE,OPADOI,OPADOI PENTECOSTAL CHURCH,178,1,0,0,130,25,156,4,160,0,O-35-190-04-06-02
PALLISA,PALLISA COUNTY,KAMEKE,OPADOI,OPADOI,322,3,0,6,204,70,283,6,289,0,O-35-190-04-06-03
PALLISA,PALLISA COUNTY,KAMUGE,BOLISO II,BOLISO P/S,700,19,6,14,262,239,540,0,540,0,O-35-190-05-01-01
PALLISA,PALLISA COUNTY,KAMUGE,BOLISO II,BOLISO II CO-OP STORE,546,24,9,20,286,91,430,24,454,0,O-35-190-05-01-02
PALLISA,PALLISA COUNTY,KAMUGE,KAGOLI,KAGOLI CENTRAL BOREHOLE,645,14,7,20,156,283,480,45,525,0,O-35-190-05-02-01
PALLISA,PALLISA COUNTY,KAMUGE,KAGOLI,AGURURU MANGO TREE,141,2,1,1,15,99,118,6,124,0,O-35-190-05-02-02
PALLISA,PALLISA COUNTY,KAMUGE,KAGOLI,KAMUGE - OLINGA P/S,624,5,1,8,218,207,439,21,460,0,O-35-190-05-02-03
PALLISA,PALLISA COUNTY,KAMUGE,KALAPATA,BUKADUKA BOREHOLE A,468,4,5,5,248,117,379,5,384,0,O-35-190-05-03-01
PALLISA,PALLISA COUNTY,KAMUGE,KALAPATA,KALAPATA P/S,426,1,0,5,115,230,351,8,359,0,O-35-190-05-03-02
PALLISA,PALLISA COUNTY,KAMUGE,KALAPATA,MPUMWIRE KAMPALA,430,2,3,7,190,144,346,2,348,0,O-35-190-05-03-03
PALLISA,PALLISA COUNTY,KAMUGE,KAMUGE,KAMUGE SUB HQS,595,4,5,11,207,173,400,9,409,0,O-35-190-05-04-01
PALLISA,PALLISA COUNTY,KAMUGE,KAMUGE,KAMUGE PRIMARY SCHOOL,261,1,8,4,88,95,196,7,203,0,O-35-190-05-04-02
PALLISA,PALLISA COUNTY,KAMUGE,KAMUGE,NAMUDIANA,566,3,1,4,104,311,423,28,451,0,O-35-190-05-04-03
PALLISA,PALLISA COUNTY,KAMUGE,KAMUGE,KAMUGE STATION P/S,480,8,1,16,150,183,358,37,395,0,O-35-190-05-04-04
PALLISA,PALLISA COUNTY,KASODO,APAPA,APAPA P.S.,581,7,1,8,298,105,419,44,463,0,O-35-190-06-01-01
PALLISA,PALLISA COUNTY,KASODO,APAPA,OSONGA P.S,561,9,8,17,269,153,456,29,485,0,O-35-190-06-01-02
PALLISA,PALLISA COUNTY,KASODO,APAPA,APAPA PRM CHURCH,156,0,0,1,92,41,134,4,138,0,O-35-190-06-01-03
PALLISA,PALLISA COUNTY,KASODO,KASODO,KASODO T.C,672,3,10,4,257,206,480,14,494,0,O-35-190-06-02-01
PALLISA,PALLISA COUNTY,KASODO,KASODO,NANGOBI C. RC I COURT,421,5,1,7,141,152,306,24,330,0,O-35-190-06-02-02
PALLISA,PALLISA COUNTY,KASODO,KASODO,BUKALINO P/S,467,2,8,5,169,162,346,13,359,0,O-35-190-06-02-03
PALLISA,PALLISA COUNTY,KASODO,NAJENETI,NABITENDE P.S,691,0,2,3,207,286,498,18,516,0,O-35-190-06-03-01
PALLISA,PALLISA COUNTY,KASODO,NAJENETI,NAJENIT P.S,638,3,11,3,174,281,472,19,491,0,O-35-190-06-03-02
PALLISA,PALLISA COUNTY,KASODO,NAJENETI,MANENO'S AREA,483,3,2,4,154,205,368,4,372,0,O-35-190-06-03-03
PALLISA,PALLISA COUNTY,KASODO,NGALWE,NGALWE T.C,470,3,7,4,157,197,368,15,383,0,O-35-190-06-04-01
PALLISA,PALLISA COUNTY,KASODO,NGALWE,KASODO TECH. SCH.,554,5,10,9,192,200,416,6,422,0,O-35-190-06-04-02
PALLISA,PALLISA COUNTY,KASODO,NGALWE,KAUKULA LATE KAMUSINI'S PLAC,517,1,6,1,243,134,385,16,401,0,O-35-190-06-04-03
PALLISA,PALLISA COUNTY,KASODO,OLOK,ODWARAT P/S,660,12,3,6,466,33,520,33,553,0,O-35-190-06-05-01
PALLISA,PALLISA COUNTY,KASODO,OLOK,WALUGEGA MANGO TREE,223,0,2,1,110,47,160,9,169,0,O-35-190-06-05-02
PALLISA,PALLISA COUNTY,KASODO,OLOK,ST. BAPTIST CHURCH,429,1,2,2,331,29,365,10,375,0,O-35-190-06-05-03
PALLISA,PALLISA COUNTY,KASODO,OLOK,OLOK P.S.,480,4,2,6,327,43,382,25,407,0,O-35-190-06-05-04
PALLISA,PALLISA COUNTY,PALLISA,AKADOT,KOMOLO G.C.S. LTD.,799,20,8,10,425,136,599,23,622,0,O-35-190-07-01-01
PALLISA,PALLISA COUNTY,PALLISA,AKADOT,MUUT'S MANGO TREE,440,4,0,5,234,129,372,33,405,0,O-35-190-07-01-02
PALLISA,PALLISA COUNTY,PALLISA,AKADOT,OKAREBWOK,389,5,6,8,218,80,317,23,340,0,O-35-190-07-01-03
PALLISA,PALLISA COUNTY,PALLISA,KABOLOI,KABOLOI PS,674,9,2,7,380,135,533,40,573,0,O-35-190-07-02-01
PALLISA,PALLISA COUNTY,PALLISA,KABOLOI,ORIKODIA CENTRE,464,6,4,8,224,117,359,12,371,0,O-35-190-07-02-02
PALLISA,PALLISA COUNTY,PALLISA,KABOLOI,OPULE'S MANGO TREE,203,1,0,3,100,64,168,0,168,0,O-35-190-07-02-03
PALLISA,PALLISA COUNTY,PALLISA,SUPA,MIKA'S GROUND,363,3,2,7,104,137,253,16,269,0,O-35-190-07-03-01
PALLISA,PALLISA COUNTY,PALLISA,SUPA,KAGOLI CHURCH,400,4,2,3,154,144,307,7,314,0,O-35-190-07-03-02
PALLISA,PALLISA COUNTY,PALLISA,SUPA,KYELE,365,4,1,8,163,102,278,27,305,0,O-35-190-07-03-03
PALLISA,PALLISA COUNTY,PALLISA TOWN COUNCIL,EAST WARD,SUPA AGRIC OFFICE,736,4,4,6,350,97,461,31,492,0,O-35-190-08-01-01
PALLISA,PALLISA COUNTY,PALLISA TOWN COUNCIL,EAST WARD,SUPA CENTRAL,687,9,5,8,341,145,508,26,534,0,O-35-190-08-01-02
PALLISA,PALLISA COUNTY,PALLISA TOWN COUNCIL,HOSPITAL WARD,COMMUNITY CENTRE,270,2,1,2,102,72,179,6,185,0,O-35-190-08-02-01
PALLISA,PALLISA COUNTY,PALLISA TOWN COUNCIL,HOSPITAL WARD,PALLISA HOSPITAL,785,3,3,8,309,132,455,11,466,0,O-35-190-08-02-02
PALLISA,PALLISA COUNTY,PALLISA TOWN COUNCIL,HOSPITAL WARD,KAWOKEN P.R.M CHURCH,393,4,1,14,175,116,310,5,315,0,O-35-190-08-02-03
PALLISA,PALLISA COUNTY,PALLISA TOWN COUNCIL,KAGWESE WARD,LATE BUNYONGO'S MANGO TREE,290,1,2,0,98,96,197,11,208,0,O-35-190-08-03-01
PALLISA,PALLISA COUNTY,PALLISA TOWN COUNCIL,KAGWESE WARD,EKABA'S PLACE,310,4,1,2,150,87,244,11,255,0,O-35-190-08-03-02
PALLISA,PALLISA COUNTY,PALLISA TOWN COUNCIL,KAGWESE WARD,POLICE STATION,604,1,0,1,167,169,338,9,347,0,O-35-190-08-03-03
PALLISA,PALLISA COUNTY,PALLISA TOWN COUNCIL,KAGWESE WARD,NALUFENYA P/S,665,5,2,5,175,218,405,13,418,0,O-35-190-08-03-04
PALLISA,PALLISA COUNTY,PALLISA TOWN COUNCIL,KAGWESE WARD,INDUSTRIAL AREA,793,3,0,5,162,263,433,10,443,0,O-35-190-08-03-05
PALLISA,PALLISA COUNTY,PALLISA TOWN COUNCIL,KAGWESE WARD,BUJOLOMO MANGO TREE,646,5,7,5,146,305,468,15,483,0,O-35-190-08-03-06
PALLISA,PALLISA COUNTY,PALLISA TOWN COUNCIL,KAGWESE WARD,PALLISA HEALTH CENTRE,956,3,1,3,215,259,481,18,499,0,O-35-190-08-03-07
PALLISA,PALLISA COUNTY,PALLISA TOWN COUNCIL,KAUCHO WARD,PALLISA TOWNSHIP P/S,490,2,2,2,119,157,282,11,293,0,O-35-190-08-04-01
PALLISA,PALLISA COUNTY,PALLISA TOWN COUNCIL,KAUCHO WARD,VICTORY S.S,453,1,1,3,132,119,256,5,261,0,O-35-190-08-04-02
PALLISA,PALLISA COUNTY,PALLISA TOWN COUNCIL,KAUCHO WARD,KALAKI SUB COUNTY HQTRS,416,3,1,3,143,104,254,8,262,0,O-35-190-08-04-03
PALLISA,PALLISA COUNTY,PALLISA TOWN COUNCIL,KAUCHO WARD,AKADOT P/S,492,6,3,7,226,95,337,13,350,0,O-35-190-08-04-04
PALLISA,PALLISA COUNTY,PALLISA TOWN COUNCIL,KAUCHO WARD,AMUSALA,349,3,2,4,214,47,270,9,279,0,O-35-190-08-04-05
PALLISA,PALLISA COUNTY,PALLISA TOWN COUNCIL,KAUCHO WARD,KAUCHO BOYS P/S,415,1,3,3,158,65,230,7,237,0,O-35-190-08-04-06
PALLISA,PALLISA COUNTY,PALLISA TOWN COUNCIL,WEST WARD,PALLISA HIGH SCH.,392,0,2,0,100,95,197,12,209,0,O-35-190-08-05-01
PALLISA,PALLISA COUNTY,PALLISA TOWN COUNCIL,WEST WARD,ODWARAT C.O.U,311,0,0,3,205,61,269,5,274,0,O-35-190-08-05-02
PALLISA,PALLISA COUNTY,PALLISA TOWN COUNCIL,WEST WARD,ODWARAT - OLUA P/S,879,3,2,11,435,134,585,14,599,0,O-35-190-08-05-03
PALLISA,PALLISA COUNTY,PALLISA TOWN COUNCIL,WEST WARD,PALLISA OPEN MARKET,345,2,0,1,76,51,130,2,132,0,O-35-190-08-05-04
PALLISA,PALLISA COUNTY,PUTI-PUTI,BOLISO I,AMUSIAT PS,757,5,0,26,347,225,603,24,627,0,O-35-190-09-01-01
PALLISA,PALLISA COUNTY,PUTI-PUTI,BOLISO I,AMUSIAT-OGINGA,187,1,1,12,118,41,173,14,187,0,O-35-190-09-01-02
PALLISA,PALLISA COUNTY,PUTI-PUTI,BOLISO I,KUTAI TRADING CENTRE,463,3,0,6,110,249,368,16,384,0,O-35-190-09-01-03
PALLISA,PALLISA COUNTY,PUTI-PUTI,BOLISO I,KAMUGE MARKET,480,3,4,7,175,176,365,45,410,0,O-35-190-09-01-04
PALLISA,PALLISA COUNTY,PUTI-PUTI,LIMOTO,LIMOTO P/S,974,3,2,8,291,402,706,20,726,0,O-35-190-09-02-01
PALLISA,PALLISA COUNTY,PUTI-PUTI,LIMOTO,OGORIA P.S.,748,7,5,15,235,266,528,21,549,0,O-35-190-09-02-02
PALLISA,PALLISA COUNTY,PUTI-PUTI,MPONGI,MPONGI P.S.,818,11,3,4,234,277,529,0,529,0,O-35-190-09-03-01
PALLISA,PALLISA COUNTY,PUTI-PUTI,MPONGI,SUSUJE MANGO TREE A,627,8,2,14,212,214,450,12,462,0,O-35-190-09-03-02
PALLISA,PALLISA COUNTY,PUTI-PUTI,MPONGI,DODOI P/S,299,3,4,4,122,98,231,15,246,0,O-35-190-09-03-03
PALLISA,PALLISA COUNTY,PUTI-PUTI,PUTI-PUTI,TUKEI CATHOLIC CHURCH,788,9,2,7,208,378,604,22,626,0,O-35-190-09-04-01
PALLISA,PALLISA COUNTY,PUTI-PUTI,PUTI-PUTI,KEUKA T.C.,701,9,2,13,191,276,491,34,525,0,O-35-190-09-04-02
SOROTI,SOROTI COUNTY,ARAPAI,ALOET,ABALANG-ARAPAI AGRI. COLLEGE,441,6,3,2,273,25,309,7,316,0,O-38-205-01-01-01
SOROTI,SOROTI COUNTY,ARAPAI,ALOET,AKAIKAI,841,11,6,7,504,60,588,34,622,0,O-38-205-01-01-02
SOROTI,SOROTI COUNTY,ARAPAI,ALOET,AKUM-ALOET,591,10,4,7,348,42,411,26,437,0,O-38-205-01-01-03
SOROTI,SOROTI COUNTY,ARAPAI,ALOET,ALOET CENTRAL-TESO COLLEGE,681,3,1,5,344,89,442,12,454,0,O-38-205-01-01-04
SOROTI,SOROTI COUNTY,ARAPAI,ALOET,ARABAKA-OGOLOI,245,3,0,0,155,26,184,0,184,0,O-38-205-01-01-05
SOROTI,SOROTI COUNTY,ARAPAI,ARAPAI,AMORU A,333,7,1,1,208,32,249,15,264,0,O-38-205-01-02-01
SOROTI,SOROTI COUNTY,ARAPAI,ARAPAI,AMORU B,430,5,0,2,281,21,309,11,320,0,O-38-205-01-02-02
SOROTI,SOROTI COUNTY,ARAPAI,ARAPAI,ARAPAI,708,3,3,5,519,44,574,11,585,0,O-38-205-01-02-03
SOROTI,SOROTI COUNTY,ARAPAI,ARAPAI,KANGETA BAR,470,8,3,0,354,17,382,5,387,0,O-38-205-01-02-04
SOROTI,SOROTI COUNTY,ARAPAI,DAKABELA,DAKABELA B - APEGE,368,8,3,2,288,18,319,5,324,0,O-38-205-01-03-01
SOROTI,SOROTI COUNTY,ARAPAI,DAKABELA,DAKABELA C - OLEGEI,349,6,1,3,262,14,286,8,294,0,O-38-205-01-03-02
SOROTI,SOROTI COUNTY,ARAPAI,DAKABELA,DAKABELA- A TUKUM P. SCH.,610,20,4,7,453,16,500,15,515,0,O-38-205-01-03-03
SOROTI,SOROTI COUNTY,ARAPAI,DAKABELA,AGAYA,246,2,0,5,178,14,199,11,210,0,O-38-205-01-03-04
SOROTI,SOROTI COUNTY,ARAPAI,DAKABELA,AMOTOT,408,6,2,5,303,21,337,3,340,0,O-38-205-01-03-05
SOROTI,SOROTI COUNTY,ARAPAI,ODUDUI,AGIRIGIROI,586,19,5,19,280,129,452,14,466,0,O-38-205-01-04-01
SOROTI,SOROTI COUNTY,ARAPAI,ODUDUI,ODUDUI A,468,13,1,8,307,47,376,15,391,0,O-38-205-01-04-02
SOROTI,SOROTI COUNTY,ARAPAI,ODUDUI,ODUDUI B,1021,29,10,12,658,34,743,28,771,0,O-38-205-01-04-03
SOROTI,SOROTI COUNTY,ASURET,MUKURA,MUKURA A,814,8,3,2,507,83,603,11,614,0,O-38-205-02-01-01
SOROTI,SOROTI COUNTY,ASURET,MUKURA,MUKURA B,566,6,2,2,396,43,449,14,463,0,O-38-205-02-01-02
SOROTI,SOROTI COUNTY,ASURET,MUKURA,MUKURA C,806,20,5,16,496,75,612,30,642,0,O-38-205-02-01-03
SOROTI,SOROTI COUNTY,ASURET,OBULE,ADACAR PRIMARY SCHOOL,715,12,6,5,407,89,519,21,540,0,O-38-205-02-02-01
SOROTI,SOROTI COUNTY,ASURET,OBULE,AKISIM - OTOITOI,311,5,1,3,193,59,261,4,265,0,O-38-205-02-02-02
SOROTI,SOROTI COUNTY,ASURET,OBULE,OBULE PRIMARY SCHOOL,789,0,4,1,623,19,647,11,658,0,O-38-205-02-02-03
SOROTI,SOROTI COUNTY,ASURET,OBULE,OTAABA,684,11,9,11,410,89,530,14,544,0,O-38-205-02-02-04
SOROTI,SOROTI COUNTY,ASURET,OCOKICAN,OCOKICAN A,951,15,4,3,583,125,730,15,745,0,O-38-205-02-03-01
SOROTI,SOROTI COUNTY,ASURET,OCOKICAN,OCOKICAN B,791,11,5,6,468,88,578,15,593,0,O-38-205-02-03-02
SOROTI,SOROTI COUNTY,ASURET,OTATAI,OTATAI A - ORIMAI PRIMARY SCH,571,6,1,3,398,49,457,8,465,0,O-38-205-02-04-01
SOROTI,SOROTI COUNTY,ASURET,OTATAI,OTATAI B - OTATAI PRIMARY SCH,892,13,4,4,569,100,690,30,720,0,O-38-205-02-04-02
SOROTI,SOROTI COUNTY,ASURET,OTATAI,OTATAI C - OMODOI,481,13,1,1,297,49,361,12,373,0,O-38-205-02-04-03
SOROTI,SOROTI COUNTY,GWERI,AUKOT,AUKOT A,728,6,1,6,432,114,559,5,564,0,O-38-205-03-01-01
SOROTI,SOROTI COUNTY,GWERI,AUKOT,AUKOT C,864,15,5,10,552,84,666,6,672,0,O-38-205-03-01-02
SOROTI,SOROTI COUNTY,GWERI,AUKOT,AWOJA LABOUR LINE,879,10,4,7,404,190,615,18,633,0,O-38-205-03-01-03
SOROTI,SOROTI COUNTY,GWERI,AUKOT,OJEBE MKT,637,6,8,2,423,71,510,7,517,0,O-38-205-03-01-04
SOROTI,SOROTI COUNTY,GWERI,AWALIWAL,AMOROTO P/SCH,689,16,1,12,413,84,526,10,536,0,O-38-205-03-02-01
SOROTI,SOROTI COUNTY,GWERI,AWALIWAL,AWALIWAL P/SCH,604,13,3,8,368,64,456,10,466,0,O-38-205-03-02-02
SOROTI,SOROTI COUNTY,GWERI,AWALIWAL,AMORU,428,1,0,3,249,70,323,16,339,0,O-38-205-03-02-03
SOROTI,SOROTI COUNTY,GWERI,AWALIWAL,TAKARAMIAMYWERI PRI SCH.,347,7,2,4,196,56,265,6,271,0,O-38-205-03-02-04
SOROTI,SOROTI COUNTY,GWERI,DOKOLO,ANGARO PAG,515,8,3,4,364,38,417,2,419,0,O-38-205-03-03-01
SOROTI,SOROTI COUNTY,GWERI,DOKOLO,DOKOLO A,553,4,2,2,396,21,425,8,433,0,O-38-205-03-03-02
SOROTI,SOROTI COUNTY,GWERI,DOKOLO,DOKOLO C,535,6,4,4,374,44,432,12,444,0,O-38-205-03-03-03
SOROTI,SOROTI COUNTY,GWERI,DOKOLO,OBULETERA BAR,812,10,8,4,455,132,609,29,638,0,O-38-205-03-03-04
SOROTI,SOROTI COUNTY,GWERI,GWERI,AMUSIA CATHOLIC CHURCH,258,3,0,3,200,10,216,7,223,0,O-38-205-03-04-01
SOROTI,SOROTI COUNTY,GWERI,GWERI,AMUSIA-AKUYA,537,8,6,5,360,17,396,11,407,0,O-38-205-03-04-02
SOROTI,SOROTI COUNTY,GWERI,GWERI,ANGOPET PRIMARY SCHOOL B,571,11,5,8,327,59,410,18,428,0,O-38-205-03-04-03
SOROTI,SOROTI COUNTY,GWERI,GWERI,GWERI/OPEDURO,479,10,2,6,263,77,358,16,374,0,O-38-205-03-04-04
SOROTI,SOROTI COUNTY,GWERI,GWERI,MUGENYA,419,7,7,5,238,71,328,19,347,0,O-38-205-03-04-05
SOROTI,SOROTI COUNTY,GWERI,GWERI,OPUCET-ANGOPET,436,2,1,10,275,22,310,21,331,0,O-38-205-03-04-06
SOROTI,SOROTI COUNTY,GWERI,GWERI,TELAMOT,456,10,2,7,293,54,366,9,375,0,O-38-205-03-04-07
SOROTI,SOROTI COUNTY,KAMUDA,AGORA,AGAMA MARKET,892,7,2,1,670,20,700,14,714,0,O-38-205-04-01-01
SOROTI,SOROTI COUNTY,KAMUDA,AGORA,AGORA P/SCH,578,6,3,4,410,30,453,17,470,0,O-38-205-04-01-02
SOROTI,SOROTI COUNTY,KAMUDA,AGORA,DOKOLO GINNERY,462,2,4,3,277,14,300,75,375,0,O-38-205-04-01-03
SOROTI,SOROTI COUNTY,KAMUDA,AMINIT,AMINIT P/SCH,616,4,10,2,460,7,483,16,499,0,O-38-205-04-02-01
SOROTI,SOROTI COUNTY,KAMUDA,AMINIT,AMOTOT COU,472,3,1,2,359,19,384,3,387,0,O-38-205-04-02-02
SOROTI,SOROTI COUNTY,KAMUDA,AMINIT,KAMUDA S/C HQRS,738,13,4,6,566,26,615,21,636,0,O-38-205-04-02-03
SOROTI,SOROTI COUNTY,KAMUDA,AMINIT,OLIO KAMUDA P/SCH,661,5,2,1,459,8,475,34,509,0,O-38-205-04-02-04
SOROTI,SOROTI COUNTY,KAMUDA,AMINIT,OYOMAI PRI SCHOOL,260,3,2,2,209,8,224,8,232,0,O-38-205-04-02-05
SOROTI,SOROTI COUNTY,KAMUDA,KAMUDA,ABOKET P/SCH,292,3,2,0,233,2,240,6,246,0,O-38-205-04-03-01
SOROTI,SOROTI COUNTY,KAMUDA,KAMUDA,KAMUDA P/SCH,797,4,10,1,614,17,646,14,660,0,O-38-205-04-03-02
SOROTI,SOROTI COUNTY,KAMUDA,KAMUDA,OLWELAI P/SCH,446,10,6,1,371,12,400,9,409,0,O-38-205-04-03-03
SOROTI,SOROTI COUNTY,KAMUDA,KAMUDA,OBUJA PRI SCHOOL,398,3,1,1,312,12,329,6,335,0,O-38-205-04-03-04
SOROTI,SOROTI COUNTY,KAMUDA,LALLE,LALLE P/SCH (A-ED),481,3,10,1,300,40,354,13,367,0,O-38-205-04-04-01
SOROTI,SOROTI COUNTY,KAMUDA,LALLE,LILIM CATHOLIC CHURCH,433,5,6,1,264,43,319,11,330,0,O-38-205-04-04-02
SOROTI,SOROTI COUNTY,KAMUDA,LALLE,OLUKEI CATHOLIC CHURCH,359,1,1,3,280,8,293,9,302,0,O-38-205-04-04-03
SOROTI,SOROTI COUNTY,KAMUDA,LALLE,LALLE P/SCH (EG-Z),395,3,6,4,272,50,335,6,341,0,O-38-205-04-04-04
SOROTI,SOROTI COUNTY,KATINE,KATINE,ATIRIR,864,11,6,2,436,122,577,23,600,0,O-38-205-05-01-01
SOROTI,SOROTI COUNTY,KATINE,KATINE,KATINE,533,3,3,3,337,72,418,8,426,0,O-38-205-05-01-02
SOROTI,SOROTI COUNTY,KATINE,KATINE,OJAMA,852,20,5,11,544,95,675,16,691,0,O-38-205-05-01-03
SOROTI,SOROTI COUNTY,KATINE,MEROK,MEROK P/SCH,312,2,2,1,242,12,259,5,264,0,O-38-205-05-02-01
SOROTI,SOROTI COUNTY,KATINE,MEROK,OIMAI P/SCH,703,5,3,7,406,70,491,37,528,0,O-38-205-05-02-02
SOROTI,SOROTI COUNTY,KATINE,OCULOI,AJONYI P/SCH,521,11,8,1,369,40,429,6,435,0,O-38-205-05-03-01
SOROTI,SOROTI COUNTY,KATINE,OCULOI,OBYARI,576,11,4,0,448,17,480,20,500,0,O-38-205-05-03-02
SOROTI,SOROTI COUNTY,KATINE,OCULOI,OJAGO CHURCH,592,0,1,1,451,31,484,7,491,0,O-38-205-05-03-03
SOROTI,SOROTI COUNTY,KATINE,OJOM,ADAMASIKO P/SCH,580,6,2,2,430,33,473,23,496,0,O-38-205-05-04-01
SOROTI,SOROTI COUNTY,KATINE,OJOM,AMINIT CHURCH,621,1,6,3,436,48,494,14,508,0,O-38-205-05-04-02
SOROTI,SOROTI COUNTY,KATINE,OJOM,ONYAMAKOLONG,361,4,2,1,263,33,303,3,306,0,O-38-205-05-04-03
SOROTI,SOROTI COUNTY,KATINE,OLWELAI,APASI TRADING CENTRE,714,9,4,16,423,91,543,9,552,0,O-38-205-05-05-01
SOROTI,SOROTI COUNTY,KATINE,OLWELAI,ABILIPIN,355,4,2,4,247,30,287,9,296,0,O-38-205-05-05-02
SOROTI,SOROTI COUNTY,KATINE,OLWELAI,ARUKAPUTA,287,4,0,0,222,15,241,3,244,0,O-38-205-05-05-03
SOROTI,SOROTI COUNTY,SOROTI,AMEN,AMEN C,470,4,3,0,276,53,336,65,401,0,O-38-205-06-01-01
SOROTI,SOROTI COUNTY,SOROTI,AMEN,COUNTY HQRS,765,4,1,1,431,44,481,5,486,0,O-38-205-06-01-02
SOROTI,SOROTI COUNTY,SOROTI,AMEN,ODERAI,566,6,3,0,372,58,439,16,455,0,O-38-205-06-01-03
SOROTI,SOROTI COUNTY,SOROTI,AMEN,OMALAIWA,173,1,1,3,93,18,116,3,119,0,O-38-205-06-01-04
SOROTI,SOROTI COUNTY,SOROTI,AMEN,OPIYAI COU,435,9,1,0,284,35,329,12,341,0,O-38-205-06-01-05
SOROTI,SOROTI COUNTY,SOROTI,AMEN,ARAPAI GINNERY,368,1,3,1,248,27,280,13,293,0,O-38-205-06-01-06
SOROTI,SOROTI COUNTY,SOROTI,OPUYO,AROO MANGO TREES,410,8,2,7,265,78,360,1,361,0,O-38-205-06-02-01
SOROTI,SOROTI COUNTY,SOROTI,OPUYO,OPUYO CATHOLIC CHURCH,840,12,5,4,532,109,662,12,674,0,O-38-205-06-02-02
SOROTI,SOROTI COUNTY,SOROTI,OPUYO,OPUYO PRIMARY SCHOOL,513,9,4,6,283,122,424,18,442,0,O-38-205-06-02-03
SOROTI,SOROTI COUNTY,TUBUR,ACHUNA,ABEKO P/SCH,357,5,1,2,269,24,301,5,306,0,O-38-205-07-01-01
SOROTI,SOROTI COUNTY,TUBUR,ACHUNA,ACHUNA A - RAILWAY STATION,348,4,2,4,250,10,270,5,275,0,O-38-205-07-01-02
SOROTI,SOROTI COUNTY,TUBUR,ACHUNA,ACHUNA B - TRADING CENTRE,569,10,6,4,330,31,381,9,390,0,O-38-205-07-01-03
SOROTI,SOROTI COUNTY,TUBUR,ACHUNA,ANGARO BAPTIST CHURCH,464,4,1,0,314,42,361,2,363,0,O-38-205-07-01-04
SOROTI,SOROTI COUNTY,TUBUR,APARISA,APARISA A,421,5,0,2,242,63,312,14,326,0,O-38-205-07-02-01
SOROTI,SOROTI COUNTY,TUBUR,APARISA,APARISA B,210,4,0,5,127,29,165,1,166,0,O-38-205-07-02-02
SOROTI,SOROTI COUNTY,TUBUR,APARISA,APARISA C,317,1,0,1,136,30,168,45,213,0,O-38-205-07-02-03
SOROTI,SOROTI COUNTY,TUBUR,APARISA,APARISA P/SCH,467,8,0,3,261,51,323,7,330,0,O-38-205-07-02-04
SOROTI,SOROTI COUNTY,TUBUR,APARISA,TUBUR HEALTH UNIT,588,5,2,4,416,51,478,17,495,0,O-38-205-07-02-05
SOROTI,SOROTI COUNTY,TUBUR,APARISA,TUBUR P/SCH,428,12,2,3,247,51,315,23,338,0,O-38-205-07-02-06
SOROTI,SOROTI COUNTY,TUBUR,PALAET,KEELIM CATHOLIC CHURCH,535,7,4,8,313,53,385,23,408,0,O-38-205-07-03-01
SOROTI,SOROTI COUNTY,TUBUR,PALAET,OGEESEK,272,8,1,2,188,17,216,3,219,0,O-38-205-07-03-02
SOROTI,SOROTI COUNTY,TUBUR,PALAET,PALAET A,295,4,1,7,171,24,207,17,224,0,O-38-205-07-03-03
SOROTI,SOROTI COUNTY,TUBUR,PALAET,PALAET B,241,10,0,4,147,14,175,10,185,0,O-38-205-07-03-04
SOROTI,SOROTI COUNTY,TUBUR,PALAET,PALEAT P/SCH,174,1,1,2,118,10,132,7,139,0,O-38-205-07-03-05
SOROTI,SOROTI MUNICIPALITY,EASTERN,AKISIM WARD,AKISIM HOUSING ESTATE,866,0,1,0,265,89,355,54,409,0,O-38-207-01-01-01
SOROTI,SOROTI MUNICIPALITY,EASTERN,AKISIM WARD,POLICE BARRACKS (A-M),519,1,0,0,164,44,209,6,215,0,O-38-207-01-01-02
SOROTI,SOROTI MUNICIPALITY,EASTERN,AKISIM WARD,POLICE BARRACKS (N-Z),310,0,2,0,96,19,117,1,118,0,O-38-207-01-01-03
SOROTI,SOROTI MUNICIPALITY,EASTERN,AKISIM WARD,CELL II OUTSIDE Q.GUARD,906,0,1,1,112,92,206,5,211,0,O-38-207-01-01-04
SOROTI,SOROTI MUNICIPALITY,EASTERN,CENTRAL WARD,CELL A AND B,876,2,4,1,374,131,512,11,523,0,O-38-207-01-02-01
SOROTI,SOROTI MUNICIPALITY,EASTERN,CENTRAL WARD,CELL C AND D,978,1,4,1,393,152,551,6,557,0,O-38-207-01-02-02
SOROTI,SOROTI MUNICIPALITY,EASTERN,CENTRAL WARD,CELL E AND F,995,1,3,0,442,115,561,33,594,0,O-38-207-01-02-03
SOROTI,SOROTI MUNICIPALITY,EASTERN,CENTRAL WARD,CELL G,1149,2,5,1,432,161,601,9,610,0,O-38-207-01-02-04
SOROTI,SOROTI MUNICIPALITY,EASTERN,KENGERE WARD,AGIP - TESO INN,534,1,0,0,216,102,319,1,320,0,O-38-207-01-03-01
SOROTI,SOROTI MUNICIPALITY,EASTERN,KENGERE WARD,KENGERE EAST,759,3,2,1,329,138,473,6,479,0,O-38-207-01-03-02
SOROTI,SOROTI MUNICIPALITY,EASTERN,KENGERE WARD,KIGANDANI,1019,7,5,4,448,146,610,19,629,0,O-38-207-01-03-03
SOROTI,SOROTI MUNICIPALITY,EASTERN,KENGERE WARD,TESO INN (A-M),931,2,1,0,316,152,471,76,547,0,O-38-207-01-03-04
SOROTI,SOROTI MUNICIPALITY,EASTERN,KENGERE WARD,TESO INN (N-Z),282,0,2,0,106,57,165,11,176,0,O-38-207-01-03-05
SOROTI,SOROTI MUNICIPALITY,EASTERN,MORUAPESUR WARD,BAPTIST CHURCH,925,2,9,2,427,99,539,15,554,0,O-38-207-01-04-01
SOROTI,SOROTI MUNICIPALITY,EASTERN,MORUAPESUR WARD,CELL C,545,2,3,1,254,72,332,0,332,0,O-38-207-01-04-02
SOROTI,SOROTI MUNICIPALITY,EASTERN,MORUAPESUR WARD,CELL D AND E,1018,12,4,4,401,120,541,27,568,0,O-38-207-01-04-03
SOROTI,SOROTI MUNICIPALITY,EASTERN,MORUAPESUR WARD,KITARA,300,0,2,0,128,37,167,7,174,0,O-38-207-01-04-04
SOROTI,SOROTI MUNICIPALITY,NORTHERN,CAMP SWAHILI WAR,CAMPSWAHILI A,706,1,4,2,306,91,404,8,412,0,O-38-207-02-01-01
SOROTI,SOROTI MUNICIPALITY,NORTHERN,CAMP SWAHILI WAR,CAMPSWAHILI B,767,6,5,2,362,82,457,20,477,0,O-38-207-02-01-02
SOROTI,SOROTI MUNICIPALITY,NORTHERN,CAMP SWAHILI WAR,CAMPSWAHILI C,1117,6,6,2,444,115,573,102,675,0,O-38-207-02-01-03
SOROTI,SOROTI MUNICIPALITY,NORTHERN,KICHINJANJI WARD,KICHINJANJI A,985,8,4,14,384,154,564,11,575,0,O-38-207-02-02-01
SOROTI,SOROTI MUNICIPALITY,NORTHERN,KICHINJANJI WARD,KICHINJANJI B,793,0,2,1,311,145,459,7,466,0,O-38-207-02-02-02
SOROTI,SOROTI MUNICIPALITY,NORTHERN,KICHINJANJI WARD,KICHINJANJI C,554,1,3,1,218,77,300,20,320,0,O-38-207-02-02-03
SOROTI,SOROTI MUNICIPALITY,NORTHERN,KICHINJANJI WARD,KICHINJANJI D,567,3,3,5,260,100,371,13,384,0,O-38-207-02-02-04
SOROTI,SOROTI MUNICIPALITY,NORTHERN,MADERA WARD,OPEDURU,933,8,4,5,421,78,516,27,543,0,O-38-207-02-03-01
SOROTI,SOROTI MUNICIPALITY,NORTHERN,MADERA WARD,MADERA BOYS PRIMARY SCH.,805,15,7,4,396,80,502,0,502,0,O-38-207-02-03-02
SOROTI,SOROTI MUNICIPALITY,NORTHERN,MADERA WARD,AMINIT PRIMARY SCH.,183,2,1,1,96,30,130,12,142,0,O-38-207-02-03-03
SOROTI,SOROTI MUNICIPALITY,NORTHERN,PIONEER WARD,PIONEER A,622,3,3,0,273,70,349,26,375,0,O-38-207-02-04-01
SOROTI,SOROTI MUNICIPALITY,NORTHERN,PIONEER WARD,PIONEER B,413,0,2,1,154,53,210,3,213,0,O-38-207-02-04-02
SOROTI,SOROTI MUNICIPALITY,NORTHERN,PIONEER WARD,SOROTI FLYING SCHOOL BARRAC,114,1,0,0,22,56,79,7,86,0,O-38-207-02-04-03
SOROTI,SOROTI MUNICIPALITY,WESTERN,NAKATUNYA WARD,LUBIRI - NURSERY,1223,5,5,0,552,74,636,98,734,0,O-38-207-03-01-01
SOROTI,SOROTI MUNICIPALITY,WESTERN,NAKATUNYA WARD,MALINGA,883,5,7,5,386,85,488,12,500,0,O-38-207-03-01-02
SOROTI,SOROTI MUNICIPALITY,WESTERN,NAKATUNYA WARD,ODEKE B - WIRE,1011,7,7,2,487,68,571,25,596,0,O-38-207-03-01-03
SOROTI,SOROTI MUNICIPALITY,WESTERN,NAKATUNYA WARD,ODEKE A,234,0,4,0,102,30,136,6,142,0,O-38-207-03-01-04
SOROTI,SOROTI MUNICIPALITY,WESTERN,ODERAI/MAJENGO W,ODERAI - MAJENGO,931,12,2,6,456,92,568,25,593,0,O-38-207-03-02-01
SOROTI,SOROTI MUNICIPALITY,WESTERN,PAMBA WARD,PAMBA I,562,1,4,1,272,95,373,10,383,0,O-38-207-03-03-01
SOROTI,SOROTI MUNICIPALITY,WESTERN,PAMBA WARD,PAMBA II,627,5,4,4,307,107,427,16,443,0,O-38-207-03-03-02
SOROTI,SOROTI MUNICIPALITY,WESTERN,SENIOR QUARTERS,GOLF CLUB A,972,4,6,1,460,142,613,7,620,0,O-38-207-03-04-01
SOROTI,SOROTI MUNICIPALITY,WESTERN,SENIOR QUARTERS,GOLF CLUB B,637,2,1,0,270,69,342,36,378,0,O-38-207-03-04-02
TORORO,TORORO COUNTY,KWAPA,ASINGE,ASINGE-OGIROI A,405,2,0,6,101,194,303,28,331,0,O-39-213-01-01-01
TORORO,TORORO COUNTY,KWAPA,ASINGE,ASINGE-APUWA P. SCHOOL,571,5,0,8,107,306,426,31,457,0,O-39-213-01-01-02
TORORO,TORORO COUNTY,KWAPA,ASINGE,MAYEMBE TRADING CENTRE,589,4,3,5,214,218,444,17,461,0,O-39-213-01-01-03
TORORO,TORORO COUNTY,KWAPA,ASINGE,KAMOLI TRADING CENTRE,262,5,2,4,57,124,192,19,211,0,O-39-213-01-01-04
TORORO,TORORO COUNTY,KWAPA,KALAIT,KALAIT PRIMARY SCHOOL,734,5,4,4,361,151,525,13,538,0,O-39-213-01-02-01
TORORO,TORORO COUNTY,KWAPA,KALAIT,OCHOTO,668,4,1,3,243,189,440,46,486,0,O-39-213-01-02-02
TORORO,TORORO COUNTY,KWAPA,KWAPA,KWAPA S/COUNTY HQS,774,6,5,8,205,362,586,19,605,0,O-39-213-01-03-01
TORORO,TORORO COUNTY,KWAPA,KWAPA,ASINGE P.S,529,4,5,4,204,165,382,14,396,0,O-39-213-01-03-02
TORORO,TORORO COUNTY,KWAPA,KWAPA,KABOSA SAVEDS CHURCH,260,2,0,1,62,75,140,3,143,0,O-39-213-01-03-03
TORORO,TORORO COUNTY,KWAPA,KWAPA,CHEGEN P.S,683,6,0,7,316,171,500,14,514,0,O-39-213-01-03-04
TORORO,TORORO COUNTY,KWAPA,KWAPA,K'OTENGEL,237,0,0,2,38,126,166,25,191,0,O-39-213-01-03-05
TORORO,TORORO COUNTY,KWAPA,KWAPA,CHAFU TRADING CENTRE,245,1,0,7,72,100,180,2,182,0,O-39-213-01-03-06
TORORO,TORORO COUNTY,KWAPA,MORUKEBU,MOROKEBU PRIMARY SCHOOL,721,4,3,0,372,170,549,13,562,0,O-39-213-01-04-01
TORORO,TORORO COUNTY,MALABA TOWN COUNCIL,AKOLODONG,AKOLONDONG,495,4,3,1,159,156,323,23,346,0,O-39-213-02-01-01
TORORO,TORORO COUNTY,MALABA TOWN COUNCIL,AMAGORO,AMAGORO,394,1,0,7,105,135,248,8,256,0,O-39-213-02-02-01
TORORO,TORORO COUNTY,MALABA TOWN COUNCIL,ASINGE,ASINGE,362,4,2,0,100,64,170,9,179,0,O-39-213-02-03-01
TORORO,TORORO COUNTY,MALABA TOWN COUNCIL,MALABA,NORTH I KAASETS,802,2,1,1,221,131,356,9,365,0,O-39-213-02-04-01
TORORO,TORORO COUNTY,MALABA TOWN COUNCIL,MALABA,A NORTH II CHURCH,873,3,1,2,193,143,342,6,348,0,O-39-213-02-04-02
TORORO,TORORO COUNTY,MALABA TOWN COUNCIL,MALABA,A SOUTH I PRIMARY,349,0,1,1,65,59,126,0,126,0,O-39-213-02-04-03
TORORO,TORORO COUNTY,MALABA TOWN COUNCIL,MALABA,A SOUTH II TRANSOCEAN,344,0,3,1,107,62,173,2,175,0,O-39-213-02-04-04
TORORO,TORORO COUNTY,MALABA TOWN COUNCIL,MALABA,B EAST I MAGAMAGA,553,4,0,1,159,84,248,9,257,0,O-39-213-02-04-05
TORORO,TORORO COUNTY,MALABA TOWN COUNCIL,MALABA,B EAST II SEALAND (A-M),620,3,1,2,186,110,302,9,311,0,O-39-213-02-04-06
TORORO,TORORO COUNTY,MALABA TOWN COUNCIL,MALABA,B WEST SEBEI QTRS,526,3,0,2,139,179,323,15,338,0,O-39-213-02-04-07
TORORO,TORORO COUNTY,MALABA TOWN COUNCIL,MALABA,B EAST II SEALAND (N-Z),530,0,3,0,154,92,249,4,253,0,O-39-213-02-04-08
TORORO,TORORO COUNTY,MALABA TOWN COUNCIL,MALABA,MALABA,264,0,0,0,78,37,115,2,117,0,O-39-213-02-04-09
TORORO,TORORO COUNTY,MALABA TOWN COUNCIL,OBORE,OBORE A,819,4,3,0,206,125,338,1,339,0,O-39-213-02-05-01
TORORO,TORORO COUNTY,MALABA TOWN COUNCIL,OBORE,OBORE B,705,1,2,1,160,112,276,9,285,0,O-39-213-02-05-02
TORORO,TORORO COUNTY,MELLA,AMONI,AMALAI PENTECOSTAL CHURCH,588,5,0,3,162,219,389,23,412,0,O-39-213-03-01-01
TORORO,TORORO COUNTY,MELLA,AMONI,AMONI P. SCHOOL,704,2,2,6,407,138,555,23,578,0,O-39-213-03-01-02
TORORO,TORORO COUNTY,MELLA,AMONI,KAKUYE GEORGE CENTRE,550,6,1,11,237,122,377,36,413,0,O-39-213-03-01-03
TORORO,TORORO COUNTY,MELLA,AMONI,KODIKE CHURCH OF UGANDA,522,8,1,5,199,157,370,19,389,0,O-39-213-03-01-04
TORORO,TORORO COUNTY,MELLA,APOKOR,GLADYS' PLACE,343,1,0,1,48,160,210,54,264,0,O-39-213-03-02-01
TORORO,TORORO COUNTY,MELLA,APOKOR,APOKOR TRADING CENTRE,482,2,3,2,117,200,324,23,347,0,O-39-213-03-02-02
TORORO,TORORO COUNTY,MELLA,APOKOR,AMANEMOIT PRIMARY SCHOOL,468,7,3,3,123,185,321,29,350,0,O-39-213-03-02-03
TORORO,TORORO COUNTY,MELLA,APOKOR,PEREJE PLACE,253,5,0,2,79,70,156,35,191,0,O-39-213-03-02-04
TORORO,TORORO COUNTY,MELLA,KOITANGIRO,KOITANGIRO P. SCHOOL A,428,3,1,4,120,160,288,19,307,0,O-39-213-03-03-01
TORORO,TORORO COUNTY,MELLA,KOITANGIRO,KOITANGIRO P.S. B,214,1,0,1,86,59,147,11,158,0,O-39-213-03-03-02
TORORO,TORORO COUNTY,MELLA,MELLA,OMAYEMBE,476,7,1,0,164,109,281,84,365,0,O-39-213-03-04-01
TORORO,TORORO COUNTY,MELLA,MELLA,PENTECOSTAL OUTREACH,362,2,0,3,144,147,296,1,297,0,O-39-213-03-04-02
TORORO,TORORO COUNTY,MELLA,MELLA,MELLA P/S,416,2,1,2,158,100,263,6,269,0,O-39-213-03-04-03
TORORO,TORORO COUNTY,MELLA,MELLA,CHECK POINT,389,1,1,1,74,213,290,25,315,0,O-39-213-03-04-04
TORORO,TORORO COUNTY,MERIKIT,AMURWO,GAYAZA MARKET,335,4,2,1,191,52,250,27,277,0,O-39-213-04-01-01
TORORO,TORORO COUNTY,MERIKIT,AMURWO,AMURWO P/S,477,7,1,1,258,95,362,9,371,0,O-39-213-04-01-02
TORORO,TORORO COUNTY,MERIKIT,AMURWO,AMURWO C.O.U,519,3,0,2,227,120,352,7,359,0,O-39-213-04-01-03
TORORO,TORORO COUNTY,MERIKIT,APOKOR,BEDI PALE,607,5,0,2,358,125,490,5,495,0,O-39-213-04-02-01
TORORO,TORORO COUNTY,MERIKIT,APOKOR,APOKOR P. S.,573,3,2,0,323,78,406,56,462,0,O-39-213-04-02-02
TORORO,TORORO COUNTY,MERIKIT,KACHINGA,C.A. TRADING CENTRE,429,2,3,2,214,99,320,51,371,0,O-39-213-04-03-01
TORORO,TORORO COUNTY,MERIKIT,KACHINGA,KACHINGA,337,2,1,0,155,73,231,52,283,0,O-39-213-04-03-02
TORORO,TORORO COUNTY,MERIKIT,KACHINGA,MORUKAPEL,559,5,3,1,200,80,289,165,454,0,O-39-213-04-03-03
TORORO,TORORO COUNTY,MERIKIT,MALIRI,MVULE TREE,433,2,1,1,271,69,344,14,358,0,O-39-213-04-04-01
TORORO,TORORO COUNTY,MERIKIT,MALIRI,MALIR P.S B,332,0,2,3,150,98,253,5,258,0,O-39-213-04-04-02
TORORO,TORORO COUNTY,MERIKIT,MALIRI,MANGO TREE,631,7,2,0,222,158,389,117,506,0,O-39-213-04-04-03
TORORO,TORORO COUNTY,MERIKIT,MALIRI,MALIRI P.S. D,350,8,4,1,184,61,258,39,297,0,O-39-213-04-04-04
TORORO,TORORO COUNTY,MERIKIT,MERIKIT,MERIKIT H/UNIT,425,8,3,1,208,46,266,60,326,0,O-39-213-04-05-01
TORORO,TORORO COUNTY,MERIKIT,MERIKIT,MEREKIT P/S,290,3,4,1,154,47,209,13,222,0,O-39-213-04-05-02
TORORO,TORORO COUNTY,MERIKIT,MERIKIT,MERIKIT P.S. A,403,6,0,3,215,52,276,38,314,0,O-39-213-04-05-03
TORORO,TORORO COUNTY,MERIKIT,MERIKIT,MERIKIT P.S. B,458,7,2,3,300,46,358,9,367,0,O-39-213-04-05-04
TORORO,TORORO COUNTY,MOLO,KIDOKO,KIDOKO P.S.,336,3,16,3,216,32,270,14,284,0,O-39-213-05-01-01
TORORO,TORORO COUNTY,MOLO,KIDOKO,NO CHANGE CENTRE,644,3,1,1,278,137,420,76,496,0,O-39-213-05-01-02
TORORO,TORORO COUNTY,MOLO,KIPANGOR,NYEMNYEM P.S.,415,3,4,5,228,100,340,15,355,0,O-39-213-05-02-01
TORORO,TORORO COUNTY,MOLO,KIPANGOR,KIPANGOR MARKET,493,4,7,3,257,100,371,16,387,0,O-39-213-05-02-02
TORORO,TORORO COUNTY,MOLO,KIPANGOR,NANKATA BAR,268,4,4,0,171,45,224,5,229,0,O-39-213-05-02-03
TORORO,TORORO COUNTY,MOLO,KIPANGOR,PAPAKOL CENTRE,436,4,4,1,253,69,331,5,336,0,O-39-213-05-02-04
TORORO,TORORO COUNTY,MOLO,MOLO,MORU CO-OP SOCIETY,578,3,3,1,287,159,453,18,471,0,O-39-213-05-03-01
TORORO,TORORO COUNTY,MOLO,MOLO,MOLO SUB/COUNTY HQRS,691,2,3,4,224,225,458,28,486,0,O-39-213-05-03-02
TORORO,TORORO COUNTY,MOLO,MOLO,RAILWAY STATION,619,1,2,7,279,169,458,24,482,0,O-39-213-05-03-03
TORORO,TORORO COUNTY,MOLO,TUBA,GINNERY,649,5,0,1,302,169,477,8,485,0,O-39-213-05-04-01
TORORO,TORORO COUNTY,MOLO,TUBA,TUBA PRIMARY SCHOOL,303,0,4,0,137,69,210,8,218,0,O-39-213-05-04-02
TORORO,TORORO COUNTY,MOLO,TUBA,MILE 8 MARKET,231,2,6,0,91,51,150,24,174,0,O-39-213-05-04-03
TORORO,TORORO COUNTY,MUKUJU,AKADOT,AKADOT PRIMARY SCHOOL,611,5,8,0,405,118,536,14,550,0,O-39-213-06-01-01
TORORO,TORORO COUNTY,MUKUJU,AKADOT,ATIR CHURCH,814,8,7,8,434,104,561,27,588,0,O-39-213-06-01-02
TORORO,TORORO COUNTY,MUKUJU,AKADOT,AKADOT SOCIETY A,333,2,1,2,216,93,314,9,323,0,O-39-213-06-01-03
TORORO,TORORO COUNTY,MUKUJU,AKADOT,AKADOT SOCIETY B,336,6,5,2,174,38,225,36,261,0,O-39-213-06-01-04
TORORO,TORORO COUNTY,MUKUJU,ATIRI,ATIRI S.S.S,646,3,3,0,219,61,286,81,367,0,O-39-213-06-02-01
TORORO,TORORO COUNTY,MUKUJU,ATIRI,KAJARAU,1200,5,0,5,321,384,715,88,803,0,O-39-213-06-02-02
TORORO,TORORO COUNTY,MUKUJU,ATIRI,ATIRI PRIMARY SCHOOL,232,0,1,1,134,46,182,6,188,0,O-39-213-06-02-03
TORORO,TORORO COUNTY,MUKUJU,KALACHAI,KALACHAI C O UGANDA,695,4,1,1,164,257,427,97,524,0,O-39-213-06-03-01
TORORO,TORORO COUNTY,MUKUJU,KALACHAI,KALACHAI CATHOLIC CHURCH,726,7,1,0,216,211,435,94,529,0,O-39-213-06-03-02
TORORO,TORORO COUNTY,MUKUJU,KAMULI,KAMULI P/SCHOOL A,497,5,3,3,203,70,284,59,343,0,O-39-213-06-04-01
TORORO,TORORO COUNTY,MUKUJU,KAMULI,KAMULI P. SCHOOL B,305,4,0,0,127,44,175,43,218,0,O-39-213-06-04-02
TORORO,TORORO COUNTY,MUKUJU,KAMULI,KAMULI P. SCHOOL C,433,1,0,0,237,54,292,43,335,0,O-39-213-06-04-03
TORORO,TORORO COUNTY,MUKUJU,KAMULI,PAGOYA P. SCHOOL,426,3,4,1,209,40,257,0,257,0,O-39-213-06-04-04
TORORO,TORORO COUNTY,MUKUJU,MUKUJU,AKWOROT P. SCHOOL A,279,2,1,4,100,111,218,5,223,0,O-39-213-06-05-01
TORORO,TORORO COUNTY,MUKUJU,MUKUJU,AKWOROT P. SCHOOL B,165,2,0,0,45,55,102,19,121,0,O-39-213-06-05-02
TORORO,TORORO COUNTY,MUKUJU,MUKUJU,MUKUJU,509,1,3,1,196,142,343,22,365,0,O-39-213-06-05-03
TORORO,TORORO COUNTY,MUKUJU,MUKUJU,MUKUJU B,464,2,0,0,171,94,267,18,285,0,O-39-213-06-05-04
TORORO,TORORO COUNTY,MUKUJU,PETTA,ST. ANDREW'S COLLEGE,567,1,1,1,267,72,342,83,425,0,O-39-213-06-06-01
TORORO,TORORO COUNTY,MUKUJU,PETTA,AUKOT C.O. UGANDA,407,5,1,0,199,42,247,50,297,0,O-39-213-06-06-02
TORORO,TORORO COUNTY,MUKUJU,PETTA,PETTA P/ SCHOOL,405,7,0,1,220,102,330,44,374,0,O-39-213-06-06-03
TORORO,TORORO COUNTY,MUKUJU,PETTA,TOTOKIDWE P/SCHOOL,516,7,2,4,187,175,375,16,391,0,O-39-213-06-06-04
TORORO,TORORO COUNTY,OSUKURU,KAYORO,ASINGET MARKET,444,7,60,2,142,109,320,20,340,0,O-39-213-07-01-01
TORORO,TORORO COUNTY,OSUKURU,KAYORO,BUYEMBA P. SCHOOL A,450,1,4,1,149,146,301,0,301,0,O-39-213-07-01-02
TORORO,TORORO COUNTY,OSUKURU,KAYORO,KAYORO TRADING CENTRE,565,2,6,4,200,184,396,13,409,0,O-39-213-07-01-03
TORORO,TORORO COUNTY,OSUKURU,KAYORO,AGOLOT CHURCH,465,1,0,4,82,215,302,4,306,0,O-39-213-07-01-04
TORORO,TORORO COUNTY,OSUKURU,KAYORO,UTRO,567,3,10,6,153,192,364,27,391,0,O-39-213-07-01-05
TORORO,TORORO COUNTY,OSUKURU,KAYORO,SALIM'S PLACE,656,5,3,6,166,287,467,16,483,0,O-39-213-07-01-06
TORORO,TORORO COUNTY,OSUKURU,KAYORO,KASIPODO,364,0,1,1,91,171,264,14,278,0,O-39-213-07-01-07
TORORO,TORORO COUNTY,OSUKURU,MORUKATIPE,APUTIRI PRIMARY SCHOOL,515,5,1,5,160,202,373,34,407,0,O-39-213-07-02-01
TORORO,TORORO COUNTY,OSUKURU,MORUKATIPE,ANGOROM-MULALO BAR A,358,3,1,3,96,170,273,16,289,0,O-39-213-07-02-02
TORORO,TORORO COUNTY,OSUKURU,MORUKATIPE,ATIPE ROCK,723,5,2,6,274,207,494,32,526,0,O-39-213-07-02-03
TORORO,TORORO COUNTY,OSUKURU,MORUKATIPE,TORORO PRISONS,221,0,0,1,72,57,130,9,139,0,O-39-213-07-02-04
TORORO,TORORO COUNTY,OSUKURU,MORUKATIPE,ANGOROM-MULALO BAR B,511,2,3,6,165,220,396,20,416,0,O-39-213-07-02-05
TORORO,TORORO COUNTY,OSUKURU,NYALAKOT,AMONI NATIONAL WATER WORKS,398,4,2,3,180,191,380,18,398,0,O-39-213-07-03-01
TORORO,TORORO COUNTY,OSUKURU,NYALAKOT,ASINGE-ANGOLOLO BAR,496,3,1,10,135,173,322,31,353,0,O-39-213-07-03-02
TORORO,TORORO COUNTY,OSUKURU,NYALAKOT,KACHOMO (MORUKATIPE P/SCHO,655,7,4,12,212,162,397,27,424,0,O-39-213-07-03-03
TORORO,TORORO COUNTY,OSUKURU,NYALAKOT,KACHOMO (KAPIRIBELA),462,5,0,0,183,169,357,16,373,0,O-39-213-07-03-04
TORORO,TORORO COUNTY,OSUKURU,NYALAKOT,ORIYOI PRIMARY SCHOOL,722,7,1,3,219,321,551,23,574,0,O-39-213-07-03-05
TORORO,TORORO COUNTY,OSUKURU,NYALAKOT,MWOGO BAR,195,3,0,1,54,53,111,8,119,0,O-39-213-07-03-06
TORORO,TORORO COUNTY,OSUKURU,OSUKURU,LULUKOYO TREE GROUND,508,3,3,4,233,148,391,0,391,0,O-39-213-07-04-01
TORORO,TORORO COUNTY,OSUKURU,OSUKURU,COMORO TRADING CENTRE B,504,6,3,4,191,155,359,12,371,0,O-39-213-07-04-02
TORORO,TORORO COUNTY,OSUKURU,OSUKURU,GREEN LAND TICAF,567,4,9,5,220,112,350,6,356,0,O-39-213-07-04-03
TORORO,TORORO COUNTY,OSUKURU,OSUKURU,OSUKURU SUB/COUNTY HQRS A,584,2,6,0,165,175,348,18,366,0,O-39-213-07-04-04
TORORO,TORORO COUNTY,OSUKURU,OSUKURU,ASINGE PLAY GROUND,354,3,5,6,78,168,260,37,297,0,O-39-213-07-04-05
TORORO,TORORO COUNTY,OSUKURU,OSUKURU,OSUKURU P/S B,669,4,2,5,183,243,437,30,467,0,O-39-213-07-04-06
TORORO,TORORO COUNTY,OSUKURU,OSUKURU,U C I PRIMARY SCHOOL A,547,1,5,0,158,82,246,0,246,0,O-39-213-07-04-07
TORORO,TORORO COUNTY,OSUKURU,OSUKURU,NGELECHOM P. SCHOOL,439,5,2,2,100,203,312,0,312,0,O-39-213-07-04-08
TORORO,TORORO COUNTY,OSUKURU,OSUKURU,ABWANGET T.T.C,440,8,4,3,111,204,330,20,350,0,O-39-213-07-04-09
TORORO,TORORO COUNTY,OSUKURU,OSUKURU,U C I PRIMARY SCHOOL B,532,3,11,1,212,68,295,10,305,0,O-39-213-07-04-10
TORORO,TORORO MUNICIPALITY,TORORO EASTERN,AMAGORO A,DISTRICT FARM INSTITUTE,647,1,6,4,211,189,411,11,422,0,O-39-214-01-01-01
TORORO,TORORO MUNICIPALITY,TORORO EASTERN,AMAGORO A,AMAGORO PRIMARY SCHOOL,622,8,7,4,142,295,456,22,478,0,O-39-214-01-01-02
TORORO,TORORO MUNICIPALITY,TORORO EASTERN,AMAGORO A,TORORO UNIPORTS,792,7,6,3,302,191,509,16,525,0,O-39-214-01-01-03
TORORO,TORORO MUNICIPALITY,TORORO EASTERN,AMAGORO A,ELGON VIEW PRIMARY SCH,445,0,13,1,152,58,224,4,228,0,O-39-214-01-01-04
TORORO,TORORO MUNICIPALITY,TORORO EASTERN,AMAGORO B,ST. KIZITO PRIMARY SCHOOL A,554,1,4,2,147,188,342,24,366,0,O-39-214-01-02-01
TORORO,TORORO MUNICIPALITY,TORORO EASTERN,AMAGORO B,ST. KIZITO PRIMARY SCHOOL B,748,2,3,4,195,270,474,12,486,0,O-39-214-01-02-02
TORORO,TORORO MUNICIPALITY,TORORO EASTERN,KASOLI,KASOLI,580,1,7,3,171,128,310,17,327,0,O-39-214-01-03-01
TORORO,TORORO MUNICIPALITY,TORORO EASTERN,KASOLI,NAME_MISSING,514,2,6,0,151,122,281,11,292,0,O-39-214-01-03-02
TORORO,TORORO MUNICIPALITY,TORORO EASTERN,KASOLI,POLICE QUARTERS,637,1,5,1,199,105,311,7,318,0,O-39-214-01-03-03
TORORO,TORORO MUNICIPALITY,TORORO EASTERN,KASOLI,RAILWAY QUARTERS,555,1,2,1,257,82,343,4,347,0,O-39-214-01-03-04
TORORO,TORORO MUNICIPALITY,TORORO EASTERN,NYANGOLE,NYANGOLE A,514,5,5,5,136,148,299,15,314,0,O-39-214-01-04-01
TORORO,TORORO MUNICIPALITY,TORORO EASTERN,NYANGOLE,NYANGOLE B,546,5,3,7,190,138,343,12,355,0,O-39-214-01-04-02
TORORO,TORORO MUNICIPALITY,TORORO WESTERN,AGURURU A,OGUTI P. SCHOOL,557,4,3,0,153,62,222,3,225,0,O-39-214-02-01-01
TORORO,TORORO MUNICIPALITY,TORORO WESTERN,AGURURU A,AGURURU T/C,502,3,3,1,124,106,237,5,242,0,O-39-214-02-01-02
TORORO,TORORO MUNICIPALITY,TORORO WESTERN,AGURURU A,HAJI KOIRE'S PLACE,751,0,2,0,223,163,388,6,394,0,O-39-214-02-01-03
TORORO,TORORO MUNICIPALITY,TORORO WESTERN,AGURURU A,ABAMURIS PLACE,548,1,2,0,134,92,229,6,235,0,O-39-214-02-01-04
TORORO,TORORO MUNICIPALITY,TORORO WESTERN,AGURURU A,CHEMWINULA H. CENTRE,352,2,6,2,92,167,269,14,283,0,O-39-214-02-01-05
TORORO,TORORO MUNICIPALITY,TORORO WESTERN,AGURURU A,AGURURU {N-Z},377,1,3,0,125,65,194,1,195,0,O-39-214-02-01-06
TORORO,TORORO MUNICIPALITY,TORORO WESTERN,AGURURU A,HAJI KOIRE/LONG HOUSE N-Z,438,1,4,0,125,100,230,2,232,0,O-39-214-02-01-07
TORORO,TORORO MUNICIPALITY,TORORO WESTERN,AGURURU B,AGURURU P.S.,541,2,6,0,154,173,335,24,359,0,O-39-214-02-02-01
TORORO,TORORO MUNICIPALITY,TORORO WESTERN,AGURURU B,U C C SITE,710,2,2,0,210,170,384,11,395,0,O-39-214-02-02-02
TORORO,TORORO MUNICIPALITY,TORORO WESTERN,AGURURU B,JAMBULA II,437,1,3,0,103,108,215,15,230,0,O-39-214-02-02-03
TORORO,TORORO MUNICIPALITY,TORORO WESTERN,AGURURU B,MULONGO'S PLACE,286,0,11,1,95,87,194,14,208,0,O-39-214-02-02-04
TORORO,TORORO MUNICIPALITY,TORORO WESTERN,BISON/MAGURIA,BISON A,502,2,5,2,158,110,277,13,290,0,O-39-214-02-03-01
TORORO,TORORO MUNICIPALITY,TORORO WESTERN,BISON/MAGURIA,BISON B,463,1,4,4,111,102,222,35,257,0,O-39-214-02-03-02
TORORO,TORORO MUNICIPALITY,TORORO WESTERN,BISON/MAGURIA,MILLENIUM UNIVERSAL COLLEGE,609,2,6,0,168,110,286,9,295,0,O-39-214-02-03-03
TORORO,TORORO MUNICIPALITY,TORORO WESTERN,BISON/MAGURIA,JUBA PRIMARY SCHOOL,382,2,4,2,151,81,240,27,267,0,O-39-214-02-03-04
TORORO,TORORO MUNICIPALITY,TORORO WESTERN,BISON/MAGURIA,BISON A {N-Z},386,6,7,1,140,95,249,3,252,0,O-39-214-02-03-05
TORORO,TORORO MUNICIPALITY,TORORO WESTERN,BISON/MAGURIA,BISON B {N - Z},482,1,3,3,128,95,230,15,245,0,O-39-214-02-03-06
TORORO,TORORO MUNICIPALITY,TORORO WESTERN,CENTRAL,ELGONIA INDUSTRIES,531,4,4,0,174,78,260,1,261,0,O-39-214-02-04-01
TORORO,TORORO MUNICIPALITY,TORORO WESTERN,CENTRAL,MUNICIPAL GARDENS II A,829,3,9,0,260,153,425,7,432,0,O-39-214-02-04-02
TORORO,TORORO MUNICIPALITY,TORORO WESTERN,CENTRAL,MUNICIPAL GARDENS III A,1138,2,14,0,373,146,535,8,543,0,O-39-214-02-04-03
TORORO,TORORO MUNICIPALITY,TORORO WESTERN,CENTRAL,CHILDRENS PARK,659,0,2,2,162,85,251,4,255,0,O-39-214-02-04-04
TORORO,TORORO MUNICIPALITY,TORORO WESTERN,CENTRAL,ELGONIA INDUSTRIES {N-Z},473,4,1,0,149,57,211,1,212,0,O-39-214-02-04-05
TORORO,TORORO MUNICIPALITY,TORORO WESTERN,CENTRAL,MUNICIPAL GARDENS II B,399,3,4,1,125,50,183,1,184,0,O-39-214-02-04-06
TORORO,TORORO MUNICIPALITY,TORORO WESTERN,CENTRAL,MUNICIPAL GARDENS III B,487,1,7,0,173,62,243,3,246,0,O-39-214-02-04-07
TORORO,WEST BUDAMA CTY NORTH,KIREWA,KATANDI,PAJIEWO,369,1,3,2,160,49,215,56,271,0,O-39-209-01-01-01
TORORO,WEST BUDAMA CTY NORTH,KIREWA,KATANDI,KATANDI PRIMARY SCHOOL,432,4,5,0,104,57,170,123,293,0,O-39-209-01-01-02
TORORO,WEST BUDAMA CTY NORTH,KIREWA,KATANDI,KATANDI MAGEMBO-TINDO SELE,517,11,9,7,171,66,264,103,367,0,O-39-209-01-01-03
TORORO,WEST BUDAMA CTY NORTH,KIREWA,KATANDI,WIKUS PRMARY SCHOOL,498,13,16,1,148,66,244,114,358,0,O-39-209-01-01-04
TORORO,WEST BUDAMA CTY NORTH,KIREWA,KIREWA,KIREWA,461,5,8,2,150,81,246,81,327,0,O-39-209-01-02-01
TORORO,WEST BUDAMA CTY NORTH,KIREWA,KIREWA,PANYALIECH,592,7,16,4,244,92,363,124,487,0,O-39-209-01-02-02
TORORO,WEST BUDAMA CTY NORTH,KIREWA,KIREWA,NYAFUMBA,506,8,10,3,168,72,261,99,360,0,O-39-209-01-02-03
TORORO,WEST BUDAMA CTY NORTH,KIREWA,KIREWA,SIMWENGI,656,9,8,7,211,198,433,11,444,0,O-39-209-01-02-04
TORORO,WEST BUDAMA CTY NORTH,KIREWA,MIFUMI,MIFUMI PRIMARY SCHOOL,541,4,8,1,179,159,351,87,438,0,O-39-209-01-03-01
TORORO,WEST BUDAMA CTY NORTH,KIREWA,MIFUMI,NGULIMO-BUWENDA MARKET,585,4,21,5,198,143,371,95,466,0,O-39-209-01-03-02
TORORO,WEST BUDAMA CTY NORTH,KIREWA,MIFUMI,NYABANJA P. SCHOOL,688,6,61,0,202,175,444,117,561,0,O-39-209-01-03-03
TORORO,WEST BUDAMA CTY NORTH,KIREWA,MIFUMI,MIFUMI ECD,229,5,15,0,88,50,158,42,200,0,O-39-209-01-03-04
TORORO,WEST BUDAMA CTY NORTH,KIREWA,SENDA,SENDA CATHOLIC CHURCH A,470,13,8,12,215,78,326,33,359,0,O-39-209-01-04-01
TORORO,WEST BUDAMA CTY NORTH,KIREWA,SENDA,SENDA CATHOLIC CHURCH B,534,4,9,6,237,144,400,20,420,0,O-39-209-01-04-02
TORORO,WEST BUDAMA CTY NORTH,KIREWA,SONI,KAINJA PRIMARY SCHOOL,501,8,4,6,253,111,382,23,405,0,O-39-209-01-05-01
TORORO,WEST BUDAMA CTY NORTH,KIREWA,SONI,NYAGOKE PRIMARY SCHOOL,381,2,5,8,163,112,290,19,309,0,O-39-209-01-05-02
TORORO,WEST BUDAMA CTY NORTH,KIREWA,SONI,SONI PRIMARY SCHOOL A,425,5,7,3,174,91,280,49,329,0,O-39-209-01-05-03
TORORO,WEST BUDAMA CTY NORTH,KIREWA,SONI,"SONI PRIMARY SCHOOL ""B""",378,2,3,0,120,103,228,53,281,0,O-39-209-01-05-04
TORORO,WEST BUDAMA CTY NORTH,KIREWA,SONI,NYAKATOKE,331,3,7,3,145,110,268,14,282,0,O-39-209-01-05-05
TORORO,WEST BUDAMA CTY NORTH,KISOKO,GWARAGWARA,COUNTY CHIEF'S RES,696,4,7,0,128,307,446,110,556,0,O-39-209-02-01-01
TORORO,WEST BUDAMA CTY NORTH,KISOKO,GWARAGWARA,GWARAGWARA PROJECT,482,3,2,0,61,312,378,23,401,0,O-39-209-02-01-02
TORORO,WEST BUDAMA CTY NORTH,KISOKO,GWARAGWARA,GWARAGWARA P/S,597,6,4,5,73,285,373,98,471,0,O-39-209-02-01-03
TORORO,WEST BUDAMA CTY NORTH,KISOKO,KISOKO,MORIWA,431,5,13,7,162,151,338,10,348,0,O-39-209-02-02-01
TORORO,WEST BUDAMA CTY NORTH,KISOKO,KISOKO,BENDO,510,2,6,6,139,219,372,44,416,0,O-39-209-02-02-02
TORORO,WEST BUDAMA CTY NORTH,KISOKO,KISOKO,KISOKO COUNTY HQRS,294,2,0,0,52,148,202,21,223,0,O-39-209-02-02-03
TORORO,WEST BUDAMA CTY NORTH,KISOKO,KISOKO,DIDA CHURCH,382,1,3,3,110,178,295,23,318,0,O-39-209-02-02-04
TORORO,WEST BUDAMA CTY NORTH,KISOKO,MORKISWA,AMOR-KISOKO,593,6,7,4,126,329,472,40,512,0,O-39-209-02-03-01
TORORO,WEST BUDAMA CTY NORTH,KISOKO,MORKISWA,MORGWANG MARKET,478,3,1,2,123,166,295,0,295,0,O-39-209-02-03-02
TORORO,WEST BUDAMA CTY NORTH,KISOKO,MORKISWA,MORKISWA P/SCHOOL,717,6,0,1,182,293,482,101,583,0,O-39-209-02-03-03
TORORO,WEST BUDAMA CTY NORTH,KISOKO,PEI - PEI,KAKOLA,747,11,15,10,196,320,552,55,607,0,O-39-209-02-04-01
TORORO,WEST BUDAMA CTY NORTH,KISOKO,PEI - PEI,PEIPEI P. SCHOOL,411,1,5,0,86,197,289,67,356,0,O-39-209-02-04-02
TORORO,WEST BUDAMA CTY NORTH,NAGONGERA,KATAJULA,KATAJULA COOP. SOCIETY,518,13,4,7,237,140,401,12,413,0,O-39-209-03-01-01
TORORO,WEST BUDAMA CTY NORTH,NAGONGERA,KATAJULA,MIKOME,529,3,19,0,222,96,340,89,429,0,O-39-209-03-01-02
TORORO,WEST BUDAMA CTY NORTH,NAGONGERA,KATAJULA,MATINDI PRIMARY SCHOOL,436,6,14,5,157,146,328,18,346,0,O-39-209-03-01-03
TORORO,WEST BUDAMA CTY NORTH,NAGONGERA,KATAJULA,MUKWANA PRIMARY SCHOOL,420,2,5,1,133,161,302,43,345,0,O-39-209-03-01-04
TORORO,WEST BUDAMA CTY NORTH,NAGONGERA,KATAJULA,WOLERA MARKET,458,12,18,5,189,97,321,24,345,0,O-39-209-03-01-05
TORORO,WEST BUDAMA CTY NORTH,NAGONGERA,KATAJULA,MUKERA TRADING CENTRE,362,1,6,1,84,139,231,66,297,0,O-39-209-03-01-06
TORORO,WEST BUDAMA CTY NORTH,NAGONGERA,MAUNDO,POKECHO-ONERI,357,1,4,0,108,104,217,71,288,0,O-39-209-03-02-01
TORORO,WEST BUDAMA CTY NORTH,NAGONGERA,MAUNDO,POKONGO PLAIN P.SCHOOL,491,6,22,1,216,114,359,17,376,0,O-39-209-03-02-02
TORORO,WEST BUDAMA CTY NORTH,NAGONGERA,MAUNDO,MAUNDO P. SCHOOL,696,18,36,8,304,177,543,24,567,0,O-39-209-03-02-03
TORORO,WEST BUDAMA CTY NORTH,NAGONGERA,MAUNDO,MAUNDO MARKET,516,10,11,2,204,65,292,147,439,0,O-39-209-03-02-04
TORORO,WEST BUDAMA CTY NORTH,NAGONGERA,MAUNDO,P'OCHIENG OBARA,228,2,3,2,67,96,170,24,194,0,O-39-209-03-02-05
TORORO,WEST BUDAMA CTY NORTH,NAGONGERA,MAUNDO,POKONG ROCK P/S,264,3,3,1,99,106,212,7,219,0,O-39-209-03-02-06
TORORO,WEST BUDAMA CTY NORTH,NAGONGERA,NAGONGERA,CHING MAROMU,301,6,21,2,82,71,182,0,182,0,O-39-209-03-03-01
TORORO,WEST BUDAMA CTY NORTH,NAGONGERA,NAGONGERA,MAHANGA PRIMARY SCHOOL,548,2,10,0,195,130,337,66,403,0,O-39-209-03-03-02
TORORO,WEST BUDAMA CTY NORTH,NAGONGERA,NAGONGERA,NAGONGERA BOYS PRIMARY SCH,387,2,6,6,164,105,283,31,314,0,O-39-209-03-03-03
TORORO,WEST BUDAMA CTY NORTH,NAGONGERA,NAGONGERA,NAGONGERA S/COUNTY HQRS I,452,1,23,6,181,124,335,12,347,0,O-39-209-03-03-04
TORORO,WEST BUDAMA CTY NORTH,NAGONGERA,NAGONGERA,P'OBURU ODANGO,441,3,17,6,169,138,333,18,351,0,O-39-209-03-03-05
TORORO,WEST BUDAMA CTY NORTH,NAGONGERA,NAGONGERA,ROCK HILL PRIMARY SCHOOL,396,3,52,6,151,80,292,16,308,0,O-39-209-03-03-06
TORORO,WEST BUDAMA CTY NORTH,NAGONGERA,NAGONGERA,RUCHWA,378,3,9,1,156,51,220,0,220,0,O-39-209-03-03-07
TORORO,WEST BUDAMA CTY NORTH,NAGONGERA,NAGONGERA,BULER,527,4,21,3,189,167,384,38,422,0,O-39-209-03-03-08
TORORO,WEST BUDAMA CTY NORTH,NAGONGERA,NAGONGERA,WERE,354,5,6,2,139,66,218,82,300,0,O-39-209-03-03-09
TORORO,WEST BUDAMA CTY NORTH,NAGONGERA,NAMWAYA,CHAMI-KWOK,336,0,2,1,61,149,213,65,278,0,O-39-209-03-04-01
TORORO,WEST BUDAMA CTY NORTH,NAGONGERA,NAMWAYA,PADAMIANO,313,0,4,1,113,88,206,0,206,0,O-39-209-03-04-02
TORORO,WEST BUDAMA CTY NORTH,NAGONGERA,NAMWAYA,ROCK MARKET,340,1,15,0,54,166,236,30,266,0,O-39-209-03-04-03
TORORO,WEST BUDAMA CTY NORTH,NAGONGERA,NAMWAYA,MBOYA TRADING CENTRE,282,1,1,0,59,121,182,45,227,0,O-39-209-03-04-04
TORORO,WEST BUDAMA CTY NORTH,NAGONGERA,NAMWAYA,NAMWAYA P. SCHOOL,510,2,8,3,159,167,339,86,425,0,O-39-209-03-04-05
TORORO,WEST BUDAMA CTY NORTH,NAGONGERA,NAMWAYA,NAMWAYA TRADING CENTRE,626,4,5,0,108,265,382,119,501,0,O-39-209-03-04-06
TORORO,WEST BUDAMA CTY NORTH,PAYA,BARINYANGA,ATAPARA PRIMARY SCHOOL,429,4,3,0,157,117,281,91,372,0,O-39-209-04-01-01
TORORO,WEST BUDAMA CTY NORTH,PAYA,BARINYANGA,BARINYANGA COOP. SOCIETY,349,1,4,1,110,139,255,36,291,0,O-39-209-04-01-02
TORORO,WEST BUDAMA CTY NORTH,PAYA,BARINYANGA,BARINYANGA C.O.U,436,8,4,3,206,93,314,49,363,0,O-39-209-04-01-03
TORORO,WEST BUDAMA CTY NORTH,PAYA,BARINYANGA,SENGO C.O.U,325,2,4,0,131,95,232,52,284,0,O-39-209-04-01-04
TORORO,WEST BUDAMA CTY NORTH,PAYA,BARINYANGA,SENGO PRIMARY SCHOOL,431,10,1,1,128,152,292,68,360,0,O-39-209-04-01-05
TORORO,WEST BUDAMA CTY NORTH,PAYA,NABOA,P'OKADAKI,228,7,6,1,140,43,197,8,205,0,O-39-209-04-02-01
TORORO,WEST BUDAMA CTY NORTH,PAYA,NABOA,NABOA C/U,507,12,5,2,197,143,359,79,438,0,O-39-209-04-02-02
TORORO,WEST BUDAMA CTY NORTH,PAYA,NAMWENDIA,PANOAH P/S,398,5,9,3,219,94,330,8,338,0,O-39-209-04-03-01
TORORO,WEST BUDAMA CTY NORTH,PAYA,NAMWENDIA,BIYEMOTH T/C,430,0,5,3,146,201,355,24,379,0,O-39-209-04-03-02
TORORO,WEST BUDAMA CTY NORTH,PAYA,NAMWENDIA,BERE P/S,442,5,5,4,172,132,318,52,370,0,O-39-209-04-03-03
TORORO,WEST BUDAMA CTY NORTH,PAYA,NAMWENDIA,NAMWENDIA P/S,396,5,1,6,131,151,294,59,353,0,O-39-209-04-03-04
TORORO,WEST BUDAMA CTY NORTH,PAYA,NAWIRE,CORNER TRADING CENTRE,317,3,1,3,153,98,258,18,276,0,O-39-209-04-04-01
TORORO,WEST BUDAMA CTY NORTH,PAYA,NAWIRE,MILE TWO T/C,344,5,6,3,160,73,247,16,263,0,O-39-209-04-04-02
TORORO,WEST BUDAMA CTY NORTH,PAYA,NAWIRE,PAYA S/COUNTY HQRS.,415,0,12,0,181,56,249,0,249,0,O-39-209-04-04-03
TORORO,WEST BUDAMA CTY NORTH,PAYA,NAWIRE,NAWIRE PRIMARY SCHOOL,466,3,7,6,218,111,345,32,377,0,O-39-209-04-04-04
TORORO,WEST BUDAMA CTY NORTH,PAYA,NAWIRE,RULWA P'OKIRIA,593,14,13,10,279,87,403,18,421,0,O-39-209-04-04-05
TORORO,WEST BUDAMA CTY NORTH,PAYA,NAWIRE,RAMOGI ROCK,272,1,9,2,86,90,188,34,222,0,O-39-209-04-04-06
TORORO,WEST BUDAMA CTY NORTH,PAYA,NAWIRE,YAMOLULI MAUNDO,202,3,18,0,91,30,142,37,179,0,O-39-209-04-04-07
TORORO,WEST BUDAMA CTY NORTH,PAYA,PAYA,BARINYANGA PRIMARY SCH.,358,10,1,7,129,140,287,24,311,0,O-39-209-04-05-01
TORORO,WEST BUDAMA CTY NORTH,PAYA,PAYA,BARINYANGA TECHNICAL SCH.,589,11,14,7,196,233,461,21,482,0,O-39-209-04-05-02
TORORO,WEST BUDAMA CTY NORTH,PAYA,PAYA,PAMPAYA PRIMARY SCHOOL,465,4,11,6,178,139,338,15,353,0,O-39-209-04-05-03
TORORO,WEST BUDAMA CTY NORTH,PAYA,PAYA,PARANGANG PRIMARY SCH.,405,3,11,2,103,177,296,32,328,0,O-39-209-04-05-04
TORORO,WEST BUDAMA CTY NORTH,PAYA,PAYA,POYO TRADING CENTRE,496,9,7,5,206,148,375,14,389,0,O-39-209-04-05-05
TORORO,WEST BUDAMA CTY NORTH,PAYA,PER PER,MARUKI C/U,392,0,12,0,181,56,249,53,302,0,O-39-209-04-06-01
TORORO,WEST BUDAMA CTY NORTH,PAYA,PER PER,PER-PER P/S,439,5,9,3,162,128,307,22,329,0,O-39-209-04-06-02
TORORO,WEST BUDAMA CTY NORTH,PAYA,PER PER,PER-PER CATHOLIC CHURCH,268,9,7,3,91,111,221,5,226,0,O-39-209-04-06-03
TORORO,WEST BUDAMA CTY NORTH,PAYA,SERE,SERE P/S,402,12,10,2,173,55,252,43,295,0,O-39-209-04-07-01
TORORO,WEST BUDAMA CTY NORTH,PAYA,SERE,RUMAKUYU PADUSA II,376,6,7,4,133,125,275,27,302,0,O-39-209-04-07-02
TORORO,WEST BUDAMA CTY NORTH,PAYA,SERE,RUMAKUYU TRADING CENTRE,456,5,3,1,85,223,317,52,369,0,O-39-209-04-07-03
TORORO,WEST BUDAMA CTY NORTH,PAYA,SERE,LIWIRA P/S,309,2,4,1,34,119,160,94,254,0,O-39-209-04-07-04
TORORO,WEST BUDAMA CTY NORTH,PAYA,SERE,MWENGE T/C,412,2,3,0,150,99,254,84,338,0,O-39-209-04-07-05
TORORO,WEST BUDAMA CTY NORTH,PAYA,SERE,MWENGE P/S,295,3,5,5,125,72,210,7,217,0,O-39-209-04-07-06
TORORO,WEST BUDAMA CTY NORTH,PAYA,SOP-SOP,KIKADHI T/C,551,8,0,6,161,105,280,139,419,0,O-39-209-04-08-01
TORORO,WEST BUDAMA CTY NORTH,PAYA,SOP-SOP,MARUKI CORNER BOREHOLE,248,1,2,5,113,72,193,9,202,0,O-39-209-04-08-02
TORORO,WEST BUDAMA CTY NORTH,PETTA,MBULA,MBULA,670,11,13,4,205,205,438,99,537,0,O-39-209-05-01-01
TORORO,WEST BUDAMA CTY NORTH,PETTA,MBULA,MACHAR PRIMARY SCHOOL I,686,5,7,4,142,278,436,47,483,0,O-39-209-05-01-02
TORORO,WEST BUDAMA CTY NORTH,PETTA,MBULA,KAMOLO,229,5,7,3,95,49,159,34,193,0,O-39-209-05-01-03
TORORO,WEST BUDAMA CTY NORTH,PETTA,PAKOI,PETTA PRIMARY SCHOOL II,734,4,48,5,294,137,488,111,599,0,O-39-209-05-02-01
TORORO,WEST BUDAMA CTY NORTH,PETTA,PETTA,AYAGO PRIMARY SCHOOL,599,0,11,4,152,253,420,53,473,0,O-39-209-05-03-01
TORORO,WEST BUDAMA CTY NORTH,PETTA,PETTA,PETTA PRIMARY SCHOOL I,531,4,15,4,124,199,346,50,396,0,O-39-209-05-03-02
TORORO,WEST BUDAMA CTY NORTH,PETTA,PETTA,OWINO MARKET,295,1,5,4,57,169,236,17,253,0,O-39-209-05-03-03
TORORO,WEST BUDAMA CTY NORTH,PETTA,RAMOGI,KANANG G.C. SOCIETY,595,3,8,3,146,276,436,73,509,0,O-39-209-05-04-01
TORORO,WEST BUDAMA CTY NORTH,PETTA,RAMOGI,MAKAURI H/C,261,3,12,1,81,90,187,14,201,0,O-39-209-05-04-02
TORORO,WEST BUDAMA CTY NORTH,PETTA,RAMOGI,RAMOGI PRIMARY SCHOOL,489,3,6,0,113,158,280,100,380,0,O-39-209-05-04-03
TORORO,WEST BUDAMA CTY SOUTH,IYOLWA,GULE,P'OKOTH'S PLACE-SEGERE,583,7,8,7,184,172,378,28,406,0,O-39-210-01-01-01
TORORO,WEST BUDAMA CTY SOUTH,IYOLWA,GULE,MAGOLA PRI. SCHOOL,326,2,30,1,134,76,243,7,250,0,O-39-210-01-01-02
TORORO,WEST BUDAMA CTY SOUTH,IYOLWA,GULE,MAGOLA C/U,410,5,22,6,115,133,281,20,301,0,O-39-210-01-01-03
TORORO,WEST BUDAMA CTY SOUTH,IYOLWA,GULE,NAMBOGO P/S,264,0,4,0,83,127,214,7,221,0,O-39-210-01-01-04
TORORO,WEST BUDAMA CTY SOUTH,IYOLWA,IYOLWA,IYOLWA PRIMARY SCHOOL POT A,475,3,8,5,83,233,332,29,361,0,O-39-210-01-02-01
TORORO,WEST BUDAMA CTY SOUTH,IYOLWA,IYOLWA,GULE PRIMARY SCHOOL,425,3,11,1,156,159,330,11,341,0,O-39-210-01-02-02
TORORO,WEST BUDAMA CTY SOUTH,IYOLWA,MAGOLA,ST. AGNES P/S,643,5,18,5,230,241,499,10,509,0,O-39-210-01-03-01
TORORO,WEST BUDAMA CTY SOUTH,IYOLWA,MAGOLA,P'OKACH TRADING CENTRE,379,0,9,3,150,125,287,11,298,0,O-39-210-01-03-02
TORORO,WEST BUDAMA CTY SOUTH,IYOLWA,MAGOLA,PONYIMI P/S,446,3,33,5,156,126,323,21,344,0,O-39-210-01-03-03
TORORO,WEST BUDAMA CTY SOUTH,IYOLWA,MAGOLA,PAPOLI PARISH,48,2,6,1,15,6,30,0,30,0,O-39-210-01-03-04
TORORO,WEST BUDAMA CTY SOUTH,IYOLWA,OJILAI,FUNGWE PRIMARY SCHOOL,505,4,8,4,135,198,349,29,378,0,O-39-210-01-04-01
TORORO,WEST BUDAMA CTY SOUTH,IYOLWA,OJILAI,OJILAI PRIMARY SCHOOL,522,9,20,11,181,165,386,21,407,0,O-39-210-01-04-02
TORORO,WEST BUDAMA CTY SOUTH,IYOLWA,OJILAI,BUMANDA PRI. SCHOOL,340,4,2,1,145,125,277,7,284,0,O-39-210-01-04-03
TORORO,WEST BUDAMA CTY SOUTH,IYOLWA,PABONE,PABONE PRIMARY SCHOOL,599,2,3,1,100,309,415,42,457,0,O-39-210-01-05-01
TORORO,WEST BUDAMA CTY SOUTH,IYOLWA,PABONE,IYOLWA TECH SCHOOL,328,1,4,6,54,166,231,6,237,0,O-39-210-01-05-02
TORORO,WEST BUDAMA CTY SOUTH,IYOLWA,PABONE,PAMUSIANI POLLLING STATION,568,3,11,2,176,233,425,24,449,0,O-39-210-01-05-03
TORORO,WEST BUDAMA CTY SOUTH,IYOLWA,PAPOL,PAPOL PRI. SCHOOL,559,6,52,4,155,146,363,21,384,0,O-39-210-01-06-01
TORORO,WEST BUDAMA CTY SOUTH,IYOLWA,PAPOL,MILE 8 MARKET,388,4,20,2,117,127,270,8,278,0,O-39-210-01-06-02
TORORO,WEST BUDAMA CTY SOUTH,IYOLWA,POYAMERI,PODUT PRI. SCHOOL,348,2,14,2,136,128,282,9,291,0,O-39-210-01-07-01
TORORO,WEST BUDAMA CTY SOUTH,IYOLWA,POYAMERI,POYAWO PRI. SCHOOL,431,1,8,2,123,179,313,20,333,0,O-39-210-01-07-02
TORORO,WEST BUDAMA CTY SOUTH,IYOLWA,POYEMI,POYEM PRIMARY SCHOOL,492,3,8,4,133,141,289,10,299,0,O-39-210-01-08-01
TORORO,WEST BUDAMA CTY SOUTH,IYOLWA,POYEMI,AUYO,507,2,14,0,157,154,327,2,329,0,O-39-210-01-08-02
TORORO,WEST BUDAMA CTY SOUTH,IYOLWA,POYEMI,NYEMERA,456,0,26,4,159,152,341,3,344,0,O-39-210-01-08-03
TORORO,WEST BUDAMA CTY SOUTH,MULANDA,LWALA,PAJWENDA A T/C,570,8,66,5,211,159,449,14,463,0,O-39-210-02-01-01
TORORO,WEST BUDAMA CTY SOUTH,MULANDA,LWALA,PANYIRENJA P/S,615,11,65,5,190,207,478,15,493,0,O-39-210-02-01-02
TORORO,WEST BUDAMA CTY SOUTH,MULANDA,LWALA,PAJWENDA  C,685,12,47,4,207,211,481,40,521,0,O-39-210-02-01-03
TORORO,WEST BUDAMA CTY SOUTH,MULANDA,LWALA,PAJWENDA D T.CENTRE,665,8,57,12,168,226,471,28,499,0,O-39-210-02-01-04
TORORO,WEST BUDAMA CTY SOUTH,MULANDA,LWALA,PAJWENDA E T.CENTRE,615,9,24,7,249,145,434,25,459,0,O-39-210-02-01-05
TORORO,WEST BUDAMA CTY SOUTH,MULANDA,LWALA,PAJWENDA F T/CENTRE,365,13,19,7,132,94,265,26,291,0,O-39-210-02-01-06
TORORO,WEST BUDAMA CTY SOUTH,MULANDA,LWALA,ROCHWA,298,1,7,3,91,148,250,15,265,0,O-39-210-02-01-07
TORORO,WEST BUDAMA CTY SOUTH,MULANDA,MULANDA,ATANGALA-LOKOMWA,558,6,63,15,184,155,423,25,448,0,O-39-210-02-02-01
TORORO,WEST BUDAMA CTY SOUTH,MULANDA,MULANDA,CHAWOLO,710,7,26,7,316,199,555,13,568,0,O-39-210-02-02-02
TORORO,WEST BUDAMA CTY SOUTH,MULANDA,MULANDA,PASINDI,724,8,23,12,273,183,499,0,499,0,O-39-210-02-02-03
TORORO,WEST BUDAMA CTY SOUTH,MULANDA,MULANDA,POBWOKI-MULAND STORE,447,3,46,0,147,101,297,16,313,0,O-39-210-02-02-04
TORORO,WEST BUDAMA CTY SOUTH,MULANDA,MULANDA,POCHOWA-PAITA,543,10,29,8,197,162,406,17,423,0,O-39-210-02-02-05
TORORO,WEST BUDAMA CTY SOUTH,MULANDA,MULANDA,KOROBUDI,531,10,39,2,185,164,400,13,413,0,O-39-210-02-02-06
TORORO,WEST BUDAMA CTY SOUTH,MULANDA,MULANDA,POBWOKI TRADING CENTRE,427,3,17,2,120,125,267,76,343,0,O-39-210-02-02-07
TORORO,WEST BUDAMA CTY SOUTH,MULANDA,MWELO,ABWEL P/S,622,6,19,9,227,198,459,18,477,0,O-39-210-02-03-01
TORORO,WEST BUDAMA CTY SOUTH,MULANDA,MWELO,RU-UBERI,648,7,18,5,255,206,491,29,520,0,O-39-210-02-03-02
TORORO,WEST BUDAMA CTY SOUTH,MULANDA,MWELO,RUGOT CHURCH,726,6,21,7,277,196,507,17,524,0,O-39-210-02-03-03
TORORO,WEST BUDAMA CTY SOUTH,MULANDA,MWELO,MWELO P.S,557,7,12,7,286,114,426,14,440,0,O-39-210-02-03-04
TORORO,WEST BUDAMA CTY SOUTH,MULANDA,MWELO,PROJECT,582,2,14,5,155,265,441,6,447,0,O-39-210-02-03-05
TORORO,WEST BUDAMA CTY SOUTH,MULANDA,MWELO,KISOTE,441,12,17,5,262,79,375,6,381,0,O-39-210-02-03-06
TORORO,WEST BUDAMA CTY SOUTH,NABUYOGA,NABUYOGA,MIGANJA PRI. SCHOOL (A),418,6,4,8,184,122,324,9,333,0,O-39-210-03-01-01
TORORO,WEST BUDAMA CTY SOUTH,NABUYOGA,NABUYOGA,MIGANJA PRI. SCHOOL (B),494,7,14,8,207,90,326,27,353,0,O-39-210-03-01-02
TORORO,WEST BUDAMA CTY SOUTH,NABUYOGA,NABUYOGA,BENDO NURSERY SCHOOL,257,4,0,6,81,110,201,7,208,0,O-39-210-03-01-03
TORORO,WEST BUDAMA CTY SOUTH,NABUYOGA,NABUYOGA,NABUYOGA S/COUNTY HQRS (A),271,3,3,2,107,86,201,1,202,0,O-39-210-03-01-04
TORORO,WEST BUDAMA CTY SOUTH,NABUYOGA,NABUYOGA,NABUYOGA S/COUNTY HQRS (B),356,3,5,3,127,147,285,15,300,0,O-39-210-03-01-05
TORORO,WEST BUDAMA CTY SOUTH,NABUYOGA,NAMWANGA,LUGINGI OUTREACH,534,7,53,8,214,152,434,7,441,0,O-39-210-03-02-01
TORORO,WEST BUDAMA CTY SOUTH,NABUYOGA,NAMWANGA,NABUYOGA PRIMARY SCHOOL I,557,12,25,10,178,167,392,25,417,0,O-39-210-03-02-02
TORORO,WEST BUDAMA CTY SOUTH,NABUYOGA,NAMWANGA,BUJWALA PRIMARY SCHOOL,631,10,7,4,333,126,480,6,486,0,O-39-210-03-02-03
TORORO,WEST BUDAMA CTY SOUTH,NABUYOGA,NAMWANGA,NABUYOGA PRIMARY SCHOOL III,222,8,6,1,72,89,176,4,180,0,O-39-210-03-02-04
TORORO,WEST BUDAMA CTY SOUTH,NABUYOGA,NYAMALOGO,SIWA MISSION,392,9,9,4,96,169,287,14,301,0,O-39-210-03-03-01
TORORO,WEST BUDAMA CTY SOUTH,NABUYOGA,NYAMALOGO,SIWA PRIMARY SCHOOL,212,2,2,5,35,108,152,12,164,0,O-39-210-03-03-02
TORORO,WEST BUDAMA CTY SOUTH,NABUYOGA,NYAMALOGO,NYAMALOGO PRIMARY SCHOOL,484,13,7,9,256,101,386,23,409,0,O-39-210-03-03-03
TORORO,WEST BUDAMA CTY SOUTH,NABUYOGA,NYAMALOGO,GABA T.C.,354,3,4,8,115,145,275,9,284,0,O-39-210-03-03-04
TORORO,WEST BUDAMA CTY SOUTH,NABUYOGA,NYAMALOGO,CATHOLIC CHURCH,291,4,8,9,126,62,209,20,229,0,O-39-210-03-03-05
TORORO,WEST BUDAMA CTY SOUTH,NABUYOGA,NYAMALOGO,LWALA P'OBONA MKT,446,4,8,7,98,240,357,10,367,0,O-39-210-03-03-06
TORORO,WEST BUDAMA CTY SOUTH,NABUYOGA,PAWANGA,KIYEYI HIGH SCHOOL,395,1,8,2,180,98,289,20,309,0,O-39-210-03-04-01
TORORO,WEST BUDAMA CTY SOUTH,NABUYOGA,PAWANGA,KIYEYI PRIMARY SCHOOL,466,3,12,5,166,127,313,10,323,0,O-39-210-03-04-02
TORORO,WEST BUDAMA CTY SOUTH,NABUYOGA,PAWANGA,MUWAFU CHRISTIAN CENTRE,449,11,7,5,153,158,334,8,342,0,O-39-210-03-04-03
TORORO,WEST BUDAMA CTY SOUTH,NABUYOGA,PAWANGA,UMBWA TRADING CENTRE,308,4,5,1,99,62,171,65,236,0,O-39-210-03-04-04
TORORO,WEST BUDAMA CTY SOUTH,NABUYOGA,PAWANGA,MUWAFU P. SCHOOL,375,6,20,5,174,74,279,25,304,0,O-39-210-03-04-05
TORORO,WEST BUDAMA CTY SOUTH,RUBONGI,KIDERA,AGOLA PRIMARY SCHOOL,498,4,20,5,161,150,340,17,357,0,O-39-210-04-01-01
TORORO,WEST BUDAMA CTY SOUTH,RUBONGI,KIDERA,KIDERA PRIMARY SCHOOL,486,4,54,4,165,118,345,21,366,0,O-39-210-04-01-02
TORORO,WEST BUDAMA CTY SOUTH,RUBONGI,KIDERA,NEW COVENANT CHURCH,129,1,8,0,72,37,118,2,120,0,O-39-210-04-01-03
TORORO,WEST BUDAMA CTY SOUTH,RUBONGI,NYAKESI,IYOKANGO C/OF UGANDA A,219,3,2,1,109,47,162,10,172,0,O-39-210-04-02-01
TORORO,WEST BUDAMA CTY SOUTH,RUBONGI,NYAKESI,IYOKANGO C/OF UGANDA B,263,1,6,2,148,61,218,13,231,0,O-39-210-04-02-02
TORORO,WEST BUDAMA CTY SOUTH,RUBONGI,NYAKESI,NYAKESI GINNERY,542,5,3,5,104,342,459,32,491,0,O-39-210-04-02-03
TORORO,WEST BUDAMA CTY SOUTH,RUBONGI,NYAKESI,AGWAIT PRIMARY SCHOOL,365,6,1,5,98,147,257,20,277,0,O-39-210-04-02-04
TORORO,WEST BUDAMA CTY SOUTH,RUBONGI,NYAKESI,GRACE CHURCH,374,4,3,4,122,117,250,39,289,0,O-39-210-04-02-05
TORORO,WEST BUDAMA CTY SOUTH,RUBONGI,NYANGOLE,MUDODO PRIMARY SCHOOL A,342,10,7,7,148,60,232,7,239,0,O-39-210-04-03-01
TORORO,WEST BUDAMA CTY SOUTH,RUBONGI,NYANGOLE,MUDODO PRIMARY SCHOOL B,144,0,2,2,64,41,109,5,114,0,O-39-210-04-03-02
TORORO,WEST BUDAMA CTY SOUTH,RUBONGI,NYANGOLE,ODHORO TREE,359,4,12,6,141,111,274,8,282,0,O-39-210-04-03-03
TORORO,WEST BUDAMA CTY SOUTH,RUBONGI,NYANGOLE,MUDODO PRIMARY SCHOOL C,263,6,19,0,127,57,209,2,211,0,O-39-210-04-03-04
TORORO,WEST BUDAMA CTY SOUTH,RUBONGI,NYANGOLE,SALVATION ARMY P. SCHOOL A,577,6,7,5,243,99,360,16,376,0,O-39-210-04-03-05
TORORO,WEST BUDAMA CTY SOUTH,RUBONGI,NYANGOLE,ACHILET PRIMARY SCHOOL,546,10,9,6,186,172,383,30,413,0,O-39-210-04-03-06
TORORO,WEST BUDAMA CTY SOUTH,RUBONGI,OSIA,ABUR PROJECT,451,10,19,8,152,110,299,7,306,0,O-39-210-04-04-01
TORORO,WEST BUDAMA CTY SOUTH,RUBONGI,OSIA,OSIA P. S,515,14,7,12,154,178,365,37,402,0,O-39-210-04-04-02
TORORO,WEST BUDAMA CTY SOUTH,RUBONGI,OSIA,KATEREMA A,409,11,45,6,154,100,316,11,327,0,O-39-210-04-04-03
TORORO,WEST BUDAMA CTY SOUTH,RUBONGI,OSIA,KATEREMA BC,284,5,6,1,76,111,199,14,213,0,O-39-210-04-04-04
TORORO,WEST BUDAMA CTY SOUTH,RUBONGI,OSIA,KAGWARA C.O.U,301,2,7,5,104,96,214,19,233,0,O-39-210-04-04-05
TORORO,WEST BUDAMA CTY SOUTH,RUBONGI,OSIA,RUMAKUYU,302,6,3,1,61,98,169,69,238,0,O-39-210-04-04-06
TORORO,WEST BUDAMA CTY SOUTH,RUBONGI,PANYANGASI,PANYANGASI P/SCHOOL A,401,4,8,5,77,214,308,13,321,0,O-39-210-04-05-01
TORORO,WEST BUDAMA CTY SOUTH,RUBONGI,PANYANGASI,PANYANGASI P/SCHOOL B,485,5,3,1,87,340,436,11,447,0,O-39-210-04-05-02
TORORO,WEST BUDAMA CTY SOUTH,RUBONGI,PANYANGASI,MASEYE PRIMARY SCHOOL,630,4,9,3,148,353,517,8,525,0,O-39-210-04-05-03
TORORO,WEST BUDAMA CTY SOUTH,RUBONGI,PANYANGASI,RUBONGI PRIMARY SCHOOL,267,5,2,1,82,100,190,16,206,0,O-39-210-04-05-04
TORORO,WEST BUDAMA CTY SOUTH,RUBONGI,PANYANGASI,RUBONGI SECONDARY SCHOOL,325,4,9,1,112,128,254,0,254,0,O-39-210-04-05-05
TORORO,WEST BUDAMA CTY SOUTH,RUBONGI,PANYANGASI,CATHOLIC CHURCH,564,7,6,4,134,266,417,13,430,0,O-39-210-04-05-06
TORORO,WEST BUDAMA CTY SOUTH,RUBONGI,PANYANGASI,KIDERA CHRISTIAN CENTRE,258,2,17,0,60,103,182,37,219,0,O-39-210-04-05-07
TORORO,WEST BUDAMA CTY SOUTH,RUBONGI,PANYANGASI,AGINENSIO OBARA'S COMPOUND,154,2,4,1,29,113,149,5,154,0,O-39-210-04-05-08
TORORO,WEST BUDAMA CTY SOUTH,RUBONGI,PANYANGASI,"OUTSIDE Q.GUARD ""A""",841,3,4,1,113,249,370,27,397,0,O-39-210-04-05-09
TORORO,WEST BUDAMA CTY SOUTH,RUBONGI,PANYANGASI,"OUTSIDE Q.GUARD ""B""",458,0,0,1,41,94,136,2,138,0,O-39-210-04-05-10
BUGIRI,BUKOOLI CENTRAL,BUDHAYA,BUDHAYA,MAZIRIGA P SCHOOL A (A-M),412,5,1,6,69,223,304,31,335,0,O-41-31-01-01-01
BUGIRI,BUKOOLI CENTRAL,BUDHAYA,BUDHAYA,NAMATU PRI. SCHOOL,455,4,0,0,117,155,276,7,283,0,O-41-31-01-01-02
BUGIRI,BUKOOLI CENTRAL,BUDHAYA,BUDHAYA,KIWANDANGABO P SCHOOL,764,5,2,7,103,378,495,33,528,0,O-41-31-01-01-03
BUGIRI,BUKOOLI CENTRAL,BUDHAYA,BUDHAYA,BUDHAYA P. SCHOOL,665,6,3,5,135,316,465,22,487,0,O-41-31-01-01-04
BUGIRI,BUKOOLI CENTRAL,BUDHAYA,BUDHAYA,BUMWANGU PRI. SCHOOL,714,7,4,6,204,261,482,54,536,0,O-41-31-01-01-05
BUGIRI,BUKOOLI CENTRAL,BUDHAYA,BUDHAYA,MAZIRINGA P. SCHOOL B (N-Z),458,2,3,0,93,228,326,10,336,0,O-41-31-01-01-06
BUGIRI,BUKOOLI CENTRAL,BUDHAYA,BUKATU,BUKATU MOSQUE,527,4,7,10,122,210,353,1,354,0,O-41-31-01-02-01
BUGIRI,BUKOOLI CENTRAL,BUDHAYA,BUKATU,BUKATU P SCHOOL,713,2,2,6,139,271,420,15,435,0,O-41-31-01-02-02
BUGIRI,BUKOOLI CENTRAL,BUDHAYA,BUWOLYA,MAKOOVA MOSQUE,232,1,2,1,51,110,165,10,175,0,O-41-31-01-03-01
BUGIRI,BUKOOLI CENTRAL,BUDHAYA,BUWOLYA,BUWOLYA MOSQUE,701,3,1,5,184,311,504,16,520,0,O-41-31-01-03-02
BUGIRI,BUKOOLI CENTRAL,BUDHAYA,BUWOLYA,KIMASA PR. SCH.,477,2,2,5,87,288,384,15,399,0,O-41-31-01-03-03
BUGIRI,BUKOOLI CENTRAL,BUDHAYA,BUWOLYA,BUWOLYA PRI. SCH.,260,0,1,0,63,142,206,6,212,0,O-41-31-01-03-04
BUGIRI,BUKOOLI CENTRAL,BUDHAYA,MAYUGE,NSANVU NEW APOSTOLIC CHURC,599,7,2,5,82,264,360,0,360,0,O-41-31-01-04-01
BUGIRI,BUKOOLI CENTRAL,BUDHAYA,MAYUGE,NSANVU PRI SCHOOL,842,7,0,3,86,392,488,41,529,0,O-41-31-01-04-02
BUGIRI,BUKOOLI CENTRAL,BUDHAYA,MAYUGE,MAYUGE P. SCHOOL,653,1,2,3,181,240,427,10,437,0,O-41-31-01-04-03
BUGIRI,BUKOOLI CENTRAL,BUDHAYA,MAYUGE,MAYUGE HEALTH CENTRE,668,3,3,2,135,241,384,19,403,0,O-41-31-01-04-04
BUGIRI,BUKOOLI CENTRAL,BULESA,BULUWE,BULUWE P. SCHOOL,469,7,4,2,107,160,280,21,301,0,O-41-31-02-01-01
BUGIRI,BUKOOLI CENTRAL,BULESA,BULUWE,NANGALAMA P. SCHOOL,522,5,4,2,80,257,348,33,381,0,O-41-31-02-01-02
BUGIRI,BUKOOLI CENTRAL,BULESA,BULUWE,MAKONDE CHURCH,348,5,1,2,120,84,212,19,231,0,O-41-31-02-01-03
BUGIRI,BUKOOLI CENTRAL,BULESA,BUWUNI,BUWUNI CATHOLIC CHURCH (A-M,607,4,2,1,175,185,367,0,367,0,O-41-31-02-02-01
BUGIRI,BUKOOLI CENTRAL,BULESA,BUWUNI,BUWUNI WOMEN'S DISPENSARY,260,3,6,2,62,100,173,14,187,0,O-41-31-02-02-02
BUGIRI,BUKOOLI CENTRAL,BULESA,BUWUNI,BUWUNI APOSTOLIC CHURCH,474,7,8,8,102,173,298,15,313,0,O-41-31-02-02-03
BUGIRI,BUKOOLI CENTRAL,BULESA,BUWUNI,BUWUNI C.O.U,875,6,9,10,248,244,517,42,559,0,O-41-31-02-02-04
BUGIRI,BUKOOLI CENTRAL,BULESA,BUWUNI,KIBIMBA RICE FACTORY,171,1,4,0,62,51,118,5,123,0,O-41-31-02-02-05
BUGIRI,BUKOOLI CENTRAL,BULESA,BUWUNI,BUBUZI P SCHOOL,467,2,4,2,108,219,335,15,350,0,O-41-31-02-02-06
BUGIRI,BUKOOLI CENTRAL,BULESA,BUWUNI,BUGOSERE FELLOWSHIP CHURC,533,11,6,6,111,248,382,22,404,0,O-41-31-02-02-07
BUGIRI,BUKOOLI CENTRAL,BULESA,BUWUNI,BUWUNI CATHOLIC CHURCH (N-Z),470,3,2,3,113,153,274,24,298,0,O-41-31-02-02-08
BUGIRI,BUKOOLI CENTRAL,BULESA,IGGWE,LUWERO PRI. SCHOOL,557,8,1,2,128,177,316,5,321,0,O-41-31-02-03-01
BUGIRI,BUKOOLI CENTRAL,BULESA,IGGWE,BULEBI MUSLIM SCHOOL,489,2,0,2,100,200,304,25,329,0,O-41-31-02-03-02
BUGIRI,BUKOOLI CENTRAL,BULESA,IGGWE,MAWERERE MOSQUE,629,6,1,3,166,273,449,18,467,0,O-41-31-02-03-03
BUGIRI,BUKOOLI CENTRAL,BULESA,IGGWE,NTAWAWULA PRIMARY SCHOOL,334,0,2,1,50,147,200,20,220,0,O-41-31-02-03-04
BUGIRI,BUKOOLI CENTRAL,BULESA,KITODHA,BAHMAN PRI SCHOOL,653,4,5,6,180,242,437,20,457,0,O-41-31-02-04-01
BUGIRI,BUKOOLI CENTRAL,BULESA,KITODHA,KITODHA PRI. SCHOOL,521,5,1,2,129,243,380,11,391,0,O-41-31-02-04-02
BUGIRI,BUKOOLI CENTRAL,BULESA,KITODHA,NAKISAMO UNIVERSAL CHURCH,653,3,4,3,137,191,338,25,363,0,O-41-31-02-04-03
BUGIRI,BUKOOLI CENTRAL,BULESA,NAMASERE,NAKIGUNJU BAPTIST SCHOOL,521,2,0,7,83,279,371,16,387,0,O-41-31-02-05-01
BUGIRI,BUKOOLI CENTRAL,BULESA,NAMASERE,BUWUNI P. SCHOOL,448,3,0,1,92,218,314,16,330,0,O-41-31-02-05-02
BUGIRI,BUKOOLI CENTRAL,BULESA,NAMASERE,BULESA BAPTIST SCHOOL,643,0,5,11,105,256,377,61,438,0,O-41-31-02-05-03
BUGIRI,BUKOOLI CENTRAL,BULESA,NAMASERE,NAKABALE CHURCH,464,2,1,5,124,168,300,14,314,0,O-41-31-02-05-04
BUGIRI,BUKOOLI CENTRAL,BULESA,NAMASERE,BUKUTA PRI SCHOOL,722,4,5,8,131,325,473,34,507,0,O-41-31-02-05-05
BUGIRI,BUKOOLI CENTRAL,BULIDHA,BULIDHA,BULIDHA SUB COUNTY HQTRS,487,0,4,1,83,228,316,12,328,0,O-41-31-03-01-01
BUGIRI,BUKOOLI CENTRAL,BULIDHA,BULIDHA,ITORO CHURCH,553,4,2,6,112,236,360,10,370,0,O-41-31-03-01-02
BUGIRI,BUKOOLI CENTRAL,BULIDHA,BULIDHA,NANSAGA MUSLIM PRIMARY SCH,275,2,0,3,47,131,183,6,189,0,O-41-31-03-01-03
BUGIRI,BUKOOLI CENTRAL,BULIDHA,BULIDHA,BULIDHA P SCHOOL,699,8,9,12,196,220,445,25,470,0,O-41-31-03-01-04
BUGIRI,BUKOOLI CENTRAL,BULIDHA,MAKOMA,ISAKABUSOLO PRI. SCHOOL,685,4,5,7,120,343,479,19,498,0,O-41-31-03-02-01
BUGIRI,BUKOOLI CENTRAL,BULIDHA,MAKOMA,MAKOMA NURSERY SCHOOL,427,4,9,6,89,199,307,17,324,0,O-41-31-03-02-02
BUGIRI,BUKOOLI CENTRAL,BULIDHA,MAKOMA,MAKOMA P. SCHOOL,718,5,1,8,136,333,483,33,516,0,O-41-31-03-02-03
BUGIRI,BUKOOLI CENTRAL,BULIDHA,MAKOMA,BUSAKIRA PRI SCHOOL,792,5,10,7,118,329,469,45,514,0,O-41-31-03-02-04
BUGIRI,BUKOOLI CENTRAL,BULIDHA,NABIGINGO,MAYOLE MOSQUE,222,0,1,3,54,94,152,0,152,0,O-41-31-03-03-01
BUGIRI,BUKOOLI CENTRAL,BULIDHA,NABIGINGO,NABIGINGO PRI. SCHOOL,530,3,3,3,134,192,335,17,352,0,O-41-31-03-03-02
BUGIRI,BUKOOLI CENTRAL,BULIDHA,NABIGINGO,MUFUMI P. SCHOOL,427,4,1,9,116,150,280,15,295,0,O-41-31-03-03-03
BUGIRI,BUKOOLI CENTRAL,BULIDHA,WAKAWAKA,WAKAWAKA PRI SCHOOL,738,3,4,3,179,200,389,0,389,0,O-41-31-03-04-01
BUGIRI,BUKOOLI CENTRAL,BULIDHA,WAKAWAKA,KIBUYE PRIMARY SCHOOL (A-M),455,4,3,2,93,165,267,26,293,0,O-41-31-03-04-02
BUGIRI,BUKOOLI CENTRAL,BULIDHA,WAKAWAKA,KIBUYE PRIMARY SCHOOL (N-Z),392,3,1,4,82,180,270,14,284,0,O-41-31-03-04-03
BUGIRI,BUKOOLI CENTRAL,BUWUNGA,BUBUGO,BUBUGO CHURCH OF UGANDA (N,373,0,1,5,74,164,244,17,261,0,O-41-31-04-01-01
BUGIRI,BUKOOLI CENTRAL,BUWUNGA,BUBUGO,BUBUGO CHURCH OF UGANDA (A,500,2,0,3,103,201,309,73,382,0,O-41-31-04-01-02
BUGIRI,BUKOOLI CENTRAL,BUWUNGA,BUBUGO,NAMBOFA CO-OP SOCIETY,504,1,1,2,125,228,357,11,368,0,O-41-31-04-01-03
BUGIRI,BUKOOLI CENTRAL,BUWUNGA,BUPALA,WALUGOMA PRI. SCHOOL,668,4,4,1,182,279,470,14,484,0,O-41-31-04-02-01
BUGIRI,BUKOOLI CENTRAL,BUWUNGA,BUPALA,BUPALA PR SCHOOL,503,1,2,3,136,237,379,10,389,0,O-41-31-04-02-02
BUGIRI,BUKOOLI CENTRAL,BUWUNGA,BUSOGA,NAKASENYI GROUND,295,2,2,2,76,169,251,8,259,0,O-41-31-04-03-01
BUGIRI,BUKOOLI CENTRAL,BUWUNGA,BUSOGA,BUSOGA P. SCHOOL,471,5,2,2,137,174,320,7,327,0,O-41-31-04-03-02
BUGIRI,BUKOOLI CENTRAL,BUWUNGA,BUSOWA,NAKAWA PRI. SCHOOL,388,3,2,0,107,173,285,6,291,0,O-41-31-04-04-01
BUGIRI,BUKOOLI CENTRAL,BUWUNGA,BUSOWA,BULUME BAPTIST SCHOOL,498,1,4,6,122,248,381,11,392,0,O-41-31-04-04-02
BUGIRI,BUKOOLI CENTRAL,BUWUNGA,BUSOWA,BULUME P. SCHOOL (A-M ),518,2,5,3,150,174,334,12,346,0,O-41-31-04-04-03
BUGIRI,BUKOOLI CENTRAL,BUWUNGA,BUSOWA,BULUME P. SCHOOL (N-Z),425,0,6,0,102,171,279,4,283,0,O-41-31-04-04-04
BUGIRI,BUKOOLI CENTRAL,BUWUNGA,BUWUNGA,BUDIDI CATHOLIC CHURCH,310,0,7,0,66,135,208,23,231,0,O-41-31-04-05-01
BUGIRI,BUKOOLI CENTRAL,BUWUNGA,BUWUNGA,BUWUNGA PR SCHOOL,667,2,1,1,176,264,444,10,454,0,O-41-31-04-05-02
BUGIRI,BUKOOLI CENTRAL,BUWUNGA,BUWUNGA,BUWUNGA SUB-COUNTY HQS,395,2,0,3,97,200,302,9,311,0,O-41-31-04-05-03
BUGIRI,BUKOOLI CENTRAL,BUWUNGA,KAVULE,KAVULE PR SCHOOL,384,3,2,1,140,120,266,19,285,0,O-41-31-04-06-01
BUGIRI,BUKOOLI CENTRAL,BUWUNGA,KAVULE,KASALA HEALTH PROJ CENTRE,317,1,1,3,121,136,262,2,264,0,O-41-31-04-06-02
BUGIRI,BUKOOLI CENTRAL,BUWUNGA,KAVULE,MAWANGA CO-OP SOCIETY,618,1,0,3,118,315,437,12,449,0,O-41-31-04-06-03
BUGIRI,BUKOOLI CENTRAL,BUWUNGA,LUWOKO,LUWOKO C.O.U,470,1,1,0,99,252,353,1,354,0,O-41-31-04-07-01
BUGIRI,BUKOOLI CENTRAL,BUWUNGA,LUWOKO,LUWOOKO P. SCHOOL,564,2,0,1,120,279,402,14,416,0,O-41-31-04-07-02
BUGIRI,BUKOOLI CENTRAL,BUWUNGA,LUWOKO,KITEIGALWA MOSQUE,412,3,3,1,172,137,316,5,321,0,O-41-31-04-07-03
BUGIRI,BUKOOLI CENTRAL,BUWUNGA,MAGOOLA,MAGOOLA PR SCHOOL,714,2,0,1,91,449,543,4,547,0,O-41-31-04-08-01
BUGIRI,BUKOOLI CENTRAL,BUWUNGA,MAGOOLA,IMULI CATHOLIC CHURCH,289,1,0,0,47,166,214,11,225,0,O-41-31-04-08-02
BUGIRI,BUKOOLI CENTRAL,BUWUNGA,MAGOOLA,MAKOMA PRI. SCHOOL,297,1,0,1,72,175,249,0,249,0,O-41-31-04-08-03
BUGIRI,BUKOOLI CENTRAL,BUWUNGA,NAMBALE,KAYAIGO MOSQUE,600,3,1,4,247,189,444,14,458,0,O-41-31-04-09-01
BUGIRI,BUKOOLI CENTRAL,BUWUNGA,NAMBALE,KATALA PR. SCH.,441,3,1,2,178,156,340,86,426,0,O-41-31-04-09-02
BUGIRI,BUKOOLI CENTRAL,BUWUNGA,NAMBALE,BUTUMBA PR. SCH.,251,0,0,3,62,104,169,3,172,0,O-41-31-04-09-03
BUGIRI,BUKOOLI CENTRAL,BUWUNGA,NAMBALE,BUGOMBO JUNCTION,306,3,0,3,110,103,219,8,227,0,O-41-31-04-09-04
BUGIRI,BUKOOLI CENTRAL,BUWUNGA,NAWANDHUKI,NAMALENA PRI. SCHOOL,421,0,4,0,58,192,254,49,303,0,O-41-31-04-10-01
BUGIRI,BUKOOLI CENTRAL,BUWUNGA,NAWANDHUKI,BUSOWA CATHOLIC CHURCH,581,5,0,5,143,287,440,9,449,0,O-41-31-04-10-02
BUGIRI,BUKOOLI CENTRAL,MUTERERE,BULULU,NONGO PR SCHOOL,385,3,0,0,117,113,233,62,295,0,O-41-31-05-01-01
BUGIRI,BUKOOLI CENTRAL,MUTERERE,BULULU,NABUYANDA CATHOLIC CHURCH,444,6,3,6,159,144,318,12,330,0,O-41-31-05-01-02
BUGIRI,BUKOOLI CENTRAL,MUTERERE,BULULU,BULULU P. SCHOOL,730,2,2,5,110,324,443,35,478,0,O-41-31-05-01-03
BUGIRI,BUKOOLI CENTRAL,MUTERERE,BULULU,LUBANYI BAPTIST SCHOOL,376,3,2,6,77,193,281,9,290,0,O-41-31-05-01-04
BUGIRI,BUKOOLI CENTRAL,MUTERERE,KAYOGERA,NALUYA PRI. SCHOOL,396,4,2,1,177,131,315,3,318,0,O-41-31-05-02-01
BUGIRI,BUKOOLI CENTRAL,MUTERERE,KAYOGERA,BUKIRI PRI. SCHOOL,782,2,4,13,218,301,538,20,558,0,O-41-31-05-02-02
BUGIRI,BUKOOLI CENTRAL,MUTERERE,KAYOGERA,KAYOGERA PRIMARY SCHOOL,573,2,1,3,138,285,429,19,448,0,O-41-31-05-02-03
BUGIRI,BUKOOLI CENTRAL,MUTERERE,KAYOGERA,NAIGOMA CHURCH OF UGANDA,531,5,4,2,173,218,402,18,420,0,O-41-31-05-02-04
BUGIRI,BUKOOLI CENTRAL,MUTERERE,KITUMBA,KITUMBA APOSTOLIC CHURCH,435,2,2,4,87,210,305,17,322,0,O-41-31-05-03-01
BUGIRI,BUKOOLI CENTRAL,MUTERERE,KITUMBA,KIMBALE P. SCHOOL,836,1,3,3,200,375,582,26,608,0,O-41-31-05-03-02
BUGIRI,BUKOOLI CENTRAL,MUTERERE,KITUMBA,GULU CHURCH,381,1,3,2,113,161,280,9,289,0,O-41-31-05-03-03
BUGIRI,BUKOOLI CENTRAL,MUTERERE,MUTERERE,NGUNGA P. SCHOOL,399,3,1,0,67,220,291,14,305,0,O-41-31-05-04-01
BUGIRI,BUKOOLI CENTRAL,MUTERERE,MUTERERE,MUTERERE P. SCHOOL,486,1,0,2,99,238,340,4,344,0,O-41-31-05-04-02
BUGIRI,BUKOOLI CENTRAL,MUTERERE,MUTERERE,BUSINI MOSQUE,296,3,0,2,50,142,197,42,239,0,O-41-31-05-04-03
BUGIRI,BUKOOLI CENTRAL,MUTERERE,MUTERERE,MUTERERE S/C HQRS (A-M),578,1,0,0,184,217,402,1,403,0,O-41-31-05-04-04
BUGIRI,BUKOOLI CENTRAL,MUTERERE,MUTERERE,KYAIKU BAPTIST SCHOOL,486,3,0,0,111,239,353,9,362,0,O-41-31-05-04-05
BUGIRI,BUKOOLI CENTRAL,MUTERERE,MUTERERE,MUTERERE S/Q HQRS (N-Z),453,1,0,0,101,193,295,11,306,0,O-41-31-05-04-06
BUGIRI,BUKOOLI CENTRAL,MUTERERE,MUTERERE,KIGUSA NEW APOSTOLIC CHURC,365,3,2,2,62,217,286,7,293,0,O-41-31-05-04-07
BUGIRI,BUKOOLI CENTRAL,NANKOMA,ISEGERO,WANSIMBA PRI. SCHOOL,608,2,4,6,135,273,420,0,420,0,O-41-31-06-01-01
BUGIRI,BUKOOLI CENTRAL,NANKOMA,ISEGERO,NALUBAALE SECONDARY SCHO,585,3,1,3,116,260,383,15,398,0,O-41-31-06-01-02
BUGIRI,BUKOOLI CENTRAL,NANKOMA,ISEGERO,ISEGERO TRADING CENTRE,544,3,1,2,102,221,329,8,337,0,O-41-31-06-01-03
BUGIRI,BUKOOLI CENTRAL,NANKOMA,MASITA,ITAKAIBOLU PR SCHOOL,637,1,2,3,181,221,408,26,434,0,O-41-31-06-02-01
BUGIRI,BUKOOLI CENTRAL,NANKOMA,MASITA,NAKASISI GROUND,379,3,6,5,118,151,283,8,291,0,O-41-31-06-02-02
BUGIRI,BUKOOLI CENTRAL,NANKOMA,MASITA,MASITA PRI. SCHOOL,669,4,2,5,143,284,438,38,476,0,O-41-31-06-02-03
BUGIRI,BUKOOLI CENTRAL,NANKOMA,MASITA,LWAMUNYI GROUND,236,0,1,2,73,109,185,4,189,0,O-41-31-06-02-04
BUGIRI,BUKOOLI CENTRAL,NANKOMA,MATOVU,MATOVU PRIMARY SCHOOL (A-M,534,2,3,3,105,237,350,15,365,0,O-41-31-06-03-01
BUGIRI,BUKOOLI CENTRAL,NANKOMA,MATOVU,NAWAMBWA P SCHOOL,421,1,0,0,70,207,278,6,284,0,O-41-31-06-03-02
BUGIRI,BUKOOLI CENTRAL,NANKOMA,MATOVU,MATOVU PRIMARY SCHOOL (N-Z,456,1,1,4,69,208,283,11,294,0,O-41-31-06-03-03
BUGIRI,BUKOOLI CENTRAL,NANKOMA,MATOVU,KIGOBERO GROUND,317,1,1,2,82,138,224,3,227,0,O-41-31-06-03-04
BUGIRI,BUKOOLI CENTRAL,NANKOMA,NAMAKOKO,BUSIMBI MOSQUE,796,7,1,5,230,303,546,12,558,0,O-41-31-06-04-01
BUGIRI,BUKOOLI CENTRAL,NANKOMA,NAMAKOKO,NAMAKOKO CHURCH,512,1,2,5,149,166,323,15,338,0,O-41-31-06-04-02
BUGIRI,BUKOOLI CENTRAL,NANKOMA,NAMAKOKO,BUTEGWA CO-OP SOCIETY,489,0,3,3,97,239,342,18,360,0,O-41-31-06-04-03
BUGIRI,BUKOOLI CENTRAL,NANKOMA,NANKOMA,NANKOMA S/C HQS,621,2,5,5,149,209,370,13,383,0,O-41-31-06-05-01
BUGIRI,BUKOOLI CENTRAL,NANKOMA,NANKOMA,NANKOMA MOSQUE,589,0,2,2,123,191,318,5,323,0,O-41-31-06-05-02
BUGIRI,BUKOOLI CENTRAL,NANKOMA,NANKOMA,NANKOMA HEALTH CENTRE,597,0,2,2,129,176,309,19,328,0,O-41-31-06-05-03
BUGIRI,BUKOOLI CENTRAL,NANKOMA,NANKOMA,NAWANGO FELLOWSHIP CHURCH,377,5,0,2,98,160,265,17,282,0,O-41-31-06-05-04
BUGIRI,BUKOOLI CENTRAL,NANKOMA,NANKOMA,NAMUTENGA CHURCH,814,5,17,0,262,292,576,12,588,0,O-41-31-06-05-05
BUGIRI,BUKOOLI CENTRAL,NANKOMA,NANKOMA,KYEMEIRE P. SCHOOL,234,3,2,5,40,113,163,17,180,0,O-41-31-06-05-06
BUGIRI,BUKOOLI CENTRAL,NANKOMA,NANKOMA,NAKASITA/KASAWO C.O.U,476,2,2,1,114,215,334,8,342,0,O-41-31-06-05-07
BUGIRI,BUKOOLI CENTRAL,NANKOMA,NSONO,NAMUGANZA MARKET (N-Z),582,5,4,5,182,195,391,12,403,0,O-41-31-06-06-01
BUGIRI,BUKOOLI CENTRAL,NANKOMA,NSONO,NAMUGANZA MARKET (A-M),564,8,1,9,173,174,365,19,384,0,O-41-31-06-06-02
BUGIRI,BUKOOLI CENTRAL,NANKOMA,NSONO,NSONO P. SCHOOL,339,1,3,1,50,165,220,15,235,0,O-41-31-06-06-03
BUGIRI,BUKOOLI CENTRAL,NANKOMA,NSONO,KASONGOIRE PRI. SCHOOL,443,3,1,6,159,141,310,16,326,0,O-41-31-06-06-04
BUGIRI,BUKOOLI NORTH,BUGIRI T/C,BWOLE,BUSANZI MOSQUE (A-M),389,1,1,1,106,92,201,11,212,0,O-41-32-01-01-01
BUGIRI,BUKOOLI NORTH,BUGIRI T/C,BWOLE,BUKOOLI TECH SCHOOL,502,3,2,2,133,159,299,6,305,0,O-41-32-01-01-02
BUGIRI,BUKOOLI NORTH,BUGIRI T/C,BWOLE,ALL SAINTS CHURCH (A-M),440,2,1,0,157,76,236,35,271,0,O-41-32-01-01-03
BUGIRI,BUKOOLI NORTH,BUGIRI T/C,BWOLE,BUSANZI MOSQUE (N-Z),342,2,0,1,64,97,164,37,201,0,O-41-32-01-01-04
BUGIRI,BUKOOLI NORTH,BUGIRI T/C,BWOLE,HINDOCHA PR SCH (A-M),511,1,4,0,142,90,237,10,247,0,O-41-32-01-01-05
BUGIRI,BUKOOLI NORTH,BUGIRI T/C,BWOLE,ALL SAINTS CHURCH (N-Z),294,0,0,0,74,91,165,6,171,0,O-41-32-01-01-06
BUGIRI,BUKOOLI NORTH,BUGIRI T/C,BWOLE,HINDOCHA PR SCH (N-Z),444,1,0,1,89,104,195,5,200,0,O-41-32-01-01-07
BUGIRI,BUKOOLI NORTH,BUGIRI T/C,NALUWERERE,NALUWERERE POLICE POST (A-M,410,2,1,1,122,123,249,13,262,0,O-41-32-01-02-01
BUGIRI,BUKOOLI NORTH,BUGIRI T/C,NALUWERERE,NALUWERERE COMM. CENTRE,809,4,4,2,188,208,406,17,423,0,O-41-32-01-02-02
BUGIRI,BUKOOLI NORTH,BUGIRI T/C,NALUWERERE,NALUWERERE POLICE POST (N-Z),347,1,2,1,90,111,205,9,214,0,O-41-32-01-02-03
BUGIRI,BUKOOLI NORTH,BUGIRI T/C,NALUWERERE,NALUWERERE CATHOLIC CHURC,236,2,0,0,52,60,114,26,140,0,O-41-32-01-02-04
BUGIRI,BUKOOLI NORTH,BUGIRI T/C,NDIFAKULYA A,BUKOOLI COLLEGE,347,1,0,0,72,142,215,6,221,0,O-41-32-01-03-01
BUGIRI,BUKOOLI NORTH,BUGIRI T/C,NDIFAKULYA A,MWANAMUGIMU CLINIC (N-Z),554,4,0,0,109,176,289,30,319,0,O-41-32-01-03-02
BUGIRI,BUKOOLI NORTH,BUGIRI T/C,NDIFAKULYA A,MWANAMUGIMU CLINIC (A-M),650,7,1,4,187,212,411,0,411,0,O-41-32-01-03-03
BUGIRI,BUKOOLI NORTH,BUGIRI T/C,NKUSI,BUGIRI BUS PARK (A-H),590,3,2,1,171,151,328,14,342,0,O-41-32-01-04-01
BUGIRI,BUKOOLI NORTH,BUGIRI T/C,NKUSI,BUGIRI BUS PARK (I-L),620,1,2,1,147,136,287,33,320,0,O-41-32-01-04-02
BUGIRI,BUKOOLI NORTH,BUGIRI T/C,NKUSI,NALUWERERE T.C. OFFICE,656,2,4,1,160,193,360,18,378,0,O-41-32-01-04-03
BUGIRI,BUKOOLI NORTH,BUGIRI T/C,NKUSI,BUGIRI BUS PARK (M-NAF),679,2,2,1,219,153,377,12,389,0,O-41-32-01-04-04
BUGIRI,BUKOOLI NORTH,BUGIRI T/C,NKUSI,BUGIRI BUS PARK (NAG-NZ),646,0,1,0,120,183,304,11,315,0,O-41-32-01-04-05
BUGIRI,BUKOOLI NORTH,BUGIRI T/C,NKUSI,BUGIRI BUS PARK (O-Z),577,2,1,0,147,87,237,56,293,0,O-41-32-01-04-06
BUGIRI,BUKOOLI NORTH,BULUGUYI,BUFUNDA,BUFUNDA CHURCH OF UGANDA,598,2,1,1,75,322,401,27,428,0,O-41-32-02-01-01
BUGIRI,BUKOOLI NORTH,BULUGUYI,BUFUNDA,BUDUNYI PRI. SCHOOL,473,1,1,0,58,301,361,14,375,0,O-41-32-02-01-02
BUGIRI,BUKOOLI NORTH,BULUGUYI,BUFUNDA,BUFUNDA MOSQUE,329,1,0,0,34,193,228,14,242,0,O-41-32-02-01-03
BUGIRI,BUKOOLI NORTH,BULUGUYI,BUGAYI,BULUGUYI SUB COUNTY HQTRS,502,6,2,2,70,245,325,14,339,0,O-41-32-02-02-01
BUGIRI,BUKOOLI NORTH,BULUGUYI,BUGAYI,BULESI CHURCH,188,3,1,5,50,88,147,4,151,0,O-41-32-02-02-02
BUGIRI,BUKOOLI NORTH,BULUGUYI,BUGAYI,BUFASI PRI. S CHOOL,483,1,2,2,36,303,344,0,344,0,O-41-32-02-02-03
BUGIRI,BUKOOLI NORTH,BULUGUYI,BULUGUYI,BULUGUYI NURSERY SCHOOL,338,4,4,2,85,144,239,14,253,0,O-41-32-02-03-01
BUGIRI,BUKOOLI NORTH,BULUGUYI,BULUGUYI,LUGANO PRIMARY SCHOOL,305,2,2,0,33,189,226,22,248,0,O-41-32-02-03-02
BUGIRI,BUKOOLI NORTH,BULUGUYI,BULUGUYI,KITOVU CHURCH OF UGANDA,440,4,2,5,54,296,361,9,370,0,O-41-32-02-03-03
BUGIRI,BUKOOLI NORTH,BULUGUYI,BULUGUYI,SIRONGO PRI. SCHOOL,404,1,3,1,61,232,298,10,308,0,O-41-32-02-03-04
BUGIRI,BUKOOLI NORTH,BULUGUYI,MUWAYO,MUWAYO MOSQUE (A-M),532,2,5,3,115,199,324,50,374,0,O-41-32-02-04-01
BUGIRI,BUKOOLI NORTH,BULUGUYI,MUWAYO,BUDUMA CHILD DEV'T CENTRE,765,5,5,15,133,382,540,0,540,0,O-41-32-02-04-02
BUGIRI,BUKOOLI NORTH,BULUGUYI,MUWAYO,BUDUMA CHURCH OF UGANDA,464,1,2,5,118,181,307,19,326,0,O-41-32-02-04-03
BUGIRI,BUKOOLI NORTH,BULUGUYI,MUWAYO,BUTEMA C.O.U (A-M),433,1,4,3,79,188,275,22,297,0,O-41-32-02-04-04
BUGIRI,BUKOOLI NORTH,BULUGUYI,MUWAYO,MUWAYO MOSQUE (N-Z),589,1,9,5,135,245,395,19,414,0,O-41-32-02-04-05
BUGIRI,BUKOOLI NORTH,BULUGUYI,MUWAYO,BUTEMA C.O.U (N-Z),525,3,2,3,111,239,358,12,370,0,O-41-32-02-04-06
BUGIRI,BUKOOLI NORTH,BULUGUYI,NSANGO,KAYAGO BAPTIST P/SCH,690,2,2,4,88,342,438,25,463,0,O-41-32-02-05-01
BUGIRI,BUKOOLI NORTH,BULUGUYI,NSANGO,NSANGO P/S,462,2,6,6,78,248,340,11,351,0,O-41-32-02-05-02
BUGIRI,BUKOOLI NORTH,BULUGUYI,NSANGO,KISOKO MOSQUE,302,1,0,1,85,136,223,9,232,0,O-41-32-02-05-03
BUGIRI,BUKOOLI NORTH,IWEMBA,BUGESO,BUGESO CHURCH (A-M),585,0,2,0,63,263,328,101,429,0,O-41-32-03-01-01
BUGIRI,BUKOOLI NORTH,IWEMBA,BUGESO,BUGESO CHURCH (N-Z),409,2,0,3,50,185,240,19,259,0,O-41-32-03-01-02
BUGIRI,BUKOOLI NORTH,IWEMBA,BUYALA,KIMIRA PRI. SCHOOL,230,0,1,0,23,114,138,39,177,0,O-41-32-03-02-01
BUGIRI,BUKOOLI NORTH,IWEMBA,BUYALA,KIGULU P/S,605,0,2,1,35,331,369,65,434,0,O-41-32-03-02-02
BUGIRI,BUKOOLI NORTH,IWEMBA,BUYALA,BUYALA P/S,615,4,0,4,127,295,430,13,443,0,O-41-32-03-02-03
BUGIRI,BUKOOLI NORTH,IWEMBA,IWEMBA,IWEMBA PR/SCHOOL,697,4,1,2,95,379,481,12,493,0,O-41-32-03-03-01
BUGIRI,BUKOOLI NORTH,IWEMBA,IWEMBA,BUKANDA APOSTOLIC CHURCH,464,1,3,4,38,265,311,4,315,0,O-41-32-03-03-02
BUGIRI,BUKOOLI NORTH,IWEMBA,NABIRERE,KASOKWE P/S,582,5,0,7,116,234,362,20,382,0,O-41-32-03-04-01
BUGIRI,BUKOOLI NORTH,IWEMBA,NABIRERE,NABIRERE PRI. SCHOOL,701,1,0,1,89,348,439,29,468,0,O-41-32-03-04-02
BUGIRI,BUKOOLI NORTH,IWEMBA,NAMBO,NAWANGALI PRI. SCHOOL,498,2,6,5,105,259,377,17,394,0,O-41-32-03-05-01
BUGIRI,BUKOOLI NORTH,IWEMBA,NAMBO,NAMBO PRI. SCHOOL,583,1,9,1,148,281,440,10,450,0,O-41-32-03-05-02
BUGIRI,BUKOOLI NORTH,KAPYANGA,BUGIRI A,KAPYANGA S/C HQRS,497,3,1,3,103,214,324,16,340,0,O-41-32-04-01-01
BUGIRI,BUKOOLI NORTH,KAPYANGA,BUGIRI A,BUGABO PRI. SCHOOL (A-M),391,1,0,3,57,210,271,11,282,0,O-41-32-04-01-02
BUGIRI,BUKOOLI NORTH,KAPYANGA,BUGIRI A,BUGIRI P. SCHOOL,697,7,3,7,129,260,406,24,430,0,O-41-32-04-01-03
BUGIRI,BUKOOLI NORTH,KAPYANGA,BUGIRI A,NABYUNU CHURCH,590,4,1,2,120,275,402,16,418,0,O-41-32-04-01-04
BUGIRI,BUKOOLI NORTH,KAPYANGA,BUGIRI A,BUKONDE GROUND,522,5,1,1,171,196,374,36,410,0,O-41-32-04-01-05
BUGIRI,BUKOOLI NORTH,KAPYANGA,BUGIRI A,BUGABO PRI. SCHOOL (N-Z),399,4,0,2,65,205,276,17,293,0,O-41-32-04-01-06
BUGIRI,BUKOOLI NORTH,KAPYANGA,BUGIRI A,BUSANZI PENT. CHURCH,409,1,2,1,87,161,252,34,286,0,O-41-32-04-01-07
BUGIRI,BUKOOLI NORTH,KAPYANGA,BUGUNGA,BUSWIRIRI PR SCHOOL,885,8,4,13,314,251,590,11,601,0,O-41-32-04-02-01
BUGIRI,BUKOOLI NORTH,KAPYANGA,BUGUNGA,BUGUNGA PR/SCHOOL,501,4,2,4,80,279,369,13,382,0,O-41-32-04-02-02
BUGIRI,BUKOOLI NORTH,KAPYANGA,BUGUNGA,BUSOLO PRI. SCHOOL,474,7,1,3,112,182,305,28,333,0,O-41-32-04-02-03
BUGIRI,BUKOOLI NORTH,KAPYANGA,BUGUNGA,BUDIBYA PRI. SCHOOL,512,10,5,7,179,135,336,17,353,0,O-41-32-04-02-04
BUGIRI,BUKOOLI NORTH,KAPYANGA,ISAGAZA,NAMAYEMBA P. SCHOOL (N-Z),808,6,7,4,279,190,486,12,498,0,O-41-32-04-03-01
BUGIRI,BUKOOLI NORTH,KAPYANGA,ISAGAZA,BUGOYOZI PRI. SCHOOL,644,4,1,4,221,223,453,34,487,0,O-41-32-04-03-02
BUGIRI,BUKOOLI NORTH,KAPYANGA,ISAGAZA,ISAGAZA PENTECOSTAL CHURCH,535,3,2,2,163,201,371,28,399,0,O-41-32-04-03-03
BUGIRI,BUKOOLI NORTH,KAPYANGA,ISAGAZA,NAMAYEMBA BAPTIST CHURCH,668,3,4,3,147,103,260,23,283,0,O-41-32-04-03-04
BUGIRI,BUKOOLI NORTH,KAPYANGA,ISAGAZA,NAMAYEMBA PARENTS SCHOOL,726,4,3,4,242,141,394,11,405,0,O-41-32-04-03-05
BUGIRI,BUKOOLI NORTH,KAPYANGA,ISAGAZA,NAMAGO CHURCH,264,6,2,1,109,87,205,6,211,0,O-41-32-04-03-06
BUGIRI,BUKOOLI NORTH,KAPYANGA,ISAGAZA,NAMAYEMBA P. SCHOOL (A-M),413,4,2,2,95,80,183,14,197,0,O-41-32-04-03-07
BUGIRI,BUKOOLI NORTH,KAPYANGA,KISEITAKA,KIRONGERO P. SCHOOL,412,1,0,0,63,196,260,61,321,0,O-41-32-04-04-01
BUGIRI,BUKOOLI NORTH,KAPYANGA,KISEITAKA,KAATO PRI. SCHOOL,399,3,4,2,73,197,279,35,314,0,O-41-32-04-04-02
BUGIRI,BUKOOLI NORTH,KAPYANGA,KISEITAKA,KISEITAKA P. SCHOOL,384,2,0,5,63,208,278,10,288,0,O-41-32-04-04-03
BUGIRI,BUKOOLI NORTH,KAPYANGA,KISEITAKA,KIRONGERO CATHOLIC CHURCH,401,2,1,3,77,196,279,17,296,0,O-41-32-04-04-04
BUGIRI,BUKOOLI NORTH,KAPYANGA,KISEITAKA,WANENGA PRIMARY SCHOOL,538,2,1,1,50,284,338,53,391,0,O-41-32-04-04-05
BUGIRI,BUKOOLI NORTH,KAPYANGA,KISEITAKA,NAMINYANGWE PRI. SCHOOL,501,3,3,2,123,191,322,0,322,0,O-41-32-04-04-06
BUGIRI,BUKOOLI NORTH,KAPYANGA,NAKAVULE,NAKAVULE C.O.U,457,4,0,2,118,184,308,17,325,0,O-41-32-04-05-01
BUGIRI,BUKOOLI NORTH,KAPYANGA,NAKAVULE,IZIRA P. SCHOOL,610,2,2,3,151,250,408,25,433,0,O-41-32-04-05-02
BUGIRI,BUKOOLI NORTH,KAPYANGA,NAKAVULE,NAKAVULE PRI SCHOOL,378,1,1,1,133,150,286,8,294,0,O-41-32-04-05-03
BUGIRI,BUKOOLI NORTH,KAPYANGA,NAKAVULE,KAMANGO PRI. SCHOOL,248,1,0,1,45,144,191,7,198,0,O-41-32-04-05-04
BUGIRI,BUKOOLI NORTH,KAPYANGA,NAMUKONGE,IGOGO MOSQUE,321,2,7,1,55,145,210,7,217,0,O-41-32-04-06-01
BUGIRI,BUKOOLI NORTH,KAPYANGA,NAMUKONGE,BUKAYE PRI. SCHOOL,719,6,2,5,129,350,492,28,520,0,O-41-32-04-06-02
BUGIRI,BUKOOLI NORTH,KAPYANGA,NAMUKONGE,KAYANGO HEALTH UNIT,773,4,2,7,124,320,457,41,498,0,O-41-32-04-06-03
BUGIRI,BUKOOLI NORTH,KAPYANGA,NAMUKONGE,BUWOFU PR SCHOOL,771,6,3,4,203,320,536,27,563,0,O-41-32-04-06-04
BUGIRI,BUKOOLI NORTH,KAPYANGA,NDIFAKULYA,LWABA GROUND,413,3,2,2,84,223,314,0,314,0,O-41-32-04-07-01
BUGIRI,BUKOOLI NORTH,KAPYANGA,NDIFAKULYA,NDIFAKULYA PRI. SCHOOL,503,2,5,2,102,228,339,34,373,0,O-41-32-04-07-02
BUGIRI,BUKOOLI NORTH,KAPYANGA,NDIFAKULYA,MUGONA GROUND,638,0,0,1,118,270,389,39,428,0,O-41-32-04-07-03
BUGIRI,BUKOOLI NORTH,KAPYANGA,NDIFAKULYA,BUKAYE GROUND,249,0,0,1,37,167,205,5,210,0,O-41-32-04-07-04
BUGIRI,BUKOOLI NORTH,NABUKALU,BUTYABULE,BUTYABULE P. SCHOOL,506,0,6,2,124,259,391,24,415,0,O-41-32-05-01-01
BUGIRI,BUKOOLI NORTH,NABUKALU,BUTYABULE,KYABAKAIRE P. SCHOOL,509,4,3,1,65,294,367,24,391,0,O-41-32-05-01-02
BUGIRI,BUKOOLI NORTH,NABUKALU,BUTYABULE,NAWANSEGA CO-OP SOCIETY,479,10,8,3,110,227,358,30,388,0,O-41-32-05-01-03
BUGIRI,BUKOOLI NORTH,NABUKALU,ISEGERO,BUKWAKU CO-OP SOCIETY,95,1,1,0,17,46,65,2,67,0,O-41-32-05-02-01
BUGIRI,BUKOOLI NORTH,NABUKALU,ISEGERO,NABUKIMA PRI. SCHOOL,304,1,1,5,96,129,232,0,232,0,O-41-32-05-02-02
BUGIRI,BUKOOLI NORTH,NABUKALU,ISEGERO,ITANDA COMMUNITY CENTRE,660,2,17,4,178,207,408,1,409,0,O-41-32-05-02-03
BUGIRI,BUKOOLI NORTH,NABUKALU,ISEGERO,ISEGERO PRI. SCHOOL,829,8,14,5,193,346,566,33,599,0,O-41-32-05-02-04
BUGIRI,BUKOOLI NORTH,NABUKALU,KASITA,BUBALYA CHURCH,543,1,13,5,105,259,383,18,401,0,O-41-32-05-03-01
BUGIRI,BUKOOLI NORTH,NABUKALU,KASITA,NABUKALU S/COUNTY HQRS,598,5,4,1,68,332,410,12,422,0,O-41-32-05-03-02
BUGIRI,BUKOOLI NORTH,NABUKALU,KASITA,KATETEMPE CHURCH,162,1,2,2,56,71,132,2,134,0,O-41-32-05-03-03
BUGIRI,BUKOOLI NORTH,NABUKALU,KASITA,KABASALA MOSLEM PRI. SCHOOL,254,1,3,0,79,116,199,14,213,0,O-41-32-05-03-04
BUGIRI,BUKOOLI NORTH,NABUKALU,KASITA,KAKINDU PRI. SCHOOL,478,1,7,1,66,276,351,16,367,0,O-41-32-05-03-05
BUGIRI,BUKOOLI NORTH,NABUKALU,LWANIKA,LWANIKA P. SCHOOL (A-M),643,1,6,1,103,324,435,11,446,0,O-41-32-05-04-01
BUGIRI,BUKOOLI NORTH,NABUKALU,LWANIKA,LWANIKA P. SCHOOL,370,0,0,3,44,217,264,4,268,0,O-41-32-05-04-02
BUGIRI,BUKOOLI NORTH,NABUKALU,LWANIKA,KIWONGOLO PRI. SCHOOL (N-Z),93,0,1,0,12,55,68,19,87,0,O-41-32-05-04-03
BUGIRI,BUKOOLI NORTH,NABUKALU,NAKIVAMBA,NAKIVAMBA BAPTIST SCHOOL,510,0,2,3,115,243,363,9,372,0,O-41-32-05-05-01
BUGIRI,BUKOOLI NORTH,NABUKALU,NAKIVAMBA,NAKIVAMBA MOSQUE,299,2,1,0,54,177,234,9,243,0,O-41-32-05-05-02
BUGIRI,BUKOOLI NORTH,NABUKALU,NKAIZA,NAKITAKA MOSQUE,353,3,5,3,67,219,297,6,303,0,O-41-32-05-06-01
BUGIRI,BUKOOLI NORTH,NABUKALU,NKAIZA,BUKUBANSIRI HEALTH UNIT,593,2,4,8,71,345,430,35,465,0,O-41-32-05-06-02
BUGIRI,BUKOOLI NORTH,NABUKALU,NKAIZA,NKAIZA PR SCHOOL,453,6,0,5,94,242,347,12,359,0,O-41-32-05-06-03
BUGIRI,BUKOOLI NORTH,NABUKALU,NKAIZA,BULANGA MOSQUE,276,1,4,2,84,126,217,13,230,0,O-41-32-05-06-04
BUGIRI,BUKOOLI NORTH,NABUKALU,WANGOBO,NSOKWE MOSQUE,582,3,0,1,156,263,423,5,428,0,O-41-32-05-07-01
BUGIRI,BUKOOLI NORTH,NABUKALU,WANGOBO,WANGOBO PR SCHOOL,303,1,0,0,105,117,223,7,230,0,O-41-32-05-07-02
BUGIRI,BUKOOLI NORTH,NABUKALU,WANGOBO,ITENTE MOSQUE,307,2,1,3,84,133,223,2,225,0,O-41-32-05-07-03
BUSIA,SAMIA BUGWE CTY SOUTH,BUHEHE,BUHASABA,MUSABA TRADING CENTRE,606,5,2,3,123,370,503,6,509,0,O-42-212-01-01-01
BUSIA,SAMIA BUGWE CTY SOUTH,BUHEHE,BUHASABA,BUSITENGE - MUKWANYA CHURC,624,5,3,1,109,393,511,14,525,0,O-42-212-01-01-02
BUSIA,SAMIA BUGWE CTY SOUTH,BUHEHE,BUHASABA,BUHABASA TRADING CENTRE,566,3,2,2,72,402,481,10,491,0,O-42-212-01-01-03
BUSIA,SAMIA BUGWE CTY SOUTH,BUHEHE,BUHASABA,MAGOMBE PRIMARY SCHOOL,519,3,1,1,87,320,412,11,423,0,O-42-212-01-01-04
BUSIA,SAMIA BUGWE CTY SOUTH,BUHEHE,BUHASABA,BUCHAKI A,444,3,2,0,102,269,376,8,384,0,O-42-212-01-01-05
BUSIA,SAMIA BUGWE CTY SOUTH,BUHEHE,BUHASABA,OPEN GATE T.C,305,3,1,2,62,184,252,7,259,0,O-42-212-01-01-06
BUSIA,SAMIA BUGWE CTY SOUTH,BUHEHE,BUHEHE,BUNYADETI P/SCHOOL,788,7,9,6,148,407,577,23,600,0,O-42-212-01-02-01
BUSIA,SAMIA BUGWE CTY SOUTH,BUHEHE,BUHEHE,BUNYADETI TRADING CENTRE,602,10,4,2,76,343,435,26,461,0,O-42-212-01-02-02
BUSIA,SAMIA BUGWE CTY SOUTH,BUHEHE,BUHEHE,BUNYIDE PRIMARY SCHOOL,672,6,4,6,84,417,517,27,544,0,O-42-212-01-02-03
BUSIA,SAMIA BUGWE CTY SOUTH,BUHEHE,BUHEHE,NAHAYAKA P. SCHOOL,557,6,6,3,113,277,405,14,419,0,O-42-212-01-02-04
BUSIA,SAMIA BUGWE CTY SOUTH,BUHEHE,BUHEHE,BUHEHE S/CTY HQRS,225,1,7,5,41,124,178,12,190,0,O-42-212-01-02-05
BUSIA,SAMIA BUGWE CTY SOUTH,BUHEHE,BULWENGE,BUSUBO PRIMARY SCHOOL,269,4,2,1,43,181,231,10,241,0,O-42-212-01-03-01
BUSIA,SAMIA BUGWE CTY SOUTH,BUHEHE,BULWENGE,BULWENGE P. SCHOOL,721,5,2,4,95,443,549,20,569,0,O-42-212-01-03-02
BUSIA,SAMIA BUGWE CTY SOUTH,BUHEHE,BULWENGE,SIBONA HEALTH CENTRE,469,7,10,4,66,300,387,5,392,0,O-42-212-01-03-03
BUSIA,SAMIA BUGWE CTY SOUTH,BUHEHE,BULWENGE,BUKWALA C.O.U,383,3,2,3,72,225,305,22,327,0,O-42-212-01-03-04
BUSIA,SAMIA BUGWE CTY SOUTH,LUMINO,DADIRA,JUNGE,292,3,3,0,58,161,225,10,235,0,O-42-212-02-01-01
BUSIA,SAMIA BUGWE CTY SOUTH,LUMINO,DADIRA,MORORO,482,7,3,3,69,294,376,15,391,0,O-42-212-02-01-02
BUSIA,SAMIA BUGWE CTY SOUTH,LUMINO,DADIRA,APOSTOLIC CHURCH RUGEGA,548,6,4,8,83,345,446,12,458,0,O-42-212-02-01-03
BUSIA,SAMIA BUGWE CTY SOUTH,LUMINO,DADIRA,DADIRA P. SCHOOL,462,3,2,7,45,276,333,29,362,0,O-42-212-02-01-04
BUSIA,SAMIA BUGWE CTY SOUTH,LUMINO,HASYULE,BUDIMO PRIMARY SCHOOL,526,5,1,4,96,281,387,24,411,0,O-42-212-02-02-01
BUSIA,SAMIA BUGWE CTY SOUTH,LUMINO,HASYULE,BUKOBE P. SCHOOL,433,4,4,4,102,199,313,18,331,0,O-42-212-02-02-02
BUSIA,SAMIA BUGWE CTY SOUTH,LUMINO,HASYULE,MWERA MARKET,624,5,1,2,93,361,462,14,476,0,O-42-212-02-02-03
BUSIA,SAMIA BUGWE CTY SOUTH,LUMINO,HASYULE,HASYULE STORE,505,7,4,8,94,286,399,31,430,0,O-42-212-02-02-04
BUSIA,SAMIA BUGWE CTY SOUTH,LUMINO,JINJA,SYAMALEDE C.O.U,453,4,13,8,131,211,367,12,379,0,O-42-212-02-03-01
BUSIA,SAMIA BUGWE CTY SOUTH,LUMINO,JINJA,BUWERERO P/S,609,4,5,8,139,284,440,19,459,0,O-42-212-02-03-02
BUSIA,SAMIA BUGWE CTY SOUTH,LUMINO,LUMINO,BUKWEKWE P/ SCHOOL,738,5,6,6,197,311,525,22,547,0,O-42-212-02-04-01
BUSIA,SAMIA BUGWE CTY SOUTH,LUMINO,LUMINO,LUMINO S/C HQRS,428,3,1,1,123,184,312,42,354,0,O-42-212-02-04-02
BUSIA,SAMIA BUGWE CTY SOUTH,LUMINO,LUMINO,NANGUTU,661,3,4,8,139,344,498,28,526,0,O-42-212-02-04-03
BUSIA,SAMIA BUGWE CTY SOUTH,LUMINO,MAJANJI,MADUWA P/S,524,6,2,6,112,266,392,25,417,0,O-42-212-02-05-01
BUSIA,SAMIA BUGWE CTY SOUTH,LUMINO,MAJANJI,MAJANJI P. SCHOOL,450,3,0,3,91,230,327,19,346,0,O-42-212-02-05-02
BUSIA,SAMIA BUGWE CTY SOUTH,LUMINO,MAJANJI,BULWANDE C.O.U,338,2,1,0,89,173,265,8,273,0,O-42-212-02-05-03
BUSIA,SAMIA BUGWE CTY SOUTH,LUMINO,NAGABITA,BUHENYE PROJECT,416,3,4,6,127,171,311,20,331,0,O-42-212-02-06-01
BUSIA,SAMIA BUGWE CTY SOUTH,LUMINO,NAGABITA,NAHABANJO RCM,426,5,5,4,119,183,316,9,325,0,O-42-212-02-06-02
BUSIA,SAMIA BUGWE CTY SOUTH,LUMINO,NAGABITA,GANGU T/C,520,7,6,5,147,212,377,18,395,0,O-42-212-02-06-03
BUSIA,SAMIA BUGWE CTY SOUTH,LUNYO,BUSIABALA,BUSIABALA,408,2,2,3,96,198,301,17,318,0,O-42-212-03-01-01
BUSIA,SAMIA BUGWE CTY SOUTH,LUNYO,BUSIABALA,BUKUHU B/HOLE,246,2,1,2,161,49,215,9,224,0,O-42-212-03-01-02
BUSIA,SAMIA BUGWE CTY SOUTH,LUNYO,BUSIME,NAMAMERA CHURCH,547,8,1,8,82,308,407,13,420,0,O-42-212-03-02-01
BUSIA,SAMIA BUGWE CTY SOUTH,LUNYO,BUSIME,MUYEMBE TEYARI T. CENTRE,379,6,2,7,82,210,307,22,329,0,O-42-212-03-02-02
BUSIA,SAMIA BUGWE CTY SOUTH,LUNYO,BUSIME,LUKABA CHURCHES,524,6,6,5,99,289,405,17,422,0,O-42-212-03-02-03
BUSIA,SAMIA BUGWE CTY SOUTH,LUNYO,BWANIHA,BULOSI P. SCHOOL,464,8,2,4,79,272,365,13,378,0,O-42-212-03-03-01
BUSIA,SAMIA BUGWE CTY SOUTH,LUNYO,BWANIHA,BWANIHA TRADING CENTRE,387,3,0,0,77,214,294,11,305,0,O-42-212-03-03-02
BUSIA,SAMIA BUGWE CTY SOUTH,LUNYO,BWANIHA,BWANIKA PATIST P/S,401,9,0,3,73,233,318,16,334,0,O-42-212-03-03-03
BUSIA,SAMIA BUGWE CTY SOUTH,LUNYO,BWANIHA,DAKHA A NDANDA'S AREA,453,4,1,3,98,265,371,18,389,0,O-42-212-03-03-04
BUSIA,SAMIA BUGWE CTY SOUTH,LUNYO,LUNYO,BULONDANI C/OF UGANDA,484,6,3,6,131,234,380,19,399,0,O-42-212-03-04-01
BUSIA,SAMIA BUGWE CTY SOUTH,LUNYO,LUNYO,LUNYO PRIMARY SCHOOL,181,0,1,0,54,76,131,5,136,0,O-42-212-03-04-02
BUSIA,SAMIA BUGWE CTY SOUTH,LUNYO,LUNYO,SIHOMA T/C,376,3,1,5,121,172,302,6,308,0,O-42-212-03-04-03
BUSIA,SAMIA BUGWE CTY SOUTH,LUNYO,MUNDINDI,MUNDINDI P/ SCHOOL,421,0,3,3,110,222,338,6,344,0,O-42-212-03-05-01
BUSIA,SAMIA BUGWE CTY SOUTH,LUNYO,MUNDINDI,MUNDINDI TRADING CENTRE,703,10,5,4,207,334,560,10,570,0,O-42-212-03-05-02
BUSIA,SAMIA BUGWE CTY SOUTH,LUNYO,MUNDINDI,SIRERE P. SCHOOL,445,7,5,1,123,158,294,35,329,0,O-42-212-03-05-03
BUSIA,SAMIA BUGWE CTY SOUTH,LUNYO,MUNDINDI,ARAMBE T/C,344,2,3,3,53,215,276,8,284,0,O-42-212-03-05-04
BUSIA,SAMIA BUGWE CTY SOUTH,LUNYO,MUNDINDI,LWALA BOREHOLE,316,2,2,3,98,151,256,11,267,0,O-42-212-03-05-05
BUSIA,SAMIA BUGWE CTY SOUTH,LUNYO,NALWIRE,BULEKEI P/ SCHOOL,341,5,1,3,69,165,243,13,256,0,O-42-212-03-06-01
BUSIA,SAMIA BUGWE CTY SOUTH,LUNYO,NALWIRE,BUTENGE P/ SCHOOL A,470,7,10,4,139,175,335,17,352,0,O-42-212-03-06-02
BUSIA,SAMIA BUGWE CTY SOUTH,LUNYO,NALWIRE,HUKEMO T/ CENTER,764,7,6,6,192,286,497,24,521,0,O-42-212-03-06-03
BUSIA,SAMIA BUGWE CTY SOUTH,LUNYO,NALWIRE,BUSOHONI OPEN BIBLE CHURCH,322,1,5,1,101,120,228,16,244,0,O-42-212-03-06-04
BUSIA,SAMIA BUGWE CTY SOUTH,LUNYO,NEKUKU,NEKUKU P/SCHOOL,409,2,14,4,151,164,335,6,341,0,O-42-212-03-07-01
BUSIA,SAMIA BUGWE CTY SOUTH,LUNYO,NEKUKU,TUNGATUNGA TRADING CENTRE,311,3,6,5,62,183,259,16,275,0,O-42-212-03-07-02
BUSIA,SAMIA BUGWE CTY SOUTH,LUNYO,NEKUKU,MANYOFU,434,3,1,2,89,247,342,20,362,0,O-42-212-03-07-03
BUSIA,SAMIA BUGWE CTY SOUTH,LUNYO,RUKAKA,LUMULI P/SCHOOL,465,2,5,2,99,291,399,11,410,0,O-42-212-03-08-01
BUSIA,SAMIA BUGWE CTY SOUTH,LUNYO,RUKAKA,LUKAKA CHURCH,428,2,3,8,126,200,339,17,356,0,O-42-212-03-08-02
BUSIA,SAMIA BUGWE CTY SOUTH,MASABA,BUTANGASI,BUTANGASI P. SCHOOL,683,5,4,3,179,350,541,29,570,0,O-42-212-04-01-01
BUSIA,SAMIA BUGWE CTY SOUTH,MASABA,BUTANGASI,MUMUYEMBE - OWAGANDA,674,11,5,5,125,383,529,6,535,0,O-42-212-04-01-02
BUSIA,SAMIA BUGWE CTY SOUTH,MASABA,BUTANGASI,MUNAKA TRADING CENTRE,614,4,3,4,146,342,499,11,510,0,O-42-212-04-01-03
BUSIA,SAMIA BUGWE CTY SOUTH,MASABA,BUTANGASI,SIFUYO TRADING CENTRE,495,2,4,3,90,275,374,10,384,0,O-42-212-04-01-04
BUSIA,SAMIA BUGWE CTY SOUTH,MASABA,MASABA,BUJWANGA P/S,497,5,8,3,96,269,381,23,404,0,O-42-212-04-02-01
BUSIA,SAMIA BUGWE CTY SOUTH,MASABA,MASABA,LWANIHA P/S,790,6,16,9,259,310,600,13,613,0,O-42-212-04-02-02
BUSIA,SAMIA BUGWE CTY SOUTH,MASABA,MASABA,MAGALE P/S,605,11,3,5,134,298,451,44,495,0,O-42-212-04-02-03
BUSIA,SAMIA BUGWE CTY SOUTH,MASABA,MASABA,NAMALA P/S,664,3,8,1,161,317,490,27,517,0,O-42-212-04-02-04
BUSIA,SAMIA BUGWE CTY SOUTH,MASABA,MASABA,SEKA T.C,266,3,6,1,49,149,208,14,222,0,O-42-212-04-02-05
BUSIA,SAMIA BUGWE CTY SOUTH,MASABA,MBEHENYI,BUSONGA PRIMARY SCHOOL,734,4,7,3,143,401,558,21,579,0,O-42-212-04-03-01
BUSIA,SAMIA BUGWE CTY SOUTH,MASABA,MBEHENYI,BUTACHO PRIMARY SCHOOL,512,3,2,3,79,299,386,16,402,0,O-42-212-04-03-02
BUSIA,SAMIA BUGWE CTY SOUTH,MASABA,MBEHENYI,MBEHENYI P/ SCHOOL,407,0,5,0,115,190,310,27,337,0,O-42-212-04-03-03
BUSIA,SAMIA BUGWE CTY SOUTH,MASABA,MBEHENYI,MASABA SUB/COUNTY HQRS,530,5,9,2,122,219,357,56,413,0,O-42-212-04-03-04
BUSIA,SAMIA BUGWE CTY SOUTH,MASABA,MBEHENYI,MUMUNYEMBE OWAMANGOLI,499,3,4,4,106,231,348,31,379,0,O-42-212-04-03-05
BUSIA,SAMIA BUGWE CTY SOUTH,MASABA,MBEHENYI,OBULUNGU PRIMARY SCHOOL,413,7,6,4,113,187,317,16,333,0,O-42-212-04-03-06
BUSIA,SAMIA BUGWE CTY SOUTH,MASAFU,BUHATUBA,BUDANDU PRIMARY SCHOOL,616,7,13,3,174,228,425,28,453,0,O-42-212-05-01-01
BUSIA,SAMIA BUGWE CTY SOUTH,MASAFU,BUHATUBA,BUKALIKHA PRIMARY SCHOOL,496,6,10,1,152,191,360,14,374,0,O-42-212-05-01-02
BUSIA,SAMIA BUGWE CTY SOUTH,MASAFU,BUHATUBA,BUHATUBA T.C,393,4,10,5,99,185,303,13,316,0,O-42-212-05-01-03
BUSIA,SAMIA BUGWE CTY SOUTH,MASAFU,BUMUNJI,BULONGIT T.C,369,3,4,6,93,187,293,14,307,0,O-42-212-05-02-01
BUSIA,SAMIA BUGWE CTY SOUTH,MASAFU,BUMUNJI,BUDIBYA BOREHOLE,279,1,10,5,66,116,198,20,218,0,O-42-212-05-02-02
BUSIA,SAMIA BUGWE CTY SOUTH,MASAFU,BUMUNJI,BUMUNJI TRADING CENTRE,619,7,5,13,205,210,440,28,468,0,O-42-212-05-02-03
BUSIA,SAMIA BUGWE CTY SOUTH,MASAFU,BUMUNJI,BUWALIRA PRIMARY SCHOOL,614,13,7,14,297,118,449,16,465,0,O-42-212-05-02-04
BUSIA,SAMIA BUGWE CTY SOUTH,MASAFU,BUMUNJI,BWAYA TRADING CENTRE,484,5,6,5,123,213,352,23,375,0,O-42-212-05-02-05
BUSIA,SAMIA BUGWE CTY SOUTH,MASAFU,BUSIKHO,BUYIMINI,683,5,9,5,157,360,536,30,566,0,O-42-212-05-03-01
BUSIA,SAMIA BUGWE CTY SOUTH,MASAFU,BUSIKHO,BUYIYE,676,5,4,8,146,368,531,18,549,0,O-42-212-05-03-02
BUSIA,SAMIA BUGWE CTY SOUTH,MASAFU,BUTOTE,BUJABI,697,3,4,8,197,241,453,29,482,0,O-42-212-05-04-01
BUSIA,SAMIA BUGWE CTY SOUTH,MASAFU,BUTOTE,BUSIKHO T T C,469,7,2,0,64,238,311,17,328,0,O-42-212-05-04-02
BUSIA,SAMIA BUGWE CTY SOUTH,MASAFU,BUTOTE,BUTOTE,370,3,5,2,76,197,283,11,294,0,O-42-212-05-04-03
BUSIA,SAMIA BUGWE CTY SOUTH,MASAFU,BUTOTE,MASAFU TRADING CENTRE,399,4,5,1,102,204,316,5,321,0,O-42-212-05-04-04
BUSIA,SAMIA BUGWE CTY SOUTH,MASAFU,KUBO,KUBO P/S,667,1,8,4,204,280,497,16,513,0,O-42-212-05-05-01
BUSIA,SAMIA BUGWE CTY SOUTH,MASAFU,KUBO,BUKOBE P/S,547,1,4,3,218,208,434,0,434,0,O-42-212-05-05-02
BUSIA,SAMIA BUGWE CTY SOUTH,MASAFU,MASAFU,KODEMA,628,2,5,5,105,356,473,35,508,0,O-42-212-05-06-01
BUSIA,SAMIA BUGWE CTY SOUTH,MASAFU,MASAFU,MASAFU,586,3,8,4,139,263,417,34,451,0,O-42-212-05-06-02
BUSIA,SAMIA BUGWE CTY SOUTH,MASAFU,MASAFU,SICHEHE-SIKOHWE T/C,230,2,1,2,40,125,170,16,186,0,O-42-212-05-06-03
BUSIA,SAMIA BUGWE CTY SOUTH,MASAFU,MASINYA,BUHUMWA TRADING CENTRE,450,1,6,8,145,183,343,30,373,0,O-42-212-05-07-01
BUSIA,SAMIA BUGWE CTY SOUTH,MASAFU,MASINYA,BULEKYA TRADING CENTRE,656,5,5,9,268,202,489,39,528,0,O-42-212-05-07-02
BUSIA,SAMIA BUGWE CTY SOUTH,MASAFU,MAWANGA,BUDIBYA PRIMARY SCHOOL,533,1,2,4,123,239,369,59,428,0,O-42-212-05-08-01
BUSIA,SAMIA BUGWE CTY SOUTH,MASAFU,MAWANGA,MUKANGU P/ SCHOOL,330,3,3,1,106,152,265,4,269,0,O-42-212-05-08-02
BUSIA,SAMIA BUGWE CTY SOUTH,MASAFU,MAWANGA,NAMAYEMBA TRADING CENTRE,465,1,1,4,116,231,353,26,379,0,O-42-212-05-08-03
BUSIA,SAMIA BUGWE CTY SOUTH,MASAFU,MAWANGA,MAWANGA COU,426,4,4,0,96,252,356,22,378,0,O-42-212-05-08-04
BUSIA,SAMIA BUGWE CTY SOUTH,MASAFU,MAWANGA,BUSEDU T/C,327,0,5,3,81,175,264,25,289,0,O-42-212-05-08-05
BUSIA,SAMIA BUGWE NORTH,BULUMBI,BUBANGO,BULUMBI S/C HQS,597,3,3,2,131,281,420,9,429,0,O-42-211-01-01-01
BUSIA,SAMIA BUGWE NORTH,BULUMBI,BUBANGO,NAMUTERE,283,2,6,10,64,127,209,5,214,0,O-42-211-01-01-02
BUSIA,SAMIA BUGWE NORTH,BULUMBI,BUBANGO,HAMASANJA P/S,363,4,1,8,72,202,287,15,302,0,O-42-211-01-01-03
BUSIA,SAMIA BUGWE NORTH,BULUMBI,BUHOBE,BUHOBE A,652,6,3,11,155,282,457,16,473,0,O-42-211-01-02-01
BUSIA,SAMIA BUGWE NORTH,BULUMBI,BUHOBE,BUHOBE B,656,6,3,4,139,292,444,4,448,0,O-42-211-01-02-02
BUSIA,SAMIA BUGWE NORTH,BULUMBI,BUHUMI,NAMUNGODI P. SCHOOL,751,9,6,12,231,278,536,24,560,0,O-42-211-01-03-01
BUSIA,SAMIA BUGWE NORTH,BULUMBI,BUHUMI,SIDIMBIRE MVULE TREE,249,3,5,3,101,77,189,7,196,0,O-42-211-01-03-02
BUSIA,SAMIA BUGWE NORTH,BULUMBI,BUKHUBALO,HALUBA,483,7,5,9,116,169,306,20,326,0,O-42-211-01-04-01
BUSIA,SAMIA BUGWE NORTH,BULUMBI,BUKHUBALO,NAMASYOLO PR. SCH,429,1,8,5,136,172,322,5,327,0,O-42-211-01-04-02
BUSIA,SAMIA BUGWE NORTH,BULUMBI,BUKHUBALO,NANYONYI P/S,385,1,12,6,83,164,266,10,276,0,O-42-211-01-04-03
BUSIA,SAMIA BUGWE NORTH,BULUMBI,BUKHUBALO,MU CORNER T.C,274,1,3,1,45,156,206,3,209,0,O-42-211-01-04-04
BUSIA,SAMIA BUGWE NORTH,BULUMBI,BULUMBI,BUHOYA P/SCHOOL,543,1,6,4,162,233,406,20,426,0,O-42-211-01-05-01
BUSIA,SAMIA BUGWE NORTH,BULUMBI,BULUMBI,NUDA,749,6,19,7,241,273,546,21,567,0,O-42-211-01-05-02
BUSIA,SAMIA BUGWE NORTH,BULUMBI,BUSIBEMBE,BUSIBEMBE PRIMARY SCH,568,4,10,7,149,262,432,28,460,0,O-42-211-01-06-01
BUSIA,SAMIA BUGWE NORTH,BULUMBI,BUSIBEMBE,SHAURI T/C,642,4,5,9,135,329,482,17,499,0,O-42-211-01-06-02
BUSIA,SAMIA BUGWE NORTH,BULUMBI,BUWEMBE,BUMIRA MBAKO P/S,773,8,11,5,212,294,530,18,548,0,O-42-211-01-07-01
BUSIA,SAMIA BUGWE NORTH,BULUMBI,BUWEMBE,BUWEMBE P/S,390,6,6,7,127,110,256,15,271,0,O-42-211-01-07-02
BUSIA,SAMIA BUGWE NORTH,BULUMBI,BUWEMBE,BUWEMBE G.C.S TREE,613,5,7,8,167,272,459,15,474,0,O-42-211-01-07-03
BUSIA,SAMIA BUGWE NORTH,BULUMBI,BUYUNDA,BUHONGE TRADING CENTRE,460,4,1,2,77,275,359,12,371,0,O-42-211-01-08-01
BUSIA,SAMIA BUGWE NORTH,BULUMBI,BUYUNDA,SOKOMUJINGA T.C,467,5,3,6,92,257,363,13,376,0,O-42-211-01-08-02
BUSIA,SAMIA BUGWE NORTH,BULUMBI,BUYUNDA,BUSIGUMBA P/S,331,5,0,2,80,170,257,9,266,0,O-42-211-01-08-03
BUSIA,SAMIA BUGWE NORTH,BUSIA T.C.,CENTRAL,NANGWE MUGUNGU A,435,3,7,2,136,76,224,18,242,0,O-42-211-02-01-01
BUSIA,SAMIA BUGWE NORTH,BUSIA T.C.,CENTRAL,NANGWE MUGUNGU B,495,2,1,1,141,117,262,12,274,0,O-42-211-02-01-02
BUSIA,SAMIA BUGWE NORTH,BUSIA T.C.,CENTRAL,NANGWE CUSTOMS ROAD A,884,2,2,2,244,162,412,20,432,0,O-42-211-02-01-03
BUSIA,SAMIA BUGWE NORTH,BUSIA T.C.,CENTRAL,NANGWE CUSTOMS ROAD B,376,0,0,3,119,93,215,12,227,0,O-42-211-02-01-04
BUSIA,SAMIA BUGWE NORTH,BUSIA T.C.,CENTRAL,NANGWE MUGUNGU JAMBULA TR,353,2,2,0,112,89,205,6,211,0,O-42-211-02-01-05
BUSIA,SAMIA BUGWE NORTH,BUSIA T.C.,NORTH A,MIRACLE CENTRE,1038,3,2,5,267,209,486,19,505,0,O-42-211-02-02-01
BUSIA,SAMIA BUGWE NORTH,BUSIA T.C.,NORTH A,BUSIA RED-CROSS OFFICE B,582,1,5,1,153,72,232,8,240,0,O-42-211-02-02-02
BUSIA,SAMIA BUGWE NORTH,BUSIA T.C.,NORTH A,TEACHERS QUARTERS,377,0,4,1,96,105,206,4,210,0,O-42-211-02-02-03
BUSIA,SAMIA BUGWE NORTH,BUSIA T.C.,NORTH A,PRODUCE MARKET,369,1,1,0,101,54,157,6,163,0,O-42-211-02-02-04
BUSIA,SAMIA BUGWE NORTH,BUSIA T.C.,NORTH A,SOMA COLLEGE SCHOOL C,850,8,2,0,248,136,394,9,403,0,O-42-211-02-02-05
BUSIA,SAMIA BUGWE NORTH,BUSIA T.C.,NORTH A,BUSIA RED-CROSS OFFICE C,633,3,3,3,144,82,235,8,243,0,O-42-211-02-02-06
BUSIA,SAMIA BUGWE NORTH,BUSIA T.C.,NORTH B,ELIM CHURCH MANGO TREE,528,2,1,1,148,91,243,14,257,0,O-42-211-02-03-01
BUSIA,SAMIA BUGWE NORTH,BUSIA T.C.,NORTH B,NAIKONTA,458,3,1,0,126,76,206,11,217,0,O-42-211-02-03-02
BUSIA,SAMIA BUGWE NORTH,BUSIA T.C.,NORTH B,BUCHICHA P/SCHOOL,546,5,5,1,224,89,324,17,341,0,O-42-211-02-03-03
BUSIA,SAMIA BUGWE NORTH,BUSIA T.C.,NORTH C,WATER TANK,547,2,0,0,154,65,221,5,226,0,O-42-211-02-04-01
BUSIA,SAMIA BUGWE NORTH,BUSIA T.C.,NORTH C,QUARAN SCHOOL NEAR MILL A,580,2,0,0,189,70,261,7,268,0,O-42-211-02-04-02
BUSIA,SAMIA BUGWE NORTH,BUSIA T.C.,NORTH C,LATE OMAYO'S MANGO TREE A,685,4,1,2,189,83,279,8,287,0,O-42-211-02-04-03
BUSIA,SAMIA BUGWE NORTH,BUSIA T.C.,NORTH C,LATE OMAYO'S MANGO TREE B,495,2,3,0,185,45,235,7,242,0,O-42-211-02-04-04
BUSIA,SAMIA BUGWE NORTH,BUSIA T.C.,NORTH C,BANANDA HIGH SCHOOL,402,0,0,0,124,53,177,5,182,0,O-42-211-02-04-05
BUSIA,SAMIA BUGWE NORTH,BUSIA T.C.,NORTH EAST A,EASTERN NEW MARKET,470,0,0,1,179,74,254,13,267,0,O-42-211-02-05-01
BUSIA,SAMIA BUGWE NORTH,BUSIA T.C.,NORTH EAST A,GREENS ACADEMY SCHOOL,726,2,1,1,210,81,295,8,303,0,O-42-211-02-05-02
BUSIA,SAMIA BUGWE NORTH,BUSIA T.C.,NORTH EAST A,HATARI PALACE,496,0,0,0,127,68,195,2,197,0,O-42-211-02-05-03
BUSIA,SAMIA BUGWE NORTH,BUSIA T.C.,NORTH EAST A,MOSQUE SCHOOL,639,1,2,1,261,107,372,6,378,0,O-42-211-02-05-04
BUSIA,SAMIA BUGWE NORTH,BUSIA T.C.,NORTH EAST A,BUS PARK,343,0,3,0,130,54,187,2,189,0,O-42-211-02-05-05
BUSIA,SAMIA BUGWE NORTH,BUSIA T.C.,NORTH EAST A,WESTERN NEW MARKET,402,1,1,1,149,66,218,5,223,0,O-42-211-02-05-06
BUSIA,SAMIA BUGWE NORTH,BUSIA T.C.,NORTH EAST A,NEW TAXI PARK,650,1,1,2,222,123,349,11,360,0,O-42-211-02-05-07
BUSIA,SAMIA BUGWE NORTH,BUSIA T.C.,NORTH EAST B,MOLASSES CENTRE,528,0,4,2,149,114,269,5,274,0,O-42-211-02-06-01
BUSIA,SAMIA BUGWE NORTH,BUSIA T.C.,NORTH EAST B,TOWN NURSERY SCHOOL,333,0,1,0,92,67,160,4,164,0,O-42-211-02-06-02
BUSIA,SAMIA BUGWE NORTH,BUSIA T.C.,NORTH EAST B,PARENTS SECONDARY SCHOOL,370,1,0,0,76,55,132,4,136,0,O-42-211-02-06-03
BUSIA,SAMIA BUGWE NORTH,BUSIA T.C.,NORTH EAST B,VICTORY CHURCH,344,0,0,1,95,53,149,11,160,0,O-42-211-02-06-04
BUSIA,SAMIA BUGWE NORTH,BUSIA T.C.,SOUTH EAST,MARACHA D AT OJAMES PLACE,341,1,0,1,84,96,182,2,184,0,O-42-211-02-07-01
BUSIA,SAMIA BUGWE NORTH,BUSIA T.C.,SOUTH EAST,MARACHI 'D' AT THE CLINIC,386,0,1,1,80,109,191,13,204,0,O-42-211-02-07-02
BUSIA,SAMIA BUGWE NORTH,BUSIA T.C.,SOUTH EAST,MARACHI D MWALIMU'S PLACE (A,459,1,0,2,137,104,244,13,257,0,O-42-211-02-07-03
BUSIA,SAMIA BUGWE NORTH,BUSIA T.C.,SOUTH EAST,MARACHI D AT HAJI WANDERA'S,712,0,1,2,164,166,333,18,351,0,O-42-211-02-07-04
BUSIA,SAMIA BUGWE NORTH,BUSIA T.C.,SOUTH EAST,NAME_MISSING,551,1,0,1,142,132,276,3,279,0,O-42-211-02-07-05
BUSIA,SAMIA BUGWE NORTH,BUSIA T.C.,SOUTH EAST,NDEGE'S PLACE,557,2,3,1,179,107,292,20,312,0,O-42-211-02-07-06
BUSIA,SAMIA BUGWE NORTH,BUSIA T.C.,SOUTH EAST,ROSE ACHA'S PLACE,129,0,0,0,28,30,58,2,60,0,O-42-211-02-07-07
BUSIA,SAMIA BUGWE NORTH,BUSIA T.C.,SOUTH EAST,MARACHI D MWALIMU'S PLACE (F-,603,4,3,2,87,75,171,13,184,0,O-42-211-02-07-08
BUSIA,SAMIA BUGWE NORTH,BUSIA T.C.,SOUTH WEST,BUSIA OLD PARK,629,1,0,0,207,94,302,8,310,0,O-42-211-02-08-01
BUSIA,SAMIA BUGWE NORTH,BUSIA T.C.,SOUTH WEST,BUSIA INTERGRATED P S,629,7,2,3,212,120,344,5,349,0,O-42-211-02-08-02
BUSIA,SAMIA BUGWE NORTH,BUSIA T.C.,SOUTH WEST,DAIRY PLANT,517,3,5,1,131,89,229,6,235,0,O-42-211-02-08-03
BUSIA,SAMIA BUGWE NORTH,BUSIA T.C.,SOUTH WEST,MADIBIRA P/SCHOOL,681,1,4,2,215,178,400,19,419,0,O-42-211-02-08-04
BUSIA,SAMIA BUGWE NORTH,BUSIA T.C.,SOUTH WEST,NANGWE CORNER BAR,615,6,3,0,170,151,330,9,339,0,O-42-211-02-08-05
BUSIA,SAMIA BUGWE NORTH,BUSIA T.C.,SOUTH WEST,NANGWE MARKET,743,3,5,1,237,190,436,6,442,0,O-42-211-02-08-06
BUSIA,SAMIA BUGWE NORTH,BUSIA T.C.,SOUTH WEST,BILARI P/S,449,1,5,0,131,70,207,4,211,0,O-42-211-02-08-07
BUSIA,SAMIA BUGWE NORTH,BUSIA T.C.,SOUTH WEST,MAYOR'S GARDEN,364,0,1,1,85,55,142,4,146,0,O-42-211-02-08-08
BUSIA,SAMIA BUGWE NORTH,BUSITEMA,AJUKETE,AJUKETE,488,6,4,1,75,268,354,21,375,0,O-42-211-03-01-01
BUSIA,SAMIA BUGWE NORTH,BUSITEMA,AJUKETE,OPEN GATE T.C (A-I),336,5,1,2,51,196,255,9,264,0,O-42-211-03-01-02
BUSIA,SAMIA BUGWE NORTH,BUSITEMA,AJUKETE,OPEN GATE T.C (J-Z),386,5,2,2,98,176,283,22,305,0,O-42-211-03-01-03
BUSIA,SAMIA BUGWE NORTH,BUSITEMA,BUCHICHA,BUSUWU,602,11,6,6,222,164,409,21,430,0,O-42-211-03-02-01
BUSIA,SAMIA BUGWE NORTH,BUSITEMA,BUCHICHA,MUNDAYA T.C,344,3,5,6,136,109,259,16,275,0,O-42-211-03-02-02
BUSIA,SAMIA BUGWE NORTH,BUSITEMA,BUSITEMA,BUSITEMA AGRICULTURAL COLLE,311,5,7,11,66,116,205,4,209,0,O-42-211-03-03-01
BUSIA,SAMIA BUGWE NORTH,BUSITEMA,BUSITEMA,NGOCHI T.C,430,2,0,6,152,162,322,5,327,0,O-42-211-03-03-02
BUSIA,SAMIA BUGWE NORTH,BUSITEMA,BUSITEMA,MAKINA PR. SCHOOL,557,6,7,9,149,214,385,18,403,0,O-42-211-03-03-03
BUSIA,SAMIA BUGWE NORTH,BUSITEMA,BUSITEMA,SYULE P/S,534,9,6,3,124,239,381,14,395,0,O-42-211-03-03-04
BUSIA,SAMIA BUGWE NORTH,BUSITEMA,CHAWO,BUSITEMA S/COUNTY HQRS,391,1,4,1,89,147,242,5,247,0,O-42-211-03-04-01
BUSIA,SAMIA BUGWE NORTH,BUSITEMA,CHAWO,NANGULU PRIMARY SCHOOL,483,4,3,10,124,200,341,21,362,0,O-42-211-03-04-02
BUSIA,SAMIA BUGWE NORTH,BUSITEMA,CHAWO,NDAIGA TRADING CENTRE,696,4,6,7,159,298,474,24,498,0,O-42-211-03-04-03
BUSIA,SAMIA BUGWE NORTH,BUSITEMA,CHAWO,NAMBEWO T.C,530,5,3,8,103,264,383,11,394,0,O-42-211-03-04-04
BUSIA,SAMIA BUGWE NORTH,BUSITEMA,HABULEKE,HABULEKE PR. SCHOOL,482,9,7,6,162,170,354,28,382,0,O-42-211-03-05-01
BUSIA,SAMIA BUGWE NORTH,BUSITEMA,HABULEKE,MBATU PR. SCHOOL,319,1,1,7,70,157,236,23,259,0,O-42-211-03-05-02
BUSIA,SAMIA BUGWE NORTH,BUSITEMA,SIKUDA,MULUHONI T.C,527,7,5,6,171,206,395,5,400,0,O-42-211-03-06-01
BUSIA,SAMIA BUGWE NORTH,BUSITEMA,SIKUDA,HEKAKA,394,2,2,2,89,168,263,18,281,0,O-42-211-03-06-02
BUSIA,SAMIA BUGWE NORTH,BUSITEMA,SIKUDA,ASOPOTOIT,735,5,4,4,226,320,559,11,570,0,O-42-211-03-06-03
BUSIA,SAMIA BUGWE NORTH,BUSITEMA,SYANYONJA,BUSITEMA TRADING CENTRE,558,4,5,5,153,220,387,22,409,0,O-42-211-03-07-01
BUSIA,SAMIA BUGWE NORTH,BUSITEMA,TIIRA,TABONGO,428,2,2,4,125,195,328,8,336,0,O-42-211-03-08-01
BUSIA,SAMIA BUGWE NORTH,BUSITEMA,TIIRA,TIIRA,600,8,5,2,189,215,419,16,435,0,O-42-211-03-08-02
BUSIA,SAMIA BUGWE NORTH,BUTEBA,ABOCHET,OKAME P. SCHOOL,699,8,6,24,201,245,484,27,511,0,O-42-211-04-01-01
BUSIA,SAMIA BUGWE NORTH,BUTEBA,ABOCHET,NAIKONTA,462,5,4,6,147,169,331,5,336,0,O-42-211-04-01-02
BUSIA,SAMIA BUGWE NORTH,BUTEBA,ABOCHET,MASANJA T.C,413,6,5,11,112,159,293,15,308,0,O-42-211-04-01-03
BUSIA,SAMIA BUGWE NORTH,BUTEBA,ABOCHET,SALAMA,717,4,6,12,139,350,511,46,557,0,O-42-211-04-01-04
BUSIA,SAMIA BUGWE NORTH,BUTEBA,AMONEKAKINEI,AMONEKAKINEI PR. SCHOOL,597,5,1,6,148,278,438,21,459,0,O-42-211-04-02-01
BUSIA,SAMIA BUGWE NORTH,BUTEBA,AMONEKAKINEI,WAIBI'S CENTRE,591,5,5,6,140,301,457,14,471,0,O-42-211-04-02-02
BUSIA,SAMIA BUGWE NORTH,BUTEBA,BUTEBA,BUTEBA BAPTIST PR. SCHOOL,587,10,3,10,136,247,406,27,433,0,O-42-211-04-03-01
BUSIA,SAMIA BUGWE NORTH,BUTEBA,BUTEBA,BUTEBA PRIMARY SCHOOL,669,9,4,9,170,279,471,31,502,0,O-42-211-04-03-02
BUSIA,SAMIA BUGWE NORTH,BUTEBA,BUTEBA,KAYORO PRIMARY SCHOOL,504,6,4,6,91,187,294,18,312,0,O-42-211-04-03-03
BUSIA,SAMIA BUGWE NORTH,BUTEBA,BUTEBA,KAYORO S. SCHOOL,468,6,0,5,89,242,342,11,353,0,O-42-211-04-03-04
BUSIA,SAMIA BUGWE NORTH,BUTEBA,BUTEBA,OCHOKOLO'S CENTRE,811,10,3,13,150,457,633,12,645,0,O-42-211-04-03-05
BUSIA,SAMIA BUGWE NORTH,BUTEBA,BUTEBA,AMONGORA T.C,454,5,10,5,84,226,330,11,341,0,O-42-211-04-03-06
BUSIA,SAMIA BUGWE NORTH,BUTEBA,MAWERO,ONYUNYURI,889,14,3,10,294,267,588,40,628,0,O-42-211-04-04-01
BUSIA,SAMIA BUGWE NORTH,BUTEBA,MAWERO,MAWERO ISLAMIC SCHOOL,169,2,3,5,51,65,126,6,132,0,O-42-211-04-04-02
BUSIA,SAMIA BUGWE NORTH,BUTEBA,MAWERO,MAWERO P SCHOOL,639,11,7,7,164,233,422,22,444,0,O-42-211-04-04-03
BUSIA,SAMIA BUGWE NORTH,DABANI,BUSIA,MAYOMBE T. CENTRE,583,8,6,10,190,196,410,22,432,0,O-42-211-05-01-01
BUSIA,SAMIA BUGWE NORTH,DABANI,BUSIA,MAYOMBE P. S,561,10,2,4,226,142,384,10,394,0,O-42-211-05-01-02
BUSIA,SAMIA BUGWE NORTH,DABANI,BUSIA,NAMAUBI T. C,586,6,5,1,193,179,384,18,402,0,O-42-211-05-01-03
BUSIA,SAMIA BUGWE NORTH,DABANI,BUSIA,ZIKULA T/C,495,2,6,5,216,105,334,20,354,0,O-42-211-05-01-04
BUSIA,SAMIA BUGWE NORTH,DABANI,BUWUMBA,BUWUMBA P/S,583,9,4,7,229,172,421,21,442,0,O-42-211-05-02-01
BUSIA,SAMIA BUGWE NORTH,DABANI,BUWUMBA,BUKANGA COU,307,3,1,0,77,164,245,12,257,0,O-42-211-05-02-02
BUSIA,SAMIA BUGWE NORTH,DABANI,BUWUMBA,BUWUMBA T/C,512,3,0,8,150,223,384,19,403,0,O-42-211-05-02-03
BUSIA,SAMIA BUGWE NORTH,DABANI,BUYENGO,BUYENGO P. SCHOOL,758,8,8,3,224,365,608,26,634,0,O-42-211-05-03-01
BUSIA,SAMIA BUGWE NORTH,DABANI,DABANI,DABANI BOYS' P/SCHOOL,684,9,9,7,213,234,472,16,488,0,O-42-211-05-04-01
BUSIA,SAMIA BUGWE NORTH,DABANI,DABANI,DABANI HOSPITAL T.C,538,6,2,4,201,183,396,16,412,0,O-42-211-05-04-02
BUSIA,SAMIA BUGWE NORTH,DABANI,DABANI,DABANI S/COUNTY HQRS,501,6,4,2,212,126,350,9,359,0,O-42-211-05-04-03
BUSIA,SAMIA BUGWE NORTH,DABANI,DABANI,MULULUMBA CHURCH,203,0,1,1,43,103,148,11,159,0,O-42-211-05-04-04
BUSIA,SAMIA BUGWE NORTH,DABANI,NANGWE,BUSUMBA CHURCH OF UGANDA,379,3,2,4,159,134,302,12,314,0,O-42-211-05-05-01
BUSIA,SAMIA BUGWE NORTH,DABANI,NANGWE,NANGWE C.O.U,662,6,15,7,237,210,475,23,498,0,O-42-211-05-05-02
BUSIA,SAMIA BUGWE NORTH,DABANI,NANGWE,MUNDAA C.O.U,382,4,4,4,175,90,277,14,291,0,O-42-211-05-05-03
KATAKWI,USUK COUNTY,KAPUJAN,KAPUJAN,ADODOI P/S,701,11,5,6,321,181,524,12,536,0,O-43-206-01-01-01
KATAKWI,USUK COUNTY,KAPUJAN,KAPUJAN,KAPUJANI I,278,7,1,3,155,40,206,15,221,0,O-43-206-01-01-02
KATAKWI,USUK COUNTY,KAPUJAN,KAPUJAN,KAPUJANI II,416,11,6,21,184,97,319,22,341,0,O-43-206-01-01-03
KATAKWI,USUK COUNTY,KAPUJAN,KOKORIO,KOKORIO A,295,5,1,7,156,66,235,8,243,0,O-43-206-01-02-01
KATAKWI,USUK COUNTY,KAPUJAN,KOKORIO,KOKORIO B,287,1,2,3,165,45,216,5,221,0,O-43-206-01-02-02
KATAKWI,USUK COUNTY,KAPUJAN,KOKORIO,OMOSINGO,521,9,5,12,260,97,383,0,383,0,O-43-206-01-02-03
KATAKWI,USUK COUNTY,KAPUJAN,ORIMAI,GORIA MZEE ODEKE,446,14,4,8,192,141,359,17,376,0,O-43-206-01-03-01
KATAKWI,USUK COUNTY,KAPUJAN,ORIMAI,ORIMAI A,377,4,3,3,162,102,274,18,292,0,O-43-206-01-03-02
KATAKWI,USUK COUNTY,KAPUJAN,ORIMAI,ORIMAI B,324,3,1,2,154,74,234,3,237,0,O-43-206-01-03-03
KATAKWI,USUK COUNTY,KATAKWI,ABELA,ABELA CATHOLIC CHURCH A,545,7,4,14,277,88,390,13,403,0,O-43-206-02-01-01
KATAKWI,USUK COUNTY,KATAKWI,ABELA,ABELA CATHOLIC CHURCH B,534,6,1,4,286,57,354,20,374,0,O-43-206-02-01-02
KATAKWI,USUK COUNTY,KATAKWI,ABELA,GETOM P/S C,575,10,1,13,330,45,399,33,432,0,O-43-206-02-01-03
KATAKWI,USUK COUNTY,KATAKWI,ABWANGET,NAMULE CENTRE,445,7,1,8,251,68,335,22,357,0,O-43-206-02-02-01
KATAKWI,USUK COUNTY,KATAKWI,ABWANGET,OLUPE MANGO TREES,470,10,1,13,257,65,346,21,367,0,O-43-206-02-02-02
KATAKWI,USUK COUNTY,KATAKWI,ALELES,ALELES A,526,11,5,9,236,123,384,11,395,0,O-43-206-02-03-01
KATAKWI,USUK COUNTY,KATAKWI,ALELES,ALELES B,426,11,2,9,193,116,331,30,361,0,O-43-206-02-03-02
KATAKWI,USUK COUNTY,KATAKWI,ALIAKAMER,ALIAKAMER B,691,16,10,23,193,276,518,37,555,0,O-43-206-02-04-01
KATAKWI,USUK COUNTY,KATAKWI,ALIAKAMER,ALIAKAMER P/S,491,11,0,10,204,117,342,0,342,0,O-43-206-02-04-02
KATAKWI,USUK COUNTY,KATAKWI,ALIAKAMER,ALOGOOK P/S,789,12,18,26,144,357,557,42,599,0,O-43-206-02-04-03
KATAKWI,USUK COUNTY,KATAKWI,ALUKUCOK,ALUKUCOK A,508,3,1,8,333,49,394,13,407,0,O-43-206-02-05-01
KATAKWI,USUK COUNTY,KATAKWI,ALUKUCOK,ALUKUCOK B,658,11,7,10,398,56,482,15,497,0,O-43-206-02-05-02
KATAKWI,USUK COUNTY,KATAKWI,DADAS,DADAS A,738,15,8,20,419,68,530,9,539,0,O-43-206-02-06-01
KATAKWI,USUK COUNTY,KATAKWI,DADAS,DADAS B,482,9,9,14,324,41,397,15,412,0,O-43-206-02-06-02
KATAKWI,USUK COUNTY,KATAKWI,KATAKWI,APOLIN,424,6,4,12,117,162,301,18,319,0,O-43-206-02-07-01
KATAKWI,USUK COUNTY,KATAKWI,KATAKWI,OCORIMONGIN TRADING CENTRE,705,9,1,13,245,198,466,21,487,0,O-43-206-02-07-02
KATAKWI,USUK COUNTY,KATAKWI,KATAKWI,OLELA,631,15,8,19,140,288,470,29,499,0,O-43-206-02-07-03
KATAKWI,USUK COUNTY,KATAKWI,KATAKWI,OCORIMONGIN CATHOLIC CHURC,235,5,3,2,66,82,158,11,169,0,O-43-206-02-07-04
KATAKWI,USUK COUNTY,KATAKWI TOWN COUNCIL,NORTHERN WARD,KATAKWI TOWNSHIP PRI SCH(A-,712,6,9,8,291,90,404,12,416,0,O-43-206-03-01-01
KATAKWI,USUK COUNTY,KATAKWI TOWN COUNCIL,NORTHERN WARD,KATAKWI T/B B,503,3,5,7,198,103,316,21,337,0,O-43-206-03-01-02
KATAKWI,USUK COUNTY,KATAKWI TOWN COUNCIL,NORTHERN WARD,KATAKWI TOWNSHIP PRI SCH (N-,229,3,2,0,80,40,125,3,128,0,O-43-206-03-01-03
KATAKWI,USUK COUNTY,KATAKWI TOWN COUNCIL,SOUTHERN WARD,P.A.G CHURCH (N-Z),390,2,5,1,180,45,233,13,246,0,O-43-206-03-02-01
KATAKWI,USUK COUNTY,KATAKWI TOWN COUNCIL,SOUTHERN WARD,KATAKWI PRI SCHOOL,140,2,4,1,62,27,96,8,104,0,O-43-206-03-02-02
KATAKWI,USUK COUNTY,KATAKWI TOWN COUNCIL,SOUTHERN WARD,P.A.G CHURCH (A-M),954,11,6,11,364,123,515,33,548,0,O-43-206-03-02-03
KATAKWI,USUK COUNTY,MAGORO,KAMENU,ALELES,223,0,2,3,73,88,166,13,179,0,O-43-206-04-01-01
KATAKWI,USUK COUNTY,MAGORO,KAMENU,KAMENU C,372,9,2,9,152,89,261,13,274,0,O-43-206-04-01-02
KATAKWI,USUK COUNTY,MAGORO,KAMENU,KAMENU CATHOLIC CHURCH,190,5,4,5,50,88,152,12,164,0,O-43-206-04-01-03
KATAKWI,USUK COUNTY,MAGORO,KAMENU,KAMENU P/S,434,8,2,7,111,182,310,27,337,0,O-43-206-04-01-04
KATAKWI,USUK COUNTY,MAGORO,KAMENU,OITELA KAMENU,222,7,8,15,68,93,191,8,199,0,O-43-206-04-01-05
KATAKWI,USUK COUNTY,MAGORO,MAGORO,AJAMAKA,449,8,5,14,170,116,313,21,334,0,O-43-206-04-02-01
KATAKWI,USUK COUNTY,MAGORO,MAGORO,AKWORO (OMYEBEKO),385,7,1,4,180,97,289,10,299,0,O-43-206-04-02-02
KATAKWI,USUK COUNTY,MAGORO,MAGORO,CENTRE(MAGORO),318,3,5,5,149,67,229,8,237,0,O-43-206-04-02-03
KATAKWI,USUK COUNTY,MAGORO,MAGORO,KANAPA SOCIETY,199,3,3,5,100,44,155,12,167,0,O-43-206-04-02-04
KATAKWI,USUK COUNTY,MAGORO,OMASIA,ADURUKOI,157,9,4,3,45,65,126,6,132,0,O-43-206-04-03-01
KATAKWI,USUK COUNTY,MAGORO,OMASIA,KIPINYANG (MIROI),382,17,7,7,147,104,282,13,295,0,O-43-206-04-03-02
KATAKWI,USUK COUNTY,MAGORO,OMASIA,ORIAU A,357,9,1,0,246,23,279,3,282,0,O-43-206-04-03-03
KATAKWI,USUK COUNTY,MAGORO,OMASIA,ORIAU B,431,10,11,12,169,121,323,15,338,0,O-43-206-04-03-04
KATAKWI,USUK COUNTY,MAGORO,OPETA,AGULE,266,15,2,5,156,19,197,0,197,0,O-43-206-04-04-01
KATAKWI,USUK COUNTY,MAGORO,OPETA,AKISIM (AKUM),197,9,3,6,67,64,149,8,157,0,O-43-206-04-04-02
KATAKWI,USUK COUNTY,MAGORO,OPETA,KIDE,385,12,0,8,102,163,285,0,285,0,O-43-206-04-04-03
KATAKWI,USUK COUNTY,NGARIAM,ACHANGA,ACHANGA A,418,6,5,9,53,188,261,17,278,0,O-43-206-05-01-01
KATAKWI,USUK COUNTY,NGARIAM,BISINA,AKISIM,265,9,4,11,72,129,225,8,233,0,O-43-206-05-02-01
KATAKWI,USUK COUNTY,NGARIAM,BISINA,OPERU ELIPA - BISINA,489,11,4,23,155,195,388,27,415,0,O-43-206-05-02-02
KATAKWI,USUK COUNTY,NGARIAM,KAIKAMOSING,ACHANGA B,351,9,6,6,129,106,256,29,285,0,O-43-206-05-03-01
KATAKWI,USUK COUNTY,NGARIAM,KAIKAMOSING,SUB-COUNTY HQRS,450,27,7,13,114,155,316,15,331,0,O-43-206-05-03-02
KATAKWI,USUK COUNTY,NGARIAM,NGARIAM,ALENGO,200,4,0,4,31,101,140,9,149,0,O-43-206-05-04-01
KATAKWI,USUK COUNTY,NGARIAM,NGARIAM,AMORUONGORA PR. SCHO,277,5,5,8,116,66,200,16,216,0,O-43-206-05-04-02
KATAKWI,USUK COUNTY,NGARIAM,NGARIAM,NGARIAM NRA,205,3,6,3,122,23,157,12,169,0,O-43-206-05-04-03
KATAKWI,USUK COUNTY,NGARIAM,ODOOT,ODOOT A,297,18,6,6,152,40,222,20,242,0,O-43-206-05-05-01
KATAKWI,USUK COUNTY,NGARIAM,ODOOT,ODOOT B,211,11,3,6,112,43,175,5,180,0,O-43-206-05-05-02
KATAKWI,USUK COUNTY,NGARIAM,ODOOT,OKWAMOMWAR CATHOLIC CHUR,535,16,17,27,200,142,402,28,430,0,O-43-206-05-05-03
KATAKWI,USUK COUNTY,NGARIAM,OLILIM,OLILIM PR. SCHOOL,564,15,6,21,118,216,376,54,430,0,O-43-206-05-06-01
KATAKWI,USUK COUNTY,NGARIAM,OLILIM,PALAM,346,9,7,1,180,48,245,14,259,0,O-43-206-05-06-02
KATAKWI,USUK COUNTY,NGARIAM,OLILIM,OUTSIDE Q. GUARD,467,0,0,0,14,23,37,1,38,0,O-43-206-05-06-03
KATAKWI,USUK COUNTY,NGARIAM,PAKWI,OCWIIN P/S,386,14,8,18,95,180,315,12,327,0,O-43-206-05-07-01
KATAKWI,USUK COUNTY,NGARIAM,PAKWI,RWAATAMA,404,13,4,11,78,212,318,23,341,0,O-43-206-05-07-02
KATAKWI,USUK COUNTY,NGARIAM,PAKWI,OUTSIDE Q. GUARD,242,0,0,0,0,0,0,0,0,1,O-43-206-05-07-03
KATAKWI,USUK COUNTY,OMODOI,AMUSIA,ATAPAR OBUNOK A,390,18,3,9,164,78,272,17,289,0,O-43-206-06-01-01
KATAKWI,USUK COUNTY,OMODOI,AMUSIA,ATAPAR OBUNOK B,383,12,8,12,110,151,293,13,306,0,O-43-206-06-01-02
KATAKWI,USUK COUNTY,OMODOI,ANGODINGOD,AKISIM P/S,499,15,4,18,230,82,349,21,370,0,O-43-206-06-02-01
KATAKWI,USUK COUNTY,OMODOI,ANGODINGOD,ANGODINGOD A,244,2,1,0,117,57,177,10,187,0,O-43-206-06-02-02
KATAKWI,USUK COUNTY,OMODOI,ANGODINGOD,ANGODINGOD C,138,0,3,3,95,22,123,1,124,0,O-43-206-06-02-03
KATAKWI,USUK COUNTY,OMODOI,ANGODINGOD,ANGODINGOD P/S,268,2,2,9,117,66,196,13,209,0,O-43-206-06-02-04
KATAKWI,USUK COUNTY,OMODOI,APARISA,APARISA P/S,562,11,6,18,285,101,421,19,440,0,O-43-206-06-03-01
KATAKWI,USUK COUNTY,OMODOI,ASURET,TOROMA BOYS PRI. SCHOOL,191,2,4,3,60,46,115,8,123,0,O-43-206-06-04-01
KATAKWI,USUK COUNTY,OMODOI,ASURET,MZEE KOLUO'S MANGO,859,16,3,18,408,208,653,17,670,0,O-43-206-06-04-02
KATAKWI,USUK COUNTY,OMODOI,OMODOI,OMODOI A,451,4,2,2,244,66,318,18,336,0,O-43-206-06-05-01
KATAKWI,USUK COUNTY,OMODOI,OMODOI,OMODOI B,623,20,9,15,350,64,458,28,486,0,O-43-206-06-05-02
KATAKWI,USUK COUNTY,ONGONGOJA,AKETA,AKETA B,347,5,2,8,104,111,230,29,259,0,O-43-206-07-01-01
KATAKWI,USUK COUNTY,ONGONGOJA,AKETA,AKETA NRA,346,16,1,9,138,72,236,17,253,0,O-43-206-07-01-02
KATAKWI,USUK COUNTY,ONGONGOJA,OBWOBWO,AKWAMOR PR. SCHOOL,251,7,6,7,104,64,188,19,207,0,O-43-206-07-02-01
KATAKWI,USUK COUNTY,ONGONGOJA,OKOCHO,OKOCHO - ADACAR PR/S,607,23,2,27,129,291,472,19,491,0,O-43-206-07-03-01
KATAKWI,USUK COUNTY,ONGONGOJA,OKUDA,OMERIMONG A,664,13,4,19,130,294,460,28,488,0,O-43-206-07-04-01
KATAKWI,USUK COUNTY,ONGONGOJA,OMUKUNY,OMERIMONG B,735,22,8,18,144,344,536,29,565,0,O-43-206-07-05-01
KATAKWI,USUK COUNTY,ONGONGOJA,ONGATUNYO,AKETA A,728,16,7,16,165,268,472,28,500,0,O-43-206-07-06-01
KATAKWI,USUK COUNTY,ONGONGOJA,ONGONGOJA,OKUDA MARKET,568,14,0,9,171,106,300,20,320,0,O-43-206-07-07-01
KATAKWI,USUK COUNTY,TOROMA,AKURAO,AKURAO,662,7,5,12,220,269,513,23,536,0,O-43-206-08-01-01
KATAKWI,USUK COUNTY,TOROMA,APUUTON,APUUTON P/S,742,6,3,15,166,403,593,22,615,0,O-43-206-08-02-01
KATAKWI,USUK COUNTY,TOROMA,OMINYA,OMINYA A,600,6,3,9,126,306,450,0,450,0,O-43-206-08-03-01
KATAKWI,USUK COUNTY,TOROMA,OMINYA,OMINYA B,453,4,3,6,55,322,390,17,407,0,O-43-206-08-03-02
KATAKWI,USUK COUNTY,TOROMA,TOROMA,SUB-CTY HQRS,890,15,5,17,349,220,606,18,624,0,O-43-206-08-04-01
KATAKWI,USUK COUNTY,USUK,AAKUM,AAKUM A,538,6,1,11,202,167,387,26,413,0,O-43-206-09-01-01
KATAKWI,USUK COUNTY,USUK,AAKUM,AAKUM B,541,11,2,5,214,182,414,22,436,0,O-43-206-09-01-02
KATAKWI,USUK COUNTY,USUK,ABWOKODIA,ABWOK-OBIA P/S,562,4,10,8,103,271,396,38,434,0,O-43-206-09-02-01
KATAKWI,USUK COUNTY,USUK,ADACAR,ADACAR P/S,533,10,4,10,155,216,395,30,425,0,O-43-206-09-03-01
KATAKWI,USUK COUNTY,USUK,ADACAR,OUTSIDE Q. GUARD,112,0,0,0,0,0,0,0,0,1,O-43-206-09-03-02
KATAKWI,USUK COUNTY,USUK,CHELEUKO,OBULOK AKOBO,580,5,10,11,148,297,471,15,486,0,O-43-206-09-04-01
KATAKWI,USUK COUNTY,USUK,OKORITOK,KORITOK A,341,7,6,5,133,78,229,11,240,0,O-43-206-09-05-01
KATAKWI,USUK COUNTY,USUK,OKORITOK,KORITOK B,318,3,0,4,116,93,216,24,240,0,O-43-206-09-05-02
KATAKWI,USUK COUNTY,USUK,ONGEMA,IYENGUBER,673,10,8,21,122,254,415,20,435,0,O-43-206-09-06-01
KATAKWI,USUK COUNTY,USUK,USUK,USUK A,849,8,9,6,227,284,534,0,534,0,O-43-206-09-07-01
KATAKWI,USUK COUNTY,USUK,USUK,USUK B,309,3,0,6,84,114,207,21,228,0,O-43-206-09-07-02
KATAKWI,USUK COUNTY,USUK,USUK,USUK C,417,4,0,2,97,156,259,18,277,0,O-43-206-09-07-03
MAYUGE,BUNYA COUNTY EAST,BUWAYA,BUWAISWA,BUWAISWA TRADING CENTRE,825,3,1,4,209,280,497,9,506,0,O-49-34-01-01-01
MAYUGE,BUNYA COUNTY EAST,BUWAYA,BUWAISWA,BUWAYA Pr SCH,764,4,2,5,136,303,450,3,453,0,O-49-34-01-01-02
MAYUGE,BUNYA COUNTY EAST,BUWAYA,BUYERE,BUYERE P/S,757,3,9,11,258,245,526,12,538,0,O-49-34-01-02-01
MAYUGE,BUNYA COUNTY EAST,BUWAYA,BUYERE,BUGUWA TRADING CENTRE,215,0,1,0,45,92,138,5,143,0,O-49-34-01-02-02
MAYUGE,BUNYA COUNTY EAST,BUWAYA,ISIKIRO,ISIKIRO TRADING CENTRE,765,2,8,8,170,249,437,43,480,0,O-49-34-01-03-01
MAYUGE,BUNYA COUNTY EAST,BUWAYA,ISIKIRO,KIKUBO HEALTH UNIT,562,0,5,5,96,243,349,14,363,0,O-49-34-01-03-02
MAYUGE,BUNYA COUNTY EAST,BUWAYA,KABAINGIRIRE,KABAYINGIRE P/S,604,1,5,4,142,257,409,6,415,0,O-49-34-01-04-01
MAYUGE,BUNYA COUNTY EAST,BUWAYA,KABAINGIRIRE,NAKATE T/CENTRE,289,3,0,3,50,158,214,9,223,0,O-49-34-01-04-02
MAYUGE,BUNYA COUNTY EAST,BUWAYA,MAINA,MWEZI MUVULE TREE,513,3,8,1,154,174,340,9,349,0,O-49-34-01-05-01
MAYUGE,BUNYA COUNTY EAST,BUWAYA,MAINA,MAINA STORE,774,2,8,7,235,272,524,22,546,0,O-49-34-01-05-02
MAYUGE,BUNYA COUNTY EAST,BUWAYA,MAINA,BALITA Pr. SCH.,506,4,3,1,100,238,346,3,349,0,O-49-34-01-05-03
MAYUGE,BUNYA COUNTY EAST,BUWAYA,MUGGI,MUGGI HEALTH CENTRE.,410,2,2,2,94,169,269,3,272,0,O-49-34-01-06-01
MAYUGE,BUNYA COUNTY EAST,BUWAYA,MUGGI,MPUNGWE Pr. SCH.,821,2,4,9,190,251,456,11,467,0,O-49-34-01-06-02
MAYUGE,BUNYA COUNTY EAST,BUWAYA,NANGAMBO,BUWOLYA MUSLIM SCH.,266,0,3,1,75,112,191,6,197,0,O-49-34-01-07-01
MAYUGE,BUNYA COUNTY EAST,BUWAYA,NANGAMBO,BUWOLYA T/C,439,1,3,0,86,166,256,10,266,0,O-49-34-01-07-02
MAYUGE,BUNYA COUNTY EAST,BUWAYA,NANGAMBO,IWUUBA T/C,527,1,2,2,68,259,332,22,354,0,O-49-34-01-07-03
MAYUGE,BUNYA COUNTY EAST,BUWAYA,NSANGO,NSANGO MUVULE TREE,680,4,3,4,136,241,388,11,399,0,O-49-34-01-08-01
MAYUGE,BUNYA COUNTY EAST,BUWAYA,NSANGO,BULONDO PLAYGROUND,622,2,3,2,59,251,317,19,336,0,O-49-34-01-08-02
MAYUGE,BUNYA COUNTY EAST,BUWAYA,WAIRAMA,KASUTAIME P. SCH.,451,2,7,2,70,196,277,5,282,0,O-49-34-01-09-01
MAYUGE,BUNYA COUNTY EAST,BUWAYA,WAIRAMA,MPUMU TRADING CENTRE,248,2,0,0,90,96,188,6,194,0,O-49-34-01-09-02
MAYUGE,BUNYA COUNTY EAST,BUWAYA,WAIRAMA,BULYANGADA MOSQUE,593,1,3,3,127,247,381,9,390,0,O-49-34-01-09-03
MAYUGE,BUNYA COUNTY EAST,BUWAYA,WAIRAMA,MUNYONYI MUSLIM SCH,629,3,5,6,166,251,431,7,438,0,O-49-34-01-09-04
MAYUGE,BUNYA COUNTY EAST,BUWAYA,WAMULONGO,NAMATOOKE P/S,306,0,2,2,78,140,222,6,228,0,O-49-34-01-10-01
MAYUGE,BUNYA COUNTY EAST,BUWAYA,WAMULONGO,MAKOOVA TRADING CENTRE,407,1,1,3,71,209,285,6,291,0,O-49-34-01-10-02
MAYUGE,BUNYA COUNTY EAST,BUWAYA,WAMULONGO,WAMULONGO Pr. SCH.,648,2,5,4,106,288,405,7,412,0,O-49-34-01-10-03
MAYUGE,BUNYA COUNTY EAST,BUWAYA,WAMULONGO,BUSWIKIRA Pr. SCH.,512,2,3,0,68,288,361,0,361,0,O-49-34-01-10-04
MAYUGE,BUNYA COUNTY EAST,KIGANDALO,BUGONDO,WALUKOKO SCH. {A - M},429,4,3,2,107,141,257,12,269,0,O-49-34-02-01-01
MAYUGE,BUNYA COUNTY EAST,KIGANDALO,BUGONDO,WALUKOKO SCH. {N - Z},384,0,1,3,70,160,234,6,240,0,O-49-34-02-01-02
MAYUGE,BUNYA COUNTY EAST,KIGANDALO,BUGONDO,NAKAWA T.C,598,1,2,2,135,253,393,7,400,0,O-49-34-02-01-03
MAYUGE,BUNYA COUNTY EAST,KIGANDALO,BUGOTO,MUSUBI A CENTRE,596,8,0,4,156,162,330,20,350,0,O-49-34-02-02-01
MAYUGE,BUNYA COUNTY EAST,KIGANDALO,BUGOTO,MUSUBI B CENTRE,360,3,3,1,74,96,177,9,186,0,O-49-34-02-02-02
MAYUGE,BUNYA COUNTY EAST,KIGANDALO,BUGOTO,BUTUMBULA,532,1,6,3,118,221,349,3,352,0,O-49-34-02-02-03
MAYUGE,BUNYA COUNTY EAST,KIGANDALO,BUGOTO,BUGOTO SDA SCHOOL,591,3,3,0,192,169,367,18,385,0,O-49-34-02-02-04
MAYUGE,BUNYA COUNTY EAST,KIGANDALO,BUGOTO,MUYANZI T.C,372,2,1,5,84,94,186,8,194,0,O-49-34-02-02-05
MAYUGE,BUNYA COUNTY EAST,KIGANDALO,BUGOTO,NAWAMPONGO T.C,340,0,8,1,37,147,193,1,194,0,O-49-34-02-02-06
MAYUGE,BUNYA COUNTY EAST,KIGANDALO,BUGOTO,BUNGOTO B. TC,362,4,4,0,100,115,223,9,232,0,O-49-34-02-02-07
MAYUGE,BUNYA COUNTY EAST,KIGANDALO,BUGUMIA,MAKOOMA Tr CENTRE,531,6,1,3,169,114,293,17,310,0,O-49-34-02-03-01
MAYUGE,BUNYA COUNTY EAST,KIGANDALO,BUGUMIA,KIRONGO Pr SCH A,316,1,1,3,57,122,184,2,186,0,O-49-34-02-03-02
MAYUGE,BUNYA COUNTY EAST,KIGANDALO,BUGUMIA,BUGUMYA Tr CENTRE,521,3,2,6,141,216,368,7,375,0,O-49-34-02-03-03
MAYUGE,BUNYA COUNTY EAST,KIGANDALO,BUGUMIA,NAKASUWA CATHOLIC CHURCH,498,2,3,2,110,210,327,17,344,0,O-49-34-02-03-04
MAYUGE,BUNYA COUNTY EAST,KIGANDALO,BUGUMIA,KIRONGO P. SCHOOL B,453,5,4,6,96,152,263,13,276,0,O-49-34-02-03-05
MAYUGE,BUNYA COUNTY EAST,KIGANDALO,BUKABOLI,KALAGALA CHURCH OF UGANDA,706,3,2,2,114,328,449,9,458,0,O-49-34-02-04-01
MAYUGE,BUNYA COUNTY EAST,KIGANDALO,BUKABOLI,BUKABOLI Pr SCH.,441,0,1,2,141,175,319,0,319,0,O-49-34-02-04-02
MAYUGE,BUNYA COUNTY EAST,KIGANDALO,BUKABOLI,NAMULWANA TR CENTRE,494,2,1,1,62,186,252,77,329,0,O-49-34-02-04-03
MAYUGE,BUNYA COUNTY EAST,KIGANDALO,BUYUGU,BUYUGU TR CENTRE A {A - M},511,3,1,2,74,131,211,102,313,0,O-49-34-02-05-01
MAYUGE,BUNYA COUNTY EAST,KIGANDALO,BUYUGU,BUYUGU TR CENTRE B,544,4,3,1,115,153,276,83,359,0,O-49-34-02-05-02
MAYUGE,BUNYA COUNTY EAST,KIGANDALO,BUYUGU,BUYUGU TR CENTRE A {N - Z},543,6,2,5,107,193,313,18,331,0,O-49-34-02-05-03
MAYUGE,BUNYA COUNTY EAST,KIGANDALO,ISENDA,ISENDA Pr. SCH.,713,8,2,6,105,305,426,15,441,0,O-49-34-02-06-01
MAYUGE,BUNYA COUNTY EAST,KIGANDALO,ISENDA,NAMAIGA P/S,661,2,0,4,84,349,439,7,446,0,O-49-34-02-06-02
MAYUGE,BUNYA COUNTY EAST,KIGANDALO,KIGANDALO,KIGANDALO Tr. CENTRE (A -M),414,0,5,2,65,167,239,15,254,0,O-49-34-02-07-01
MAYUGE,BUNYA COUNTY EAST,KIGANDALO,KIGANDALO,KIGANDALO T.C (N-Z),376,4,11,4,58,161,238,6,244,0,O-49-34-02-07-02
MAYUGE,BUNYA COUNTY EAST,KIGANDALO,KIGANDALO,NAKAZIGO SCH.,600,1,2,3,92,285,383,5,388,0,O-49-34-02-07-03
MAYUGE,BUNYA COUNTY EAST,KIGANDALO,KIGANDALO,WANDAWA CATHOLIC CHURCH,553,6,5,6,97,229,343,10,353,0,O-49-34-02-07-04
MAYUGE,BUNYA COUNTY EAST,KIGANDALO,KIGULU,BUGULU Pr. SCH.,695,6,2,1,137,243,389,77,466,0,O-49-34-02-08-01
MAYUGE,BUNYA COUNTY EAST,KIGANDALO,KIGULU,KIGULU CHURCH,737,3,2,1,153,260,419,12,431,0,O-49-34-02-08-02
MAYUGE,BUNYA COUNTY EAST,KIGANDALO,KIGULU,KIREWA CHURCH,556,5,0,4,57,312,378,12,390,0,O-49-34-02-08-03
MAYUGE,BUNYA COUNTY EAST,KIGANDALO,KIOGA (MAYENGO),KIOGA Tr. CENTRE,662,1,4,2,103,270,380,12,392,0,O-49-34-02-09-01
MAYUGE,BUNYA COUNTY EAST,KIGANDALO,KIOGA (MAYENGO),BUYEGO Tr. CENTRE,409,1,3,3,71,202,280,15,295,0,O-49-34-02-09-02
MAYUGE,BUNYA COUNTY EAST,KIGANDALO,KIOGA (MAYENGO),BWEZA PR. SCH,485,2,6,3,91,183,285,43,328,0,O-49-34-02-09-03
MAYUGE,BUNYA COUNTY EAST,KIGANDALO,MALEKA,NAKIWALO P/S,381,0,0,3,58,118,179,39,218,0,O-49-34-02-10-01
MAYUGE,BUNYA COUNTY EAST,KIGANDALO,MALEKA,ISOOLA TRADING CENTRE,600,3,4,5,142,232,386,6,392,0,O-49-34-02-10-02
MAYUGE,BUNYA COUNTY EAST,KIGANDALO,MALEKA,MALEKA TR. CENTRE,554,1,6,1,132,203,343,12,355,0,O-49-34-02-10-03
MAYUGE,BUNYA COUNTY EAST,KIGANDALO,MATOVU,MATOVU TR CENTRE,766,1,2,8,174,237,422,29,451,0,O-49-34-02-11-01
MAYUGE,BUNYA COUNTY EAST,KIGANDALO,MATOVU,MATOVU FELLOWSHIP CHURCH,804,5,9,5,128,325,472,15,487,0,O-49-34-02-11-02
MAYUGE,BUNYA COUNTY EAST,KIGANDALO,MAYIRINYA,LWANDERA T/CENTRE,688,8,2,6,124,280,420,20,440,0,O-49-34-02-12-01
MAYUGE,BUNYA COUNTY EAST,KIGANDALO,MAYIRINYA,MAYIRINYA TR CENTRE,523,2,1,1,115,181,300,9,309,0,O-49-34-02-12-02
MAYUGE,BUNYA COUNTY EAST,KIGANDALO,MAYIRINYA,BUSIRO P. S/NAWANDEGEYI,320,3,5,2,63,165,238,8,246,0,O-49-34-02-12-03
MAYUGE,BUNYA COUNTY EAST,KIGANDALO,MAYIRINYA,KASOZI TR CENTRE,482,2,5,3,115,168,293,9,302,0,O-49-34-02-12-04
MAYUGE,BUNYA COUNTY EAST,KIGANDALO,MAYIRINYA,MAYIRINYA T. C. (N-Z),323,2,2,0,58,113,175,53,228,0,O-49-34-02-12-05
MAYUGE,BUNYA COUNTY EAST,KIGANDALO,MAYIRINYA,NAWANDEGEYI T/C,388,0,0,3,126,120,249,13,262,0,O-49-34-02-12-06
MAYUGE,BUNYA COUNTY WEST,BAITAMBOGWE,BUSUYI,BUSUYI BEACH,631,2,2,3,109,314,430,6,436,0,O-49-36-01-01-01
MAYUGE,BUNYA COUNTY WEST,BAITAMBOGWE,BUSUYI,KASITA P/S,427,2,3,0,47,260,312,9,321,0,O-49-36-01-01-02
MAYUGE,BUNYA COUNTY WEST,BAITAMBOGWE,BUSUYI,BUYEMBA P/S,144,1,1,0,8,72,82,0,82,0,O-49-36-01-01-03
MAYUGE,BUNYA COUNTY WEST,BAITAMBOGWE,BUTTE,WAGONA CENTRE,592,3,1,2,100,290,396,25,421,0,O-49-36-01-02-01
MAYUGE,BUNYA COUNTY WEST,BAITAMBOGWE,BUTTE,BUTTE PRIMARY SCHOOL,772,7,1,4,111,430,553,16,569,0,O-49-36-01-02-02
MAYUGE,BUNYA COUNTY WEST,BAITAMBOGWE,BUTTE,IGEYERO PR/SCHOOL,598,4,3,0,120,300,427,11,438,0,O-49-36-01-02-03
MAYUGE,BUNYA COUNTY WEST,BAITAMBOGWE,BUTTE,NALWESAMBULA CENTRE,649,4,4,5,159,241,413,24,437,0,O-49-36-01-02-04
MAYUGE,BUNYA COUNTY WEST,BAITAMBOGWE,IGULUIBI,IGULUIBI PRIMARY SCHOOL,706,0,15,2,86,306,409,20,429,0,O-49-36-01-03-01
MAYUGE,BUNYA COUNTY WEST,BAITAMBOGWE,IGULUIBI,WAIBALE,150,1,0,0,19,77,97,4,101,0,O-49-36-01-03-02
MAYUGE,BUNYA COUNTY WEST,BAITAMBOGWE,IGULUIBI,NTOKOLO TRADING CENTRE,682,2,2,2,83,280,369,9,378,0,O-49-36-01-03-03
MAYUGE,BUNYA COUNTY WEST,BAITAMBOGWE,KATONTE,BUWANGA CENTRE,593,5,2,3,91,290,391,21,412,0,O-49-36-01-04-01
MAYUGE,BUNYA COUNTY WEST,BAITAMBOGWE,KATONTE,KATONTE CENTRE,483,1,1,0,66,285,353,0,353,0,O-49-36-01-04-02
MAYUGE,BUNYA COUNTY WEST,BAITAMBOGWE,KATONTE,LUKONE CENTRE,384,1,0,2,24,215,242,34,276,0,O-49-36-01-04-03
MAYUGE,BUNYA COUNTY WEST,BAITAMBOGWE,KATONTE,NAMAGERA CENTRE,407,1,0,2,47,281,331,6,337,0,O-49-36-01-04-04
MAYUGE,BUNYA COUNTY WEST,BAITAMBOGWE,KATONTE,NSINDA CENTRE,449,3,0,3,42,265,313,8,321,0,O-49-36-01-04-05
MAYUGE,BUNYA COUNTY WEST,BAITAMBOGWE,KATONTE,MAGAMAGA CENTRE,290,1,5,0,66,150,222,12,234,0,O-49-36-01-04-06
MAYUGE,BUNYA COUNTY WEST,BAITAMBOGWE,LUGOLOLE,BAITAMBOGWE S/COUNTY HQTR,657,1,1,3,139,242,386,13,399,0,O-49-36-01-05-01
MAYUGE,BUNYA COUNTY WEST,BAITAMBOGWE,LUGOLOLE,LUGOLOLE MARKET,596,3,1,2,98,289,393,14,407,0,O-49-36-01-05-02
MAYUGE,BUNYA COUNTY WEST,BAITAMBOGWE,LUGOLOLE,LUGOLOLE MUVULE TREE,563,4,3,2,90,288,387,16,403,0,O-49-36-01-05-03
MAYUGE,BUNYA COUNTY WEST,BAITAMBOGWE,LUGOLOLE,MBIRIZI PR. SCH.,435,3,0,1,68,255,327,9,336,0,O-49-36-01-05-04
MAYUGE,BUNYA COUNTY WEST,BAITAMBOGWE,LUGOLOLE,NABALONGO PRIMARY SCHOOL,405,1,0,1,98,218,318,9,327,0,O-49-36-01-05-05
MAYUGE,BUNYA COUNTY WEST,BAITAMBOGWE,LUGOLOLE,BAITAMBOGWE T/C,393,3,4,2,114,172,295,0,295,0,O-49-36-01-05-06
MAYUGE,BUNYA COUNTY WEST,BAITAMBOGWE,LUGOLOLE,BUVUBA,374,1,0,3,56,175,235,10,245,0,O-49-36-01-05-07
MAYUGE,BUNYA COUNTY WEST,BAITAMBOGWE,MISOLI,NTINKALU TRADING CENTRE,489,5,0,2,99,169,275,24,299,0,O-49-36-01-06-01
MAYUGE,BUNYA COUNTY WEST,BAITAMBOGWE,MISOLI,MUSOLI PRIMARY SCHOOL A,499,2,4,1,106,207,320,12,332,0,O-49-36-01-06-02
MAYUGE,BUNYA COUNTY WEST,BAITAMBOGWE,MISOLI,MUSOLI P/SCH B,611,6,1,1,153,211,372,13,385,0,O-49-36-01-06-03
MAYUGE,BUNYA COUNTY WEST,BAITAMBOGWE,MISOLI,NTINKALU CHURCH,327,0,2,1,72,109,184,4,188,0,O-49-36-01-06-04
MAYUGE,BUNYA COUNTY WEST,BAITAMBOGWE,MULINGILIRE,NAMUSENWA TRADING CENTRE,594,3,2,1,103,278,387,29,416,0,O-49-36-01-07-01
MAYUGE,BUNYA COUNTY WEST,BAITAMBOGWE,MULINGILIRE,BUGODI TRADING CENTRE,792,7,2,2,98,441,550,12,562,0,O-49-36-01-07-02
MAYUGE,BUNYA COUNTY WEST,BAITAMBOGWE,MULINGILIRE,MUSITA TRADING CENTRE A,546,0,2,2,127,236,367,6,373,0,O-49-36-01-07-03
MAYUGE,BUNYA COUNTY WEST,BAITAMBOGWE,MULINGILIRE,MULINGIRIRE CENTRE,221,3,0,1,24,149,177,4,181,0,O-49-36-01-07-04
MAYUGE,BUNYA COUNTY WEST,BAITAMBOGWE,MULINGILIRE,MUSITA TRADING CENTRE B,288,0,0,0,50,141,191,8,199,0,O-49-36-01-07-05
MAYUGE,BUNYA COUNTY WEST,BAITAMBOGWE,WABULUNGU,MAGAMAGA PRIMARY SCHOOL,331,0,1,0,7,54,62,2,64,0,O-49-36-01-08-01
MAYUGE,BUNYA COUNTY WEST,BAITAMBOGWE,WABULUNGU,WABULUNGU P/S,812,5,2,4,163,365,539,14,553,0,O-49-36-01-08-02
MAYUGE,BUNYA COUNTY WEST,BAITAMBOGWE,WABULUNGU,WABULUNGU KIHONI,514,4,0,0,129,173,306,10,316,0,O-49-36-01-08-03
MAYUGE,BUNYA COUNTY WEST,BAITAMBOGWE,WABULUNGU,WABULUNGU MUKOKO,619,0,0,0,143,160,303,4,307,0,O-49-36-01-08-04
MAYUGE,BUNYA COUNTY WEST,BAITAMBOGWE,WABULUNGU,BUKOLI TRADING CENTRE,730,5,3,1,102,299,410,34,444,0,O-49-36-01-08-05
MAYUGE,BUNYA COUNTY WEST,BAITAMBOGWE,WABULUNGU,WABULUNGU QUARRY,1147,6,2,3,159,287,457,4,461,0,O-49-36-01-08-06
MAYUGE,BUNYA COUNTY WEST,BAITAMBOGWE,WABULUNGU,MAGAMAGA OUTSIDE GUARD (A-,479,0,0,0,20,164,184,4,188,0,O-49-36-01-08-07
MAYUGE,BUNYA COUNTY WEST,BAITAMBOGWE,WABULUNGU,MAGAMAGA OUTSIDE (N-Z),383,0,0,1,9,131,141,7,148,0,O-49-36-01-08-08
MAYUGE,BUNYA COUNTY WEST,BAITAMBOGWE,WANDAGO,WANDAGO C.O.U,423,0,1,0,61,124,186,8,194,0,O-49-36-01-09-01
MAYUGE,BUNYA COUNTY WEST,BAITAMBOGWE,WANDAGO,WANDAGO TRADING CENTRE,590,4,2,1,114,204,325,9,334,0,O-49-36-01-09-02
MAYUGE,BUNYA COUNTY WEST,BAITAMBOGWE,WANDAGO,WAIRASA TRADING CENTRE,706,7,4,6,144,233,394,28,422,0,O-49-36-01-09-03
MAYUGE,BUNYA COUNTY WEST,BAITAMBOGWE,WANDAGO,NAMALERE TRADING CENTRE,168,3,2,1,54,60,120,6,126,0,O-49-36-01-09-04
MAYUGE,BUNYA COUNTY WEST,IMANYIRO,BUFULUBI,BUKOMYA CENTRE,516,3,2,0,84,200,289,14,303,0,O-49-36-02-01-01
MAYUGE,BUNYA COUNTY WEST,IMANYIRO,BUFULUBI,BUFULUBI C.O.U,577,3,2,1,89,304,399,12,411,0,O-49-36-02-01-02
MAYUGE,BUNYA COUNTY WEST,IMANYIRO,BUFULUBI,LWABALA CENTRE,760,3,4,1,124,370,502,29,531,0,O-49-36-02-01-03
MAYUGE,BUNYA COUNTY WEST,IMANYIRO,BUKALEEBA,NAMUGONGO ISLAND,256,1,1,2,100,72,176,5,181,0,O-49-36-02-02-01
MAYUGE,BUNYA COUNTY WEST,IMANYIRO,BUKALEEBA,WALUMBE BEACH,634,2,2,6,182,169,361,8,369,0,O-49-36-02-02-02
MAYUGE,BUNYA COUNTY WEST,IMANYIRO,BUKALEEBA,NAKALANGA BEACH,683,4,6,1,171,167,349,15,364,0,O-49-36-02-02-03
MAYUGE,BUNYA COUNTY WEST,IMANYIRO,BUKALEEBA,BUKALEEBA FARM,393,2,5,3,109,131,250,5,255,0,O-49-36-02-02-04
MAYUGE,BUNYA COUNTY WEST,IMANYIRO,BUYEMBA,BUYEMBA TAWHEED MOSQUE,582,1,6,1,161,209,378,13,391,0,O-49-36-02-03-01
MAYUGE,BUNYA COUNTY WEST,IMANYIRO,BUYEMBA,MUGERI RCI OFFICE,462,3,4,5,70,272,354,10,364,0,O-49-36-02-03-02
MAYUGE,BUNYA COUNTY WEST,IMANYIRO,BUYEMBA,BUKASERO NABETA SCHOOL,574,9,2,6,114,256,387,25,412,0,O-49-36-02-03-03
MAYUGE,BUNYA COUNTY WEST,IMANYIRO,BUYEMBA,BUBALAGALA CHURCH,257,1,0,5,29,154,189,11,200,0,O-49-36-02-03-04
MAYUGE,BUNYA COUNTY WEST,IMANYIRO,BUYEMBA,LUUBU PR SCH,789,6,7,0,206,273,492,8,500,0,O-49-36-02-03-05
MAYUGE,BUNYA COUNTY WEST,IMANYIRO,BUYEMBA,BUKASERO B,517,3,1,9,97,239,349,7,356,0,O-49-36-02-03-06
MAYUGE,BUNYA COUNTY WEST,IMANYIRO,BUYEMBA,BUYEMBA PS,313,0,2,1,76,113,192,6,198,0,O-49-36-02-03-07
MAYUGE,BUNYA COUNTY WEST,IMANYIRO,LWANIKA,LUKINDU PRIMARY SCHOOL A,626,1,4,1,133,265,404,5,409,0,O-49-36-02-04-01
MAYUGE,BUNYA COUNTY WEST,IMANYIRO,LWANIKA,LUKINDU PRIMARY SCHOOL B,699,3,3,6,123,263,398,2,400,0,O-49-36-02-04-02
MAYUGE,BUNYA COUNTY WEST,IMANYIRO,LWANIKA,BUDGALA CENTRE,520,5,2,4,143,177,331,16,347,0,O-49-36-02-04-03
MAYUGE,BUNYA COUNTY WEST,IMANYIRO,LWANIKA,NDHOKERO CHURCH,478,1,2,4,140,105,252,81,333,0,O-49-36-02-04-04
MAYUGE,BUNYA COUNTY WEST,IMANYIRO,LWANIKA,LWANIKA CHURCH,676,2,3,3,163,248,419,11,430,0,O-49-36-02-04-05
MAYUGE,BUNYA COUNTY WEST,IMANYIRO,LWANIKA,LWANIKA PRIMARY SCHOOL,501,3,2,1,119,163,288,19,307,0,O-49-36-02-04-06
MAYUGE,BUNYA COUNTY WEST,IMANYIRO,LWANIKA,BUKATUUBE CHURCH,802,4,5,2,198,264,473,36,509,0,O-49-36-02-04-07
MAYUGE,BUNYA COUNTY WEST,IMANYIRO,MAGADA,MAGADA HEALTH CENTRE,637,4,1,3,165,268,441,13,454,0,O-49-36-02-05-01
MAYUGE,BUNYA COUNTY WEST,IMANYIRO,MAGADA,BULYAMPINDI S.S,311,1,1,3,68,134,207,19,226,0,O-49-36-02-05-02
MAYUGE,BUNYA COUNTY WEST,IMANYIRO,MAGADA,WANTE PRIMARY SCHOOL,839,5,4,4,235,394,642,18,660,0,O-49-36-02-05-03
MAYUGE,BUNYA COUNTY WEST,IMANYIRO,MAGADA,NAMAKAKALE CHURCH,550,2,2,0,101,265,370,11,381,0,O-49-36-02-05-04
MAYUGE,BUNYA COUNTY WEST,IMANYIRO,MAUTA,KABUKI TRADING CENTRE,667,1,2,6,172,259,440,8,448,0,O-49-36-02-06-01
MAYUGE,BUNYA COUNTY WEST,IMANYIRO,MAUTA,KYANDO P/SCH,719,5,5,6,156,295,467,21,488,0,O-49-36-02-06-02
MAYUGE,BUNYA COUNTY WEST,IMANYIRO,MAYUGE,LUWANURA T.C,137,0,2,1,6,93,102,0,102,0,O-49-36-02-07-01
MAYUGE,BUNYA COUNTY WEST,IMANYIRO,MAYUGE,MATUBA PRIMARY SCHOOL,335,0,0,1,45,192,238,7,245,0,O-49-36-02-07-02
MAYUGE,BUNYA COUNTY WEST,IMANYIRO,MAYUGE,BWIWULA CENTRE,653,6,11,9,157,234,417,19,436,0,O-49-36-02-07-03
MAYUGE,BUNYA COUNTY WEST,IMANYIRO,MAYUGE,BUKAWONGO CHURCH,561,4,0,4,79,329,416,19,435,0,O-49-36-02-07-04
MAYUGE,BUNYA COUNTY WEST,IMANYIRO,MBAALE,MBAALE PRIMARY SCHOOL,488,2,0,2,109,215,328,16,344,0,O-49-36-02-08-01
MAYUGE,BUNYA COUNTY WEST,IMANYIRO,MBAALE,MAGUNGA PR/SCHOOL,352,3,0,1,72,172,248,22,270,0,O-49-36-02-08-02
MAYUGE,BUNYA COUNTY WEST,IMANYIRO,MBAALE,MAKEMBO PR/SCHOOL,788,4,3,3,153,377,540,20,560,0,O-49-36-02-08-03
MAYUGE,BUNYA COUNTY WEST,IMANYIRO,MBAALE,NAMWOGI LC GROUND,359,5,1,2,58,162,228,14,242,0,O-49-36-02-08-04
MAYUGE,BUNYA COUNTY WEST,IMANYIRO,MBIRABIRA,BUWERERE P/SCH,549,0,3,1,107,239,350,17,367,0,O-49-36-02-09-01
MAYUGE,BUNYA COUNTY WEST,IMANYIRO,MBIRABIRA,MBIRAMBIRA P/SCH,580,3,4,4,94,284,389,13,402,0,O-49-36-02-09-02
MAYUGE,BUNYA COUNTY WEST,IMANYIRO,MBIRABIRA,BUFUTA T/CENTRE,437,3,0,4,125,126,258,1,259,0,O-49-36-02-09-03
MAYUGE,BUNYA COUNTY WEST,IMANYIRO,NKOMBE,NKOMBE CENTRE CHURCH,487,1,10,5,93,199,308,7,315,0,O-49-36-02-10-01
MAYUGE,BUNYA COUNTY WEST,IMANYIRO,NKOMBE,BUKENE CATH CHURCH,330,0,1,3,63,130,197,34,231,0,O-49-36-02-10-02
MAYUGE,BUNYA COUNTY WEST,IMANYIRO,NKOMBE,LWANDA,617,1,0,5,73,348,427,26,453,0,O-49-36-02-10-03
MAYUGE,BUNYA COUNTY WEST,MAYUGE TOWN COUNCIL,IKULWE,MAYUGE MARKET,1321,8,4,7,267,444,730,5,735,0,O-49-36-03-01-01
MAYUGE,BUNYA COUNTY WEST,MAYUGE TOWN COUNCIL,IKULWE,MAYUGE DISTRICT HQTRS,375,7,0,2,49,179,237,9,246,0,O-49-36-03-01-02
MAYUGE,BUNYA COUNTY WEST,MAYUGE TOWN COUNCIL,KASUGU,DWALIRO,908,9,6,0,199,341,555,24,579,0,O-49-36-03-02-01
MAYUGE,BUNYA COUNTY WEST,MAYUGE TOWN COUNCIL,KAVULE,DFI,610,8,5,0,116,287,416,8,424,0,O-49-36-03-03-01
MAYUGE,BUNYA COUNTY WEST,MAYUGE TOWN COUNCIL,KAVULE,MAYUGE COMMUNITY CENTRE,785,7,0,1,117,240,365,13,378,0,O-49-36-03-03-02
MAYUGE,BUNYA COUNTY WEST,MAYUGE TOWN COUNCIL,KYEBANDO,KYEBANDO T/C,764,5,4,3,186,312,510,7,517,0,O-49-36-03-04-01
MAYUGE,BUNYA COUNTY WEST,MAYUGE TOWN COUNCIL,KYEBANDO,ST. MULUMBA CHURCH,145,1,1,0,43,41,86,1,87,0,O-49-36-03-04-02
MAYUGE,BUNYA SOUTH,KITYERERA,BUBINGE,BUSIMO TR/CENTRE,447,4,2,4,119,167,296,2,298,0,O-49-35-01-01-01
MAYUGE,BUNYA SOUTH,KITYERERA,BUBINGE,BUBINGE BEACH,530,1,2,3,136,177,319,8,327,0,O-49-35-01-01-02
MAYUGE,BUNYA SOUTH,KITYERERA,BUBINGE,BULIDHA MARKET,550,7,3,7,165,187,369,7,376,0,O-49-35-01-01-03
MAYUGE,BUNYA SOUTH,KITYERERA,BUKALENZI,BUKOBA BEACH,633,4,2,4,139,216,365,12,377,0,O-49-35-01-02-01
MAYUGE,BUNYA SOUTH,KITYERERA,BUKALENZI,MASHAGA CENTRE,435,1,1,4,93,136,235,12,247,0,O-49-35-01-02-02
MAYUGE,BUNYA SOUTH,KITYERERA,BUKALENZI,NAMALERE CENTRE,279,1,1,2,81,103,188,1,189,0,O-49-35-01-02-03
MAYUGE,BUNYA SOUTH,KITYERERA,BUKALENZI,BUKALENZI PR/SCHOOL A,455,2,1,2,120,99,224,7,231,0,O-49-35-01-02-04
MAYUGE,BUNYA SOUTH,KITYERERA,BUKALENZI,BUKALENZI PR/SCHOOL B,370,0,1,0,63,67,131,65,196,0,O-49-35-01-02-05
MAYUGE,BUNYA SOUTH,KITYERERA,BUKALENZI,LUTALE T/CENTRE,647,8,1,7,228,90,334,9,343,0,O-49-35-01-02-06
MAYUGE,BUNYA SOUTH,KITYERERA,BUKUNJA,BUKUNJA JUNCTION,437,5,3,5,97,197,307,7,314,0,O-49-35-01-03-01
MAYUGE,BUNYA SOUTH,KITYERERA,BUKUNJA,NAMISU T/CENTRE A,436,3,1,2,82,171,259,40,299,0,O-49-35-01-03-02
MAYUGE,BUNYA SOUTH,KITYERERA,BUKUNJA,NAMISU T/CENTRE B,372,1,1,1,90,135,228,35,263,0,O-49-35-01-03-03
MAYUGE,BUNYA SOUTH,KITYERERA,BUKUNJA,LUBALI TRADING CENTRE,395,1,1,1,85,142,230,10,240,0,O-49-35-01-03-04
MAYUGE,BUNYA SOUTH,KITYERERA,BUKUNJA,BUSAALA PR. SCH.,349,0,3,2,50,152,207,13,220,0,O-49-35-01-03-05
MAYUGE,BUNYA SOUTH,KITYERERA,BUTANGALA,BUTANGALA TR/CENTRE,645,0,9,5,146,217,377,7,384,0,O-49-35-01-04-01
MAYUGE,BUNYA SOUTH,KITYERERA,BUTANGALA,BUBALI CHURCH,436,2,6,3,124,159,294,14,308,0,O-49-35-01-04-02
MAYUGE,BUNYA SOUTH,KITYERERA,BUTANGALA,MABIRIZI PR/SCHOOL {A-M},448,0,25,0,147,129,301,9,310,0,O-49-35-01-04-03
MAYUGE,BUNYA SOUTH,KITYERERA,BUTANGALA,WAITA JUNCTION,392,4,3,5,163,78,253,9,262,0,O-49-35-01-04-04
MAYUGE,BUNYA SOUTH,KITYERERA,BUTANGALA,MABIRIZI PR/SCHOOL {N-Z},334,4,11,1,79,101,196,17,213,0,O-49-35-01-04-05
MAYUGE,BUNYA SOUTH,KITYERERA,KALUBA,BUSAKIRA TR. CENTRE A {A -M},563,4,2,2,147,174,329,10,339,0,O-49-35-01-05-01
MAYUGE,BUNYA SOUTH,KITYERERA,KALUBA,BUSAKIRA TR. CENTRE B,579,1,18,2,127,126,274,61,335,0,O-49-35-01-05-02
MAYUGE,BUNYA SOUTH,KITYERERA,KALUBA,KULUBA TR. CENTRE A,558,4,4,1,115,169,293,11,304,0,O-49-35-01-05-03
MAYUGE,BUNYA SOUTH,KITYERERA,KALUBA,KULUBA TR/CENTRE B,374,2,2,2,68,129,203,7,210,0,O-49-35-01-05-04
MAYUGE,BUNYA SOUTH,KITYERERA,KALUBA,BUSAKIRA TR. CENTRE A {N-Z},401,0,4,1,49,107,161,52,213,0,O-49-35-01-05-05
MAYUGE,BUNYA SOUTH,KITYERERA,KITOVU,KITOVU PR. SCH.,649,2,2,3,102,262,371,11,382,0,O-49-35-01-06-01
MAYUGE,BUNYA SOUTH,KITYERERA,KITOVU,KABAGANJA BEACH,228,2,0,3,47,94,146,7,153,0,O-49-35-01-06-02
MAYUGE,BUNYA SOUTH,KITYERERA,KITOVU,LUTALE TR/CENTRE,295,4,1,1,58,141,205,13,218,0,O-49-35-01-06-03
MAYUGE,BUNYA SOUTH,KITYERERA,KITYERERA,NAKIBANGO CENTRE,526,1,0,6,142,182,331,12,343,0,O-49-35-01-07-01
MAYUGE,BUNYA SOUTH,KITYERERA,KITYERERA,BUGADDE PR SCH A (A-M),630,3,0,2,203,149,357,14,371,0,O-49-35-01-07-02
MAYUGE,BUNYA SOUTH,KITYERERA,KITYERERA,BUGADDE PR. SCH. B,590,5,0,4,152,134,295,13,308,0,O-49-35-01-07-03
MAYUGE,BUNYA SOUTH,KITYERERA,KITYERERA,BUGADDE PR SCH A (N-Z),488,1,1,5,98,125,230,12,242,0,O-49-35-01-07-04
MAYUGE,BUNYA SOUTH,KITYERERA,KITYERERA,KITYERERA T/C,591,4,2,1,136,284,427,4,431,0,O-49-35-01-07-05
MAYUGE,BUNYA SOUTH,KITYERERA,KITYERERA,BUSENDA P/S,274,1,3,2,58,108,172,5,177,0,O-49-35-01-07-06
MAYUGE,BUNYA SOUTH,KITYERERA,MAUMU,BUSEERA PR. SCH.,743,2,3,2,127,294,428,18,446,0,O-49-35-01-08-01
MAYUGE,BUNYA SOUTH,KITYERERA,MAUMU,MAWUMU CENTRE,634,3,0,4,156,233,396,8,404,0,O-49-35-01-08-02
MAYUGE,BUNYA SOUTH,KITYERERA,NDAIGA,NAKIRIMIRA BEACH,544,3,0,5,88,258,354,9,363,0,O-49-35-01-09-01
MAYUGE,BUNYA SOUTH,KITYERERA,NDAIGA,NGAIGA MARKET,648,0,0,3,140,281,424,16,440,0,O-49-35-01-09-02
MAYUGE,BUNYA SOUTH,KITYERERA,NDAIGA,BABALULE MOSQUE,545,1,1,4,83,281,370,8,378,0,O-49-35-01-09-03
MAYUGE,BUNYA SOUTH,KITYERERA,WAMBETE,WAMBEETE PR. SCH.,569,4,7,3,111,248,373,12,385,0,O-49-35-01-10-01
MAYUGE,BUNYA SOUTH,KITYERERA,WAMBETE,MACHECHE CENTRE,666,2,1,2,148,276,429,3,432,0,O-49-35-01-10-02
MAYUGE,BUNYA SOUTH,KITYERERA,WANDEGEYA,KATUBA MUSLIM SCH,691,0,2,4,167,257,430,78,508,0,O-49-35-01-11-01
MAYUGE,BUNYA SOUTH,KITYERERA,WANDEGEYA,WANDEGEYA PR. SCH.,602,1,4,5,123,304,437,10,447,0,O-49-35-01-11-02
MAYUGE,BUNYA SOUTH,MALONGO,BUKATABIRA,BUKATABIRA PR SCH A,488,1,2,1,89,145,238,7,245,0,O-49-35-02-01-01
MAYUGE,BUNYA SOUTH,MALONGO,BUKATABIRA,NKOLONGO CENTRE,606,2,1,1,136,217,357,12,369,0,O-49-35-02-01-02
MAYUGE,BUNYA SOUTH,MALONGO,BUKATABIRA,BUKIZIBU T/C,587,1,2,3,126,141,273,1,274,0,O-49-35-02-01-03
MAYUGE,BUNYA SOUTH,MALONGO,BUKATABIRA,NAKIGO PR. SCH.,474,4,3,2,193,115,317,8,325,0,O-49-35-02-01-04
MAYUGE,BUNYA SOUTH,MALONGO,BUKATABIRA,BUKATABIRA PR SCH B,295,1,3,0,36,79,119,7,126,0,O-49-35-02-01-05
MAYUGE,BUNYA SOUTH,MALONGO,BUKATABIRA,BULUBODHE MOSQUE,619,3,0,7,126,122,258,8,266,0,O-49-35-02-01-06
MAYUGE,BUNYA SOUTH,MALONGO,BUKATABIRA,BUMWENA TRADING CENTRE,650,2,1,0,132,49,184,36,220,0,O-49-35-02-01-07
MAYUGE,BUNYA SOUTH,MALONGO,BULUTA,BULUTA SDA CHURCH B,377,2,0,5,101,72,180,7,187,0,O-49-35-02-02-01
MAYUGE,BUNYA SOUTH,MALONGO,BULUTA,BUKAGABO MOSQUE,581,3,2,3,96,183,287,7,294,0,O-49-35-02-02-02
MAYUGE,BUNYA SOUTH,MALONGO,BULUTA,BULUTA SDA CHURCH A,426,2,3,1,111,106,223,6,229,0,O-49-35-02-02-03
MAYUGE,BUNYA SOUTH,MALONGO,BULUTA,BUKAGABO BEACH,502,2,0,1,131,88,222,11,233,0,O-49-35-02-02-04
MAYUGE,BUNYA SOUTH,MALONGO,BULUTA,BULUTA PARENTS' SCHOOL,564,5,2,10,127,154,298,7,305,0,O-49-35-02-02-05
MAYUGE,BUNYA SOUTH,MALONGO,BUMBA,BUYAKO PARENTS' SCHOOL,764,3,1,4,141,105,254,17,271,0,O-49-35-02-03-01
MAYUGE,BUNYA SOUTH,MALONGO,BWONDHA,BWODHA BEACH A,814,3,2,1,142,124,272,1,273,0,O-49-35-02-04-01
MAYUGE,BUNYA SOUTH,MALONGO,BWONDHA,BWODHA HEALTH CENTRE,769,3,2,1,134,132,272,62,334,0,O-49-35-02-04-02
MAYUGE,BUNYA SOUTH,MALONGO,BWONDHA,BWODHA P/S,845,8,3,3,257,129,400,15,415,0,O-49-35-02-04-03
MAYUGE,BUNYA SOUTH,MALONGO,DHAGUSI,MUBEMBE CENTRE,430,3,3,3,89,141,239,9,248,0,O-49-35-02-05-01
MAYUGE,BUNYA SOUTH,MALONGO,DHAGUSI,JAGUSI SETTLEMENT,815,3,2,5,131,253,394,18,412,0,O-49-35-02-05-02
MAYUGE,BUNYA SOUTH,MALONGO,DHAGUSI,GOLI,455,4,5,1,73,139,222,15,237,0,O-49-35-02-05-03
MAYUGE,BUNYA SOUTH,MALONGO,KAAZA,KAAZA SETTLEMENT CENTRE,640,5,0,0,107,157,269,5,274,0,O-49-35-02-06-01
MAYUGE,BUNYA SOUTH,MALONGO,MALONGO,NANGO PRIMARY SCHOOL A,579,4,1,0,147,157,309,7,316,0,O-49-35-02-07-01
MAYUGE,BUNYA SOUTH,MALONGO,MALONGO,MASAKA BEACH,357,3,2,0,70,136,211,8,219,0,O-49-35-02-07-02
MAYUGE,BUNYA SOUTH,MALONGO,MALONGO,MALONGO T/CENTRE A,645,2,1,2,110,152,267,44,311,0,O-49-35-02-07-03
MAYUGE,BUNYA SOUTH,MALONGO,MALONGO,MALONGO SUB-DISPENSARY,571,3,0,3,125,144,275,18,293,0,O-49-35-02-07-04
MAYUGE,BUNYA SOUTH,MALONGO,MALONGO,MALONGO PARENTS SCHOOL,370,1,2,3,54,185,245,1,246,0,O-49-35-02-07-05
MAYUGE,BUNYA SOUTH,MALONGO,MALONGO,MALONGO T/CENTRE B,443,2,1,3,80,97,183,9,192,0,O-49-35-02-07-06
MAYUGE,BUNYA SOUTH,MALONGO,MALONGO,KABUKA BEACH,284,0,1,0,32,87,120,13,133,0,O-49-35-02-07-07
MAYUGE,BUNYA SOUTH,MALONGO,MALONGO,NANGO PRIMARY SCHOOL B,576,2,0,1,105,150,258,2,260,0,O-49-35-02-07-08
MAYUGE,BUNYA SOUTH,MALONGO,MASOLYA,MASOLYA CENTRE A,369,1,1,0,82,51,135,0,135,0,O-49-35-02-08-01
MAYUGE,BUNYA SOUTH,MALONGO,MASOLYA,MASOLYA CENTRE B,309,1,1,0,79,54,135,18,153,0,O-49-35-02-08-02
MAYUGE,BUNYA SOUTH,MALONGO,NAMADHI,NAMADHI T/CENTRE C,511,4,1,1,80,145,231,35,266,0,O-49-35-02-09-01
MAYUGE,BUNYA SOUTH,MALONGO,NAMADHI,NAMADHI T/CENTRE A,441,5,1,6,72,143,227,17,244,0,O-49-35-02-09-02
MAYUGE,BUNYA SOUTH,MALONGO,NAMADHI,NAMADHI T/CENTRE B,598,2,0,3,97,253,355,11,366,0,O-49-35-02-09-03
MAYUGE,BUNYA SOUTH,MALONGO,NAMADHI,NAMAVUNDU T/CENTRE,481,3,1,2,104,150,260,7,267,0,O-49-35-02-09-04
MAYUGE,BUNYA SOUTH,MALONGO,NAMONI,MAGOOLA CENTRE,662,2,0,2,102,240,346,62,408,0,O-49-35-02-10-01
MAYUGE,BUNYA SOUTH,MALONGO,NAMONI,NAMONI CENTRE,447,2,1,8,89,141,241,16,257,0,O-49-35-02-10-02
MAYUGE,BUNYA SOUTH,MALONGO,NAMONI,NAMONI BEACH,421,1,1,1,84,141,228,6,234,0,O-49-35-02-10-03
MAYUGE,BUNYA SOUTH,MALONGO,SAGITU,BUSWETTA PR SCH,609,5,0,3,131,158,297,2,299,0,O-49-35-02-11-01
MAYUGE,BUNYA SOUTH,MALONGO,SAGITU,DEMBE BEACH,535,6,0,1,70,211,288,10,298,0,O-49-35-02-11-02
MAYUGE,BUNYA SOUTH,MALONGO,SERINYABI,SERINYABBI PARENTS' SCHOOL,411,3,1,0,79,87,170,5,175,0,O-49-35-02-12-01
SIRONKO,BUDADIRI COUNTY EAST,BUHUGU,BUGIBUGI,BUSINGIDE C.O.U,408,0,0,0,0,0,0,0,0,1,O-51-128-01-01-01
SIRONKO,BUDADIRI COUNTY EAST,BUHUGU,BUKYABO,BUSAHE C.U,245,1,0,2,36,166,205,3,208,0,O-51-128-01-02-01
SIRONKO,BUDADIRI COUNTY EAST,BUHUGU,BUKYABO,WOBOMBA'S PLACE,531,2,0,0,84,352,438,7,445,0,O-51-128-01-02-02
SIRONKO,BUDADIRI COUNTY EAST,BUHUGU,BUKYABO,BUKYABO P.S.,477,0,1,1,118,220,340,15,355,0,O-51-128-01-02-03
SIRONKO,BUDADIRI COUNTY EAST,BUHUGU,BUKYABO,GOMBE,185,0,0,0,9,145,154,2,156,0,O-51-128-01-02-04
SIRONKO,BUDADIRI COUNTY EAST,BUHUGU,BUMALIMBA,MAWO,522,1,1,0,175,114,291,16,307,0,O-51-128-01-03-01
SIRONKO,BUDADIRI COUNTY EAST,BUHUGU,BUMALIMBA,BUHUGU H/C A,313,0,0,1,117,70,188,13,201,0,O-51-128-01-03-02
SIRONKO,BUDADIRI COUNTY EAST,BUHUGU,BUMALIMBA,BUHUGU H/C B,465,2,2,3,144,149,300,9,309,0,O-51-128-01-03-03
SIRONKO,BUDADIRI COUNTY EAST,BUHUGU,BUMATOFU,BUHUGU SOCIAL CENTRE HQRS,424,1,1,1,144,137,284,9,293,0,O-51-128-01-04-01
SIRONKO,BUDADIRI COUNTY EAST,BUHUGU,BUMUGWEDI,BUSITA C. CHURCH,597,4,1,2,226,161,394,2,396,0,O-51-128-01-05-01
SIRONKO,BUDADIRI COUNTY EAST,BUHUGU,BUMUGWEDI,KIRALI PR. SCH.,431,2,2,1,166,102,273,10,283,0,O-51-128-01-05-02
SIRONKO,BUDADIRI COUNTY EAST,BUHUGU,BUMULISHA,WONANGOLI NANSAMBA,383,1,0,1,84,141,227,56,283,0,O-51-128-01-06-01
SIRONKO,BUDADIRI COUNTY EAST,BUHUGU,BUMULISHA,BUWAGAMA CATHOLIC CHURCH,314,2,0,2,30,180,214,6,220,0,O-51-128-01-06-02
SIRONKO,BUDADIRI COUNTY EAST,BUHUGU,BUMULISHA,BUMULISHA PRIMARY SCHOOL,917,2,1,4,205,363,575,19,594,0,O-51-128-01-06-03
SIRONKO,BUDADIRI COUNTY EAST,BUHUGU,BUMUSABIRE,ZEBUGUBUSI P.S.,683,0,0,2,99,532,633,17,650,0,O-51-128-01-07-01
SIRONKO,BUDADIRI COUNTY EAST,BUHUGU,BUSIITA,BUSIITA PS,490,3,2,4,89,242,340,23,363,0,O-51-128-01-08-01
SIRONKO,BUDADIRI COUNTY EAST,BUHUGU,KIBOLO,BUMATOFU PR. SCH.,646,7,2,3,202,238,452,18,470,0,O-51-128-01-09-01
SIRONKO,BUDADIRI COUNTY EAST,BUHUGU,MUSENE,MAKUTANO CENTRE,536,4,1,5,185,132,327,9,336,0,O-51-128-01-10-01
SIRONKO,BUDADIRI COUNTY EAST,BUHUGU,MUSENE,WOLANGA,579,4,0,2,167,192,365,6,371,0,O-51-128-01-10-02
SIRONKO,BUDADIRI COUNTY EAST,BUHUGU,MUTUFU,MUTUFU TRADING CENTRE,530,2,1,0,153,155,311,7,318,0,O-51-128-01-11-01
SIRONKO,BUDADIRI COUNTY EAST,BUHUGU,MUTUFU,MUTUFU C.O.U,532,0,0,3,156,186,345,21,366,0,O-51-128-01-11-02
SIRONKO,BUDADIRI COUNTY EAST,BUHUGU,NANDERE,KIGOKYE,451,4,0,3,109,164,280,0,280,0,O-51-128-01-12-01
SIRONKO,BUDADIRI COUNTY EAST,BUHUGU,NANDERE,MUTUFU CLUB,384,4,3,4,103,119,233,19,252,0,O-51-128-01-12-02
SIRONKO,BUDADIRI COUNTY EAST,BUMASIFWA,BUFAKA,BUNDAGALA P/S,489,1,4,2,103,238,348,7,355,0,O-51-128-02-01-01
SIRONKO,BUDADIRI COUNTY EAST,BUMASIFWA,BUFAKA,BUNAKOBE CATHOLIC CHURCH,346,2,0,1,65,143,211,8,219,0,O-51-128-02-01-02
SIRONKO,BUDADIRI COUNTY EAST,BUMASIFWA,BUGIBONI,KISALI PENTECOSTAL CHURCH,209,1,0,2,23,143,169,13,182,0,O-51-128-02-02-01
SIRONKO,BUDADIRI COUNTY EAST,BUMASIFWA,BUGIBONI,BUGIBONI PR. SCH.,645,3,0,0,87,364,454,11,465,0,O-51-128-02-02-02
SIRONKO,BUDADIRI COUNTY EAST,BUMASIFWA,BUGIBONI,LUSAGALI PR. SCH.,348,2,0,1,66,155,224,11,235,0,O-51-128-02-02-03
SIRONKO,BUDADIRI COUNTY EAST,BUMASIFWA,BUGITIMWA,BUGITIMWA PR SCH,731,2,0,4,80,366,452,12,464,0,O-51-128-02-03-01
SIRONKO,BUDADIRI COUNTY EAST,BUMASIFWA,BULWALA,BUMASIFWA S/C HQTR A,506,2,2,4,149,193,350,10,360,0,O-51-128-02-04-01
SIRONKO,BUDADIRI COUNTY EAST,BUMASIFWA,BULWALA,BUMASIFWA S/C HQTRS B,567,0,1,2,145,201,349,7,356,0,O-51-128-02-04-02
SIRONKO,BUDADIRI COUNTY EAST,BUMASIFWA,BUMAGABULA,WANZALA'S GROUND,550,3,2,1,72,459,537,5,542,0,O-51-128-02-05-01
SIRONKO,BUDADIRI COUNTY EAST,BUMASIFWA,BUMAGABULA,BUMUHUNE,229,0,1,0,53,160,214,8,222,0,O-51-128-02-05-02
SIRONKO,BUDADIRI COUNTY EAST,BUMASIFWA,BUMAGUZE,BUMAGUZE PR SCH,657,3,0,1,104,341,449,0,449,0,O-51-128-02-06-01
SIRONKO,BUDADIRI COUNTY EAST,BUMASIFWA,BUMASIFWA,BUNASEKE G.C.S.,655,1,3,1,101,410,516,1,517,0,O-51-128-02-07-01
SIRONKO,BUDADIRI COUNTY EAST,BUMASIFWA,BUMASOBO,BUMASOBO PR SCH,513,1,2,5,69,300,377,22,399,0,O-51-128-02-08-01
SIRONKO,BUDADIRI COUNTY EAST,BUMASIFWA,BUMASOBO,BUGIMWERA C.U,326,1,0,2,47,262,312,14,326,0,O-51-128-02-08-02
SIRONKO,BUDADIRI COUNTY EAST,BUMASIFWA,BUMASOBO,ZANZASI PR SCH,236,2,0,0,65,138,205,7,212,0,O-51-128-02-08-03
SIRONKO,BUDADIRI COUNTY EAST,BUMASIFWA,BUMULEGI,KISAWE PR. SCH.,519,6,0,2,302,60,370,16,386,0,O-51-128-02-09-01
SIRONKO,BUDADIRI COUNTY EAST,BUSULANI,BUGIMUNYE,MASABA S.S.,581,0,2,1,188,125,316,19,335,0,O-51-128-03-01-01
SIRONKO,BUDADIRI COUNTY EAST,BUSULANI,BUGIMUNYE,NAKIRUNGU P.S.,700,2,1,0,277,172,452,8,460,0,O-51-128-03-01-02
SIRONKO,BUDADIRI COUNTY EAST,BUSULANI,BUGIMUNYE,GIDONGO'S PLAY GROUND,268,1,0,1,106,88,196,5,201,0,O-51-128-03-01-03
SIRONKO,BUDADIRI COUNTY EAST,BUSULANI,BUGUBE,BUDEDA PS,516,2,0,1,89,256,348,16,364,0,O-51-128-03-02-01
SIRONKO,BUDADIRI COUNTY EAST,BUSULANI,BUKAMA,BUKAMA G.C.S.,577,2,1,4,185,188,380,10,390,0,O-51-128-03-03-01
SIRONKO,BUDADIRI COUNTY EAST,BUSULANI,BUKAMA,MAYEMBE T/C,323,0,0,1,165,72,238,6,244,0,O-51-128-03-03-02
SIRONKO,BUDADIRI COUNTY EAST,BUSULANI,BUKYAMBI,BUKYAMBI P.S.,728,2,0,4,239,244,489,12,501,0,O-51-128-03-04-01
SIRONKO,BUDADIRI COUNTY EAST,BUSULANI,BUMAWOSA,MAKUNYU P.S.,627,4,1,0,223,150,378,12,390,0,O-51-128-03-05-01
SIRONKO,BUDADIRI COUNTY EAST,BUSULANI,BUMAWOSA,MANGA CENTRE,299,2,1,4,64,159,230,7,237,0,O-51-128-03-05-02
SIRONKO,BUDADIRI COUNTY EAST,BUSULANI,BUMAWOSA,KAYEMBA'S GROUND,281,1,0,0,52,142,195,6,201,0,O-51-128-03-05-03
SIRONKO,BUDADIRI COUNTY EAST,BUSULANI,KALAWA,KILOMBE MKT,861,2,1,5,288,248,544,38,582,0,O-51-128-03-06-01
SIRONKO,BUDADIRI COUNTY EAST,BUSULANI,NAKIWONDWE,WAGAGAYI,532,3,1,4,197,124,329,6,335,0,O-51-128-03-07-01
SIRONKO,BUDADIRI COUNTY EAST,BUSULANI,NAKIWONDWE,NAKIWONDWE G.C.S,510,2,0,1,168,126,297,8,305,0,O-51-128-03-07-02
SIRONKO,BUDADIRI COUNTY EAST,BUSULANI,NAKIWONDWE,KADO,368,1,0,0,108,134,243,6,249,0,O-51-128-03-07-03
SIRONKO,BUDADIRI COUNTY EAST,BUSULANI,NAKIWONDWE,NAKIWONDWE T/C,445,1,3,0,158,81,243,3,246,0,O-51-128-03-07-04
SIRONKO,BUDADIRI COUNTY EAST,BUSULANI,NAKIWONDWE,BUDADIRI PLAYGROUND,745,2,1,2,257,222,484,2,486,0,O-51-128-03-07-05
SIRONKO,BUDADIRI COUNTY EAST,BUTANDIGA,BUKIISE,BUKIISE PR SCH,670,5,0,3,73,337,418,27,445,0,O-51-128-04-01-01
SIRONKO,BUDADIRI COUNTY EAST,BUTANDIGA,BUKIISE,BUKIISE G.C.S.,779,3,1,3,127,281,415,18,433,0,O-51-128-04-01-02
SIRONKO,BUDADIRI COUNTY EAST,BUTANDIGA,BUKIISE,WOLIMBWA'S PLACE,530,2,0,3,70,312,387,12,399,0,O-51-128-04-01-03
SIRONKO,BUDADIRI COUNTY EAST,BUTANDIGA,BUTANDIGA,BUNABUSUSU I,742,3,2,0,300,419,724,18,742,0,O-51-128-04-02-01
SIRONKO,BUDADIRI COUNTY EAST,BUTANDIGA,BUTANDIGA,BUNABUSUSU II A,879,3,0,1,203,398,605,0,605,0,O-51-128-04-02-02
SIRONKO,BUDADIRI COUNTY EAST,BUTANDIGA,BUTANDIGA,BUNABUSUSU II B,733,0,0,0,211,433,644,23,667,0,O-51-128-04-02-03
SIRONKO,BUDADIRI COUNTY EAST,BUTANDIGA,BUTANDIGA,SIGWA,438,0,0,0,23,410,433,0,433,0,O-51-128-04-02-04
SIRONKO,BUDADIRI COUNTY EAST,BUTANDIGA,NALUGUGU WARD,BUMULAHA,672,5,1,0,130,232,368,20,388,0,O-51-128-04-03-01
SIRONKO,BUDADIRI COUNTY EAST,BUTANDIGA,NALUGUGU WARD,BUSIU G.C.S,473,3,4,2,113,201,323,31,354,0,O-51-128-04-03-02
SIRONKO,BUDADIRI COUNTY EAST,BUTANDIGA,NANDAGO,NANDAGO PR SCH,530,0,4,2,121,163,290,36,326,0,O-51-128-04-04-01
SIRONKO,BUDADIRI COUNTY EAST,BUTANDIGA,NANDAGO,NALUGUGU FARM,568,4,5,5,171,176,361,2,363,0,O-51-128-04-04-02
SIRONKO,BUDADIRI COUNTY EAST,BUTANDIGA,NANDAGO,SIRONKO PR SCH,411,5,0,2,95,106,208,13,221,0,O-51-128-04-04-03
SIRONKO,BUDADIRI COUNTY EAST,BUTANDIGA,NANDAGO,BULUBA C. O. U,491,1,2,7,91,154,255,20,275,0,O-51-128-04-04-04
SIRONKO,BUDADIRI COUNTY EAST,BUTANDIGA,NANDAGO,BUGOBERO C. O. U,236,2,0,2,71,65,140,10,150,0,O-51-128-04-04-05
SIRONKO,BUDADIRI COUNTY EAST,BUTANDIGA,SIMU/PONDO,SIMU,605,1,1,3,128,239,372,16,388,0,O-51-128-04-05-01
SIRONKO,BUDADIRI COUNTY EAST,BUTANDIGA,SIMU/PONDO,NAMWENJE,613,4,1,4,64,303,376,9,385,0,O-51-128-04-05-02
SIRONKO,BUDADIRI COUNTY EAST,BUTANDIGA,SIMU/PONDO,GODYO KILUKU RD,258,1,1,6,55,158,221,14,235,0,O-51-128-04-05-03
SIRONKO,BUDADIRI COUNTY EAST,ZESUI,BUBOOLO,BUBOOLO G.C.S.,505,0,0,0,108,203,311,10,321,0,O-51-128-05-01-01
SIRONKO,BUDADIRI COUNTY EAST,ZESUI,BUBOOLO,KIDEGA,291,2,0,2,116,112,232,3,235,0,O-51-128-05-01-02
SIRONKO,BUDADIRI COUNTY EAST,ZESUI,BUFUPA,BUFUPA PR. SCH.,686,2,1,1,251,94,349,8,357,0,O-51-128-05-02-01
SIRONKO,BUDADIRI COUNTY EAST,ZESUI,BUKIBOLI,BUMAJEME CENTER,185,0,0,1,33,125,159,9,168,0,O-51-128-05-03-01
SIRONKO,BUDADIRI COUNTY EAST,ZESUI,BUKINYALE,MATEBO,385,3,0,1,106,100,210,10,220,0,O-51-128-05-04-01
SIRONKO,BUDADIRI COUNTY EAST,ZESUI,BUKINYALE,BUKINYALE PR SCH,528,3,0,0,146,142,291,11,302,0,O-51-128-05-04-02
SIRONKO,BUDADIRI COUNTY EAST,ZESUI,BULUJEWA,BUGOBIRO P.S.,748,4,0,2,133,384,523,32,555,0,O-51-128-05-05-01
SIRONKO,BUDADIRI COUNTY EAST,ZESUI,BULUJEWA,BULUJEWA DISP.,688,1,0,1,130,318,450,12,462,0,O-51-128-05-05-02
SIRONKO,BUDADIRI COUNTY EAST,ZESUI,BUMULUWE,MANGA CENTER,406,1,0,0,99,204,304,3,307,0,O-51-128-05-06-01
SIRONKO,BUDADIRI COUNTY EAST,ZESUI,BUMUMULO,BUMUMULO PS A,289,2,0,3,66,180,251,3,254,0,O-51-128-05-07-01
SIRONKO,BUDADIRI COUNTY EAST,ZESUI,BUMUMULO,MAKYELELE,438,2,0,0,205,88,295,5,300,0,O-51-128-05-07-02
SIRONKO,BUDADIRI COUNTY EAST,ZESUI,BUMUMULO,NABODI,577,2,2,3,181,208,396,6,402,0,O-51-128-05-07-03
SIRONKO,BUDADIRI COUNTY EAST,ZESUI,BUMUMULO,BUMUMULO PS B,136,1,0,1,23,65,90,1,91,0,O-51-128-05-07-04
SIRONKO,BUDADIRI COUNTY EAST,ZESUI,BUMUMULO,BUGIMAGU,437,1,0,1,162,111,275,10,285,0,O-51-128-05-07-05
SIRONKO,BUDADIRI COUNTY EAST,ZESUI,NABWEYA,KYESYA PR. SCHOOL,377,3,0,1,213,59,276,8,284,0,O-51-128-05-08-01
SIRONKO,BUDADIRI COUNTY EAST,ZESUI,SHIMUMA,MAJENGA CENTRE,253,0,0,0,124,62,186,3,189,0,O-51-128-05-09-01
SIRONKO,BUDADIRI COUNTY EAST,ZESUI,ZESUI,ZESUI A,511,3,0,1,294,27,325,11,336,0,O-51-128-05-10-01
SIRONKO,BUDADIRI COUNTY EAST,ZESUI,ZESUI,ZESUI B,511,1,1,0,248,33,283,8,291,0,O-51-128-05-10-02
SIRONKO,BUDADIRI COUNTY WEST,BUKHULO,BUKHULO,BUDAMA C C,416,3,1,2,150,117,273,10,283,0,O-51-129-01-01-01
SIRONKO,BUDADIRI COUNTY WEST,BUKHULO,BUKHULO,BUDAMA CATH CHURCH,384,4,0,1,141,122,268,12,280,0,O-51-129-01-01-02
SIRONKO,BUDADIRI COUNTY WEST,BUKHULO,BUNDEGE,BUNGWANYI C/U,749,4,3,4,224,274,509,26,535,0,O-51-129-01-02-01
SIRONKO,BUDADIRI COUNTY WEST,BUKHULO,BUNDEGE,MPOGO MOSQUE,740,3,0,3,228,154,388,8,396,0,O-51-129-01-02-02
SIRONKO,BUDADIRI COUNTY WEST,BUKHULO,BUNDEGE,BUNDEGYE AID POST,274,1,0,0,89,78,168,8,176,0,O-51-129-01-02-03
SIRONKO,BUDADIRI COUNTY WEST,BUKHULO,MAFUDU,BUNASHIMOLO CENTRE,405,1,2,5,120,144,272,2,274,0,O-51-129-01-03-01
SIRONKO,BUDADIRI COUNTY WEST,BUKHULO,MAFUDU,MAFUDU P.S. A,679,3,2,3,224,229,461,28,489,0,O-51-129-01-03-02
SIRONKO,BUDADIRI COUNTY WEST,BUKHULO,MPOGO,KADUWA P.S. A,118,1,0,0,39,11,51,1,52,0,O-51-129-01-04-01
SIRONKO,BUDADIRI COUNTY WEST,BUKHULO,MPOGO,MPOGO PS (A - M),720,5,1,2,236,154,398,68,466,0,O-51-129-01-04-02
SIRONKO,BUDADIRI COUNTY WEST,BUKHULO,MPOGO,MPOGO PS (N - Z),363,0,0,0,112,93,205,6,211,0,O-51-129-01-04-03
SIRONKO,BUDADIRI COUNTY WEST,BUKHULO,MPOGO,BUKHULO S.CTY HQTRS,340,2,0,3,81,99,185,18,203,0,O-51-129-01-04-04
SIRONKO,BUDADIRI COUNTY WEST,BUKHULO,SIRONKO,MAHEMPE C/U,607,3,5,1,189,174,372,24,396,0,O-51-129-01-05-01
SIRONKO,BUDADIRI COUNTY WEST,BUKHULO,SIRONKO,MAHEMPE P/SCH,413,3,1,4,181,87,276,12,288,0,O-51-129-01-05-02
SIRONKO,BUDADIRI COUNTY WEST,BUTEZA,BUGAMBI,BUGAMBI P.S. A,643,0,0,1,344,108,453,1,454,0,O-51-129-02-01-01
SIRONKO,BUDADIRI COUNTY WEST,BUTEZA,BUGAMBI,BUGAMBI P.S. B,808,1,1,0,392,148,542,6,548,0,O-51-129-02-01-02
SIRONKO,BUDADIRI COUNTY WEST,BUTEZA,BUGWIMBI,BUTEZA HEALTH CENTRE,626,2,0,3,222,198,425,18,443,0,O-51-129-02-02-01
SIRONKO,BUDADIRI COUNTY WEST,BUTEZA,BUGWIMBI,BUBBOLA P.S.,492,2,1,0,202,133,338,3,341,0,O-51-129-02-02-02
SIRONKO,BUDADIRI COUNTY WEST,BUTEZA,BUGWIMBI,BUGWIMBI CATHOLIC CHURCH,312,2,0,1,82,140,225,10,235,0,O-51-129-02-02-03
SIRONKO,BUDADIRI COUNTY WEST,BUTEZA,BUKAHENGERE,BUKAHENGERE PR. SCHOOL A,497,1,2,1,197,163,364,29,393,0,O-51-129-02-03-01
SIRONKO,BUDADIRI COUNTY WEST,BUTEZA,BUKAHENGERE,BUKAHENGERE PR. SCHOOL B,516,1,1,2,174,191,369,14,383,0,O-51-129-02-03-02
SIRONKO,BUDADIRI COUNTY WEST,BUTEZA,BUKIITI,BUMADIBIRA,794,1,0,0,395,119,515,0,515,0,O-51-129-02-04-01
SIRONKO,BUDADIRI COUNTY WEST,BUTEZA,BUKIITI,BUKIITI,654,1,1,1,342,94,439,9,448,0,O-51-129-02-04-02
SIRONKO,BUDADIRI COUNTY WEST,BUTEZA,BUMIRISA,BUMIRISA P.S.,665,2,1,2,252,233,490,11,501,0,O-51-129-02-05-01
SIRONKO,BUDADIRI COUNTY WEST,BUTEZA,BUMUKOHE,NAMADOGODA T/C A,643,4,1,0,219,125,349,17,366,0,O-51-129-02-06-01
SIRONKO,BUDADIRI COUNTY WEST,BUTEZA,BUMUKOHE,BUMUKONE P.S,455,6,1,2,196,154,359,4,363,0,O-51-129-02-06-02
SIRONKO,BUDADIRI COUNTY WEST,BUTEZA,BUMUKOHE,NAMADOGODA T/C B,642,2,0,2,203,118,325,4,329,0,O-51-129-02-06-03
SIRONKO,BUDADIRI COUNTY WEST,BUTEZA,BUMUKOHE,BUGIDYONYI CATHOLIC CHURCH,364,3,1,2,145,87,238,15,253,0,O-51-129-02-06-04
SIRONKO,BUDADIRI COUNTY WEST,BUTEZA,BUMUKOHE,BUTEZA G.C.S,281,1,1,0,126,102,230,5,235,0,O-51-129-02-06-05
SIRONKO,BUDADIRI COUNTY WEST,BUTEZA,BUNYAFA,BUNAZAMI,400,3,0,1,111,179,294,7,301,0,O-51-129-02-07-01
SIRONKO,BUDADIRI COUNTY WEST,BUTEZA,BUNYAFA,BUGALABI P/S,623,2,0,1,243,230,476,2,478,0,O-51-129-02-07-02
SIRONKO,BUDADIRI COUNTY WEST,BUTEZA,KIGULYA,MAGA-KIGUDYA,569,0,0,1,219,222,442,9,451,0,O-51-129-02-08-01
SIRONKO,BUDADIRI COUNTY WEST,BUTEZA,KIGULYA,BUNANDALO,462,0,0,1,206,116,323,11,334,0,O-51-129-02-08-02
SIRONKO,BUDADIRI COUNTY WEST,BUWALASI,BUBEZA,NAMBULU P.S,588,6,4,4,122,283,419,19,438,0,O-51-129-03-01-01
SIRONKO,BUDADIRI COUNTY WEST,BUWALASI,BUBEZA,BUNABUKA P.S,400,2,3,3,59,227,294,1,295,0,O-51-129-03-01-02
SIRONKO,BUDADIRI COUNTY WEST,BUWALASI,BUBEZA,BUBEZA G.C.S.,593,0,1,2,155,240,398,12,410,0,O-51-129-03-01-03
SIRONKO,BUDADIRI COUNTY WEST,BUWALASI,BUKIGALABO,BUKIGALABO G.C.S.,862,4,1,1,144,464,614,9,623,0,O-51-129-03-02-01
SIRONKO,BUDADIRI COUNTY WEST,BUWALASI,BUKIGALABO,KALASA,120,1,0,1,7,83,92,2,94,0,O-51-129-03-02-02
SIRONKO,BUDADIRI COUNTY WEST,BUWALASI,BUKIYI,MUKIYI G.C.S.,614,9,3,5,94,348,459,15,474,0,O-51-129-03-03-01
SIRONKO,BUDADIRI COUNTY WEST,BUWALASI,BUKIYI,NANGOMA T.C.,493,3,1,0,76,278,358,1,359,0,O-51-129-03-03-02
SIRONKO,BUDADIRI COUNTY WEST,BUWALASI,BUMAUSI,BUMAUSE P.S.,480,4,1,0,121,226,352,10,362,0,O-51-129-03-04-01
SIRONKO,BUDADIRI COUNTY WEST,BUWALASI,BUMAUSI,KISUMU,778,6,5,5,272,272,560,17,577,0,O-51-129-03-04-02
SIRONKO,BUDADIRI COUNTY WEST,BUWALASI,BUMUDU,BUMUDU P.S.,694,4,1,4,339,159,507,5,512,0,O-51-129-03-05-01
SIRONKO,BUDADIRI COUNTY WEST,BUWALASI,BUMUDU,BUSAMAGA P/S,330,1,1,3,183,121,309,14,323,0,O-51-129-03-05-02
SIRONKO,BUDADIRI COUNTY WEST,BUWALASI,BUSAMAGA,BUNAMBOZO,820,7,1,2,492,84,586,19,605,0,O-51-129-03-06-01
SIRONKO,BUDADIRI COUNTY WEST,BUWALASI,BUSAMAGA,BUSAMAGA S.S.,669,2,0,2,445,89,538,5,543,0,O-51-129-03-06-02
SIRONKO,BUDADIRI COUNTY WEST,BUWALASI,BUWAGI,BUMUGOTI,252,3,0,1,106,80,190,9,199,0,O-51-129-03-07-01
SIRONKO,BUDADIRI COUNTY WEST,BUWALASI,BUWAGI,KIDOWA T.C.,607,3,1,0,249,142,395,15,410,0,O-51-129-03-07-02
SIRONKO,BUDADIRI COUNTY WEST,BUWALASI,BUWAGI,BUKIRYA P.S.,648,6,2,2,211,237,458,40,498,0,O-51-129-03-07-03
SIRONKO,BUDADIRI COUNTY WEST,BUWALASI,BUYAYA,WAKINE T.C.,390,4,0,1,86,209,300,18,318,0,O-51-129-03-08-01
SIRONKO,BUDADIRI COUNTY WEST,BUWALASI,BUYAYA,BUKUMBALE G.C.S.,509,4,0,1,105,290,400,17,417,0,O-51-129-03-08-02
SIRONKO,BUDADIRI COUNTY WEST,BUWALASI,DAHAMI,BUKIYI P.S.,600,6,0,0,62,337,405,7,412,0,O-51-129-03-09-01
SIRONKO,BUDADIRI COUNTY WEST,BUWALASI,NABUDISIRU,SOOLA PR. SCHOOL,323,0,0,0,58,225,283,7,290,0,O-51-129-03-10-01
SIRONKO,BUDADIRI COUNTY WEST,BUWALASI,NABUDISIRU,NABUDISIRU,672,5,6,7,145,240,403,32,435,0,O-51-129-03-10-02
SIRONKO,BUDADIRI COUNTY WEST,BUWALASI,NAGUDI,BUWALASI S/C HQTRS,682,1,1,2,157,226,387,116,503,0,O-51-129-03-11-01
SIRONKO,BUDADIRI COUNTY WEST,BUWALASI,NAGUDI,NATUUGU,598,5,0,1,231,153,390,20,410,0,O-51-129-03-11-02
SIRONKO,BUDADIRI COUNTY WEST,BUWALASI,NAMPANGA,NAMPANGA D. A,287,1,0,0,90,98,189,4,193,0,O-51-129-03-12-01
SIRONKO,BUDADIRI COUNTY WEST,BUWALASI,NAMPANGA,KIWAGALO,458,3,2,0,127,125,257,6,263,0,O-51-129-03-12-02
SIRONKO,BUDADIRI COUNTY WEST,BUWALASI,NAMPANGA,NAMPANGA D.A. B,623,0,1,5,168,183,357,12,369,0,O-51-129-03-12-03
SIRONKO,BUDADIRI COUNTY WEST,BUYOBO,BUGWAGI,GWAGI G.C.S.,674,6,2,4,276,168,456,9,465,0,O-51-129-04-01-01
SIRONKO,BUDADIRI COUNTY WEST,BUYOBO,BUGWAGI,BUNABANDYA P.S.,592,4,1,0,400,166,571,14,585,0,O-51-129-04-01-02
SIRONKO,BUDADIRI COUNTY WEST,BUYOBO,BUGWAGI,BUMUTALE G/C/S,351,2,0,0,155,100,257,0,257,0,O-51-129-04-01-03
SIRONKO,BUDADIRI COUNTY WEST,BUYOBO,BUKIMENYA,BUNAHEMBE G.C.S. A,813,1,0,1,258,192,452,13,465,0,O-51-129-04-02-01
SIRONKO,BUDADIRI COUNTY WEST,BUYOBO,BUKIMENYA,BUNAHEMBE G.C.S. B,681,2,2,0,207,170,381,0,381,0,O-51-129-04-02-02
SIRONKO,BUDADIRI COUNTY WEST,BUYOBO,BULAMBULI,BUYOBO S/C HQRS,667,3,1,0,320,142,466,10,476,0,O-51-129-04-03-01
SIRONKO,BUDADIRI COUNTY WEST,BUYOBO,BULAMBULI,MUYOBO MULAMBULI G.C.S.,558,3,2,0,259,146,410,9,419,0,O-51-129-04-03-02
SIRONKO,BUDADIRI COUNTY WEST,BUYOBO,BULAMBULI,NAKIDEGA P.S.,786,2,1,3,209,341,556,19,575,0,O-51-129-04-03-03
SIRONKO,BUDADIRI COUNTY WEST,BUYOBO,BUSEDANI,BUMIRISA G.C.S. A,525,3,1,2,266,103,375,10,385,0,O-51-129-04-04-01
SIRONKO,BUDADIRI COUNTY WEST,BUYOBO,BUSEDANI,BUMIRISA G.C.S. B,358,1,0,0,155,90,246,7,253,0,O-51-129-04-04-02
SIRONKO,BUDADIRI COUNTY WEST,BUYOBO,BUSEDANI,BUKWAGA PR SCH,637,2,0,3,280,181,466,3,469,0,O-51-129-04-04-03
SIRONKO,BUDADIRI COUNTY WEST,BUYOBO,BUSEDANI,BUWERI T.C.,450,4,1,1,223,92,321,7,328,0,O-51-129-04-04-04
SIRONKO,BUDADIRI COUNTY WEST,BUYOBO,BUWASA,BUGUSEGE T.C.,727,3,4,4,373,125,509,6,515,0,O-51-129-04-05-01
SIRONKO,BUDADIRI COUNTY WEST,BUYOBO,BUWASA,BUGUNZU P.S.,763,4,1,2,399,127,533,8,541,0,O-51-129-04-05-02
SIRONKO,BUDADIRI COUNTY WEST,BUYOBO,BUWASA,BUWASA PR. SCHOOL,428,3,0,1,220,103,327,9,336,0,O-51-129-04-05-03
SIRONKO,BUDADIRI COUNTY WEST,BUYOBO,BUWASA,BWIKASA PR. SCH.,136,0,1,0,111,20,132,4,136,0,O-51-129-04-05-04
SIRONKO,BUDADIRI COUNTY WEST,SIRONKO T.C,CENTRAL WARD,SIRONKO P.S. A,759,2,1,1,248,198,450,6,456,0,O-51-129-05-01-01
SIRONKO,BUDADIRI COUNTY WEST,SIRONKO T.C,CENTRAL WARD,SIRONKO P.S. B,491,4,0,2,149,115,270,7,277,0,O-51-129-05-01-02
SIRONKO,BUDADIRI COUNTY WEST,SIRONKO T.C,INDUSTRIAL WARD,GINNERY A,589,3,0,3,158,191,355,11,366,0,O-51-129-05-02-01
SIRONKO,BUDADIRI COUNTY WEST,SIRONKO T.C,INDUSTRIAL WARD,GINNERY B,687,2,1,3,162,199,367,14,381,0,O-51-129-05-02-02
SIRONKO,BUDADIRI COUNTY WEST,SIRONKO T.C,INDUSTRIAL WARD,KIBIRA P/S,496,3,1,3,150,123,280,18,298,0,O-51-129-05-02-03
SIRONKO,BUDADIRI COUNTY WEST,SIRONKO T.C,INDUSTRIAL WARD,WETSENGE,303,0,0,0,88,99,187,5,192,0,O-51-129-05-02-04
SIRONKO,BUDADIRI COUNTY WEST,SIRONKO T.C,SOUTHERN WARD,NALUWALI,463,1,3,5,132,142,283,11,294,0,O-51-129-05-03-01
SIRONKO,BUDADIRI COUNTY WEST,SIRONKO T.C,SOUTHERN WARD,SALIKWA,479,3,0,0,129,133,265,18,283,0,O-51-129-05-03-02
SIRONKO,BUDADIRI COUNTY WEST,SIRONKO T.C,SOUTHERN WARD,BUNANIMI G.C.S. A,527,2,4,2,140,154,302,9,311,0,O-51-129-05-03-03
SIRONKO,BUDADIRI COUNTY WEST,SIRONKO T.C,SOUTHERN WARD,BUNANIMI G.C.S. B,329,2,1,2,97,90,192,4,196,0,O-51-129-05-03-04
SIRONKO,BUDADIRI COUNTY WEST,SIRONKO T.C,SOUTHERN WARD,BUKIENDE P.S.,645,3,2,0,258,183,446,22,468,0,O-51-129-05-03-05
KABERAMAIDO,KABERAMAIDO COUNTY,ALWA,ABALANG,ABALANGA P/SCH,558,9,2,10,301,81,403,15,418,0,O-54-200-01-01-01
KABERAMAIDO,KABERAMAIDO COUNTY,ALWA,ABALANG,ATINGI A,778,9,5,7,341,167,529,30,559,0,O-54-200-01-01-02
KABERAMAIDO,KABERAMAIDO COUNTY,ALWA,ABALANG,ATINGI B,725,13,8,10,334,132,497,38,535,0,O-54-200-01-01-03
KABERAMAIDO,KABERAMAIDO COUNTY,ALWA,ABALANG,OMINAI PRIM. SCHOOL,211,2,1,5,124,33,165,6,171,0,O-54-200-01-01-04
KABERAMAIDO,KABERAMAIDO COUNTY,ALWA,ORYAMO,AWILOLO CHURCH,755,11,7,7,442,105,572,13,585,0,O-54-200-01-02-01
KABERAMAIDO,KABERAMAIDO COUNTY,ALWA,ORYAMO,NAKUTUNYA MARKET,648,14,3,7,329,121,474,27,501,0,O-54-200-01-02-02
KABERAMAIDO,KABERAMAIDO COUNTY,ALWA,ORYAMO,ORIAMO P/SCH,577,6,6,6,326,91,435,24,459,0,O-54-200-01-02-03
KABERAMAIDO,KABERAMAIDO COUNTY,ALWA,PALATAU,ASAL BAR,341,6,6,1,193,75,281,11,292,0,O-54-200-01-03-01
KABERAMAIDO,KABERAMAIDO COUNTY,ALWA,PALATAU,BIRA CHURCH OF UG,535,8,3,5,262,145,423,11,434,0,O-54-200-01-03-02
KABERAMAIDO,KABERAMAIDO COUNTY,ALWA,PALATAU,BIRA P/SCH,436,5,3,6,273,47,334,16,350,0,O-54-200-01-03-03
KABERAMAIDO,KABERAMAIDO COUNTY,ALWA,PALATAU,OYUU BAR,444,11,6,6,228,105,356,13,369,0,O-54-200-01-03-04
KABERAMAIDO,KABERAMAIDO COUNTY,ALWA,PALATAU,TEETE P/S,124,0,1,0,62,28,91,5,96,0,O-54-200-01-03-05
KABERAMAIDO,KABERAMAIDO COUNTY,KABERAMAIDO,ACANPI,AMANAMANA,707,12,6,10,313,147,488,29,517,0,O-54-200-02-01-01
KABERAMAIDO,KABERAMAIDO COUNTY,KABERAMAIDO,ACANPI,ATURIGALIN,611,9,4,9,349,59,430,18,448,0,O-54-200-02-01-02
KABERAMAIDO,KABERAMAIDO COUNTY,KABERAMAIDO,ACANPI,OMWONY GLOBAL,387,4,3,0,251,54,312,3,315,0,O-54-200-02-01-03
KABERAMAIDO,KABERAMAIDO COUNTY,KABERAMAIDO,KABERAMAIDO,ALOOCWO BAR,482,3,9,1,246,110,369,11,380,0,O-54-200-02-02-01
KABERAMAIDO,KABERAMAIDO COUNTY,KABERAMAIDO,KABERAMAIDO,OYAMA,817,6,12,11,336,245,610,13,623,0,O-54-200-02-02-02
KABERAMAIDO,KABERAMAIDO COUNTY,KABERAMAIDO,KABERAMAIDO,ODOOT MARKET,257,4,2,4,105,69,184,12,196,0,O-54-200-02-02-03
KABERAMAIDO,KABERAMAIDO COUNTY,KABERAMAIDO,KAMUK,TEMELE,467,3,7,2,247,96,355,4,359,0,O-54-200-02-03-01
KABERAMAIDO,KABERAMAIDO COUNTY,KABERAMAIDO,KAMUK,ALIPA,467,1,2,4,263,66,336,19,355,0,O-54-200-02-03-02
KABERAMAIDO,KABERAMAIDO COUNTY,KABERAMAIDO,KAMUK,AMEJE,295,5,3,2,155,53,218,5,223,0,O-54-200-02-03-03
KABERAMAIDO,KABERAMAIDO COUNTY,KABERAMAIDO,KAMUK,KAMUK,465,8,1,2,283,56,350,18,368,0,O-54-200-02-03-04
KABERAMAIDO,KABERAMAIDO COUNTY,KABERAMAIDO,OKAPEL,ABIRABIRA (OKAPEL A),545,10,3,3,418,34,468,9,477,0,O-54-200-02-04-01
KABERAMAIDO,KABERAMAIDO COUNTY,KABERAMAIDO,OKAPEL,OKAPEL B,759,9,4,3,498,63,577,40,617,0,O-54-200-02-04-02
KABERAMAIDO,KABERAMAIDO COUNTY,KABERAMAIDO,OLELAI,ABANASOL,604,6,4,4,399,56,469,11,480,0,O-54-200-02-05-01
KABERAMAIDO,KABERAMAIDO COUNTY,KABERAMAIDO,OLELAI,AJIKAI,742,3,3,5,466,93,570,9,579,0,O-54-200-02-05-02
KABERAMAIDO,KABERAMAIDO COUNTY,KABERAMAIDO,OLELAI,ACONGWEN P/S,650,14,3,8,388,87,500,16,516,0,O-54-200-02-05-03
KABERAMAIDO,KABERAMAIDO COUNTY,KABERAMAIDO,OLELAI,ONYAIT P/S,466,4,0,5,242,108,359,10,369,0,O-54-200-02-05-04
KABERAMAIDO,KABERAMAIDO COUNTY,KABERAMAIDO T.C.,ALEM,HEADQUARTER,159,1,3,0,65,37,106,2,108,0,O-54-200-03-01-01
KABERAMAIDO,KABERAMAIDO COUNTY,KABERAMAIDO T.C.,ARARAK,ARARAK,696,4,17,2,214,143,380,10,390,0,O-54-200-03-02-01
KABERAMAIDO,KABERAMAIDO COUNTY,KABERAMAIDO T.C.,MAJENGO,MAJENGO,853,5,8,3,340,185,541,16,557,0,O-54-200-03-03-01
KABERAMAIDO,KABERAMAIDO COUNTY,KOBULUBULU,KABALKWERU,AKAROMUGENYA,442,10,4,13,237,71,335,17,352,0,O-54-200-04-01-01
KABERAMAIDO,KABERAMAIDO COUNTY,KOBULUBULU,KABALKWERU,KOBULUBULU COMMUNITY HALL,274,2,2,2,146,54,206,5,211,0,O-54-200-04-01-02
KABERAMAIDO,KABERAMAIDO COUNTY,KOBULUBULU,KABALKWERU,OGOBAI P/SCH,503,2,1,3,254,120,380,12,392,0,O-54-200-04-01-03
KABERAMAIDO,KABERAMAIDO COUNTY,KOBULUBULU,KABALKWERU,OTILL-OTAGE-ABONGORWOT,489,2,1,5,281,53,342,22,364,0,O-54-200-04-01-04
KABERAMAIDO,KABERAMAIDO COUNTY,KOBULUBULU,KATINGE,KATINGE A,767,10,8,3,498,70,589,7,596,0,O-54-200-04-02-01
KABERAMAIDO,KABERAMAIDO COUNTY,KOBULUBULU,KATINGE,KATINGE B,467,3,3,7,223,114,350,7,357,0,O-54-200-04-02-02
KABERAMAIDO,KABERAMAIDO COUNTY,KOBULUBULU,OGERAI,NACEMBWE,134,1,3,0,76,14,94,13,107,0,O-54-200-04-03-01
KABERAMAIDO,KABERAMAIDO COUNTY,KOBULUBULU,OGERAI,OGERAI,686,2,9,10,378,90,489,20,509,0,O-54-200-04-03-02
KABERAMAIDO,KABERAMAIDO COUNTY,KOBULUBULU,OKILE,OKILE A,413,5,4,4,229,54,296,11,307,0,O-54-200-04-04-01
KABERAMAIDO,KABERAMAIDO COUNTY,KOBULUBULU,OKILE,OKILE B,670,6,3,5,392,75,481,33,514,0,O-54-200-04-04-02
KABERAMAIDO,KABERAMAIDO COUNTY,KOBULUBULU,OKILE,AKADO P/SCHOOL,254,3,2,5,147,28,185,10,195,0,O-54-200-04-04-03
KABERAMAIDO,KABERAMAIDO COUNTY,OCHERO,ANYALAM,AMENYI,513,5,1,6,221,153,386,10,396,0,O-54-200-05-01-01
KABERAMAIDO,KABERAMAIDO COUNTY,OCHERO,ANYALAM,ANYALAM,523,5,2,5,323,61,396,14,410,0,O-54-200-05-01-02
KABERAMAIDO,KABERAMAIDO COUNTY,OCHERO,ANYALAM,OCANOYERE PRIMARY SCHOOL,341,3,1,4,245,10,263,16,279,0,O-54-200-05-01-03
KABERAMAIDO,KABERAMAIDO COUNTY,OCHERO,ANYALAM,ANYALAM P/S,420,3,3,3,292,40,341,7,348,0,O-54-200-05-01-04
KABERAMAIDO,KABERAMAIDO COUNTY,OCHERO,KAGAA,AWELU,820,7,8,1,554,55,625,27,652,0,O-54-200-05-02-01
KABERAMAIDO,KABERAMAIDO COUNTY,OCHERO,KAGAA,KAGAA,644,4,12,9,275,167,467,10,477,0,O-54-200-05-02-02
KABERAMAIDO,KABERAMAIDO COUNTY,OCHERO,KAGAA,ODEKERE PRIMARY SCHOOL,305,2,2,2,200,38,244,6,250,0,O-54-200-05-02-03
KABERAMAIDO,KABERAMAIDO COUNTY,OCHERO,SWAGERE,ACAMIDAKO P/SCHOOL,900,8,8,9,444,167,636,3,639,0,O-54-200-05-03-01
KABERAMAIDO,KABERAMAIDO COUNTY,OCHERO,SWAGERE,KABUREPOLI P/S,809,11,3,12,406,88,520,42,562,0,O-54-200-05-03-02
KABERAMAIDO,KABERAMAIDO COUNTY,OCHERO,SWAGERE,OKOLA P/SCHOOL,524,5,7,5,305,23,345,19,364,0,O-54-200-05-03-03
KABERAMAIDO,KABERAMAIDO COUNTY,OCHERO,SWAGERE,AKAMPALA LANDING,447,6,4,5,256,47,318,15,333,0,O-54-200-05-03-04
KABERAMAIDO,KALAKI COUNTY,ANYARA,ANYARA,ALOET,524,7,4,7,314,83,415,5,420,0,O-54-201-01-01-01
KABERAMAIDO,KALAKI COUNTY,ANYARA,ANYARA,ANYARA,566,8,3,3,308,95,417,10,427,0,O-54-201-01-01-02
KABERAMAIDO,KALAKI COUNTY,ANYARA,ANYARA,ARARAR,504,5,3,3,289,84,384,16,400,0,O-54-201-01-01-03
KABERAMAIDO,KALAKI COUNTY,ANYARA,ANYARA,ABILIMOJONG,357,13,3,4,234,41,295,13,308,0,O-54-201-01-01-04
KABERAMAIDO,KALAKI COUNTY,ANYARA,ANYARA,AGALIBU CHURCH,158,2,0,0,99,30,131,2,133,0,O-54-201-01-01-05
KABERAMAIDO,KALAKI COUNTY,ANYARA,ANYARA,ALITIMON,339,4,2,3,190,75,274,3,277,0,O-54-201-01-01-06
KABERAMAIDO,KALAKI COUNTY,ANYARA,OGWOLO,AKUM-AMORU-OPWOCET-ABWOL,512,6,2,2,341,17,368,17,385,0,O-54-201-01-02-01
KABERAMAIDO,KALAKI COUNTY,ANYARA,OGWOLO,AKUYA - AKALEN,404,4,3,0,273,43,323,12,335,0,O-54-201-01-02-02
KABERAMAIDO,KALAKI COUNTY,ANYARA,OGWOLO,ALERE-AKATAKWI-ONGOROMO,784,7,9,5,529,45,595,15,610,0,O-54-201-01-02-03
KABERAMAIDO,KALAKI COUNTY,ANYARA,OGWOLO,CORNER ABALANG,763,12,2,4,566,32,616,23,639,0,O-54-201-01-02-04
KABERAMAIDO,KALAKI COUNTY,ANYARA,OGWOLO,OPWOCET CHURCH,370,0,3,5,293,15,316,8,324,0,O-54-201-01-02-05
KABERAMAIDO,KALAKI COUNTY,ANYARA,OMID,IDAMAKAN,659,7,1,0,448,20,476,19,495,0,O-54-201-01-03-01
KABERAMAIDO,KALAKI COUNTY,ANYARA,OMID,OMID PRIMARY SCHOOL,456,3,1,4,331,13,352,11,363,0,O-54-201-01-03-02
KABERAMAIDO,KALAKI COUNTY,ANYARA,OMID,IMATOMUWA,542,10,6,5,373,48,442,9,451,0,O-54-201-01-03-03
KABERAMAIDO,KALAKI COUNTY,BULULU,KIBIMO,ETEKA TREE,619,11,6,7,383,66,473,4,477,0,O-54-201-02-01-01
KABERAMAIDO,KALAKI COUNTY,BULULU,KIBIMO,KIBIMBO P/SCH,680,6,16,9,406,72,509,14,523,0,O-54-201-02-01-02
KABERAMAIDO,KALAKI COUNTY,BULULU,KIBIMO,ALOMET PRIMARY SCHOOL,192,3,2,3,75,36,119,9,128,0,O-54-201-02-01-03
KABERAMAIDO,KALAKI COUNTY,BULULU,OBUR,ABOLA P/SCH,684,9,2,3,466,33,513,11,524,0,O-54-201-02-02-01
KABERAMAIDO,KALAKI COUNTY,BULULU,OBUR,SUB-COUNTY HTQRS,517,5,5,6,233,68,317,16,333,0,O-54-201-02-02-02
KABERAMAIDO,KALAKI COUNTY,BULULU,OBUR,OMIRIMIRI PRIMARY SCHOOL,621,6,2,11,396,53,468,19,487,0,O-54-201-02-02-03
KABERAMAIDO,KALAKI COUNTY,BULULU,OBUR,GOME,493,4,0,12,305,64,385,13,398,0,O-54-201-02-02-04
KABERAMAIDO,KALAKI COUNTY,BULULU,OCELAKUR,APWONAL T/CENTRE,566,5,10,5,393,45,458,11,469,0,O-54-201-02-03-01
KABERAMAIDO,KALAKI COUNTY,BULULU,OCELAKUR,IPENET P/SCH(A-EP),23,0,0,0,8,2,10,1,11,0,O-54-201-02-03-02
KABERAMAIDO,KALAKI COUNTY,BULULU,OCELAKUR,KACHILO P/SCH,914,5,2,5,586,100,698,25,723,0,O-54-201-02-03-03
KABERAMAIDO,KALAKI COUNTY,BULULU,OCELAKUR,OMODOI PRIMARY SCHOOL,434,3,4,2,275,53,337,13,350,0,O-54-201-02-03-04
KABERAMAIDO,KALAKI COUNTY,BULULU,OCELAKUR,OLEP,498,3,10,4,337,27,381,0,381,0,O-54-201-02-03-05
KABERAMAIDO,KALAKI COUNTY,KALAKI,KAKURE,AGULE - AKURA - OJELE,916,1,4,6,631,52,694,33,727,0,O-54-201-03-01-01
KABERAMAIDO,KALAKI COUNTY,KALAKI,KAKURE,KAKISIM - OGOLAI,780,11,9,15,531,44,610,20,630,0,O-54-201-03-01-02
KABERAMAIDO,KALAKI COUNTY,KALAKI,KAKURE,OGONGORA - OSUDO,788,13,8,9,563,48,641,22,663,0,O-54-201-03-01-03
KABERAMAIDO,KALAKI COUNTY,KALAKI,KAKURE,OYAMAI-OKAPEL,759,11,3,8,416,95,533,19,552,0,O-54-201-03-01-04
KABERAMAIDO,KALAKI COUNTY,KALAKI,KAKURE,APOKOR,293,2,0,3,192,40,237,4,241,0,O-54-201-03-01-05
KABERAMAIDO,KALAKI COUNTY,KALAKI,KALAKI,AJIDAK - AWASI,713,6,6,12,428,77,529,34,563,0,O-54-201-03-02-01
KABERAMAIDO,KALAKI COUNTY,KALAKI,KALAKI,KAKERE P/SCH,784,18,4,20,417,124,583,10,593,0,O-54-201-03-02-02
KABERAMAIDO,KALAKI COUNTY,KALAKI,KALAKI,OLYERAI CENTRAL,877,14,22,10,368,144,558,27,585,0,O-54-201-03-02-03
KABERAMAIDO,KALAKI COUNTY,KALAKI,KALAKI,ODINGOI PRIMARY SCHOOL,241,2,3,0,136,66,207,4,211,0,O-54-201-03-02-04
KABERAMAIDO,KALAKI COUNTY,KALAKI,KAMUDA,AKURAPENY,456,2,2,5,249,49,307,11,318,0,O-54-201-03-03-01
KABERAMAIDO,KALAKI COUNTY,KALAKI,KAMUDA,KADINYA P/SCH,894,14,6,13,460,128,621,29,650,0,O-54-201-03-03-02
KABERAMAIDO,KALAKI COUNTY,KALAKI,KAMUDA,KAKUYA P/SCH,845,10,14,20,376,145,565,29,594,0,O-54-201-03-03-03
KABERAMAIDO,KALAKI COUNTY,KALAKI,KAMUDA,KATITI P/S,399,2,3,6,245,50,306,17,323,0,O-54-201-03-03-04
KABERAMAIDO,KALAKI COUNTY,OTUBOI,AMORU,AMORU A,459,16,2,9,270,54,351,29,380,0,O-54-201-04-01-01
KABERAMAIDO,KALAKI COUNTY,OTUBOI,AMORU,AMORU B,296,5,5,0,183,24,217,11,228,0,O-54-201-04-01-02
KABERAMAIDO,KALAKI COUNTY,OTUBOI,AMORU,AMORU C,619,19,8,3,409,35,474,15,489,0,O-54-201-04-01-03
KABERAMAIDO,KALAKI COUNTY,OTUBOI,AMORU,OTUBOI S/C HQ'S,620,7,11,6,324,56,404,30,434,0,O-54-201-04-01-04
KABERAMAIDO,KALAKI COUNTY,OTUBOI,APAPAI,ABANGO,179,2,1,1,97,46,147,9,156,0,O-54-201-04-02-01
KABERAMAIDO,KALAKI COUNTY,OTUBOI,APAPAI,ADUDUL,674,6,4,3,457,81,551,9,560,0,O-54-201-04-02-02
KABERAMAIDO,KALAKI COUNTY,OTUBOI,APAPAI,OMUNYAL,474,6,3,13,254,109,385,8,393,0,O-54-201-04-02-03
KABERAMAIDO,KALAKI COUNTY,OTUBOI,APAPAI,OUSIA,676,4,1,5,415,84,509,8,517,0,O-54-201-04-02-04
KABERAMAIDO,KALAKI COUNTY,OTUBOI,KADIE,AMUKURAT A,285,5,5,4,134,96,244,7,251,0,O-54-201-04-03-01
KABERAMAIDO,KALAKI COUNTY,OTUBOI,KADIE,AMUKURAT B,635,12,1,8,411,79,511,19,530,0,O-54-201-04-03-02
KABERAMAIDO,KALAKI COUNTY,OTUBOI,KADIE,OTOLE CHURCH,308,9,3,4,163,74,253,4,257,0,O-54-201-04-03-03
KABERAMAIDO,KALAKI COUNTY,OTUBOI,LWALA,ADONGWERU PRI/SCH,621,4,9,4,306,145,468,10,478,0,O-54-201-04-04-01
KABERAMAIDO,KALAKI COUNTY,OTUBOI,LWALA,OCULOI SOCIETY,1097,8,9,12,665,70,764,22,786,0,O-54-201-04-04-02
KABERAMAIDO,KALAKI COUNTY,OTUBOI,LWALA,ACET-ANGOROM,848,4,12,15,402,186,619,19,638,0,O-54-201-04-04-03
KABERAMAIDO,KALAKI COUNTY,OTUBOI,LWALA,KOMOLO,176,4,1,2,35,101,143,12,155,0,O-54-201-04-04-04
KABERAMAIDO,KALAKI COUNTY,OTUBOI,OPILTOK,KABERIKOLE,496,11,2,5,346,43,407,12,419,0,O-54-201-04-05-01
KABERAMAIDO,KALAKI COUNTY,OTUBOI,OPILTOK,OPILITOK A,1168,15,23,14,511,140,703,28,731,0,O-54-201-04-05-02
KABERAMAIDO,KALAKI COUNTY,OTUBOI,OPILTOK,OPILITOK B,281,2,6,1,168,25,202,12,214,0,O-54-201-04-05-03
KABERAMAIDO,KALAKI COUNTY,OTUBOI,OPILTOK,OPILITOK C,695,8,9,16,424,98,555,13,568,0,O-54-201-04-05-04
AMURIA,AMURIA COUNTY,ABARILELA,DODOS,DODOS C.O.U,682,10,3,2,463,15,493,13,506,0,O-58-199-01-01-01
AMURIA,AMURIA COUNTY,ABARILELA,DODOS,DODOS B,731,11,4,6,445,52,518,19,537,0,O-58-199-01-01-02
AMURIA,AMURIA COUNTY,ABARILELA,DODOS,AKARE C.O.U,326,9,2,2,241,6,260,7,267,0,O-58-199-01-01-03
AMURIA,AMURIA COUNTY,ABARILELA,KATINE,AKAMURIE,581,10,1,8,174,177,370,56,426,0,O-58-199-01-02-01
AMURIA,AMURIA COUNTY,ABARILELA,KATINE,AKAMURIE P/SCH,986,17,4,16,566,105,708,37,745,0,O-58-199-01-02-02
AMURIA,AMURIA COUNTY,ABARILELA,OCAL,AGULE/OGILO,325,7,3,9,163,61,243,19,262,0,O-58-199-01-03-01
AMURIA,AMURIA COUNTY,ABARILELA,OCAL,AGULE CATHOLIC CHURCH,458,4,6,10,108,175,303,12,315,0,O-58-199-01-03-02
AMURIA,AMURIA COUNTY,ABARILELA,OCAL,OCAL,412,4,1,4,161,156,326,8,334,0,O-58-199-01-03-03
AMURIA,AMURIA COUNTY,ABARILELA,OLELAI,OLELAI A,751,18,5,18,420,96,557,11,568,0,O-58-199-01-04-01
AMURIA,AMURIA COUNTY,ABARILELA,OLELAI,ONGUTOI C/U,813,17,2,11,519,49,598,10,608,0,O-58-199-01-04-02
AMURIA,AMURIA COUNTY,AMURIA TOWN COUNCIL,AKISIM,KUJU A,188,3,1,2,77,24,107,6,113,0,O-58-199-02-01-01
AMURIA,AMURIA COUNTY,AMURIA TOWN COUNCIL,ALIRA,AMURIA H.C,511,1,2,2,201,73,279,10,289,0,O-58-199-02-02-01
AMURIA,AMURIA COUNTY,AMURIA TOWN COUNCIL,AMURIA TOWNSHIP,AMURIA TOWN SHIP,1151,7,4,15,369,139,534,21,555,0,O-58-199-02-03-01
AMURIA,AMURIA COUNTY,AMURIA TOWN COUNCIL,OKUTOI,KUJU C,171,0,0,1,75,38,114,6,120,0,O-58-199-02-04-01
AMURIA,AMURIA COUNTY,ASAMUK,AJAKI,OGOLOKWARA A,480,5,5,2,244,35,291,12,303,0,O-58-199-03-01-01
AMURIA,AMURIA COUNTY,ASAMUK,AJAKI,OGOLOKWARA B,541,5,3,4,326,34,372,10,382,0,O-58-199-03-01-02
AMURIA,AMURIA COUNTY,ASAMUK,AJAKI,OGOLOKWARA C,597,2,6,1,382,43,434,11,445,0,O-58-199-03-01-03
AMURIA,AMURIA COUNTY,ASAMUK,AMUCU,AMUCU B - DOKOLO - AMASUK P/,644,6,4,3,464,18,495,8,503,0,O-58-199-03-02-01
AMURIA,AMURIA COUNTY,ASAMUK,AMUCU,ONGINO L/C - AMUCU A,613,8,0,6,274,156,444,15,459,0,O-58-199-03-02-02
AMURIA,AMURIA COUNTY,ASAMUK,ASAMUK,ASAMUK APARISA P/S,441,5,0,2,322,21,350,6,356,0,O-58-199-03-03-01
AMURIA,AMURIA COUNTY,ASAMUK,ASAMUK,ASAMUK BARRACKS(OUTSIDE Q-,326,2,4,1,161,34,202,6,208,0,O-58-199-03-03-02
AMURIA,AMURIA COUNTY,ASAMUK,ASAMUK,ASAMUK HQRS,507,6,3,6,289,50,354,9,363,0,O-58-199-03-03-03
AMURIA,AMURIA COUNTY,ASAMUK,ASAMUK,ASAMUK OKWALO P/S,376,3,0,1,266,10,280,12,292,0,O-58-199-03-03-04
AMURIA,AMURIA COUNTY,ASAMUK,ATIRIR,ATIRIR B,387,4,5,1,274,18,302,9,311,0,O-58-199-03-04-01
AMURIA,AMURIA COUNTY,ASAMUK,ATIRIR,MALISA A,449,4,1,1,342,8,356,24,380,0,O-58-199-03-04-02
AMURIA,AMURIA COUNTY,ASAMUK,ATIRIR,OLEKAI P/S B,504,6,3,4,375,14,402,8,410,0,O-58-199-03-04-03
AMURIA,AMURIA COUNTY,ASAMUK,OBUR,OBUR A,263,2,0,0,196,5,203,14,217,0,O-58-199-03-05-01
AMURIA,AMURIA COUNTY,ASAMUK,OBUR,OBUR A ATUBAKINEI,818,20,4,4,589,21,638,16,654,0,O-58-199-03-05-02
AMURIA,AMURIA COUNTY,ASAMUK,OBUR,OBUR P/S B,429,8,4,7,290,24,333,11,344,0,O-58-199-03-05-03
AMURIA,AMURIA COUNTY,ASAMUK,ODOON,ODOON P/S A,375,4,0,9,227,43,283,10,293,0,O-58-199-03-06-01
AMURIA,AMURIA COUNTY,ASAMUK,ODOON,ODOON P/S B,503,7,3,3,311,70,394,7,401,0,O-58-199-03-06-02
AMURIA,AMURIA COUNTY,ASAMUK,ODOON,OMARIAI B,346,4,2,2,160,99,267,13,280,0,O-58-199-03-06-03
AMURIA,AMURIA COUNTY,KUJU,ABIA,ABIA P/S,714,7,4,4,440,36,491,28,519,0,O-58-199-04-01-01
AMURIA,AMURIA COUNTY,KUJU,ABIA,AGWARA P/S,651,11,2,4,409,30,456,30,486,0,O-58-199-04-01-02
AMURIA,AMURIA COUNTY,KUJU,ALERE,ABOTA P/S,589,10,1,4,289,26,330,16,346,0,O-58-199-04-02-01
AMURIA,AMURIA COUNTY,KUJU,ALERE,ALERE P/S,642,13,1,4,345,27,390,0,390,0,O-58-199-04-02-02
AMURIA,AMURIA COUNTY,KUJU,AMILMIL,AMILMIL A,530,9,3,8,194,181,395,18,413,0,O-58-199-04-03-01
AMURIA,AMURIA COUNTY,KUJU,AMILMIL,AMILMIL B,297,3,2,3,114,76,198,22,220,0,O-58-199-04-03-02
AMURIA,AMURIA COUNTY,KUJU,AMILMIL,EGANG-IKERAI,318,3,1,5,152,52,213,7,220,0,O-58-199-04-03-03
AMURIA,AMURIA COUNTY,KUJU,AMUSUS,AMUSUS P/S,408,11,0,5,243,31,290,10,300,0,O-58-199-04-04-01
AMURIA,AMURIA COUNTY,KUJU,AMUSUS,AOJAKITOI P/S,422,2,4,3,217,49,275,8,283,0,O-58-199-04-04-02
AMURIA,AMURIA COUNTY,KUJU,AMUSUS,ORIETA T/C,417,7,2,5,183,92,289,9,298,0,O-58-199-04-04-03
AMURIA,AMURIA COUNTY,KUJU,KUJU,ANGOROM P/S,502,14,0,6,231,95,346,10,356,0,O-58-199-04-05-01
AMURIA,AMURIA COUNTY,KUJU,KUJU,KUJU B,245,3,3,1,116,35,158,2,160,0,O-58-199-04-05-02
AMURIA,AMURIA COUNTY,KUJU,WILA,WILLA A ATUKUTUK,710,14,2,4,386,80,486,30,516,0,O-58-199-04-06-01
AMURIA,AMURIA COUNTY,KUJU,WILA,WILLA B AKISIM-KUJU P/S,326,6,2,3,206,30,247,10,257,0,O-58-199-04-06-02
AMURIA,AMURIA COUNTY,MORUNGATUNY,ABEKO,ARUTE,868,6,5,11,528,32,582,7,589,0,O-58-199-05-01-01
AMURIA,AMURIA COUNTY,MORUNGATUNY,MORUNGATUNY,ODEKERE PRI SCHOOL (B-Z),491,6,0,3,259,52,320,15,335,0,O-58-199-05-02-01
AMURIA,AMURIA COUNTY,MORUNGATUNY,MORUNGATUNY,ODEKERE PRI SCHOOL (A-A),596,18,4,15,322,51,410,22,432,0,O-58-199-05-02-02
AMURIA,AMURIA COUNTY,MORUNGATUNY,MORUNGATUNY,MORUNGATUNY C,579,9,2,7,308,31,357,0,357,0,O-58-199-05-02-03
AMURIA,AMURIA COUNTY,MORUNGATUNY,OCOCIA,OCHOCIA A,908,17,4,9,474,102,606,17,623,0,O-58-199-05-03-01
AMURIA,AMURIA COUNTY,MORUNGATUNY,OCOCIA,OCHOCIA B,527,7,4,4,254,62,331,19,350,0,O-58-199-05-03-02
AMURIA,AMURIA COUNTY,MORUNGATUNY,OCOCIA,AKORE PRI SCHOOL,211,3,1,1,116,19,140,7,147,0,O-58-199-05-03-03
AMURIA,AMURIA COUNTY,MORUNGATUNY,OGANGAI,MORUNGATUNY A,905,13,4,17,488,125,647,20,667,0,O-58-199-05-04-01
AMURIA,AMURIA COUNTY,MORUNGATUNY,OGOLAI,ODEPE C..O.U,340,4,3,2,178,39,226,17,243,0,O-58-199-05-05-01
AMURIA,AMURIA COUNTY,MORUNGATUNY,OGOLAI,OGOLAI,771,12,5,7,390,79,493,30,523,0,O-58-199-05-05-02
AMURIA,AMURIA COUNTY,MORUNGATUNY,OLWA/OLUSA,OLWA A,889,18,11,11,443,48,531,17,548,0,O-58-199-05-06-01
AMURIA,AMURIA COUNTY,MORUNGATUNY,OLWA/OLUSA,OLWA B,735,16,2,5,306,15,344,13,357,0,O-58-199-05-06-02
AMURIA,AMURIA COUNTY,ORUNGO,AKERIAU,AKERIAU A,567,14,2,4,368,30,418,28,446,0,O-58-199-06-01-01
AMURIA,AMURIA COUNTY,ORUNGO,AKERIAU,AKERIAU B,649,15,6,6,434,31,492,14,506,0,O-58-199-06-01-02
AMURIA,AMURIA COUNTY,ORUNGO,MORUINERA,MORUINERA A,568,6,1,9,350,52,418,26,444,0,O-58-199-06-02-01
AMURIA,AMURIA COUNTY,ORUNGO,MORUINERA,MORUINERA B,408,4,1,2,261,15,283,18,301,0,O-58-199-06-02-02
AMURIA,AMURIA COUNTY,ORUNGO,OGONGORA,OYAMAI PRI SCHOOL,519,6,4,3,339,34,386,20,406,0,O-58-199-06-03-01
AMURIA,AMURIA COUNTY,ORUNGO,OGONGORA,APAASI,522,9,0,3,371,37,420,12,432,0,O-58-199-06-03-02
AMURIA,AMURIA COUNTY,ORUNGO,OKUDE,OKUDE A,856,18,6,12,551,103,690,15,705,0,O-58-199-06-04-01
AMURIA,AMURIA COUNTY,ORUNGO,OKUDE,OKUDE B,653,6,8,1,444,17,476,8,484,0,O-58-199-06-04-02
AMURIA,AMURIA COUNTY,ORUNGO,ORUNGO,ORUNGO TOWNSHIP,619,3,9,2,290,80,384,20,404,0,O-58-199-06-05-01
AMURIA,AMURIA COUNTY,ORUNGO,ORUNGO,ORIEBAI PRI SCHOOL,375,7,1,3,246,21,278,4,282,0,O-58-199-06-05-02
AMURIA,AMURIA COUNTY,ORUNGO,ORUNGO,OPOI,426,9,2,2,257,25,295,5,300,0,O-58-199-06-05-03
AMURIA,AMURIA COUNTY,ORUNGO,ORUNGO,ORUNGO PRI. SCHOOL,692,6,3,2,391,22,424,20,444,0,O-58-199-06-05-04
AMURIA,AMURIA COUNTY,WERA,AMOLO,AMOLO,847,11,0,8,513,52,584,26,610,0,O-58-199-07-01-01
AMURIA,AMURIA COUNTY,WERA,ANGOLE,AJOTA P/S,435,9,1,3,282,41,336,12,348,0,O-58-199-07-02-01
AMURIA,AMURIA COUNTY,WERA,ANGOLE,ATEN P/S,494,6,3,9,262,92,372,22,394,0,O-58-199-07-02-02
AMURIA,AMURIA COUNTY,WERA,ANGOLE,ANGOLE B,308,4,1,2,205,17,229,11,240,0,O-58-199-07-02-03
AMURIA,AMURIA COUNTY,WERA,ANGOLE,ANGOLE C,247,3,3,3,141,35,185,4,189,0,O-58-199-07-02-04
AMURIA,AMURIA COUNTY,WERA,ANGOLE,ANGOLE P/S,280,1,2,1,167,12,183,9,192,0,O-58-199-07-02-05
AMURIA,AMURIA COUNTY,WERA,ANGOLE,ANGOLE A,403,9,1,1,271,31,313,4,317,0,O-58-199-07-02-06
AMURIA,AMURIA COUNTY,WERA,SUGUR,AMUKURAT B,843,15,8,8,525,20,576,38,614,0,O-58-199-07-03-01
AMURIA,AMURIA COUNTY,WERA,SUGUR,KENGERE,815,27,6,13,509,20,575,55,630,0,O-58-199-07-03-02
AMURIA,AMURIA COUNTY,WERA,WERA,OLIANAI P/S,485,14,7,7,281,48,357,21,378,0,O-58-199-07-04-01
AMURIA,AMURIA COUNTY,WERA,WERA,WERA A,278,4,5,4,145,45,203,6,209,0,O-58-199-07-04-02
AMURIA,AMURIA COUNTY,WERA,WERA,WERA B,363,9,2,1,256,25,293,15,308,0,O-58-199-07-04-03
AMURIA,AMURIA COUNTY,WERA,WERA,WERA P/S,374,9,6,3,219,43,280,7,287,0,O-58-199-07-04-04
BUKWO,KONGASIS COUNTY,BUKWA,AMANANG,CHEBIRBEI,353,0,0,1,14,266,281,7,288,0,O-59-74-01-01-01
BUKWO,KONGASIS COUNTY,BUKWA,AMANANG,KAPCHEBAI,337,1,0,0,34,260,295,9,304,0,O-59-74-01-01-02
BUKWO,KONGASIS COUNTY,BUKWA,AMANANG,KUBULWO,455,3,1,3,28,354,389,2,391,0,O-59-74-01-01-03
BUKWO,KONGASIS COUNTY,BUKWA,AMANANG,SHOSHO,287,1,1,0,18,233,253,4,257,0,O-59-74-01-01-04
BUKWO,KONGASIS COUNTY,BUKWA,CHEKWASTA,KWEEN,352,2,0,2,26,213,243,10,253,0,O-59-74-01-02-01
BUKWO,KONGASIS COUNTY,BUKWA,CHEKWASTA,CHEMUGUN,232,1,0,1,7,171,180,10,190,0,O-59-74-01-02-02
BUKWO,KONGASIS COUNTY,BUKWA,KIRETEI,CHEMWEYET,505,3,0,1,32,288,324,36,360,0,O-59-74-01-03-01
BUKWO,KONGASIS COUNTY,BUKWA,KIRETEI,CHEPKUTO P/S,533,1,0,1,25,398,425,12,437,0,O-59-74-01-03-02
BUKWO,KONGASIS COUNTY,BUKWA,MUIMET,CHEBINYINY,760,7,1,3,45,515,571,40,611,0,O-59-74-01-04-01
BUKWO,KONGASIS COUNTY,BUKWA,MUIMET,TOWN VILLAGE,548,2,0,3,47,315,367,9,376,0,O-59-74-01-04-02
BUKWO,KONGASIS COUNTY,BUKWA,MUIMET,KAPKOROSOI,504,1,1,1,23,366,392,16,408,0,O-59-74-01-04-03
BUKWO,KONGASIS COUNTY,CHESOWER,KAMET,BOROWON,386,2,0,0,4,320,326,4,330,0,O-59-74-02-01-01
BUKWO,KONGASIS COUNTY,CHESOWER,KAMET,KAPKUMOLON,508,2,2,6,7,407,424,7,431,0,O-59-74-02-01-02
BUKWO,KONGASIS COUNTY,CHESOWER,KAMET,MOSON,277,0,0,0,5,237,242,6,248,0,O-59-74-02-01-03
BUKWO,KONGASIS COUNTY,CHESOWER,NYALIT,MERE,615,3,1,0,70,373,447,19,466,0,O-59-74-02-02-01
BUKWO,KONGASIS COUNTY,CHESOWER,NYALIT,MOLOL,684,6,0,5,112,388,511,23,534,0,O-59-74-02-02-02
BUKWO,KONGASIS COUNTY,CHESOWER,NYALIT,NYALIT,672,9,0,3,38,451,501,10,511,0,O-59-74-02-02-03
BUKWO,KONGASIS COUNTY,CHESOWER,NYALIT,KAPSIYWO P/S,331,5,0,3,18,250,276,12,288,0,O-59-74-02-02-04
BUKWO,KONGASIS COUNTY,CHESOWER,TULEL,CHEMURON,515,1,1,0,12,425,439,21,460,0,O-59-74-02-03-01
BUKWO,KONGASIS COUNTY,CHESOWER,TULEL,KOIKOI,359,2,1,0,16,283,302,9,311,0,O-59-74-02-03-02
BUKWO,KONGASIS COUNTY,CHESOWER,TULEL,TULEL,502,3,1,2,17,379,402,6,408,0,O-59-74-02-03-03
BUKWO,KONGASIS COUNTY,KABEI,KORTEK,CHESIMAT,679,5,1,5,75,342,428,15,443,0,O-59-74-03-01-01
BUKWO,KONGASIS COUNTY,KABEI,KORTEK,KAPSES,333,1,0,2,13,247,263,10,273,0,O-59-74-03-01-02
BUKWO,KONGASIS COUNTY,KABEI,KORTEK,KUBOBEI,403,3,5,4,22,251,285,21,306,0,O-59-74-03-01-03
BUKWO,KONGASIS COUNTY,KABEI,MOKOYON,KABASKEN,263,1,0,1,5,209,216,7,223,0,O-59-74-03-02-01
BUKWO,KONGASIS COUNTY,KABEI,MOKOYON,MOKOYON,460,1,0,2,43,319,365,11,376,0,O-59-74-03-02-02
BUKWO,KONGASIS COUNTY,KABEI,MOKOYON,ROROK,394,4,0,1,8,277,290,6,296,0,O-59-74-03-02-03
BUKWO,KONGASIS COUNTY,KABEI,MUTUSHET,KAPTERIT,517,0,0,1,5,362,368,1,369,0,O-59-74-03-03-01
BUKWO,KONGASIS COUNTY,KABEI,MUTUSHET,KITAW,544,2,0,0,12,451,465,7,472,0,O-59-74-03-03-02
BUKWO,KONGASIS COUNTY,KABEI,MUTUSHET,NYALYIT,290,1,0,1,14,223,239,14,253,0,O-59-74-03-03-03
BUKWO,KONGASIS COUNTY,KABEI,RIWO,KAPKWARE,540,3,0,5,15,323,346,14,360,0,O-59-74-03-04-01
BUKWO,KONGASIS COUNTY,KABEI,RIWO,SHAMBABEL,582,2,0,1,5,430,438,4,442,0,O-59-74-03-04-02
BUKWO,KONGASIS COUNTY,SUAM,KAPTERERWA,CHEBINYINY,633,3,1,5,27,370,406,12,418,0,O-59-74-04-01-01
BUKWO,KONGASIS COUNTY,SUAM,KAPTERERWA,KAPNANDI UPPER,627,1,1,0,8,380,390,10,400,0,O-59-74-04-01-02
BUKWO,KONGASIS COUNTY,SUAM,KAPTERERWA,KAPTAL,625,3,3,10,11,388,415,18,433,0,O-59-74-04-01-03
BUKWO,KONGASIS COUNTY,SUAM,KAPTERERWA,KAPKOLOSWO,380,0,3,2,9,269,283,20,303,0,O-59-74-04-01-04
BUKWO,KONGASIS COUNTY,SUAM,KAPTERERWA,KAPNANDI LOWER,442,2,1,2,20,293,318,8,326,0,O-59-74-04-01-05
BUKWO,KONGASIS COUNTY,SUAM,KWIRWOT,KAPKOBOR 'A',679,4,0,2,74,284,364,19,383,0,O-59-74-04-02-01
BUKWO,KONGASIS COUNTY,SUAM,KWIRWOT,KAPKOBOR 'B' (A-Z),561,1,0,0,59,237,297,4,301,0,O-59-74-04-02-02
BUKWO,KONGASIS COUNTY,SUAM,KWIRWOT,KURONGUR,674,0,0,0,53,305,358,7,365,0,O-59-74-04-02-03
BUKWO,KONGASIS COUNTY,SUAM,KWIRWOT,KAPKWENO,447,2,0,1,25,264,292,10,302,0,O-59-74-04-02-04
BUKWO,KONGASIS COUNTY,SUAM,KWIRWOT,MATIMBEI,691,1,1,1,10,425,438,66,504,0,O-59-74-04-02-05
BUKWO,KONGASIS COUNTY,SUAM,KWIRWOT,KWIRWOT,318,1,1,1,19,185,207,5,212,0,O-59-74-04-02-06
BUKWO,KONGASIS COUNTY,SUAM,KWIRWOT,KULULU,271,2,1,0,24,200,227,8,235,0,O-59-74-04-02-07
BUKWO,KONGASIS COUNTY,SUAM,KWIRWOT,KAPCHUNIAY,182,1,1,0,26,104,132,4,136,0,O-59-74-04-02-08
BUKWO,KONGASIS COUNTY,SUAM,KWIRWOT,KAPKOBOR 'B' (N-Z),391,1,0,0,23,152,176,11,187,0,O-59-74-04-02-09
BUKWO,KONGASIS COUNTY,SUAM,SINENDET,CHEMWABIT,660,6,2,6,13,503,530,12,542,0,O-59-74-04-03-01
BUKWO,KONGASIS COUNTY,SUAM,SINENDET,KAPKOROS,649,3,3,1,36,453,496,11,507,0,O-59-74-04-03-02
BUKWO,KONGASIS COUNTY,SUAM,SINENDET,REBERON,504,5,2,0,19,395,421,14,435,0,O-59-74-04-03-03
BUKWO,KONGASIS COUNTY,SUAM,SINENDET,KAPROBEN,282,0,0,1,3,212,216,2,218,0,O-59-74-04-03-04
BUKWO,KONGASIS COUNTY,SUAM,SINENDET,SINENDET,189,0,0,0,12,120,132,18,150,0,O-59-74-04-03-05
BUTALEJA,BUNYOLE COUNTY,BUDUMBA,BUDUMBA,BUDUMBA GSC,564,6,9,2,168,186,371,11,382,0,O-60-208-01-01-01
BUTALEJA,BUNYOLE COUNTY,BUDUMBA,BUDUMBA,BUDUMBA P/S II,464,2,7,8,97,217,331,18,349,0,O-60-208-01-01-02
BUTALEJA,BUNYOLE COUNTY,BUDUMBA,BUDUSU,BUDUSU PRIMARY SCHOOL,639,2,8,2,115,306,433,13,446,0,O-60-208-01-02-01
BUTALEJA,BUNYOLE COUNTY,BUDUMBA,BUDUSU,BUYANGA T. C.,449,5,4,9,78,241,337,13,350,0,O-60-208-01-02-02
BUTALEJA,BUNYOLE COUNTY,BUDUMBA,BUDUSU,KAMOCHA-MADALASA P/S,534,1,5,4,113,237,360,12,372,0,O-60-208-01-02-03
BUTALEJA,BUNYOLE COUNTY,BUDUMBA,BUGEGEGE,BUGEGEGE PRIMARY SCHOOL,489,5,10,1,158,204,378,12,390,0,O-60-208-01-03-01
BUTALEJA,BUNYOLE COUNTY,BUDUMBA,BUGEGEGE,MAGOJE PRIMARY SCHOOL,337,4,13,0,138,85,240,13,253,0,O-60-208-01-03-02
BUTALEJA,BUNYOLE COUNTY,BUDUMBA,BUGEGEGE,NAMANDA PRIMARY SCHOOL,398,4,0,4,137,169,314,12,326,0,O-60-208-01-03-03
BUTALEJA,BUNYOLE COUNTY,BUDUMBA,BUNAWALE,BULINDA CHURCH OF UGANDA,460,3,20,2,137,188,350,3,353,0,O-60-208-01-04-01
BUTALEJA,BUNYOLE COUNTY,BUDUMBA,BUNAWALE,BUNAWALE PRIMARY SCHOOL A,582,3,11,6,97,276,393,16,409,0,O-60-208-01-04-02
BUTALEJA,BUNYOLE COUNTY,BUDUMBA,BUNAWALE,"BUNAWALE PRIMARY SCHOOL ""B""",385,6,9,6,95,178,294,3,297,0,O-60-208-01-04-03
BUTALEJA,BUNYOLE COUNTY,BUDUMBA,BUSABI,BUBAALI TRADING CENTRE,747,4,19,5,214,259,501,13,514,0,O-60-208-01-05-01
BUTALEJA,BUNYOLE COUNTY,BUDUMBA,BUSABI,BUSABI PRIMARY SCHOOL,658,3,17,4,221,238,483,9,492,0,O-60-208-01-05-02
BUTALEJA,BUNYOLE COUNTY,BUDUMBA,BUWESA,BUGANGU PRIMARY SCHOOL,318,4,1,4,134,99,242,19,261,0,O-60-208-01-06-01
BUTALEJA,BUNYOLE COUNTY,BUDUMBA,BUWESA,BUWESA PRIMARY SCHOOL,509,6,14,8,138,147,313,27,340,0,O-60-208-01-06-02
BUTALEJA,BUNYOLE COUNTY,BUDUMBA,BUWESA,MALANGHA PRIMARY SCHOOL,712,13,11,11,253,249,537,13,550,0,O-60-208-01-06-03
BUTALEJA,BUNYOLE COUNTY,BUDUMBA,HABIGA,HABIGA PRIMARY SCHOOL,628,2,19,3,206,253,483,2,485,0,O-60-208-01-07-01
BUTALEJA,BUNYOLE COUNTY,BUDUMBA,MABALE,NDALILA TRADING CENTRE,128,0,5,0,27,57,89,1,90,0,O-60-208-01-08-01
BUTALEJA,BUNYOLE COUNTY,BUDUMBA,MABALE,BUNGHANGA C.O.U,359,8,6,5,90,132,241,12,253,0,O-60-208-01-08-02
BUTALEJA,BUNYOLE COUNTY,BUDUMBA,MABALE,BUDUMBA S/COUNTY HQRS,792,11,22,4,136,308,481,16,497,0,O-60-208-01-08-03
BUTALEJA,BUNYOLE COUNTY,BUDUMBA,MABALE,BUNGHANGA TRADING CENTRE,589,1,16,3,145,242,407,7,414,0,O-60-208-01-08-04
BUTALEJA,BUNYOLE COUNTY,BUDUMBA,MANYAMYE,MANYAMYE PRIMARY SCHOOL,653,8,9,6,178,216,417,17,434,0,O-60-208-01-09-01
BUTALEJA,BUNYOLE COUNTY,BUDUMBA,MASANGHE,MASANGHE P/S,729,6,12,7,288,188,501,5,506,0,O-60-208-01-10-01
BUTALEJA,BUNYOLE COUNTY,BUSABA,BUSABA,BUBUHE PRIMARY SCHOOL,631,7,11,5,152,362,537,13,550,0,O-60-208-02-01-01
BUTALEJA,BUNYOLE COUNTY,BUSABA,BUSABA,BUDOBA PRIMARY SCHOOL,413,7,2,4,92,182,287,14,301,0,O-60-208-02-01-02
BUTALEJA,BUNYOLE COUNTY,BUSABA,BUSABA,BUGOSA GROWERS SOCIETY,460,4,28,3,120,145,300,0,300,0,O-60-208-02-01-03
BUTALEJA,BUNYOLE COUNTY,BUSABA,BUSABA,BUGWERA PRIMARY SCHOOL,678,7,16,3,115,349,490,6,496,0,O-60-208-02-01-04
BUTALEJA,BUNYOLE COUNTY,BUSABA,BUSABA,BUSABA SUB/COUNTY HQRTS,637,4,5,2,109,308,428,8,436,0,O-60-208-02-01-05
BUTALEJA,BUNYOLE COUNTY,BUSABA,BUSABA,MULANGA TRADING CENTRE,556,2,62,1,128,347,540,8,548,0,O-60-208-02-01-06
BUTALEJA,BUNYOLE COUNTY,BUSABA,BUSABA,NAHAGULU,344,3,8,4,115,81,211,4,215,0,O-60-208-02-01-07
BUTALEJA,BUNYOLE COUNTY,BUSABA,MULAGI,BUMWAMI,658,7,10,4,109,246,376,8,384,0,O-60-208-02-02-01
BUTALEJA,BUNYOLE COUNTY,BUSABA,MULAGI,MULAGI,671,5,6,3,106,265,385,12,397,0,O-60-208-02-02-02
BUTALEJA,BUNYOLE COUNTY,BUSABA,MULAGI,BUWIHULA,371,4,14,0,116,90,224,3,227,0,O-60-208-02-02-03
BUTALEJA,BUNYOLE COUNTY,BUSABA,MULAGI,LUDODO,579,10,12,5,191,149,367,11,378,0,O-60-208-02-02-04
BUTALEJA,BUNYOLE COUNTY,BUSABA,MULAGI,MUSITU,469,2,6,3,157,156,324,12,336,0,O-60-208-02-02-05
BUTALEJA,BUNYOLE COUNTY,BUSABA,MULAGI,LWAMBOGA T/C,275,1,16,1,88,71,177,7,184,0,O-60-208-02-02-06
BUTALEJA,BUNYOLE COUNTY,BUSOLWE,BUBALYA,BUKABEBA PRIMARY SCHOOL,385,1,3,0,132,112,248,12,260,0,O-60-208-03-01-01
BUTALEJA,BUNYOLE COUNTY,BUSOLWE,BUBALYA,BUSOLWE RAILWAY STATION,462,4,5,5,132,157,303,7,310,0,O-60-208-03-01-02
BUTALEJA,BUNYOLE COUNTY,BUSOLWE,BUBALYA,BUBALYA PRIMARY SCHOOL,677,9,14,4,257,137,421,23,444,0,O-60-208-03-01-03
BUTALEJA,BUNYOLE COUNTY,BUSOLWE,BUBALYA,NAMUNYAGWE,383,3,3,1,172,94,273,0,273,0,O-60-208-03-01-04
BUTALEJA,BUNYOLE COUNTY,BUSOLWE,BUBALYA,NALUGONGO P/SCH,570,3,17,4,121,234,379,24,403,0,O-60-208-03-01-05
BUTALEJA,BUNYOLE COUNTY,BUSOLWE,BUSOLWE,BUSOLWE PRIMARY S.I,530,4,1,3,157,216,381,12,393,0,O-60-208-03-02-01
BUTALEJA,BUNYOLE COUNTY,BUSOLWE,BUSOLWE,BUSOLWE TEACHERS' RESOURC,803,8,9,0,243,261,521,19,540,0,O-60-208-03-02-02
BUTALEJA,BUNYOLE COUNTY,BUSOLWE,BUSOLWE,BUHALYA T.C,403,5,12,2,135,137,291,18,309,0,O-60-208-03-02-03
BUTALEJA,BUNYOLE COUNTY,BUSOLWE,BUSOLWE,NAPEKERE P/S,367,5,1,3,103,153,265,7,272,0,O-60-208-03-02-04
BUTALEJA,BUNYOLE COUNTY,BUSOLWE,BUSOLWE,KALOSO MEETING PLACE,293,2,4,3,83,132,224,7,231,0,O-60-208-03-02-05
BUTALEJA,BUNYOLE COUNTY,BUSOLWE,BUSOLWE,NAWASU MOSQUE,350,1,4,1,142,103,251,7,258,0,O-60-208-03-02-06
BUTALEJA,BUNYOLE COUNTY,BUSOLWE,BUWUMU,BUKEDE-BUHASANGO,422,7,4,2,99,149,261,4,265,0,O-60-208-03-03-01
BUTALEJA,BUNYOLE COUNTY,BUSOLWE,BUWUMU,BUSOLWE MULTIPLE HALL,569,4,8,4,166,206,388,17,405,0,O-60-208-03-03-02
BUTALEJA,BUNYOLE COUNTY,BUSOLWE,BUWUMU,BUSOKO,446,9,3,4,127,162,305,1,306,0,O-60-208-03-03-03
BUTALEJA,BUNYOLE COUNTY,BUSOLWE,BUWUMU,MUGULU INTERGRATED P/S,466,2,4,6,128,165,305,14,319,0,O-60-208-03-03-04
BUTALEJA,BUNYOLE COUNTY,BUSOLWE,BUWUMU,NAKWIGA MOSQUE,552,9,4,10,136,277,436,24,460,0,O-60-208-03-03-05
BUTALEJA,BUNYOLE COUNTY,BUSOLWE,MUGULU,MUGULU PRIMARY SCH.,698,8,7,8,210,215,448,20,468,0,O-60-208-03-04-01
BUTALEJA,BUNYOLE COUNTY,BUSOLWE,MUGULU,MUGULU TRADING CENTRE,602,5,6,1,154,267,433,21,454,0,O-60-208-03-04-02
BUTALEJA,BUNYOLE COUNTY,BUTALEJA,BUSIBIRA,BUGOSA PRIMARY SCHOOL,659,1,14,3,161,262,441,14,455,0,O-60-208-04-01-01
BUTALEJA,BUNYOLE COUNTY,BUTALEJA,BUSIBIRA,BAGANGULA,499,7,1,5,96,221,330,9,339,0,O-60-208-04-01-02
BUTALEJA,BUNYOLE COUNTY,BUTALEJA,BUSIBIRA,BUZIBIRA,500,3,8,4,154,199,368,2,370,0,O-60-208-04-01-03
BUTALEJA,BUNYOLE COUNTY,BUTALEJA,BUSIBIRA,MULANDA,321,1,0,1,44,186,232,5,237,0,O-60-208-04-01-04
BUTALEJA,BUNYOLE COUNTY,BUTALEJA,KAITI,WANDEGEYA T.C,290,0,2,0,35,175,212,4,216,0,O-60-208-04-02-01
BUTALEJA,BUNYOLE COUNTY,BUTALEJA,KAITI,NAMUTIMA PRIMARY SCHOOL,325,1,7,2,86,152,248,10,258,0,O-60-208-04-02-02
BUTALEJA,BUNYOLE COUNTY,BUTALEJA,KAITI,NANJERE PR. SCHOOL,314,5,3,4,75,156,243,10,253,0,O-60-208-04-02-03
BUTALEJA,BUNYOLE COUNTY,BUTALEJA,NAKWASI,BUTESA PRIMARY SCHOOL,590,5,2,3,263,157,430,6,436,0,O-60-208-04-03-01
BUTALEJA,BUNYOLE COUNTY,BUTALEJA,NAKWASI,MABALE PRIMARY SCHOOL,468,0,1,4,88,273,366,15,381,0,O-60-208-04-03-02
BUTALEJA,BUNYOLE COUNTY,BUTALEJA,NAKWASI,NAKWASI PRIMARY SCHOOL,567,4,2,2,118,212,338,114,452,0,O-60-208-04-03-03
BUTALEJA,BUNYOLE COUNTY,BUTALEJA,NAKWASI,BUTENGA,417,8,3,7,120,194,332,12,344,0,O-60-208-04-03-04
BUTALEJA,BUNYOLE COUNTY,BUTALEJA,NAMULO,NAMULO PRIMARY SCHOOL,454,3,2,2,109,234,350,3,353,0,O-60-208-04-04-01
BUTALEJA,BUNYOLE COUNTY,BUTALEJA,NAMULO,TINDI,444,5,5,3,88,209,310,6,316,0,O-60-208-04-04-02
BUTALEJA,BUNYOLE COUNTY,BUTALEJA T.C,BUNGHAGI,GAYAZA MARKET,709,9,8,3,158,296,474,16,490,0,O-60-208-05-01-01
BUTALEJA,BUNYOLE COUNTY,BUTALEJA T.C,BUNGHAGI,LERESI PRIMARY SCHOOL,600,6,6,11,104,338,465,15,480,0,O-60-208-05-01-02
BUTALEJA,BUNYOLE COUNTY,BUTALEJA T.C,BUTALEJA,NADIDE'S PLACE,766,3,7,2,70,403,485,53,538,0,O-60-208-05-02-01
BUTALEJA,BUNYOLE COUNTY,BUTALEJA T.C,HISEGA,BUTALEJA PRIMARY SCHOOL,466,3,6,9,60,228,306,16,322,0,O-60-208-05-03-01
BUTALEJA,BUNYOLE COUNTY,BUTALEJA T.C,HISEGA,NAMUBI TREE,362,5,6,2,58,198,269,9,278,0,O-60-208-05-03-02
BUTALEJA,BUNYOLE COUNTY,BUTALEJA T.C,LUJEHE,LUJEHE COOP SOCIETY,514,4,12,1,64,192,273,84,357,0,O-60-208-05-04-01
BUTALEJA,BUNYOLE COUNTY,BUTALEJA T.C,LUJEHE,NAMULEMU PRIMARY SCH. I,310,3,3,3,37,190,236,11,247,0,O-60-208-05-04-02
BUTALEJA,BUNYOLE COUNTY,BUTALEJA T.C,LUJEHE,BUTUNGA CHURCH,296,0,5,1,50,175,231,2,233,0,O-60-208-05-04-03
BUTALEJA,BUNYOLE COUNTY,BUTALEJA T.C,NANYULU,BUTALEJA SUB/COUNTY HQRS,553,1,7,2,89,204,303,11,314,0,O-60-208-05-05-01
BUTALEJA,BUNYOLE COUNTY,BUTALEJA T.C,SEGENDA,BUTALEJA INTERGRATED P/S,440,7,3,2,66,266,344,6,350,0,O-60-208-05-06-01
BUTALEJA,BUNYOLE COUNTY,KACHONGA,KACHONGA,KACHONGA C.O.U,615,2,2,8,151,251,414,9,423,0,O-60-208-06-01-01
BUTALEJA,BUNYOLE COUNTY,KACHONGA,KACHONGA,COOP. SOCIETY,615,6,3,2,155,256,422,23,445,0,O-60-208-06-01-02
BUTALEJA,BUNYOLE COUNTY,KACHONGA,KACHONGA,NAWEYO HEALTH CENTRE II,480,3,2,3,140,120,268,14,282,0,O-60-208-06-01-03
BUTALEJA,BUNYOLE COUNTY,KACHONGA,KAITI,KAITI PRIMARY SCHOOL,698,5,6,9,156,328,504,24,528,0,O-60-208-06-02-01
BUTALEJA,BUNYOLE COUNTY,KACHONGA,KAITI,NAHAMYA P/S,632,10,3,1,154,358,526,11,537,0,O-60-208-06-02-02
BUTALEJA,BUNYOLE COUNTY,KACHONGA,KAITI,KAITI II,570,6,7,4,170,218,405,22,427,0,O-60-208-06-02-03
BUTALEJA,BUNYOLE COUNTY,KACHONGA,NABIGANDA,NABIGANDA MARKET PLACE,686,7,3,4,164,261,439,15,454,0,O-60-208-06-03-01
BUTALEJA,BUNYOLE COUNTY,KACHONGA,NABIGANDA,NAMAJJI RC MEETING PLACE,584,3,3,1,209,187,403,14,417,0,O-60-208-06-03-02
BUTALEJA,BUNYOLE COUNTY,KACHONGA,NABIGANDA,NAMAFAFA MOSQUE,667,7,4,4,260,206,481,19,500,0,O-60-208-06-03-03
BUTALEJA,BUNYOLE COUNTY,KACHONGA,NAMAWA,COOP. SOCIETY,593,4,7,2,120,253,386,7,393,0,O-60-208-06-04-01
BUTALEJA,BUNYOLE COUNTY,KACHONGA,NAMAWA,NAMAWA P.S,674,6,5,4,194,224,433,21,454,0,O-60-208-06-04-02
BUTALEJA,BUNYOLE COUNTY,KACHONGA,NAMBALE,KACHEKERE PRIMARY SCHOOL,532,3,1,2,94,246,346,51,397,0,O-60-208-06-05-01
BUTALEJA,BUNYOLE COUNTY,KACHONGA,NAMBALE,LUHOLA,318,0,0,1,48,169,218,21,239,0,O-60-208-06-05-02
BUTALEJA,BUNYOLE COUNTY,KACHONGA,NAMBALE,MUYENGA,731,0,2,2,140,387,531,5,536,0,O-60-208-06-05-03
BUTALEJA,BUNYOLE COUNTY,KACHONGA,NAMPOLOGOMA,KACHONGA S/COUNTY HQRS,613,3,1,2,137,233,376,18,394,0,O-60-208-06-06-01
BUTALEJA,BUNYOLE COUNTY,KACHONGA,NAMPOLOGOMA,NAMPOLOGOMA CHURCH OR UG,359,11,4,2,66,103,186,52,238,0,O-60-208-06-06-02
BUTALEJA,BUNYOLE COUNTY,KACHONGA,NAMPOLOGOMA,NAMUNASA PRIMARY SCHOOL,534,12,3,1,134,152,302,89,391,0,O-60-208-06-06-03
BUTALEJA,BUNYOLE COUNTY,KACHONGA,NAMPOLOGOMA,MAWANGA P/S,427,9,8,2,150,124,293,25,318,0,O-60-208-06-06-04
BUTALEJA,BUNYOLE COUNTY,KACHONGA,NAMPOLOGOMA,NAMUSITA CATHOLIC CHURCH,315,6,0,9,85,111,211,15,226,0,O-60-208-06-06-05
BUTALEJA,BUNYOLE COUNTY,KACHONGA,NAMUNASA,NAMUNASA P/S,236,1,0,0,25,133,159,5,164,0,O-60-208-06-07-01
BUTALEJA,BUNYOLE COUNTY,KACHONGA,NAMUNASA,MUHULA P/S,596,10,3,6,95,281,395,44,439,0,O-60-208-06-07-02
BUTALEJA,BUNYOLE COUNTY,KACHONGA,NAMUNASA,MUHULA DOHO ISLAMIC PR SCH,381,6,0,2,61,216,285,2,287,0,O-60-208-06-07-03
BUTALEJA,BUNYOLE COUNTY,KACHONGA,NASINYI,NASINYI P/S,627,3,5,7,212,213,440,21,461,0,O-60-208-06-08-01
BUTALEJA,BUNYOLE COUNTY,KACHONGA,NASINYI,NAKASANGA P/S,563,1,3,1,164,259,428,7,435,0,O-60-208-06-08-02
BUTALEJA,BUNYOLE COUNTY,MAZIMASA,DOHO,WEGGA,642,4,3,3,172,273,455,15,470,0,O-60-208-07-01-01
BUTALEJA,BUNYOLE COUNTY,MAZIMASA,DOHO,LUBEMBE PRIMARY SCHOOL,525,3,1,1,138,216,359,22,381,0,O-60-208-07-01-02
BUTALEJA,BUNYOLE COUNTY,MAZIMASA,DOHO,MUHUYU TRADING CENTRE,578,7,4,9,193,200,413,8,421,0,O-60-208-07-01-03
BUTALEJA,BUNYOLE COUNTY,MAZIMASA,DOHO,NAPOLOGOMA PRIMARY SCHOOL,509,4,7,4,75,213,303,10,313,0,O-60-208-07-01-04
BUTALEJA,BUNYOLE COUNTY,MAZIMASA,DOHO,NAMATOKE,577,8,2,2,130,179,321,88,409,0,O-60-208-07-01-05
BUTALEJA,BUNYOLE COUNTY,MAZIMASA,DOHO,POLES SHADE,540,6,2,12,76,285,381,10,391,0,O-60-208-07-01-06
BUTALEJA,BUNYOLE COUNTY,MAZIMASA,DOHO,NAMUSERU,350,3,4,3,77,136,223,10,233,0,O-60-208-07-01-07
BUTALEJA,BUNYOLE COUNTY,MAZIMASA,DOHO,DOHO PRIMARY SCH,214,5,2,4,77,70,158,9,167,0,O-60-208-07-01-08
BUTALEJA,BUNYOLE COUNTY,MAZIMASA,KACHONGA,MAZIMASA B,310,3,1,1,76,88,169,8,177,0,O-60-208-07-02-01
BUTALEJA,BUNYOLE COUNTY,MAZIMASA,KACHONGA,BUFUJJA PRIMARY SCHOOL,485,4,6,3,118,214,345,5,350,0,O-60-208-07-02-02
BUTALEJA,BUNYOLE COUNTY,MAZIMASA,KACHONGA,KACHONGA TRADING CENTRE I,642,3,5,2,124,206,340,74,414,0,O-60-208-07-02-03
BUTALEJA,BUNYOLE COUNTY,MAZIMASA,KACHONGA,KACHONGA TRADING CENTRE II,563,1,1,1,87,261,351,0,351,0,O-60-208-07-02-04
BUTALEJA,BUNYOLE COUNTY,MAZIMASA,KACHONGA,MVULE TREE,382,3,3,0,67,186,259,37,296,0,O-60-208-07-02-05
BUTALEJA,BUNYOLE COUNTY,MAZIMASA,KACHONGA,LUBANGA,478,5,2,6,175,155,343,19,362,0,O-60-208-07-02-06
BUTALEJA,BUNYOLE COUNTY,MAZIMASA,KACHONGA,MUTUMBA,592,7,10,0,133,239,389,16,405,0,O-60-208-07-02-07
BUTALEJA,BUNYOLE COUNTY,MAZIMASA,KANGALABA,KANGALABA PRIMARY SCHOOL,308,2,2,0,107,84,195,3,198,0,O-60-208-07-03-01
BUTALEJA,BUNYOLE COUNTY,MAZIMASA,KANGALABA,MUTAHI,317,3,0,0,124,112,239,6,245,0,O-60-208-07-03-02
BUTALEJA,BUNYOLE COUNTY,MAZIMASA,KANGALABA,KANGALABA T/C,421,2,1,1,99,204,307,8,315,0,O-60-208-07-03-03
BUTALEJA,BUNYOLE COUNTY,MAZIMASA,KAPISA,BUDIBA MOSQUE,284,2,2,1,61,133,199,18,217,0,O-60-208-07-04-01
BUTALEJA,BUNYOLE COUNTY,MAZIMASA,KAPISA,NAKABI,272,3,2,2,94,88,189,0,189,0,O-60-208-07-04-02
BUTALEJA,BUNYOLE COUNTY,MAZIMASA,KAPISA,MAZIMASA BOREHOLE,538,6,4,2,159,168,339,11,350,0,O-60-208-07-04-03
BUTALEJA,BUNYOLE COUNTY,MAZIMASA,KAPISA,MAZIMASA S/COUNTY HQRS.,453,4,1,1,130,164,300,13,313,0,O-60-208-07-04-04
BUTALEJA,BUNYOLE COUNTY,MAZIMASA,KAPISA,KAPISA,703,7,2,7,178,261,455,11,466,0,O-60-208-07-04-05
BUTALEJA,BUNYOLE COUNTY,MAZIMASA,KAPISA,MANAFA MANGO TREE,390,2,4,2,86,189,283,5,288,0,O-60-208-07-04-06
BUTALEJA,BUNYOLE COUNTY,MAZIMASA,WANGALE,MASULULA PRIMARY SCHOOL,548,1,1,2,78,280,362,4,366,0,O-60-208-07-05-01
BUTALEJA,BUNYOLE COUNTY,MAZIMASA,WANGALE,WANGALE PRIMARY SCHOOL,742,4,6,3,139,344,496,26,522,0,O-60-208-07-05-02
BUTALEJA,BUNYOLE COUNTY,MAZIMASA,WANGALE,BUGOMBE PRIMARY SCH,193,0,4,0,43,88,135,5,140,0,O-60-208-07-05-03
BUTALEJA,BUNYOLE COUNTY,NAWANJOFU,BINGO,BINGO TRADING CENTRE,710,3,6,4,74,404,491,3,494,0,O-60-208-08-01-01
BUTALEJA,BUNYOLE COUNTY,NAWANJOFU,BINGO,HIGOYE KAYEMBE,378,6,0,1,44,201,252,6,258,0,O-60-208-08-01-02
BUTALEJA,BUNYOLE COUNTY,NAWANJOFU,BUBINGE,HIRIGA C.O.U,366,0,4,3,101,180,288,12,300,0,O-60-208-08-02-01
BUTALEJA,BUNYOLE COUNTY,NAWANJOFU,BUBINGE,BUBINGE MOSQUE,738,1,56,1,177,477,712,26,738,0,O-60-208-08-02-02
BUTALEJA,BUNYOLE COUNTY,NAWANJOFU,BUBINGE,BWERYA P/S,393,1,2,0,86,180,269,13,282,0,O-60-208-08-02-03
BUTALEJA,BUNYOLE COUNTY,NAWANJOFU,BUGALO,BUGALO PRIMARY SCHOOL,683,3,3,5,72,446,529,21,550,0,O-60-208-08-03-01
BUTALEJA,BUNYOLE COUNTY,NAWANJOFU,BUGALO,BUHADIO PRIMARY SCHOOL,537,7,2,3,48,376,436,11,447,0,O-60-208-08-03-02
BUTALEJA,BUNYOLE COUNTY,NAWANJOFU,BUGALO,SOMBA TRADING CENTRE,296,2,0,1,92,141,236,2,238,0,O-60-208-08-03-03
BUTALEJA,BUNYOLE COUNTY,NAWANJOFU,MASANGHE,SUNI PRIMARY SCHOOL,664,10,6,3,132,273,424,24,448,0,O-60-208-08-04-01
BUTALEJA,BUNYOLE COUNTY,NAWANJOFU,MASANGHE,MASANGHE,273,1,3,4,51,175,234,5,239,0,O-60-208-08-04-02
BUTALEJA,BUNYOLE COUNTY,NAWANJOFU,MASANGHE,LWAMBOGO PRIMARY SCHOOL,475,5,15,4,148,130,302,17,319,0,O-60-208-08-04-03
KALIRO,BULAMOGI,BUMANYA,BUDOMERO,KYANFUBBA LANDING SITE,414,1,1,3,27,335,367,5,372,0,O-64-72-01-01-01
KALIRO,BULAMOGI,BUMANYA,BUDOMERO,KYANJADDE/KSIKI/BUDAMBU,722,1,3,3,40,514,561,28,589,0,O-64-72-01-01-02
KALIRO,BULAMOGI,BUMANYA,BUDOMERO,MUKONO/BUDOMERO/KAHANGO,297,2,0,1,17,228,248,5,253,0,O-64-72-01-01-03
KALIRO,BULAMOGI,BUMANYA,BUDOMERO,NAIRIKA PRIMARY SOCIETY,704,1,0,1,64,512,578,0,578,0,O-64-72-01-01-04
KALIRO,BULAMOGI,BUMANYA,BUDOMERO,MUKKO MUSEREBENDE,274,1,1,0,20,195,217,21,238,0,O-64-72-01-01-05
KALIRO,BULAMOGI,BUMANYA,BULUMBA,BULUMBA GINNERY BULUMBA,791,6,3,4,94,420,527,27,554,0,O-64-72-01-02-01
KALIRO,BULAMOGI,BUMANYA,BULUMBA,NALENYA C.O.U,442,3,0,1,12,345,361,7,368,0,O-64-72-01-02-02
KALIRO,BULAMOGI,BUMANYA,BULUMBA,BUJJEJJE/COU/BUJJEJJE,402,1,0,2,13,334,350,1,351,0,O-64-72-01-02-03
KALIRO,BULAMOGI,BUMANYA,BULUMBA,MASUNA C.O.U,220,0,0,3,10,164,177,3,180,0,O-64-72-01-02-04
KALIRO,BULAMOGI,BUMANYA,BULUMBA,NKOTE PRIMARY SCHOOL,264,2,0,1,15,201,219,5,224,0,O-64-72-01-02-05
KALIRO,BULAMOGI,BUMANYA,BUMANYA,GENDWA T C,599,3,0,0,38,443,484,2,486,0,O-64-72-01-03-01
KALIRO,BULAMOGI,BUMANYA,BUMANYA,BULUMI C O U,578,3,0,2,71,369,445,17,462,0,O-64-72-01-03-02
KALIRO,BULAMOGI,BUMANYA,BUMANYA,BUMANYA T.C,232,0,0,2,14,146,162,9,171,0,O-64-72-01-03-03
KALIRO,BULAMOGI,BUMANYA,BUMANYA,BUMANYA S/C HQRS,577,0,0,3,32,368,403,14,417,0,O-64-72-01-03-04
KALIRO,BULAMOGI,BUMANYA,KASULETA,NABIGWALI P/SCHOOL,443,3,0,5,32,292,332,16,348,0,O-64-72-01-04-01
KALIRO,BULAMOGI,BUMANYA,KASULETA,KALALU C.O.U,367,2,0,1,20,276,299,7,306,0,O-64-72-01-04-02
KALIRO,BULAMOGI,BUMANYA,KASULETA,KANANSEGA,604,3,0,3,17,459,482,4,486,0,O-64-72-01-04-03
KALIRO,BULAMOGI,BUMANYA,KASULETA,NABIGWALI P/SCHOOL TAKIRA/BU,388,0,0,2,22,275,299,13,312,0,O-64-72-01-04-04
KALIRO,BULAMOGI,BUMANYA,KASULETA,KANAMBATIKO P/S,488,1,1,2,26,359,389,11,400,0,O-64-72-01-04-05
KALIRO,BULAMOGI,BUMANYA,KIYUNGA,BUSALAMUKA PR. SCHOOL,473,2,3,3,31,319,358,6,364,0,O-64-72-01-05-01
KALIRO,BULAMOGI,BUMANYA,KIYUNGA,NABITENDE C O U A,348,0,0,3,24,247,274,8,282,0,O-64-72-01-05-02
KALIRO,BULAMOGI,BUMANYA,KIYUNGA,BWIITE S.D.A,359,0,0,1,13,242,256,9,265,0,O-64-72-01-05-03
KALIRO,BULAMOGI,BUMANYA,KIYUNGA,NABITENDE C O U B,547,3,0,2,26,407,438,8,446,0,O-64-72-01-05-04
KALIRO,BULAMOGI,BUMANYA,KYANI,KYANI P/SCHOOL KYANI,530,1,1,4,17,348,371,24,395,0,O-64-72-01-06-01
KALIRO,BULAMOGI,BUMANYA,KYANI,IHAGALO C O U,689,1,1,6,35,491,534,16,550,0,O-64-72-01-06-02
KALIRO,BULAMOGI,BUMANYA,KYANI,NAMUSOLO C O U,605,3,0,8,44,462,517,16,533,0,O-64-72-01-06-03
KALIRO,BULAMOGI,BUMANYA,KYANI,KYANI PR. SCHOOL KISENYI,368,0,0,1,33,247,281,13,294,0,O-64-72-01-06-04
KALIRO,BULAMOGI,GADUMIRE,BUPYANA,BUYUGE P/S,591,4,1,4,34,392,435,20,455,0,O-64-72-02-01-01
KALIRO,BULAMOGI,GADUMIRE,BUPYANA,BUTAMBALA P/S,473,2,2,3,36,343,386,0,386,0,O-64-72-02-01-02
KALIRO,BULAMOGI,GADUMIRE,BUPYANA,BUPYANA T.C,361,4,0,3,30,255,292,11,303,0,O-64-72-02-01-03
KALIRO,BULAMOGI,GADUMIRE,BUPYANA,BUPYANA P/S,334,3,1,5,18,228,255,24,279,0,O-64-72-02-01-04
KALIRO,BULAMOGI,GADUMIRE,GADUMIRE,GADUMIRE S/C HQRS,445,1,1,1,21,297,321,7,328,0,O-64-72-02-02-01
KALIRO,BULAMOGI,GADUMIRE,GADUMIRE,GADUMIRE T.C B,513,4,1,0,37,350,392,15,407,0,O-64-72-02-02-02
KALIRO,BULAMOGI,GADUMIRE,GADUMIRE,GADUMIRE P/S,501,1,0,6,27,314,348,10,358,0,O-64-72-02-02-03
KALIRO,BULAMOGI,GADUMIRE,GADUMIRE,NAWANDIYO T.C,737,1,2,4,34,534,575,19,594,0,O-64-72-02-02-04
KALIRO,BULAMOGI,GADUMIRE,KISINDA,KISINDA P/S,663,1,2,1,32,459,495,16,511,0,O-64-72-02-03-01
KALIRO,BULAMOGI,GADUMIRE,KISINDA,BUSULUMBA PR/SCHOOL,551,3,0,4,33,374,414,16,430,0,O-64-72-02-03-02
KALIRO,BULAMOGI,GADUMIRE,KISINDA,BUSULUMBA T.C,742,0,3,3,31,572,609,8,617,0,O-64-72-02-03-03
KALIRO,BULAMOGI,GADUMIRE,LUBULO,KIBAALE PR/SCH,717,5,0,3,34,480,522,13,535,0,O-64-72-02-04-01
KALIRO,BULAMOGI,GADUMIRE,LUBULO,LUBULO P/S,586,1,2,2,43,436,484,14,498,0,O-64-72-02-04-02
KALIRO,BULAMOGI,GADUMIRE,PANYOLO,PANYOLO PR. SCH,905,7,0,5,43,652,707,6,713,0,O-64-72-02-05-01
KALIRO,BULAMOGI,GADUMIRE,PANYOLO,ISALO P/S,421,2,3,2,23,313,343,12,355,0,O-64-72-02-05-02
KALIRO,BULAMOGI,GADUMIRE,PANYOLO,BUSIRO T.C,242,0,0,1,7,183,191,12,203,0,O-64-72-02-05-03
KALIRO,BULAMOGI,KALIRO TOWN COUNCIL,BUDINI,BUDINI MISSION,620,4,0,4,88,305,401,3,404,0,O-64-72-03-01-01
KALIRO,BULAMOGI,KALIRO TOWN COUNCIL,BUDINI,NYANZA CHURCH OF UGANDA,259,0,0,2,15,184,201,17,218,0,O-64-72-03-01-02
KALIRO,BULAMOGI,KALIRO TOWN COUNCIL,BUKUMANKOOLA,BRIGHT FUTURE COLLEGE,624,13,0,1,103,282,399,3,402,0,O-64-72-03-02-01
KALIRO,BULAMOGI,KALIRO TOWN COUNCIL,BUKUMANKOOLA,MUTONO'S PLACE,577,3,0,0,90,306,399,10,409,0,O-64-72-03-02-02
KALIRO,BULAMOGI,KALIRO TOWN COUNCIL,BUYUNGA,KALIRO CHURCH OF UGANDA,651,6,4,0,118,237,365,7,372,0,O-64-72-03-03-01
KALIRO,BULAMOGI,KALIRO TOWN COUNCIL,BUYUNGA,KASAJJA BOREHOLE,262,4,1,2,27,167,201,5,206,0,O-64-72-03-03-02
KALIRO,BULAMOGI,KALIRO TOWN COUNCIL,LUMBUYE,KALIRO MUSLIM P/S,457,1,1,0,68,247,317,0,317,0,O-64-72-03-04-01
KALIRO,BULAMOGI,KALIRO TOWN COUNCIL,LUMBUYE,QUEEN'S COMPREHENSIVE COLL,334,2,0,0,58,172,232,5,237,0,O-64-72-03-04-02
KALIRO,BULAMOGI,KALIRO TOWN COUNCIL,NAIGOMBWA,KYABAZINGA'S PLACE,724,1,1,4,62,416,484,6,490,0,O-64-72-03-05-01
KALIRO,BULAMOGI,KALIRO TOWN COUNCIL,NAIGOMBWA,AMILI P/S,218,1,1,0,38,101,141,0,141,0,O-64-72-03-05-02
KALIRO,BULAMOGI,NAMUGONGO,BUGONZA,BUGONZA P/S,458,3,1,2,34,284,324,15,339,0,O-64-72-04-01-01
KALIRO,BULAMOGI,NAMUGONGO,BUGONZA,KANANKAMBA I,214,1,0,3,8,151,163,5,168,0,O-64-72-04-01-02
KALIRO,BULAMOGI,NAMUGONGO,BUGONZA,KANANKAMBA CHURCH,357,1,1,2,19,244,267,4,271,0,O-64-72-04-01-03
KALIRO,BULAMOGI,NAMUGONGO,BUTEGE,BUTEGE CHURCH,653,1,1,1,59,420,482,6,488,0,O-64-72-04-02-01
KALIRO,BULAMOGI,NAMUGONGO,BUTEGE,NATWANA N.T.C,443,0,1,4,58,214,277,21,298,0,O-64-72-04-02-02
KALIRO,BULAMOGI,NAMUGONGO,BUTEGE,NAMUGONGO S/C HQRS,524,5,2,0,44,295,346,9,355,0,O-64-72-04-02-03
KALIRO,BULAMOGI,NAMUGONGO,BWAYUYA,BWAYUYA T.C,553,8,2,2,63,332,407,14,421,0,O-64-72-04-03-01
KALIRO,BULAMOGI,NAMUGONGO,BWAYUYA,BWAYUYA P/S,404,2,0,6,22,271,301,8,309,0,O-64-72-04-03-02
KALIRO,BULAMOGI,NAMUGONGO,BWAYUYA,BUTESA T.C,288,1,2,1,15,216,235,11,246,0,O-64-72-04-03-03
KALIRO,BULAMOGI,NAMUGONGO,KASOKWE,KASOKWE P/S,461,4,0,2,47,284,337,14,351,0,O-64-72-04-04-01
KALIRO,BULAMOGI,NAMUGONGO,KASOKWE,KASOKWE HEALTH CENTRE,468,0,0,1,35,296,332,6,338,0,O-64-72-04-04-02
KALIRO,BULAMOGI,NAMUGONGO,KASOKWE,BUGOODO P/S,648,2,0,3,43,407,455,22,477,0,O-64-72-04-04-03
KALIRO,BULAMOGI,NAMUGONGO,KASOKWE,BUTONGOLE KIRUMBI/KIBWANGU,519,0,2,6,18,381,407,14,421,0,O-64-72-04-04-04
KALIRO,BULAMOGI,NAMUGONGO,KASOKWE,ZIBONDO P/S,445,1,1,0,29,317,348,10,358,0,O-64-72-04-04-05
KALIRO,BULAMOGI,NAMUGONGO,NABIKOLI,NABIKOOLI PARISH HQRS,616,2,2,4,50,404,462,14,476,0,O-64-72-04-05-01
KALIRO,BULAMOGI,NAMUGONGO,NABIKOLI,KANANKAMBA IV P/SCHOOL,281,0,0,2,39,141,182,7,189,0,O-64-72-04-05-02
KALIRO,BULAMOGI,NAMUGONGO,NABIKOLI,KANANKAMBA III,386,4,0,5,53,236,298,0,298,0,O-64-72-04-05-03
KALIRO,BULAMOGI,NAMUGONGO,NAMUKOGE,NAMUKOGE PR/SCHOOL A,387,2,0,2,36,222,262,5,267,0,O-64-72-04-06-01
KALIRO,BULAMOGI,NAMUGONGO,NAMUKOGE,IGULAMUBIRI,325,3,3,1,19,196,222,3,225,0,O-64-72-04-06-02
KALIRO,BULAMOGI,NAMUGONGO,NAMUKOGE,NAMUKOGE T.C,496,2,0,3,41,281,327,9,336,0,O-64-72-04-06-03
KALIRO,BULAMOGI,NAMWIWA,BUKONDE,WANGOBO PR/SCHOOL,552,1,1,2,15,422,441,18,459,0,O-64-72-05-01-01
KALIRO,BULAMOGI,NAMWIWA,BUKONDE,BUKONDE SUB - GRADE SCHOOL,614,4,0,6,47,366,423,24,447,0,O-64-72-05-01-02
KALIRO,BULAMOGI,NAMWIWA,BUKONDE,NAMEJJE KASOKOSO,492,0,4,7,34,343,388,25,413,0,O-64-72-05-01-03
KALIRO,BULAMOGI,NAMWIWA,BUKONDE,BUKONDE TRADING CENTRE,612,2,0,2,35,358,397,77,474,0,O-64-72-05-01-04
KALIRO,BULAMOGI,NAMWIWA,BUKONDE,KANABUGO C.O.U,254,0,0,3,17,177,197,12,209,0,O-64-72-05-01-05
KALIRO,BULAMOGI,NAMWIWA,BUYINDA,NANKOOLA PR. SCHOOL,605,3,6,2,35,417,463,14,477,0,O-64-72-05-02-01
KALIRO,BULAMOGI,NAMWIWA,BUYINDA,NABIINA P/S,385,1,0,1,12,293,307,14,321,0,O-64-72-05-02-02
KALIRO,BULAMOGI,NAMWIWA,BUYINDA,I F C KIRAMA P/SCHOOL,700,0,2,0,22,501,525,17,542,0,O-64-72-05-02-03
KALIRO,BULAMOGI,NAMWIWA,BUYINDA,MADIBIRA P/SCHOOL KASULETA,553,0,0,4,8,407,419,13,432,0,O-64-72-05-02-04
KALIRO,BULAMOGI,NAMWIWA,BUYINDA,KIRANGA C.O.U,582,1,0,0,20,366,387,55,442,0,O-64-72-05-02-05
KALIRO,BULAMOGI,NAMWIWA,NAMWIWA,KIGANDA P/S,417,2,0,1,51,195,249,61,310,0,O-64-72-05-03-01
KALIRO,BULAMOGI,NAMWIWA,NAMWIWA,BUSAMBEKO P/S,318,0,0,0,9,275,284,3,287,0,O-64-72-05-03-02
KALIRO,BULAMOGI,NAMWIWA,NAMWIWA,NAMWIWA STATION,704,1,0,0,70,481,552,5,557,0,O-64-72-05-03-03
KALIRO,BULAMOGI,NAMWIWA,NAMWIWA,NAKWAGALA,585,0,1,2,38,409,450,10,460,0,O-64-72-05-03-04
KALIRO,BULAMOGI,NAMWIWA,NAMWIWA,IZINGA P/S,222,0,0,0,5,182,187,6,193,0,O-64-72-05-03-05
KALIRO,BULAMOGI,NAMWIWA,SAKA,KAKOSI C O U,671,2,0,3,44,481,530,23,553,0,O-64-72-05-04-01
KALIRO,BULAMOGI,NAMWIWA,SAKA,SAAKA PR. SCHOOL,503,2,1,3,40,361,407,16,423,0,O-64-72-05-04-02
KALIRO,BULAMOGI,NAMWIWA,SAKA,KIWA NABUZI,540,1,2,3,22,374,402,17,419,0,O-64-72-05-04-03
KALIRO,BULAMOGI,NAMWIWA,SAKA,NAMULUNGU P/S,370,1,1,0,20,322,344,2,346,0,O-64-72-05-04-04
KALIRO,BULAMOGI,NAWAIKOKE,BUKAMBA,KITEGA,649,3,1,8,37,485,534,13,547,0,O-64-72-06-01-01
KALIRO,BULAMOGI,NAWAIKOKE,BUKAMBA,BUVULUNGUTI P/S,581,0,0,3,25,509,537,10,547,0,O-64-72-06-01-02
KALIRO,BULAMOGI,NAWAIKOKE,BUKAMBA,RWAMBA,423,0,0,1,30,319,350,15,365,0,O-64-72-06-01-03
KALIRO,BULAMOGI,NAWAIKOKE,BUKAMBA,KIBUYE T.C,422,1,1,0,25,306,333,9,342,0,O-64-72-06-01-04
KALIRO,BULAMOGI,NAWAIKOKE,BULUYA,BUDI BUDI,414,3,2,3,14,302,324,9,333,0,O-64-72-06-02-01
KALIRO,BULAMOGI,NAWAIKOKE,BULUYA,BULUYA I,572,1,0,1,14,420,436,5,441,0,O-64-72-06-02-02
KALIRO,BULAMOGI,NAWAIKOKE,BULUYA,MUHIRA MUHIRA,420,1,1,2,43,263,310,10,320,0,O-64-72-06-02-03
KALIRO,BULAMOGI,NAWAIKOKE,BULUYA,BULUYA II,442,2,0,4,29,292,327,4,331,0,O-64-72-06-02-04
KALIRO,BULAMOGI,NAWAIKOKE,NAMAWA,KASOZI,603,0,1,2,39,417,459,9,468,0,O-64-72-06-03-01
KALIRO,BULAMOGI,NAWAIKOKE,NAMAWA,KANANYAAIKE STAGE NALUBOMB,463,0,0,2,44,276,322,20,342,0,O-64-72-06-03-02
KALIRO,BULAMOGI,NAWAIKOKE,NAMAWA,BUHANGALA PR. SCHOOL BEEDA,694,4,2,7,57,443,513,16,529,0,O-64-72-06-03-03
KALIRO,BULAMOGI,NAWAIKOKE,NANGALA,NANGALA P/S,584,1,0,4,22,423,450,15,465,0,O-64-72-06-04-01
KALIRO,BULAMOGI,NAWAIKOKE,NANGALA,BUJUGU KASOKOSO,542,6,0,1,57,367,431,9,440,0,O-64-72-06-04-02
KALIRO,BULAMOGI,NAWAIKOKE,NANGALA,BUZINGE - NANGALA,164,1,0,1,14,119,135,2,137,0,O-64-72-06-04-03
KALIRO,BULAMOGI,NAWAIKOKE,NANGALA,KUTO CATHOLIC CHURCH,288,1,0,0,2,253,256,2,258,0,O-64-72-06-04-04
KALIRO,BULAMOGI,NAWAIKOKE,NANSOLOLO,NANTAMALI,638,0,0,2,24,420,446,6,452,0,O-64-72-06-05-01
KALIRO,BULAMOGI,NAWAIKOKE,NANSOLOLO,BULIKE,714,5,0,6,34,516,561,7,568,0,O-64-72-06-05-02
KALIRO,BULAMOGI,NAWAIKOKE,NANSOLOLO,NANSOLOLO I,361,2,0,0,11,268,281,9,290,0,O-64-72-06-05-03
KALIRO,BULAMOGI,NAWAIKOKE,NANSOLOLO,NANSOLOLO II,379,0,1,0,24,283,308,4,312,0,O-64-72-06-05-04
KALIRO,BULAMOGI,NAWAIKOKE,NAWAIKOKE,NAWAIKOKE SUB-COUNTY HQRS,630,4,0,1,63,360,428,2,430,0,O-64-72-06-06-01
KALIRO,BULAMOGI,NAWAIKOKE,NAWAIKOKE,NAWAIKOKE TRADING CENTRE,571,4,0,1,54,328,387,10,397,0,O-64-72-06-06-02
KALIRO,BULAMOGI,NAWAIKOKE,NAWAIKOKE,MWANGA MWANGA,704,0,0,6,54,493,553,14,567,0,O-64-72-06-06-03
KALIRO,BULAMOGI,NAWAIKOKE,NAWAMPITI,NAWAMPITI P/SCH,333,0,0,1,23,226,250,15,265,0,O-64-72-06-07-01
KALIRO,BULAMOGI,NAWAIKOKE,NAWAMPITI,NDIGA'S PLACE - NAWAMPITI B,804,1,0,3,38,576,618,4,622,0,O-64-72-06-07-02
KALIRO,BULAMOGI,NAWAIKOKE,NAWAMPITI,KITONTO'S PLACE KABIJA,587,1,1,5,44,423,474,6,480,0,O-64-72-06-07-03
KALIRO,BULAMOGI,NAWAIKOKE,NSAMULE,NSAMULE P/SCHOOL - NSAMULE,601,4,0,2,34,430,470,13,483,0,O-64-72-06-08-01
KALIRO,BULAMOGI,NAWAIKOKE,NSAMULE,BUKUBAITUBA,172,1,1,2,15,123,142,8,150,0,O-64-72-06-08-02
KALIRO,BULAMOGI,NAWAIKOKE,NSAMULE,BUPENI,695,1,0,1,18,517,537,3,540,0,O-64-72-06-08-03
MANAFWA,BUBULO COUNTY WEST,BUGOBERO,BUGOBERO,KHABUTOOLA A,405,0,0,0,111,136,247,0,247,0,O-67-126-01-01-01
MANAFWA,BUBULO COUNTY WEST,BUGOBERO,BUGOBERO,KHABUTOOLA B,395,2,2,1,114,148,267,12,279,0,O-67-126-01-01-02
MANAFWA,BUBULO COUNTY WEST,BUGOBERO,BUGOBERO,SIKUSI PR SCH,554,0,2,0,130,310,442,12,454,0,O-67-126-01-01-03
MANAFWA,BUBULO COUNTY WEST,BUGOBERO,BUGOBERO,NANGALWE PR SCH,577,2,5,0,115,292,414,0,414,0,O-67-126-01-01-04
MANAFWA,BUBULO COUNTY WEST,BUGOBERO,BUGOBERO,BUSANGAYI CENTRE,588,1,0,2,176,227,406,48,454,0,O-67-126-01-01-05
MANAFWA,BUBULO COUNTY WEST,BUGOBERO,BUGOBERO,NANGALWE PR SCH.(N-Z),577,1,1,1,83,293,379,1,380,0,O-67-126-01-01-06
MANAFWA,BUBULO COUNTY WEST,BUGOBERO,BUGOBERO,KHABUTOOLA,430,3,1,1,149,144,298,6,304,0,O-67-126-01-01-07
MANAFWA,BUBULO COUNTY WEST,BUGOBERO,BUMASOKHO,BUMASOKHO PR. SCH.,422,1,1,3,98,185,288,18,306,0,O-67-126-01-02-01
MANAFWA,BUBULO COUNTY WEST,BUGOBERO,BUMASOKHO,BUWAKORO C.O.U,586,1,2,5,91,324,423,4,427,0,O-67-126-01-02-02
MANAFWA,BUBULO COUNTY WEST,BUGOBERO,BUMASOKHO,BUWERWE II,413,1,0,1,64,264,330,8,338,0,O-67-126-01-02-03
MANAFWA,BUBULO COUNTY WEST,BUGOBERO,BUNANGABO,BUNANGABO PR. SCH.,742,2,3,7,243,179,434,19,453,0,O-67-126-01-03-01
MANAFWA,BUBULO COUNTY WEST,BUGOBERO,BUNANGABO,BUMUFUNI,551,2,1,1,141,122,267,42,309,0,O-67-126-01-03-02
MANAFWA,BUBULO COUNTY WEST,BUGOBERO,BUNANGABO,BUSERENGE C.O.U,389,0,0,0,0,0,0,0,0,1,O-67-126-01-03-03
MANAFWA,BUBULO COUNTY WEST,BUGOBERO,BUNANGABO,SIBANGA PR. SCH,157,1,1,0,28,70,100,3,103,0,O-67-126-01-03-04
MANAFWA,BUBULO COUNTY WEST,BUGOBERO,BUNEFULE,BUGOBERO S/C HQTRS A,475,0,1,0,121,290,412,1,413,0,O-67-126-01-04-01
MANAFWA,BUBULO COUNTY WEST,BUGOBERO,BUNEFULE,NAKHUPA PR SCH.,758,3,0,0,152,349,504,11,515,0,O-67-126-01-04-02
MANAFWA,BUBULO COUNTY WEST,BUGOBERO,BUNEFULE,BUGOBERO S/C HQTRS B,702,3,3,3,146,395,550,29,579,0,O-67-126-01-04-03
MANAFWA,BUBULO COUNTY WEST,BUGOBERO,BUNEFULE,KIWATA PS,292,2,0,2,33,177,214,18,232,0,O-67-126-01-04-04
MANAFWA,BUBULO COUNTY WEST,BUGOBERO,BUNEFULE,BUGOBERO GCS,208,0,0,1,37,107,145,9,154,0,O-67-126-01-04-05
MANAFWA,BUBULO COUNTY WEST,BUTIRU,BUKHOFU,BUKIBOKOLI P/S,511,1,0,1,52,142,196,3,199,0,O-67-126-02-01-01
MANAFWA,BUBULO COUNTY WEST,BUTIRU,BUKHOFU,BUKHOFU PR SCH (A-M),578,2,1,1,75,329,408,5,413,0,O-67-126-02-01-02
MANAFWA,BUBULO COUNTY WEST,BUTIRU,BUKHOFU,IKAALI PR. SCH,828,2,2,2,109,316,431,0,431,0,O-67-126-02-01-03
MANAFWA,BUBULO COUNTY WEST,BUTIRU,BUKHOFU,BUKHOFU PR SCH (N),467,1,0,0,43,207,251,11,262,0,O-67-126-02-01-04
MANAFWA,BUBULO COUNTY WEST,BUTIRU,BUKHOFU,BUKHOFU PR SCH (O-Z),457,1,1,1,43,179,225,5,230,0,O-67-126-02-01-05
MANAFWA,BUBULO COUNTY WEST,BUTIRU,BUKHOFU,WOPUSI T/C,230,1,0,2,23,90,116,2,118,0,O-67-126-02-01-06
MANAFWA,BUBULO COUNTY WEST,BUTIRU,BUMAGAMBO,SISUNI P/S,502,1,0,0,52,216,269,92,361,0,O-67-126-02-02-01
MANAFWA,BUBULO COUNTY WEST,BUTIRU,BUMAGAMBO,BUMUTUMA T/C,409,1,2,2,28,263,296,6,302,0,O-67-126-02-02-02
MANAFWA,BUBULO COUNTY WEST,BUTIRU,BUMAGAMBO,MAETE P. SCH,594,0,0,1,39,258,298,6,304,0,O-67-126-02-02-03
MANAFWA,BUBULO COUNTY WEST,BUTIRU,BUMAGAMBO,MANGO TREE,585,4,1,1,73,304,383,7,390,0,O-67-126-02-02-04
MANAFWA,BUBULO COUNTY WEST,BUTIRU,BUMAGAMBO,BUSHAKIRI-SIBANGA,598,2,2,6,76,326,412,15,427,0,O-67-126-02-02-05
MANAFWA,BUBULO COUNTY WEST,BUTIRU,BUMATANDA,KHATSONGA GRAIN MILL,375,1,0,3,67,194,265,17,282,0,O-67-126-02-03-01
MANAFWA,BUBULO COUNTY WEST,BUTIRU,BUMATANDA,BUMUKETSI G.C.S A,343,0,0,2,40,189,231,5,236,0,O-67-126-02-03-02
MANAFWA,BUBULO COUNTY WEST,BUTIRU,BUMATANDA,BUMUKETSI G.C.S B,376,6,2,2,87,171,268,10,278,0,O-67-126-02-03-03
MANAFWA,BUBULO COUNTY WEST,BUTIRU,BUMATANDA,LWEMUNA P/S,811,1,0,1,68,411,481,23,504,0,O-67-126-02-03-04
MANAFWA,BUBULO COUNTY WEST,BUTIRU,BUMATANDA,BUKHADALA G.C.S. A & B,292,0,2,1,38,154,195,15,210,0,O-67-126-02-03-05
MANAFWA,BUBULO COUNTY WEST,BUTIRU,BUMATANDA,WAPAPARA CENTRE,432,3,1,3,120,170,297,2,299,0,O-67-126-02-03-06
MANAFWA,BUBULO COUNTY WEST,BUTIRU,BUMATANDA,BUWANGOLOBE,498,4,1,3,57,287,352,11,363,0,O-67-126-02-03-07
MANAFWA,BUBULO COUNTY WEST,BUTIRU,BUMATANDA,BUKHADALA P/S,594,17,41,3,168,316,545,37,582,0,O-67-126-02-03-08
MANAFWA,BUBULO COUNTY WEST,BUTIRU,BUNABWANA,BUNYINZA PR/SCHOOL A,699,3,1,8,56,391,459,1,460,0,O-67-126-02-04-01
MANAFWA,BUBULO COUNTY WEST,BUTIRU,BUNABWANA,BUNYINZA PR/SCHOOL B,712,3,2,2,144,327,478,4,482,0,O-67-126-02-04-02
MANAFWA,BUBULO COUNTY WEST,BUTIRU,BUNABWANA,KHOLOMO PR. SCH.,645,3,0,3,76,366,448,23,471,0,O-67-126-02-04-03
MANAFWA,BUBULO COUNTY WEST,BUTIRU,BUNABWANA,BUTIIRI T.T.C.,494,2,1,0,60,232,295,11,306,0,O-67-126-02-04-04
MANAFWA,BUBULO COUNTY WEST,BUTIRU,BUNABWANA,BUNYINZA PR. SCH. 'C',333,2,0,1,53,182,238,12,250,0,O-67-126-02-04-05
MANAFWA,BUBULO COUNTY WEST,BUTIRU,BUNABWANA,MAHONGE CATHOLIC CHURCH,314,3,2,0,59,134,198,22,220,0,O-67-126-02-04-06
MANAFWA,BUBULO COUNTY WEST,BUTIRU,BUNABWANA,BUKALAMYA T/C,70,3,0,0,2,65,70,0,70,0,O-67-126-02-04-07
MANAFWA,BUBULO COUNTY WEST,BUTIRU,BUNABWANA,LYAMBOKO P/S,441,2,0,1,71,218,292,12,304,0,O-67-126-02-04-08
MANAFWA,BUBULO COUNTY WEST,BUTIRU,BUNYINZA,MAKENYA MKT.,401,1,2,1,60,212,276,0,276,0,O-67-126-02-05-01
MANAFWA,BUBULO COUNTY WEST,BUTIRU,BUNYINZA,BUWAYA MKT 1,515,4,0,1,85,313,403,14,417,0,O-67-126-02-05-02
MANAFWA,BUBULO COUNTY WEST,BUTIRU,BUNYINZA,BUWAYA MKT 2,534,2,0,1,135,235,373,8,381,0,O-67-126-02-05-03
MANAFWA,BUBULO COUNTY WEST,BUTIRU,BUNYINZA,NAMBALE P/S,788,5,2,2,177,398,584,14,598,0,O-67-126-02-05-04
MANAFWA,BUBULO COUNTY WEST,BUTIRU,BUNYINZA,KAYOMBE P/S,525,2,0,0,83,287,372,11,383,0,O-67-126-02-05-05
MANAFWA,BUBULO COUNTY WEST,BUTIRU,BUNYINZA,BUWASIBI T/C,288,0,0,1,50,168,219,7,226,0,O-67-126-02-05-06
MANAFWA,BUBULO COUNTY WEST,BUWAGOGO,BUBULO,BUBULO COUNTY HQRS,494,2,5,0,164,137,308,15,323,0,O-67-126-03-01-01
MANAFWA,BUBULO COUNTY WEST,BUWAGOGO,BUBULO,MAYENZE PR. SCH.,699,5,2,8,259,239,513,15,528,0,O-67-126-03-01-02
MANAFWA,BUBULO COUNTY WEST,BUWAGOGO,BUBULO,BUBULO HEALTH CENTRE,433,2,2,2,282,117,405,5,410,0,O-67-126-03-01-03
MANAFWA,BUBULO COUNTY WEST,BUWAGOGO,BUBULO,BUBULO GIRLS,469,1,4,2,175,109,291,18,309,0,O-67-126-03-01-04
MANAFWA,BUBULO COUNTY WEST,BUWAGOGO,BUBWAYA,NANYONZO PR. SCH.,552,3,4,0,147,156,310,6,316,0,O-67-126-03-02-01
MANAFWA,BUBULO COUNTY WEST,BUWAGOGO,BUBWAYA,BUBWAYA PR/SCHOOL A,675,3,4,4,226,173,410,0,410,0,O-67-126-03-02-02
MANAFWA,BUBULO COUNTY WEST,BUWAGOGO,BUBWAYA,BUBWAYA PR/SCHOOL B,261,0,3,3,60,85,151,8,159,0,O-67-126-03-02-03
MANAFWA,BUBULO COUNTY WEST,BUWAGOGO,BUBWAYA,BUMUFUNI,439,0,0,2,98,105,205,6,211,0,O-67-126-03-02-04
MANAFWA,BUBULO COUNTY WEST,BUWAGOGO,BUBWAYA,BUMWANGU,534,1,3,4,156,160,324,23,347,0,O-67-126-03-02-05
MANAFWA,BUBULO COUNTY WEST,BUWAGOGO,BUKEWA,BUKEWA DISPENSARY,453,1,2,1,216,214,434,19,453,0,O-67-126-03-03-01
MANAFWA,BUBULO COUNTY WEST,BUWAGOGO,BUKEWA,BUKEWA PR. SCH.,434,0,0,0,132,300,432,2,434,0,O-67-126-03-03-02
MANAFWA,BUBULO COUNTY WEST,BUWAGOGO,BUWAGOGO,BUNAMAHE PR/SCHOOL A,651,2,0,3,176,462,643,5,648,0,O-67-126-03-04-01
MANAFWA,BUBULO COUNTY WEST,BUWAGOGO,BUWAGOGO,SHAMUKUNGU P/S,478,2,0,0,173,290,465,3,468,0,O-67-126-03-04-02
MANAFWA,BUBULO COUNTY WEST,BUWAGOGO,BUWAGOGO,MWIKAYE T/C,713,0,0,0,0,0,0,0,0,1,O-67-126-03-04-03
MANAFWA,BUBULO COUNTY WEST,KAATO,BUKIMANYI,BUGIMANAYI GCS,376,0,0,0,248,128,376,0,376,0,O-67-126-04-01-01
MANAFWA,BUBULO COUNTY WEST,KAATO,BUKIMANYI,BUWATUWA PR. SCH. A,435,1,1,1,263,165,431,4,435,0,O-67-126-04-01-02
MANAFWA,BUBULO COUNTY WEST,KAATO,BUKIMANYI,BUWATUWA PR SCH B,267,0,1,0,102,100,203,54,257,0,O-67-126-04-01-03
MANAFWA,BUBULO COUNTY WEST,KAATO,BUKIMANYI,SHIBANGA T/C,423,2,0,1,45,364,412,5,417,0,O-67-126-04-01-04
MANAFWA,BUBULO COUNTY WEST,KAATO,BUKIMANYI,BUNABUTSALE,461,0,5,0,93,191,289,10,299,0,O-67-126-04-01-05
MANAFWA,BUBULO COUNTY WEST,KAATO,BUTOTO,BUTOTO PR. SCH.,495,4,1,1,63,272,341,0,341,0,O-67-126-04-02-01
MANAFWA,BUBULO COUNTY WEST,KAATO,BUTOTO,BUWESONGA,390,0,0,0,112,265,377,9,386,0,O-67-126-04-02-02
MANAFWA,BUBULO COUNTY WEST,KAATO,BUTOTO,BUKANZA P/S,348,0,0,0,46,294,340,6,346,0,O-67-126-04-02-03
MANAFWA,BUBULO COUNTY WEST,KAATO,BUWANGANI,BUWANGANI G.C.S. A,616,1,3,0,88,334,426,13,439,0,O-67-126-04-03-01
MANAFWA,BUBULO COUNTY WEST,KAATO,BUWANGANI,SHIKUYU PR. SCH.,808,0,1,0,220,240,461,10,471,0,O-67-126-04-03-02
MANAFWA,BUBULO COUNTY WEST,KAATO,BUWANGANI,MARONGORI CATHOLIC CHURCH,331,3,1,1,93,180,278,7,285,0,O-67-126-04-03-03
MANAFWA,BUBULO COUNTY WEST,KAATO,BUWESWA,BUWESWA PR/SCHOOL,528,2,1,3,113,256,375,18,393,0,O-67-126-04-04-01
MANAFWA,BUBULO COUNTY WEST,KAATO,BUWESWA,SHIBANGA,302,4,4,4,87,190,289,11,300,0,O-67-126-04-04-02
MANAFWA,BUBULO COUNTY WEST,KAATO,BUWESWA,BUNGOLO P/S,601,1,1,3,54,361,420,0,420,0,O-67-126-04-04-03
MANAFWA,BUBULO COUNTY WEST,SIBANGA,BULAKO,KIMALULI PRIMARY SCHOOL,597,3,0,3,76,252,334,25,359,0,O-67-126-05-01-01
MANAFWA,BUBULO COUNTY WEST,SIBANGA,BULAKO,SIBANGA E C S,429,3,2,0,40,184,229,36,265,0,O-67-126-05-01-02
MANAFWA,BUBULO COUNTY WEST,SIBANGA,BULAKO,BULAKO PR. SCH.,354,2,1,1,61,140,205,11,216,0,O-67-126-05-01-03
MANAFWA,BUBULO COUNTY WEST,SIBANGA,BULAKO,WATAKHUNA P/S,493,2,1,1,130,269,403,8,411,0,O-67-126-05-01-04
MANAFWA,BUBULO COUNTY WEST,SIBANGA,BULAKO,MULUKHU TREE,573,0,0,0,0,0,0,0,0,1,O-67-126-05-01-05
MANAFWA,BUBULO COUNTY WEST,SIBANGA,BUMATOLA,BUWALINGA CENTRE,580,4,3,4,180,161,352,21,373,0,O-67-126-05-02-01
MANAFWA,BUBULO COUNTY WEST,SIBANGA,BUMATOLA,NDOLOLELE,674,4,2,3,88,339,436,32,468,0,O-67-126-05-02-02
MANAFWA,BUBULO COUNTY WEST,SIBANGA,BUMATOLA,SISANZA CENTRE,447,0,1,2,51,301,355,15,370,0,O-67-126-05-02-03
MANAFWA,BUBULO COUNTY WEST,SIBANGA,BUMATOLA,RARAKA,314,1,0,3,238,54,296,1,297,0,O-67-126-05-02-04
MANAFWA,BUBULO COUNTY WEST,SIBANGA,BUTTA,FULUMA G.C.S.,670,3,0,2,307,314,626,43,669,0,O-67-126-05-03-01
MANAFWA,BUBULO COUNTY WEST,SIBANGA,BUTTA,NALONDO BUTTA PR. SCH,621,3,1,0,134,288,426,9,435,0,O-67-126-05-03-02
MANAFWA,BUBULO COUNTY WEST,SIBANGA,BUTTA,SIBEMBE C.O.U,474,2,4,0,121,175,302,8,310,0,O-67-126-05-03-03
MANAFWA,BUBULO COUNTY WEST,SIBANGA,BUTTA,KIBWILI T/C,333,3,3,0,102,144,252,13,265,0,O-67-126-05-03-04
MANAFWA,BUBULO COUNTY WEST,SIBANGA,BUTTA,TOOMA BUTTA P/S,257,0,0,0,0,0,0,0,0,1,O-67-126-05-03-05
MANAFWA,BUBULO COUNTY WEST,SIBANGA,BUTTA,KITSI UPLAND P/S,707,4,4,1,160,353,522,9,531,0,O-67-126-05-03-06
MANAFWA,BUBULO COUNTY WEST,SIBANGA,BUTTA,BUBITUMU II T.C,652,2,2,4,167,465,640,12,652,0,O-67-126-05-03-07
MANAFWA,BUBULO COUNTY WEST,SIBANGA,KIMALULI,BUTTA G.C.S.,789,0,41,1,200,506,748,30,778,0,O-67-126-05-04-01
MANAFWA,BUBULO COUNTY WEST,SIBANGA,KIMALULI,BUTTA PR. SCH.,477,1,1,1,87,204,294,13,307,0,O-67-126-05-04-02
MANAFWA,BUBULO COUNTY WEST,SIBANGA,KIMALULI,LWANJUSI PR. SCH.,594,7,4,5,106,315,437,3,440,0,O-67-126-05-04-03
MANAFWA,BUBULO COUNTY WEST,SIBANGA,KIMALULI,OBWANGOR CENTRE,342,2,0,4,94,153,253,27,280,0,O-67-126-05-04-04
MANAFWA,BUBULO COUNTY WEST,SIBANGA,KIMALULI,KIMALULI HIGH,342,1,0,1,57,146,205,6,211,0,O-67-126-05-04-05
PALLISA,BUDAKA COUNTY,BUDAKA,CHALI,GADUMIRE P/S,549,3,6,2,200,170,381,2,383,0,O-72-187-01-01-01
PALLISA,BUDAKA COUNTY,BUDAKA,CHALI,CHALI TRADING CENTRE,451,4,2,0,77,251,334,15,349,0,O-72-187-01-01-02
PALLISA,BUDAKA COUNTY,BUDAKA,CHALI,IRAQ T/C,380,3,0,4,97,134,238,13,251,0,O-72-187-01-01-03
PALLISA,BUDAKA COUNTY,BUDAKA,CHALI,NABIKETO T/C,305,1,2,2,63,151,219,1,220,0,O-72-187-01-01-04
PALLISA,BUDAKA COUNTY,BUDAKA,SAPIRI,BUSAGE MOSQUE,404,4,5,8,61,172,250,4,254,0,O-72-187-01-02-01
PALLISA,BUDAKA COUNTY,BUDAKA,SAPIRI,NGONDI'S TREE,328,2,3,3,65,135,208,0,208,0,O-72-187-01-02-02
PALLISA,BUDAKA COUNTY,BUDAKA,SAPIRI,POODA'S TREE,657,2,1,4,111,317,435,17,452,0,O-72-187-01-02-03
PALLISA,BUDAKA COUNTY,BUDAKA TOWN COUNCIL,BUDAKA,BUGWERE OLD SITE,695,6,3,5,146,290,450,4,454,0,O-72-187-02-01-01
PALLISA,BUDAKA COUNTY,BUDAKA TOWN COUNCIL,BUDAKA,BUGWERE NEW SITE,788,2,3,1,141,337,484,13,497,0,O-72-187-02-01-02
PALLISA,BUDAKA COUNTY,BUDAKA TOWN COUNCIL,BUDAKA,NAMIREMBE PR. SCH.,666,3,2,3,106,298,412,15,427,0,O-72-187-02-01-03
PALLISA,BUDAKA COUNTY,BUDAKA TOWN COUNCIL,MACHOLI,BUJJASI/BUKABINDI A,553,4,5,5,144,234,392,24,416,0,O-72-187-02-02-01
PALLISA,BUDAKA COUNTY,BUDAKA TOWN COUNCIL,MACHOLI,BUJJASI/BUKABINDI B,335,2,1,5,167,106,281,5,286,0,O-72-187-02-02-02
PALLISA,BUDAKA COUNTY,BUDAKA TOWN COUNCIL,MACHOLI,NAKAJETE/BWASE,696,3,2,10,125,325,465,15,480,0,O-72-187-02-02-03
PALLISA,BUDAKA COUNTY,BUDAKA TOWN COUNCIL,MACHOLI,NAKIBULU/TOWNSHIP A,582,5,3,1,134,204,347,18,365,0,O-72-187-02-02-04
PALLISA,BUDAKA COUNTY,BUDAKA TOWN COUNCIL,MACHOLI,NAKIBULU WATER TANK,412,1,1,3,128,160,293,1,294,0,O-72-187-02-02-05
PALLISA,BUDAKA COUNTY,BUDAKA TOWN COUNCIL,MACHOLI,BUDAKA P/S,265,0,0,3,49,120,172,10,182,0,O-72-187-02-02-06
PALLISA,BUDAKA COUNTY,BUDAKA TOWN COUNCIL,MACHOLI,MARKET B,528,3,0,0,83,290,376,6,382,0,O-72-187-02-02-07
PALLISA,BUDAKA COUNTY,BUDAKA TOWN COUNCIL,NAMENGO,NKWANGA'S TREE,466,3,0,4,90,232,329,15,344,0,O-72-187-02-03-01
PALLISA,BUDAKA COUNTY,BUDAKA TOWN COUNCIL,NAMENGO,NAMENGO BOYS P/S,535,2,3,2,66,291,364,15,379,0,O-72-187-02-03-02
PALLISA,BUDAKA COUNTY,IKI-IKI,IKI-IKI,BULOKI,479,4,4,2,119,180,309,12,321,0,O-72-187-03-01-01
PALLISA,BUDAKA COUNTY,IKI-IKI,IKI-IKI,IKI-IKI SCTY HQRS,466,5,10,5,98,207,325,9,334,0,O-72-187-03-01-02
PALLISA,BUDAKA COUNTY,IKI-IKI,IKI-IKI,BUGOOLA PR/SCHOOL,754,7,1,8,187,286,489,20,509,0,O-72-187-03-01-03
PALLISA,BUDAKA COUNTY,IKI-IKI,KADATUMI,KADATUMI P.S.,353,7,5,4,65,224,305,9,314,0,O-72-187-03-02-01
PALLISA,BUDAKA COUNTY,IKI-IKI,KADATUMI,KADATUMI T.C.,640,11,6,10,223,206,456,19,475,0,O-72-187-03-02-02
PALLISA,BUDAKA COUNTY,IKI-IKI,KAITANGOLE,MPANDE'S GRINDING MILL,677,13,5,9,220,223,470,33,503,0,O-72-187-03-03-01
PALLISA,BUDAKA COUNTY,IKI-IKI,KAITANGOLE,IKI- IKI INTEGRATED P.S.,587,1,6,5,158,276,446,14,460,0,O-72-187-03-03-02
PALLISA,BUDAKA COUNTY,IKI-IKI,KAKOLI,KAKOLI P.S.,596,8,5,7,177,207,404,13,417,0,O-72-187-03-04-01
PALLISA,BUDAKA COUNTY,IKI-IKI,KAKOLI,NYANZA P.S.,681,7,7,7,239,240,500,23,523,0,O-72-187-03-04-02
PALLISA,BUDAKA COUNTY,IKI-IKI,KATIRA,KATIRA CATHOLIC CHURCH,283,0,0,3,92,102,197,7,204,0,O-72-187-03-05-01
PALLISA,BUDAKA COUNTY,IKI-IKI,KATIRA,KAVULE,531,1,6,6,136,171,320,41,361,0,O-72-187-03-05-02
PALLISA,BUDAKA COUNTY,IKI-IKI,KATIRA,MUTONDA P.S.,432,4,4,7,124,176,315,22,337,0,O-72-187-03-05-03
PALLISA,BUDAKA COUNTY,IKI-IKI,KATIRA,KATIRA P.S. B,432,3,0,2,182,88,275,12,287,0,O-72-187-03-05-04
PALLISA,BUDAKA COUNTY,IKI-IKI,KATIRA,KATIRA P.S.,289,2,4,2,99,102,209,6,215,0,O-72-187-03-05-05
PALLISA,BUDAKA COUNTY,IKI-IKI,KEREKERENE,NALUWERERE T.C.,662,9,6,6,238,251,510,13,523,0,O-72-187-03-06-01
PALLISA,BUDAKA COUNTY,IKI-IKI,KEREKERENE,KEREKERENE T.C.,496,6,10,4,140,241,401,5,406,0,O-72-187-03-06-02
PALLISA,BUDAKA COUNTY,IKI-IKI,PETETE,KASULETA LC 1 CENTRE,583,2,8,2,143,258,413,7,420,0,O-72-187-03-07-01
PALLISA,BUDAKA COUNTY,IKI-IKI,PETETE,KADENGE P.S.,593,2,6,2,160,284,454,9,463,0,O-72-187-03-07-02
PALLISA,BUDAKA COUNTY,IKI-IKI,PETETE,BUGOLYA P.S.,483,4,0,1,65,193,263,3,266,0,O-72-187-03-07-03
PALLISA,BUDAKA COUNTY,IKI-IKI,PETETE,PETETE,357,2,1,0,85,263,351,0,351,0,O-72-187-03-07-04
PALLISA,BUDAKA COUNTY,KADERUNA,KABUNA,KABUNA P/S,464,7,2,7,149,202,367,0,367,0,O-72-187-04-01-01
PALLISA,BUDAKA COUNTY,KADERUNA,KABUNA,KABUNA G.C.S. LTD.,807,7,5,6,191,365,574,19,593,0,O-72-187-04-01-02
PALLISA,BUDAKA COUNTY,KADERUNA,KABUNA,KAPERI T.C,539,3,2,3,162,258,428,21,449,0,O-72-187-04-01-03
PALLISA,BUDAKA COUNTY,KADERUNA,KACHOMO,KADERUNA SCTY HQRS,695,2,4,7,139,389,541,7,548,0,O-72-187-04-02-01
PALLISA,BUDAKA COUNTY,KADERUNA,KACHOMO,BULANGIRA MUSLIM P.S.,664,7,0,6,157,286,456,11,467,0,O-72-187-04-02-02
PALLISA,BUDAKA COUNTY,KADERUNA,KACHOMO,BULALAKA,262,3,1,0,53,135,192,9,201,0,O-72-187-04-02-03
PALLISA,BUDAKA COUNTY,KADERUNA,KADENGE,KADENGHE G/TREE,566,4,2,5,150,223,384,37,421,0,O-72-187-04-03-01
PALLISA,BUDAKA COUNTY,KADERUNA,KADENGE,KADENGHE COU,468,4,1,3,155,190,353,20,373,0,O-72-187-04-03-02
PALLISA,BUDAKA COUNTY,KADERUNA,KADERUNA,NANSANSA UNDER G/T ASSESSM,466,7,0,5,97,227,336,24,360,0,O-72-187-04-04-01
PALLISA,BUDAKA COUNTY,KADERUNA,KADERUNA,NAKABALE NEAR RC I CHAIRMAN,448,4,5,5,127,210,351,13,364,0,O-72-187-04-04-02
PALLISA,BUDAKA COUNTY,KADERUNA,KADERUNA,NAKABALE - KWIRI'S PLACE,482,9,1,0,165,168,343,24,367,0,O-72-187-04-04-03
PALLISA,BUDAKA COUNTY,KADERUNA,KADERUNA,KEBULA T/C,364,2,1,7,82,181,273,27,300,0,O-72-187-04-04-04
PALLISA,BUDAKA COUNTY,KADERUNA,KIRYOLO,MIJOI,289,4,1,2,47,151,205,4,209,0,O-72-187-04-05-01
PALLISA,BUDAKA COUNTY,KADERUNA,KIRYOLO,KIRYOLO T.C.,470,5,0,5,76,260,346,9,355,0,O-72-187-04-05-02
PALLISA,BUDAKA COUNTY,KADERUNA,KIRYOLO,KIRYOLO CATHOLIC CHURCH,533,7,0,4,79,315,405,12,417,0,O-72-187-04-05-03
PALLISA,BUDAKA COUNTY,KADERUNA,KODIRI,KODIRI P.S. A,410,5,3,3,112,200,323,13,336,0,O-72-187-04-06-01
PALLISA,BUDAKA COUNTY,KADERUNA,KODIRI,KODIRI COU,484,6,4,1,114,211,336,32,368,0,O-72-187-04-06-02
PALLISA,BUDAKA COUNTY,KADERUNA,KOTINYANGA,BUNAMWERA BORE HOLE,351,5,2,1,97,174,279,12,291,0,O-72-187-04-07-01
PALLISA,BUDAKA COUNTY,KADERUNA,KOTINYANGA,KOTINYANG P/S,505,7,5,2,164,188,366,13,379,0,O-72-187-04-07-02
PALLISA,BUDAKA COUNTY,KAMERUKA,BUPUCHAI,NABUGALO T.C.,1063,5,11,6,227,497,746,19,765,0,O-72-187-05-01-01
PALLISA,BUDAKA COUNTY,KAMERUKA,BUPUCHAI,BUPUCHAI P.S.,675,2,3,4,175,373,557,13,570,0,O-72-187-05-01-02
PALLISA,BUDAKA COUNTY,KAMERUKA,KAMERUKA,NANZALA CATH. CHURCH,483,7,5,2,158,169,341,26,367,0,O-72-187-05-02-01
PALLISA,BUDAKA COUNTY,KAMERUKA,KAMERUKA,KAMERUKA P.S.,519,1,4,4,83,310,402,7,409,0,O-72-187-05-02-02
PALLISA,BUDAKA COUNTY,KAMERUKA,KAMERUKA,BUKATIKOKO C.O.U,409,5,2,2,73,237,319,10,329,0,O-72-187-05-02-03
PALLISA,BUDAKA COUNTY,KAMERUKA,KAMERUKA,NANZALA COU,457,5,3,4,94,242,348,2,350,0,O-72-187-05-02-04
PALLISA,BUDAKA COUNTY,KAMERUKA,LERYA,LERYA P.S. A,542,7,5,4,138,238,392,11,403,0,O-72-187-05-03-01
PALLISA,BUDAKA COUNTY,KAMERUKA,LERYA,GWOTO'S CHURCH,473,5,4,1,111,258,379,12,391,0,O-72-187-05-03-02
PALLISA,BUDAKA COUNTY,KAMONKOLI,JAMI,JAMI PRIMARY SCHOOL,1077,2,4,4,344,309,663,38,701,0,O-72-187-06-01-01
PALLISA,BUDAKA COUNTY,KAMONKOLI,JAMI,BUKADUKA,269,1,0,2,83,128,214,2,216,0,O-72-187-06-01-02
PALLISA,BUDAKA COUNTY,KAMONKOLI,JAMI,MULEPO'S MANGO TREE,480,3,5,2,173,167,350,9,359,0,O-72-187-06-01-03
PALLISA,BUDAKA COUNTY,KAMONKOLI,JAMI,MIVULE P/S,436,1,1,0,126,141,269,6,275,0,O-72-187-06-01-04
PALLISA,BUDAKA COUNTY,KAMONKOLI,KADIMUKOLI,KADIMUKOLI P.S.,770,6,5,2,344,171,528,15,543,0,O-72-187-06-02-01
PALLISA,BUDAKA COUNTY,KAMONKOLI,KADIMUKOLI,NFELA'S MANGO TREE,660,7,3,8,191,259,468,30,498,0,O-72-187-06-02-02
PALLISA,BUDAKA COUNTY,KAMONKOLI,KAMONKOLI,KAMONKOLI P/S,569,1,3,0,81,126,211,6,217,0,O-72-187-06-03-01
PALLISA,BUDAKA COUNTY,KAMONKOLI,KAMONKOLI,WABITU T/C,644,6,4,2,151,188,351,4,355,0,O-72-187-06-03-02
PALLISA,BUDAKA COUNTY,KAMONKOLI,KAMONKOLI,KAMONKOLI T/C,531,4,3,0,156,177,340,0,340,0,O-72-187-06-03-03
PALLISA,BUDAKA COUNTY,KAMONKOLI,KAMONKOLI,NYANZA P/S,296,0,0,0,0,0,0,0,0,1,O-72-187-06-03-04
PALLISA,BUDAKA COUNTY,KAMONKOLI,MUGITI,MUGITI T.C.,507,1,3,0,194,256,454,9,463,0,O-72-187-06-04-01
PALLISA,BUDAKA COUNTY,KAMONKOLI,MUGITI,MUGITI P/S,618,7,9,3,241,141,401,18,419,0,O-72-187-06-04-02
PALLISA,BUDAKA COUNTY,KAMONKOLI,MUGITI,MANGO TREE,608,1,3,4,172,274,454,15,469,0,O-72-187-06-04-03
PALLISA,BUDAKA COUNTY,KAMONKOLI,NYANZA,ZERUBABERIS T/C,172,0,0,0,53,71,124,5,129,0,O-72-187-06-05-01
PALLISA,BUDAKA COUNTY,KAMONKOLI,NYANZA,BWIBERU P/S,590,2,0,4,213,214,433,21,454,0,O-72-187-06-05-02
PALLISA,BUDAKA COUNTY,KAMONKOLI,NYANZA,MILO,818,8,1,6,353,163,531,33,564,0,O-72-187-06-05-03
PALLISA,BUDAKA COUNTY,KAMONKOLI,SEKULO,KWIBWILI T.C.,741,3,2,5,135,387,532,14,546,0,O-72-187-06-06-01
PALLISA,BUDAKA COUNTY,KAMONKOLI,SEKULO,KAPULUKUTU MANGO TREE,582,3,2,5,142,255,407,10,417,0,O-72-187-06-06-02
PALLISA,BUDAKA COUNTY,KAMONKOLI,SEKULO,KOSITI,729,6,3,10,229,251,499,19,518,0,O-72-187-06-06-03
PALLISA,BUDAKA COUNTY,LYAMA,LYAMA,SUNI P.S.,562,2,1,6,26,403,438,12,450,0,O-72-187-07-01-01
PALLISA,BUDAKA COUNTY,LYAMA,LYAMA,NALUBEMBE CATHOLIC CHURCH,389,1,0,1,74,196,272,3,275,0,O-72-187-07-01-02
PALLISA,BUDAKA COUNTY,LYAMA,LYAMA,KAVULE,696,1,0,1,150,326,478,18,496,0,O-72-187-07-01-03
PALLISA,BUDAKA COUNTY,LYAMA,LYAMA,NAKISENYE P.S.,793,1,10,3,130,401,545,13,558,0,O-72-187-07-01-04
PALLISA,BUDAKA COUNTY,LYAMA,LYAMA,KAKOSI,525,4,4,6,100,216,330,20,350,0,O-72-187-07-01-05
PALLISA,BUDAKA COUNTY,LYAMA,NANSANGA,NANSANGA P.S.,491,1,7,2,96,247,353,9,362,0,O-72-187-07-02-01
PALLISA,BUDAKA COUNTY,LYAMA,NANSANGA,NANSANGA PENTECOSTAL CHUR,662,2,7,3,121,313,446,16,462,0,O-72-187-07-02-02
PALLISA,BUDAKA COUNTY,LYAMA,NANSANGA,IDUDI P.S.,696,2,1,8,123,421,555,17,572,0,O-72-187-07-02-03
PALLISA,BUDAKA COUNTY,LYAMA,NANSANGA,IDUDI MOSQUE,617,1,2,1,154,271,429,8,437,0,O-72-187-07-02-04
PALLISA,BUDAKA COUNTY,LYAMA,NANSANGA,BUSIKWE T/C,325,1,1,0,108,137,247,6,253,0,O-72-187-07-02-05
PALLISA,BUDAKA COUNTY,LYAMA,TADEMERI,TADEMERI T/C,408,1,2,4,66,210,283,18,301,0,O-72-187-07-03-01
PALLISA,BUDAKA COUNTY,LYAMA,TADEMERI,LINGHOLE P.S.,512,8,3,6,47,303,367,29,396,0,O-72-187-07-03-02
PALLISA,BUDAKA COUNTY,LYAMA,TADEMERI,IRABI PLAY GROUND,470,1,2,4,80,227,314,12,326,0,O-72-187-07-03-03
PALLISA,BUDAKA COUNTY,LYAMA,TADEMERI,TADEMERI P.S.,366,1,0,4,60,190,255,9,264,0,O-72-187-07-03-04
PALLISA,BUDAKA COUNTY,NABOA,KAKULE,NAKISULE T/C,197,2,2,1,34,106,145,6,151,0,O-72-187-08-01-01
PALLISA,BUDAKA COUNTY,NABOA,KAKULE,KAKULE P.S,393,4,5,3,95,167,274,10,284,0,O-72-187-08-01-02
PALLISA,BUDAKA COUNTY,NABOA,KAKULE,KAKULE T/C,481,10,2,3,124,220,359,15,374,0,O-72-187-08-01-03
PALLISA,BUDAKA COUNTY,NABOA,KAKULE,KAMOCHA PLAY GROUND,498,4,1,1,136,234,376,17,393,0,O-72-187-08-01-04
PALLISA,BUDAKA COUNTY,NABOA,KAKULE,KIKALU MANGO TREE,501,4,5,4,113,203,329,15,344,0,O-72-187-08-01-05
PALLISA,BUDAKA COUNTY,NABOA,LUPADA,LUPADA,710,4,9,1,163,283,460,30,490,0,O-72-187-08-02-01
PALLISA,BUDAKA COUNTY,NABOA,LUPADA,NAMUSERU/BULYABA,447,3,7,3,115,208,336,13,349,0,O-72-187-08-02-02
PALLISA,BUDAKA COUNTY,NABOA,LUPADA,NAKATENDE/BUNYEKERO,836,2,6,7,168,343,526,33,559,0,O-72-187-08-02-03
PALLISA,BUDAKA COUNTY,NABOA,NABOA,BWIKOMBA,556,1,13,7,121,179,321,42,363,0,O-72-187-08-03-01
PALLISA,BUDAKA COUNTY,NABOA,NABOA,NAKATENDE BORE-HOLE,620,2,2,0,80,290,374,14,388,0,O-72-187-08-03-02
PALLISA,BUDAKA COUNTY,NABOA,NABOA,NAMAJJA,613,3,2,3,84,347,439,14,453,0,O-72-187-08-03-03
PALLISA,BUDAKA COUNTY,NABOA,NABOA,NANGEYE,363,3,2,1,86,170,262,9,271,0,O-72-187-08-03-04
PALLISA,BUDAKA COUNTY,NABOA,NAMUSITA,NAMUSITA P/S,513,8,0,2,72,285,367,12,379,0,O-72-187-08-04-01
PALLISA,BUDAKA COUNTY,NABOA,NAMUSITA,KAPANGA SUB-GRADE,723,8,1,2,178,339,528,25,553,0,O-72-187-08-04-02
PALLISA,BUDAKA COUNTY,NABOA,NAMUSITA,MANJE'S MANGO TREE,442,5,2,1,80,212,300,37,337,0,O-72-187-08-04-03
IGANGA,BUSIKI COUNTY,BULANGE,BUGOBI,BUGOBI P/S,696,3,2,6,164,287,462,17,479,0,O-75-37-01-01-01
IGANGA,BUSIKI COUNTY,BULANGE,BUGOBI,NAKAZINGA P/S,553,0,1,3,86,232,322,64,386,0,O-75-37-01-01-02
IGANGA,BUSIKI COUNTY,BULANGE,BUGOBI,KIBIGO T/C,274,2,3,6,47,135,193,4,197,0,O-75-37-01-01-03
IGANGA,BUSIKI COUNTY,BULANGE,BUKENGA,NAWANDYO P/S,704,5,0,1,122,306,434,42,476,0,O-75-37-01-02-01
IGANGA,BUSIKI COUNTY,BULANGE,BUKENGA,BUBUSA P/S,307,1,0,1,30,160,192,5,197,0,O-75-37-01-02-02
IGANGA,BUSIKI COUNTY,BULANGE,BUKENGA,NAWANDAGALA T/CENTRE,318,2,4,2,36,191,235,4,239,0,O-75-37-01-02-03
IGANGA,BUSIKI COUNTY,BULANGE,BUKENGA,NSONGWE CHURCH/UGANDA,276,2,0,0,25,173,200,4,204,0,O-75-37-01-02-04
IGANGA,BUSIKI COUNTY,BULANGE,BUKENGA,BUFUYA APOSTOLIC CHURCH,522,6,8,6,80,239,339,11,350,0,O-75-37-01-02-05
IGANGA,BUSIKI COUNTY,BULANGE,BULANGE,BULANGE S/COUNTY HQRS A,410,2,4,2,76,175,259,14,273,0,O-75-37-01-03-01
IGANGA,BUSIKI COUNTY,BULANGE,BULANGE,BULANGE S\COUNTY HQRS B,551,0,5,2,120,227,354,5,359,0,O-75-37-01-03-02
IGANGA,BUSIKI COUNTY,BULANGE,BULANGE,BULANGE S/C HQRS,444,1,2,3,86,178,270,7,277,0,O-75-37-01-03-03
IGANGA,BUSIKI COUNTY,BULANGE,BULANGE,BUWAYUYA TC,386,3,5,2,78,163,251,11,262,0,O-75-37-01-03-04
IGANGA,BUSIKI COUNTY,BULANGE,BUWAGA,BUBUTYA P/S,642,4,10,7,133,295,449,9,458,0,O-75-37-01-04-01
IGANGA,BUSIKI COUNTY,BULANGE,BUWAGA,BUWAGA T/CENTRE,729,10,14,7,158,339,528,14,542,0,O-75-37-01-04-02
IGANGA,BUSIKI COUNTY,BULANGE,BUWAGA,BUTAGOLI T/CENTRE,652,8,12,5,130,244,399,17,416,0,O-75-37-01-04-03
IGANGA,BUSIKI COUNTY,BULANGE,KIREREMA,NABBANJA MARKET,608,4,3,6,77,360,450,0,450,0,O-75-37-01-05-01
IGANGA,BUSIKI COUNTY,BULANGE,KIREREMA,BUDUNDA P/S,466,2,6,3,67,267,345,13,358,0,O-75-37-01-05-02
IGANGA,BUSIKI COUNTY,BULANGE,KIREREMA,BUNAIBBAMBA P/S,399,1,5,0,65,192,263,16,279,0,O-75-37-01-05-03
IGANGA,BUSIKI COUNTY,BULANGE,KISIIRO,KISIIRO PRIMARY SCHOOL,530,4,6,0,125,220,355,13,368,0,O-75-37-01-06-01
IGANGA,BUSIKI COUNTY,BULANGE,KISIIRO,BUWANGA CATHOLIC CHURCH,717,3,14,6,169,308,500,5,505,0,O-75-37-01-06-02
IGANGA,BUSIKI COUNTY,BULANGE,KISIIRO,LUGULU T/C,238,3,4,4,26,148,185,8,193,0,O-75-37-01-06-03
IGANGA,BUSIKI COUNTY,BULANGE,MPUMIRO,MPUMIRO PR/SCHOOL,580,4,11,7,83,272,377,21,398,0,O-75-37-01-07-01
IGANGA,BUSIKI COUNTY,BULANGE,MPUMIRO,BUYOBOYA COU,454,1,1,0,107,224,333,5,338,0,O-75-37-01-07-02
IGANGA,BUSIKI COUNTY,IVUKULA,BUWALIRA,BUWALIRA P/S,452,1,0,0,35,336,372,3,375,0,O-75-37-02-01-01
IGANGA,BUSIKI COUNTY,IVUKULA,BUWALIRA,BUDOMERO COOP. SOCIETY,535,0,2,4,49,360,415,12,427,0,O-75-37-02-01-02
IGANGA,BUSIKI COUNTY,IVUKULA,BUWALIRA,NAWANZOGI CENTRE,610,0,0,0,19,474,493,5,498,0,O-75-37-02-01-03
IGANGA,BUSIKI COUNTY,IVUKULA,BUWALIRA,BUGWE CENTRE,418,2,1,1,41,268,313,13,326,0,O-75-37-02-01-04
IGANGA,BUSIKI COUNTY,IVUKULA,BUWALIRA,BUNANGWE MANGO TREE,589,2,0,3,24,447,476,10,486,0,O-75-37-02-01-05
IGANGA,BUSIKI COUNTY,IVUKULA,IVUKULA,KANDOKE P/S,456,1,1,2,41,292,337,16,353,0,O-75-37-02-02-01
IGANGA,BUSIKI COUNTY,IVUKULA,IVUKULA,KIRANGA CENTRE,327,1,0,5,5,265,276,9,285,0,O-75-37-02-02-02
IGANGA,BUSIKI COUNTY,IVUKULA,IVUKULA,IVUKULA P/S A,497,4,1,2,37,288,332,17,349,0,O-75-37-02-02-03
IGANGA,BUSIKI COUNTY,IVUKULA,IVUKULA,IVUKULA P/S B,355,2,0,4,55,164,225,8,233,0,O-75-37-02-02-04
IGANGA,BUSIKI COUNTY,IVUKULA,IWUNGIRO,KIGUNDA CENTRE A,668,2,2,0,60,382,446,8,454,0,O-75-37-02-03-01
IGANGA,BUSIKI COUNTY,IVUKULA,IWUNGIRO,IWUNGIRO CENTRE,619,1,0,4,42,393,440,8,448,0,O-75-37-02-03-02
IGANGA,BUSIKI COUNTY,IVUKULA,IWUNGIRO,NAMAKOKO,664,3,1,3,43,443,493,15,508,0,O-75-37-02-03-03
IGANGA,BUSIKI COUNTY,IVUKULA,IWUNGIRO,KIGUNDA CENTRE B,383,0,0,1,24,244,269,9,278,0,O-75-37-02-03-04
IGANGA,BUSIKI COUNTY,IVUKULA,LWATAMA,LWATAMA CATH. CHURCH B,736,1,0,2,43,463,509,4,513,0,O-75-37-02-04-01
IGANGA,BUSIKI COUNTY,IVUKULA,LWATAMA,KIRONGO P/S,492,0,0,3,33,389,425,12,437,0,O-75-37-02-04-02
IGANGA,BUSIKI COUNTY,IVUKULA,LWATAMA,LWATAMA T/CENTRE,416,1,0,1,18,254,274,46,320,0,O-75-37-02-04-03
IGANGA,BUSIKI COUNTY,IVUKULA,LWATAMA,LWATAMA CATH. CHURCH B,305,0,0,0,4,242,246,7,253,0,O-75-37-02-04-04
IGANGA,BUSIKI COUNTY,IVUKULA,MPANDE (KISEWUZI),IVUKULA S/C HQRS,484,1,0,3,30,317,351,23,374,0,O-75-37-02-05-01
IGANGA,BUSIKI COUNTY,IVUKULA,MPANDE (KISEWUZI),KISOWOZI CENTRE,419,1,1,0,72,248,322,10,332,0,O-75-37-02-05-02
IGANGA,BUSIKI COUNTY,IVUKULA,MPANDE (KISEWUZI),MPANDE CENTRE,699,2,1,5,71,340,419,30,449,0,O-75-37-02-05-03
IGANGA,BUSIKI COUNTY,IVUKULA,NABITULA,NABITULA CENTRE A,373,3,0,1,77,193,274,7,281,0,O-75-37-02-06-01
IGANGA,BUSIKI COUNTY,IVUKULA,NABITULA,NABITULA CENTRE B,596,2,1,1,54,400,458,8,466,0,O-75-37-02-06-02
IGANGA,BUSIKI COUNTY,IVUKULA,NABITULA,NABITULA CENTRE C,640,0,0,0,63,334,397,9,406,0,O-75-37-02-06-03
IGANGA,BUSIKI COUNTY,KIBAALE,KIBAALE,NAMAKOKO CENTRE A,574,0,1,0,64,241,306,67,373,0,O-75-37-03-01-01
IGANGA,BUSIKI COUNTY,KIBAALE,KIBAALE,NAMAKOKO CENTRE B,206,0,0,0,8,141,149,6,155,0,O-75-37-03-01-02
IGANGA,BUSIKI COUNTY,KIBAALE,KIBAALE,KIBAALE P/S,650,2,3,5,122,309,441,10,451,0,O-75-37-03-01-03
IGANGA,BUSIKI COUNTY,KIBAALE,KIBAALE,BUWALI STATION,326,1,1,1,36,113,152,50,202,0,O-75-37-03-01-04
IGANGA,BUSIKI COUNTY,KIBAALE,KISEGA,KASOZI CENTRE,531,0,1,1,51,325,378,4,382,0,O-75-37-03-02-01
IGANGA,BUSIKI COUNTY,KIBAALE,KISEGA,KISEGA CENTRE A,421,1,0,0,27,204,232,52,284,0,O-75-37-03-02-02
IGANGA,BUSIKI COUNTY,KIBAALE,KISEGA,KISEGA CENTRE B,452,2,1,5,30,313,351,7,358,0,O-75-37-03-02-03
IGANGA,BUSIKI COUNTY,KIBAALE,NABISOIGI,NABISOIGI P/S,563,0,1,1,95,236,333,22,355,0,O-75-37-03-03-01
IGANGA,BUSIKI COUNTY,KIBAALE,NABISOIGI,NAWANDYO CENTRE,561,3,3,1,111,303,421,12,433,0,O-75-37-03-03-02
IGANGA,BUSIKI COUNTY,KIBAALE,NABISOIGI,NAKYERE CENTRE,461,1,2,0,20,301,324,9,333,0,O-75-37-03-03-03
IGANGA,BUSIKI COUNTY,KIBAALE,NABISOIGI,MPULIRA P/S,565,3,2,3,105,216,329,33,362,0,O-75-37-03-03-04
IGANGA,BUSIKI COUNTY,KIBAALE,NABWEYO,NABWEYO CENTRE,690,1,1,4,84,347,437,20,457,0,O-75-37-03-04-01
IGANGA,BUSIKI COUNTY,KIBAALE,NABWEYO,BUDATU CENTRE A,586,3,0,4,37,391,435,6,441,0,O-75-37-03-04-02
IGANGA,BUSIKI COUNTY,KIBAALE,NABWEYO,BUDATU CENTRE B,357,1,0,0,21,211,233,24,257,0,O-75-37-03-04-03
IGANGA,BUSIKI COUNTY,KIBAALE,NABWEYO,BUSINDI MOSQUE,753,1,7,3,120,416,547,18,565,0,O-75-37-03-04-04
IGANGA,BUSIKI COUNTY,KIBAALE,NAWANGAIZA,KAKUNYU CENTRE,529,2,0,1,18,280,301,65,366,0,O-75-37-03-05-01
IGANGA,BUSIKI COUNTY,KIBAALE,NAWANGAIZA,KINDAGO CENTRE,604,2,8,0,52,337,399,39,438,0,O-75-37-03-05-02
IGANGA,BUSIKI COUNTY,KIBAALE,NAWANGAIZA,BUDWAPA CENTRE,586,1,0,2,37,315,355,51,406,0,O-75-37-03-05-03
IGANGA,BUSIKI COUNTY,KIBAALE,NAWANGAIZA,NAWANGAIZA CENTRE,214,1,0,1,10,145,157,14,171,0,O-75-37-03-05-04
IGANGA,BUSIKI COUNTY,MAGADA,IZIRANGOBI,MULAMA T/CENTRE,659,5,2,1,64,449,521,14,535,0,O-75-37-04-01-01
IGANGA,BUSIKI COUNTY,MAGADA,IZIRANGOBI,BUWIDI P/S,421,2,4,1,45,259,311,3,314,0,O-75-37-04-01-02
IGANGA,BUSIKI COUNTY,MAGADA,IZIRANGOBI,KAITI COUNTY HQRS A,432,7,4,1,63,220,295,19,314,0,O-75-37-04-01-03
IGANGA,BUSIKI COUNTY,MAGADA,IZIRANGOBI,KAITI COUNTY HQRS B,485,1,2,0,80,215,298,14,312,0,O-75-37-04-01-04
IGANGA,BUSIKI COUNTY,MAGADA,IZIRANGOBI,KAITI CO-OP SOC,274,0,0,1,34,154,189,29,218,0,O-75-37-04-01-05
IGANGA,BUSIKI COUNTY,MAGADA,KAGULU,IRWANIRO P/S,490,2,1,0,44,253,300,64,364,0,O-75-37-04-02-01
IGANGA,BUSIKI COUNTY,MAGADA,KAGULU,NABWEYO T/CENTRE,722,9,0,5,88,409,511,15,526,0,O-75-37-04-02-02
IGANGA,BUSIKI COUNTY,MAGADA,KAGULU,KAGULU MARKET,805,9,2,12,153,373,549,23,572,0,O-75-37-04-02-03
IGANGA,BUSIKI COUNTY,MAGADA,KIWANYI,NABIKABALA P/S,549,2,0,0,56,248,306,87,393,0,O-75-37-04-03-01
IGANGA,BUSIKI COUNTY,MAGADA,KIWANYI,KALITUMBA MARKET A,569,4,6,4,70,314,398,12,410,0,O-75-37-04-03-02
IGANGA,BUSIKI COUNTY,MAGADA,KIWANYI,KALILUMBA MARKET B,413,3,8,1,60,201,273,10,283,0,O-75-37-04-03-03
IGANGA,BUSIKI COUNTY,MAGADA,MAGADA,JALUKO T/CENTRE,547,3,2,3,161,244,413,9,422,0,O-75-37-04-04-01
IGANGA,BUSIKI COUNTY,MAGADA,MAGADA,MAGADA MARKET,543,2,2,4,53,312,373,30,403,0,O-75-37-04-04-02
IGANGA,BUSIKI COUNTY,MAGADA,MAGADA,BUYANGE T/CENTRE,712,0,1,1,72,318,392,17,409,0,O-75-37-04-04-03
IGANGA,BUSIKI COUNTY,MAGADA,MAGADA,BULAGAZI SUB-GRADE SCH,210,0,0,0,7,125,132,30,162,0,O-75-37-04-04-04
IGANGA,BUSIKI COUNTY,MAGADA,MAZUBA,MAZUBA T/CENTRE,516,1,1,3,111,200,316,21,337,0,O-75-37-04-05-01
IGANGA,BUSIKI COUNTY,MAGADA,MAZUBA,IRIMBI HEALTH UNIT,392,2,3,2,91,172,270,13,283,0,O-75-37-04-05-02
IGANGA,BUSIKI COUNTY,MAGADA,MAZUBA,NSOLA COOP. SOCIETY,511,2,0,6,33,275,316,28,344,0,O-75-37-04-05-03
IGANGA,BUSIKI COUNTY,MAGADA,MAZUBA,NSOLA SUB-GRADE SCH,439,1,0,3,77,265,346,7,353,0,O-75-37-04-05-04
IGANGA,BUSIKI COUNTY,MAGADA,MAZUBA,MULEMBA CATH CHURCH,290,2,1,3,59,143,208,6,214,0,O-75-37-04-05-05
IGANGA,BUSIKI COUNTY,MAGADA,MAZUBA,MAZUBA MOSQUE,722,9,4,9,168,264,454,28,482,0,O-75-37-04-05-06
IGANGA,BUSIKI COUNTY,MAGADA,MAZUBA,MOMBASA,362,2,0,2,48,120,172,48,220,0,O-75-37-04-05-07
IGANGA,BUSIKI COUNTY,MAGADA,NABINYONYI,IRONDO JUNCTION,726,3,2,2,98,400,505,8,513,0,O-75-37-04-06-01
IGANGA,BUSIKI COUNTY,MAGADA,NABINYONYI,NABINYONYI MARKET,708,3,1,1,37,435,477,15,492,0,O-75-37-04-06-02
IGANGA,BUSIKI COUNTY,MAGADA,NABINYONYI,NSOLA P/S,770,1,0,3,4,301,309,108,417,0,O-75-37-04-06-03
IGANGA,BUSIKI COUNTY,MAGADA,NABINYONYI,GADUMIRE P/S,199,2,0,2,8,139,151,3,154,0,O-75-37-04-06-04
IGANGA,BUSIKI COUNTY,NAMUTUMBA,ITUBA,ITUBA GROUND,521,0,0,4,78,288,370,3,373,0,O-75-37-05-01-01
IGANGA,BUSIKI COUNTY,NAMUTUMBA,ITUBA,NAMUWONDO P/S,575,2,3,3,79,333,420,4,424,0,O-75-37-05-01-02
IGANGA,BUSIKI COUNTY,NAMUTUMBA,ITUBA,NAWAMPANDU P/S,550,2,3,2,68,266,341,71,412,0,O-75-37-05-01-03
IGANGA,BUSIKI COUNTY,NAMUTUMBA,KIGALAMA,NAMATO P/S,659,2,1,1,77,346,427,6,433,0,O-75-37-05-02-01
IGANGA,BUSIKI COUNTY,NAMUTUMBA,KIGALAMA,KIGALAMA P/S A,553,3,5,3,55,323,389,20,409,0,O-75-37-05-02-02
IGANGA,BUSIKI COUNTY,NAMUTUMBA,KIGALAMA,KIGALAMA P/S B,322,1,2,2,43,196,244,7,251,0,O-75-37-05-02-03
IGANGA,BUSIKI COUNTY,NAMUTUMBA,KIGALAMA,NAMAKOBA GROUND,248,2,8,0,51,109,170,2,172,0,O-75-37-05-02-04
IGANGA,BUSIKI COUNTY,NAMUTUMBA,NAKALOKWE,MAWUNGWE T/CENTRE,463,1,2,5,180,105,293,22,315,0,O-75-37-05-03-01
IGANGA,BUSIKI COUNTY,NAMUTUMBA,NAKALOKWE,BUNYAGWE CHURCH/UGANDA,434,1,3,1,36,235,276,4,280,0,O-75-37-05-03-02
IGANGA,BUSIKI COUNTY,NAMUTUMBA,NAKALOKWE,IGERERA PR/ SCHOOL,670,3,2,1,100,303,409,12,421,0,O-75-37-05-03-03
IGANGA,BUSIKI COUNTY,NAMUTUMBA,NAKALOKWE,MZEE SALMIN'S PLACE,485,3,2,1,121,183,310,8,318,0,O-75-37-05-03-04
IGANGA,BUSIKI COUNTY,NAMUTUMBA,NAKYERE,BULYABWITA C/UGANDA,461,0,1,0,38,256,295,34,329,0,O-75-37-05-04-01
IGANGA,BUSIKI COUNTY,NAMUTUMBA,NAKYERE,NAKYERE COOP SOCIETY,421,1,3,0,66,218,288,15,303,0,O-75-37-05-04-02
IGANGA,BUSIKI COUNTY,NAMUTUMBA,NAKYERE,KASEHERE C/UGANDA,318,1,3,0,30,267,301,5,306,0,O-75-37-05-04-03
IGANGA,BUSIKI COUNTY,NAMUTUMBA,NAMUTUMBA,NAMUTUMBA S/C HQRS A,328,0,1,2,75,102,180,1,181,0,O-75-37-05-05-01
IGANGA,BUSIKI COUNTY,NAMUTUMBA,NAMUTUMBA,NAMUTUMBA S/C HQRS B,689,0,1,2,75,102,180,1,181,0,O-75-37-05-05-02
IGANGA,BUSIKI COUNTY,NAMUTUMBA,NAMUTUMBA,BUWAMBI P/S,233,0,0,0,19,140,159,5,164,0,O-75-37-05-05-03
IGANGA,BUSIKI COUNTY,NAMUTUMBA,NAMUTUMBA,NAMUTUMBA S/C HQRS C,665,3,3,1,153,288,448,12,460,0,O-75-37-05-05-04
IGANGA,BUSIKI COUNTY,NAMUTUMBA,NAMUTUMBA,NAMUTUMBA C/UGANDA B,565,1,1,0,154,174,330,12,342,0,O-75-37-05-05-05
IGANGA,BUSIKI COUNTY,NAMUTUMBA,NAMUTUMBA,KAGULUMO ADVENTIST CHURCH,154,2,0,2,24,62,90,0,90,0,O-75-37-05-05-06
IGANGA,BUSIKI COUNTY,NAMUTUMBA,NAMUTUMBA,KANGULUMO P/S,406,0,2,3,72,133,210,7,217,0,O-75-37-05-05-07
IGANGA,BUSIKI COUNTY,NAMUTUMBA,NAWANSAGWA,NAMUSENO GROUND,393,1,0,3,51,194,249,5,254,0,O-75-37-05-06-01
IGANGA,BUSIKI COUNTY,NAMUTUMBA,NAWANSAGWA,KIZUBA P/S (A-M),434,2,3,0,94,108,207,83,290,0,O-75-37-05-06-02
IGANGA,BUSIKI COUNTY,NAMUTUMBA,NAWANSAGWA,NAWANSAGWA CHURCH OF UGA,327,4,2,0,39,185,230,5,235,0,O-75-37-05-06-03
IGANGA,BUSIKI COUNTY,NAMUTUMBA,NAWANSAGWA,NAWANSAGWA C/UGANDA B,510,2,3,2,92,194,293,12,305,0,O-75-37-05-06-04
IGANGA,BUSIKI COUNTY,NAMUTUMBA,NAWANSAGWA,NAWANSAGWA C/UGANDA C(A-M),451,2,8,2,97,139,248,13,261,0,O-75-37-05-06-05
IGANGA,BUSIKI COUNTY,NAMUTUMBA,NAWANSAGWA,NTALINGA CHURCH OF UGANDA,205,0,2,0,29,88,119,20,139,0,O-75-37-05-06-06
IGANGA,BUSIKI COUNTY,NAMUTUMBA,NAWANSAGWA,KIZUBA P/S (N-Z),335,4,0,4,86,130,224,21,245,0,O-75-37-05-06-07
IGANGA,BUSIKI COUNTY,NAMUTUMBA,NAWANSAGWA,NAWANSAGWA C/UGANDA C(N-Z),412,2,0,0,79,114,195,0,195,0,O-75-37-05-06-08
IGANGA,BUSIKI COUNTY,NSINZE,BUBAGO,BUBAGO P/S,622,2,0,0,58,290,350,21,371,0,O-75-37-06-01-01
IGANGA,BUSIKI COUNTY,NSINZE,BUBAGO,BULAGALA CENTRE,217,1,0,0,32,99,132,28,160,0,O-75-37-06-01-02
IGANGA,BUSIKI COUNTY,NSINZE,BUBAGO,NAMBOTE CENTRE,591,1,3,7,132,265,408,18,426,0,O-75-37-06-01-03
IGANGA,BUSIKI COUNTY,NSINZE,BUKONTE,BUDHATEMWA CATH CH A,497,2,1,2,83,237,325,13,338,0,O-75-37-06-02-01
IGANGA,BUSIKI COUNTY,NSINZE,BUKONTE,BUDHATEMWA CATH CH B,405,2,0,3,34,248,287,12,299,0,O-75-37-06-02-02
IGANGA,BUSIKI COUNTY,NSINZE,BUKONTE,BULONGO P/S A,476,2,2,2,93,193,292,8,300,0,O-75-37-06-02-03
IGANGA,BUSIKI COUNTY,NSINZE,BUKONTE,BULONGO P/S B,542,1,0,1,54,301,357,20,377,0,O-75-37-06-02-04
IGANGA,BUSIKI COUNTY,NSINZE,BUWONGO,BUWONGO CHURCH OF UGANDA,454,2,5,2,128,155,292,9,301,0,O-75-37-06-03-01
IGANGA,BUSIKI COUNTY,NSINZE,BUWONGO,BUNYWAAGWE S/GRADE SCH,438,0,2,3,113,164,282,9,291,0,O-75-37-06-03-02
IGANGA,BUSIKI COUNTY,NSINZE,BUWONGO,MALINGA CENTRE,235,3,0,1,37,108,149,3,152,0,O-75-37-06-03-03
IGANGA,BUSIKI COUNTY,NSINZE,BUWONGO,BUWONGO T/C,270,0,2,0,57,90,149,5,154,0,O-75-37-06-03-04
IGANGA,BUSIKI COUNTY,NSINZE,NAWAIKONA,KIVULE P/S,533,2,1,3,32,318,356,18,374,0,O-75-37-06-04-01
IGANGA,BUSIKI COUNTY,NSINZE,NAWAIKONA,NAWAIKONA P/S,641,1,2,2,79,275,359,106,465,0,O-75-37-06-04-02
IGANGA,BUSIKI COUNTY,NSINZE,NAWAIKONA,NABIKENGE CENTRE,119,0,1,2,16,85,104,5,109,0,O-75-37-06-04-03
IGANGA,BUSIKI COUNTY,NSINZE,NSINZE,NSINZE COMMUNITY CENTRE,676,5,1,6,99,310,421,15,436,0,O-75-37-06-05-01
IGANGA,BUSIKI COUNTY,NSINZE,NSINZE,ISEGERO P/S A,501,1,0,0,37,180,218,61,279,0,O-75-37-06-05-02
IGANGA,BUSIKI COUNTY,NSINZE,NSINZE,ISEGERO P/S B,554,2,2,2,91,288,385,8,393,0,O-75-37-06-05-03
MANAFWA,MANJIYA COUNTY,BUBIITA,BUKALASI,MALANDU GCS,461,2,3,0,58,390,453,8,461,0,O-78-133-01-01-01
MANAFWA,MANJIYA COUNTY,BUBIITA,BUKALASI,ITIMBWA MKT,765,1,3,5,59,449,517,27,544,0,O-78-133-01-01-02
MANAFWA,MANJIYA COUNTY,BUBIITA,BUMAKITA,BUMAKHWA,323,2,0,2,82,139,225,5,230,0,O-78-133-01-02-01
MANAFWA,MANJIYA COUNTY,BUBIITA,BUMAKITA,BUNASABA,563,3,2,4,129,216,354,9,363,0,O-78-133-01-02-02
MANAFWA,MANJIYA COUNTY,BUBIITA,BUMUSI,BUMUSI G.C.S.,721,7,2,5,149,265,428,28,456,0,O-78-133-01-03-01
MANAFWA,MANJIYA COUNTY,BUBIITA,BUNDESI,BUNDESI PR SCH,756,2,1,2,37,503,545,20,565,0,O-78-133-01-04-01
MANAFWA,MANJIYA COUNTY,BUBIITA,BUWAGIYU,SHIKALA PR. SCH,610,3,1,2,110,271,387,7,394,0,O-78-133-01-05-01
MANAFWA,MANJIYA COUNTY,BUBIITA,BUWAGIYU,BUNANGO,465,2,2,1,92,236,333,3,336,0,O-78-133-01-05-02
MANAFWA,MANJIYA COUNTY,BUBIITA,BUWALI,BUMATI G.C.S.,542,2,2,7,79,301,391,26,417,0,O-78-133-01-06-01
MANAFWA,MANJIYA COUNTY,BUBIITA,BUWALI,WEKOBOSA,706,2,2,5,123,349,481,30,511,0,O-78-133-01-06-02
MANAFWA,MANJIYA COUNTY,BUBIITA,BUWALI,TSAASA,501,2,1,8,44,311,366,21,387,0,O-78-133-01-06-03
MANAFWA,MANJIYA COUNTY,BUBIITA,BUWALI,KITSAWA P/S,247,0,0,0,35,146,181,12,193,0,O-78-133-01-06-04
MANAFWA,MANJIYA COUNTY,BUBIITA,MAABA,BUSOOTO,686,2,3,2,146,314,467,14,481,0,O-78-133-01-07-01
MANAFWA,MANJIYA COUNTY,BUBIITA,MAABA,BUSHIMALI P/S,362,4,0,2,58,204,268,8,276,0,O-78-133-01-07-02
MANAFWA,MANJIYA COUNTY,BUBIITA,MAABA,BUWANYANGA,616,1,2,2,84,351,440,5,445,0,O-78-133-01-07-03
MANAFWA,MANJIYA COUNTY,BUBIITA,NABULALO,LUBIRI P/S,533,3,1,0,40,264,308,11,319,0,O-78-133-01-08-01
MANAFWA,MANJIYA COUNTY,BUBIITA,NABULALO,NANYERE MARKET,370,2,0,1,37,249,289,17,306,0,O-78-133-01-08-02
MANAFWA,MANJIYA COUNTY,BUBIITA,NAMATESI,NAMETSI,455,2,1,0,41,397,441,0,441,0,O-78-133-01-09-01
MANAFWA,MANJIYA COUNTY,BUBIITA,NAMATESI,BUKIBALELA,583,1,2,1,54,386,444,4,448,0,O-78-133-01-09-02
MANAFWA,MANJIYA COUNTY,BUBIITA,NAMATESI,MASAKHANU P/S,279,1,1,0,26,244,272,5,277,0,O-78-133-01-09-03
MANAFWA,MANJIYA COUNTY,BUDUDA,BUKIBINO,BUKHABELE,509,2,2,3,190,106,303,11,314,0,O-78-133-02-01-01
MANAFWA,MANJIYA COUNTY,BUDUDA,BUKIBINO,NAMAITSU PR SCH,672,3,4,5,245,194,451,15,466,0,O-78-133-02-01-02
MANAFWA,MANJIYA COUNTY,BUDUDA,BUKIBINO,MAKALAMA P/S,324,1,2,1,140,91,235,9,244,0,O-78-133-02-01-03
MANAFWA,MANJIYA COUNTY,BUDUDA,BUSAI,SHISABASI PR SCH,617,4,0,3,161,260,428,20,448,0,O-78-133-02-02-01
MANAFWA,MANJIYA COUNTY,BUDUDA,BUSAI,BUDUDA PR SCH,683,8,2,2,184,262,458,16,474,0,O-78-133-02-02-02
MANAFWA,MANJIYA COUNTY,BUDUDA,BUSHINYEKWA,NASULA G.C.S.,398,0,0,1,72,182,255,7,262,0,O-78-133-02-03-01
MANAFWA,MANJIYA COUNTY,BUDUDA,BUSHINYEKWA,BUDUDA S/C HQTRS,478,3,2,2,102,179,288,6,294,0,O-78-133-02-03-02
MANAFWA,MANJIYA COUNTY,BUDUDA,BUSHINYEKWA,BUNEMBE PR SCH,619,4,5,5,115,260,389,24,413,0,O-78-133-02-03-03
MANAFWA,MANJIYA COUNTY,BUDUDA,BUSHINYEKWA,BUDUDA S/C HQTRS,285,0,3,1,58,115,177,10,187,0,O-78-133-02-03-04
MANAFWA,MANJIYA COUNTY,BUDUDA,BUSHINYEKWA,BULOLI C.O.U,267,2,1,0,45,112,160,8,168,0,O-78-133-02-03-05
MANAFWA,MANJIYA COUNTY,BUDUDA,BUSHINYEKWA,BUKHALALI T/C,254,1,0,0,42,137,180,6,186,0,O-78-133-02-03-06
MANAFWA,MANJIYA COUNTY,BUKIBOKOLO,BUKIBOKOLO,WALUKHANE TREE,431,3,0,4,41,224,272,5,277,0,O-78-133-03-01-01
MANAFWA,MANJIYA COUNTY,BUKIBOKOLO,BUKIBOKOLO,BUWANYANGA BUSHINYALE,296,2,0,2,35,168,207,0,207,0,O-78-133-03-01-02
MANAFWA,MANJIYA COUNTY,BUKIBOKOLO,BUKIBOKOLO,BUNAMUWENJE C.O.U,569,0,1,5,62,203,271,8,279,0,O-78-133-03-01-03
MANAFWA,MANJIYA COUNTY,BUKIBOKOLO,BUKIBOKOLO,BUKIBOKOLO GCS,501,11,2,8,89,195,305,20,325,0,O-78-133-03-01-04
MANAFWA,MANJIYA COUNTY,BUKIBOKOLO,BUKIBOKOLO,BUKHURA P.S,210,1,0,4,29,128,162,8,170,0,O-78-133-03-01-05
MANAFWA,MANJIYA COUNTY,BUKIBOKOLO,BUNAMUKYE,LUNGANGA PR SCH,397,0,0,3,34,255,292,13,305,0,O-78-133-03-02-01
MANAFWA,MANJIYA COUNTY,BUKIBOKOLO,BUNAMUKYE,BUSAMALI C/U,325,2,0,2,28,177,209,17,226,0,O-78-133-03-02-02
MANAFWA,MANJIYA COUNTY,BUKIBOKOLO,BUNAMUKYE,BUWAKHATA PR SCH,275,1,0,2,61,121,185,15,200,0,O-78-133-03-02-03
MANAFWA,MANJIYA COUNTY,BUKIBOKOLO,BUNAMUKYE,MULYALYA'S PLACE,390,1,1,2,80,257,341,5,346,0,O-78-133-03-02-04
MANAFWA,MANJIYA COUNTY,BUKIBOKOLO,BUNAMUKYE,NANYOTSO,183,1,1,1,49,71,123,12,135,0,O-78-133-03-02-05
MANAFWA,MANJIYA COUNTY,BUKIBOKOLO,BWIRIMBI,BUKARI PR SCH,339,1,2,2,36,223,264,12,276,0,O-78-133-03-03-01
MANAFWA,MANJIYA COUNTY,BUKIBOKOLO,BWIRIMBI,BULUMINO CATHOLIC CHURCH,355,2,0,3,34,229,268,3,271,0,O-78-133-03-03-02
MANAFWA,MANJIYA COUNTY,BUKIBOKOLO,BWIRIMBI,NALALI G.C.S,563,2,1,1,91,450,545,0,545,0,O-78-133-03-03-03
MANAFWA,MANJIYA COUNTY,BUKIGAI,BUFUKULA,MUTUBA'S,828,1,0,1,154,362,518,3,521,0,O-78-133-04-01-01
MANAFWA,MANJIYA COUNTY,BUKIGAI,BUFUKULA,BUNAKHAYENZE,525,1,2,2,67,339,411,16,427,0,O-78-133-04-01-02
MANAFWA,MANJIYA COUNTY,BUKIGAI,BULOBI,BULOBI G.C.S.,508,1,2,0,85,349,437,2,439,0,O-78-133-04-02-01
MANAFWA,MANJIYA COUNTY,BUKIGAI,BULOBI,NAMYENDO,679,5,0,6,92,344,447,18,465,0,O-78-133-04-02-02
MANAFWA,MANJIYA COUNTY,BUKIGAI,BUMAKUMA,BUKITONGO A,535,3,0,1,118,223,345,13,358,0,O-78-133-04-03-01
MANAFWA,MANJIYA COUNTY,BUKIGAI,BUMAKUMA,BUKITONGO B,391,0,0,3,50,228,281,9,290,0,O-78-133-04-03-02
MANAFWA,MANJIYA COUNTY,BUKIGAI,BUMATANDA,BUMUKOYA S/C HQRS,687,2,7,3,146,269,427,8,435,0,O-78-133-04-04-01
MANAFWA,MANJIYA COUNTY,BUKIGAI,BUMATANDA,NUTRITION PROJECT NURSERY S,283,6,5,0,59,204,274,1,275,0,O-78-133-04-04-02
MANAFWA,MANJIYA COUNTY,BUKIGAI,BUNAKHAYOTI,KHAKALE,297,0,0,0,37,144,181,6,187,0,O-78-133-04-05-01
MANAFWA,MANJIYA COUNTY,BUKIGAI,BUNAKHAYOTI,BUNANDUTU,315,1,2,1,33,236,273,19,292,0,O-78-133-04-05-02
MANAFWA,MANJIYA COUNTY,BUKIGAI,BUNAKHAYOTI,BUNAMALWA C.OU,613,1,0,2,64,355,422,11,433,0,O-78-133-04-05-03
MANAFWA,MANJIYA COUNTY,BUKIGAI,BUNAMUBI,NALUFUTU,1058,3,7,2,306,302,620,5,625,0,O-78-133-04-06-01
MANAFWA,MANJIYA COUNTY,BUKIGAI,BUNAMUBI,BUKIGAI H. CENTRE,222,2,0,1,85,86,174,5,179,0,O-78-133-04-06-02
MANAFWA,MANJIYA COUNTY,BUKIGAI,BUNAPORO,BUKOTITA CENTRE,431,5,3,3,86,206,303,15,318,0,O-78-133-04-07-01
MANAFWA,MANJIYA COUNTY,BUKIGAI,BUNAPORO,IBALLE GROUP,430,1,4,1,69,269,344,11,355,0,O-78-133-04-07-02
MANAFWA,MANJIYA COUNTY,BUKIGAI,BUNATSAMI,SHANZOWU P/S,708,2,6,7,88,411,514,1,515,0,O-78-133-04-08-01
MANAFWA,MANJIYA COUNTY,BUKIGAI,BUNATSAMI,BUMUNTU C.O.U,284,2,0,0,29,154,185,27,212,0,O-78-133-04-08-02
MANAFWA,MANJIYA COUNTY,BUKIGAI,BUNYANGA,BUNYANGA CENTRE,663,5,0,2,125,306,438,19,457,0,O-78-133-04-09-01
MANAFWA,MANJIYA COUNTY,BUKIGAI,BUSHIRIBO,BUSWALIKHA G.C.S.,663,1,6,2,77,431,517,14,531,0,O-78-133-04-10-01
MANAFWA,MANJIYA COUNTY,BUKIGAI,BUSHIRIBO,MUNYENDE,451,1,2,0,55,352,410,3,413,0,O-78-133-04-10-02
MANAFWA,MANJIYA COUNTY,BULUCHEKE,BUMASATA,NATOOLO'S,555,3,3,2,119,273,400,20,420,0,O-78-133-05-01-01
MANAFWA,MANJIYA COUNTY,BULUCHEKE,BUMASATA,BULUCHEKE S/C HQTRS,641,5,3,3,171,178,360,25,385,0,O-78-133-05-01-02
MANAFWA,MANJIYA COUNTY,BULUCHEKE,BUMASATA,WABUTEYAS GROUND,485,1,1,3,84,291,380,0,380,0,O-78-133-05-01-03
MANAFWA,MANJIYA COUNTY,BULUCHEKE,BUMASATA,WAMASEBE'S PLACE,195,0,0,1,29,125,155,14,169,0,O-78-133-05-01-04
MANAFWA,MANJIYA COUNTY,BULUCHEKE,BUMWALUKANI,BUMWALUKANI PR SCH,615,3,1,1,107,301,413,11,424,0,O-78-133-05-02-01
MANAFWA,MANJIYA COUNTY,BULUCHEKE,BUMWALUKANI,BUNAMULEMBWA A,302,2,1,3,33,182,221,6,227,0,O-78-133-05-02-02
MANAFWA,MANJIYA COUNTY,BULUCHEKE,BUMWALUKANI,BUNAMULEMBWA B,621,3,2,4,90,268,367,32,399,0,O-78-133-05-02-03
MANAFWA,MANJIYA COUNTY,BULUCHEKE,BUMWALUKANI,SHIAMBI,456,5,1,10,42,174,232,8,240,0,O-78-133-05-02-04
MANAFWA,MANJIYA COUNTY,BULUCHEKE,BUSHIYI,NABOOTI PR SCH,599,6,1,2,84,298,391,11,402,0,O-78-133-05-03-01
MANAFWA,MANJIYA COUNTY,BULUCHEKE,BUSHIYI,BUSHIBUYA PR. SCH.,596,2,2,5,115,307,431,35,466,0,O-78-133-05-03-02
MANAFWA,MANJIYA COUNTY,BULUCHEKE,BUSHIYI,FOOTO PR SCH,603,1,1,0,56,432,490,14,504,0,O-78-133-05-03-03
MANAFWA,MANJIYA COUNTY,BULUCHEKE,BUSHIYI,MUKUTE'S PLACE,274,3,0,4,59,145,211,6,217,0,O-78-133-05-03-04
MANAFWA,MANJIYA COUNTY,BULUCHEKE,BUSIRIWA,BUSILIWA SUB PAR HQTRS,587,1,0,1,39,358,399,8,407,0,O-78-133-05-04-01
MANAFWA,MANJIYA COUNTY,BULUCHEKE,BUSIRIWA,BUNEBOSHE T/C,408,5,1,5,127,176,314,2,316,0,O-78-133-05-04-02
MANAFWA,MANJIYA COUNTY,BUMAYOKA,BUFUMA,BUFUMA PR. SCH.,669,1,1,2,27,330,361,4,365,0,O-78-133-06-01-01
MANAFWA,MANJIYA COUNTY,BUMAYOKA,BUFUMA,BULATSE TC,426,6,0,5,35,197,243,9,252,0,O-78-133-06-01-02
MANAFWA,MANJIYA COUNTY,BUMAYOKA,BUMAYOKA,KUUSHU TC,678,1,3,2,95,338,439,55,494,0,O-78-133-06-02-01
MANAFWA,MANJIYA COUNTY,BUMAYOKA,BUMAYOKA,BUKHAENJELE GROUND,517,5,2,1,50,331,389,9,398,0,O-78-133-06-02-02
MANAFWA,MANJIYA COUNTY,BUMAYOKA,BUNANDUTU,NAMUKHUYU TC,255,0,0,1,25,178,204,5,209,0,O-78-133-06-03-01
MANAFWA,MANJIYA COUNTY,BUMAYOKA,BUNANDUTU,BUMAYOKA S/C HQTRS,394,1,0,1,35,248,285,5,290,0,O-78-133-06-03-02
MANAFWA,MANJIYA COUNTY,BUMAYOKA,ULUKUSI,NYEDE T. C.,793,1,1,6,109,472,589,22,611,0,O-78-133-06-04-01
MANAFWA,MANJIYA COUNTY,BUMAYOKA,ULUKUSI,MABONO PR. SCH.,367,2,1,4,17,246,270,11,281,0,O-78-133-06-04-02
MANAFWA,MANJIYA COUNTY,BUSHIKA,BUCHUNYA,BUSHUNYA PR. SCH.,679,2,1,1,77,312,393,31,424,0,O-78-133-07-01-01
MANAFWA,MANJIYA COUNTY,BUSHIKA,BUCHUNYA,BUMUKONYA P/S,743,6,2,2,122,235,367,24,391,0,O-78-133-07-01-02
MANAFWA,MANJIYA COUNTY,BUSHIKA,BUFUTSA,BUKIGAI PR/SCH,548,1,1,0,71,255,328,18,346,0,O-78-133-07-02-01
MANAFWA,MANJIYA COUNTY,BUSHIKA,BUFUTSA,BUSHIKA S/C HQRS,710,1,0,0,111,268,380,5,385,0,O-78-133-07-02-02
MANAFWA,MANJIYA COUNTY,BUSHIKA,BUFUTSA,BUSHINOKHO S.D.A CHURCH,423,2,1,7,105,153,268,8,276,0,O-78-133-07-02-03
MANAFWA,MANJIYA COUNTY,BUSHIKA,BUFUTSA,INDOLELELE,464,4,1,4,69,276,354,0,354,0,O-78-133-07-02-04
MANAFWA,MANJIYA COUNTY,BUSHIKA,BUFUTSA,NAMAKUTO P/S,236,2,0,1,70,122,195,5,200,0,O-78-133-07-02-05
MANAFWA,MANJIYA COUNTY,BUSHIKA,BUMUSHISHO,BUMUSHISO G.C.S.,682,2,0,1,85,344,432,15,447,0,O-78-133-07-03-01
MANAFWA,MANJIYA COUNTY,BUSHIKA,BUMUSHISHO,BUKHAWUKHA PR. SCH.,575,4,2,1,62,301,370,15,385,0,O-78-133-07-03-02
MANAFWA,MANJIYA COUNTY,BUSHIKA,BUMUSONYE,LWANGOYE G.C.S.,861,4,0,3,207,323,537,13,550,0,O-78-133-07-04-01
MANAFWA,MANJIYA COUNTY,BUSHIKA,BUMUSONYE,BUBUYERA PR. SCH.,690,3,6,3,107,246,365,9,374,0,O-78-133-07-04-02
MANAFWA,MANJIYA COUNTY,BUSHIKA,BUNABUTITI,BUNAMANDA,453,2,0,2,124,194,322,3,325,0,O-78-133-07-05-01
MANAFWA,MANJIYA COUNTY,BUSHIKA,BUNABUTITI,BUNAMANDA (N-Z),921,6,0,7,194,385,592,18,610,0,O-78-133-07-05-02
MANAFWA,MANJIYA COUNTY,BUSHIKA,BUNABUTITI,BUBUNGI,650,6,3,4,102,165,280,19,299,0,O-78-133-07-05-03
MANAFWA,MANJIYA COUNTY,BUSHIKA,BUNABUTITI,NAMATIALE T/C,413,5,3,1,165,46,220,55,275,0,O-78-133-07-05-04
KUMI,BUKEDEA COUNTY,BUKEDEA,AKERO,AKERO,588,7,6,2,219,140,374,108,482,0,O-79-96-01-01-01
KUMI,BUKEDEA COUNTY,BUKEDEA,AKUORO,AKUORO,603,6,3,6,237,212,464,15,479,0,O-79-96-01-02-01
KUMI,BUKEDEA COUNTY,BUKEDEA,EMOKORI,EMOKORI,302,0,0,1,119,61,181,3,184,0,O-79-96-01-03-01
KUMI,BUKEDEA COUNTY,BUKEDEA,KACHABULE,TAMULA,244,2,2,3,112,51,170,17,187,0,O-79-96-01-04-01
KUMI,BUKEDEA COUNTY,BUKEDEA,KACHABULE,ACABULE,201,1,1,0,45,33,80,71,151,0,O-79-96-01-04-02
KUMI,BUKEDEA COUNTY,BUKEDEA,KALOKO,KALOKO,597,5,3,6,228,186,428,10,438,0,O-79-96-01-05-01
KUMI,BUKEDEA COUNTY,BUKEDEA,KAMON,KAMON A,433,3,0,2,160,154,319,28,347,0,O-79-96-01-06-01
KUMI,BUKEDEA COUNTY,BUKEDEA,KAMON,KAMON B,439,5,3,1,154,127,290,29,319,0,O-79-96-01-06-02
KUMI,BUKEDEA COUNTY,BUKEDEA,KASOKA,KASOKA,508,16,6,2,250,68,342,17,359,0,O-79-96-01-07-01
KUMI,BUKEDEA COUNTY,BUKEDEA,KIDE,KIDE,302,2,4,0,105,56,167,15,182,0,O-79-96-01-08-01
KUMI,BUKEDEA COUNTY,BUKEDEA,KOCHEKA,KOCHEKA A,562,20,5,2,230,129,386,45,431,0,O-79-96-01-09-01
KUMI,BUKEDEA COUNTY,BUKEDEA,KOCHEKA,KOCHEKA B,347,5,0,3,149,75,232,18,250,0,O-79-96-01-09-02
KUMI,BUKEDEA COUNTY,BUKEDEA,KOKOLOTUM,KOKOLOTUM,637,10,4,1,237,112,364,93,457,0,O-79-96-01-10-01
KUMI,BUKEDEA COUNTY,BUKEDEA,KOKUTU,KOKUTU,539,6,2,4,159,228,399,10,409,0,O-79-96-01-11-01
KUMI,BUKEDEA COUNTY,BUKEDEA,OKUNGURO,OKUNGURO,838,13,4,9,365,148,539,38,577,0,O-79-96-01-12-01
KUMI,BUKEDEA COUNTY,BUKEDEA,SUULA,SUULA A,527,10,5,1,228,70,314,96,410,0,O-79-96-01-13-01
KUMI,BUKEDEA COUNTY,BUKEDEA,SUULA,SUULA B,425,4,2,3,226,60,295,5,300,0,O-79-96-01-13-02
KUMI,BUKEDEA COUNTY,KACHUMBALA,ALIGOI,ALIGOI (A-L),821,18,7,7,329,126,487,39,526,0,O-79-96-02-01-01
KUMI,BUKEDEA COUNTY,KACHUMBALA,ALIGOI,KAKEREI (M-Z),361,4,4,2,197,75,282,12,294,0,O-79-96-02-01-02
KUMI,BUKEDEA COUNTY,KACHUMBALA,AMUS,AMUS (A-M),500,3,9,3,194,154,363,19,382,0,O-79-96-02-02-01
KUMI,BUKEDEA COUNTY,KACHUMBALA,AMUS,SAPIR (N-Z),320,2,2,0,130,111,245,0,245,0,O-79-96-02-02-02
KUMI,BUKEDEA COUNTY,KACHUMBALA,APUYAN,APUYAN,212,2,0,2,54,88,146,10,156,0,O-79-96-02-03-01
KUMI,BUKEDEA COUNTY,KACHUMBALA,KABWALIN,KABWALIN,712,16,2,3,301,185,507,25,532,0,O-79-96-02-04-01
KUMI,BUKEDEA COUNTY,KACHUMBALA,KACHABOI,KACHABOI,488,3,1,4,198,129,335,12,347,0,O-79-96-02-05-01
KUMI,BUKEDEA COUNTY,KACHUMBALA,KACHUMBALA,KACHUMBALA A,680,11,6,5,291,143,456,2,458,0,O-79-96-02-06-01
KUMI,BUKEDEA COUNTY,KACHUMBALA,KACHUMBALA,KACHUMBALA B,380,4,2,0,164,61,231,19,250,0,O-79-96-02-06-02
KUMI,BUKEDEA COUNTY,KACHUMBALA,KACHURU,KACHURU (A-M),505,4,0,6,194,176,380,10,390,0,O-79-96-02-07-01
KUMI,BUKEDEA COUNTY,KACHUMBALA,KACHURU,KOMOLO (N-Z),315,0,1,5,121,88,215,5,220,0,O-79-96-02-07-02
KUMI,BUKEDEA COUNTY,KACHUMBALA,KAPAANG,KAPAANG,816,12,5,6,309,205,537,36,573,0,O-79-96-02-08-01
KUMI,BUKEDEA COUNTY,KACHUMBALA,KAWO,KAWO,596,4,5,4,270,145,428,35,463,0,O-79-96-02-09-01
KUMI,BUKEDEA COUNTY,KACHUMBALA,KOMUGE,KOMUGE (A-L),598,6,2,4,324,108,444,11,455,0,O-79-96-02-10-01
KUMI,BUKEDEA COUNTY,KACHUMBALA,KOMUGE,MAANGA (M-Z),315,8,2,1,189,52,252,7,259,0,O-79-96-02-10-02
KUMI,BUKEDEA COUNTY,KACHUMBALA,KONGATUNY,KONGATUNY,521,5,0,5,286,93,389,17,406,0,O-79-96-02-11-01
KUMI,BUKEDEA COUNTY,KACHUMBALA,KONGOIDI,KONGOIDI X,843,11,3,3,390,122,529,11,540,0,O-79-96-02-12-01
KUMI,BUKEDEA COUNTY,KACHUMBALA,KONGOIDI,KONGOIDI Y,536,8,2,1,225,84,320,15,335,0,O-79-96-02-12-02
KUMI,BUKEDEA COUNTY,KACHUMBALA,KONGUNGA,KONGUNGA(A-L),698,5,3,3,276,114,401,19,420,0,O-79-96-02-13-01
KUMI,BUKEDEA COUNTY,KACHUMBALA,KONGUNGA,KOMELEKES,697,13,6,8,249,169,445,16,461,0,O-79-96-02-13-02
KUMI,BUKEDEA COUNTY,KACHUMBALA,KONGUNGA,AIROGO (M-Z),386,2,1,1,195,78,277,13,290,0,O-79-96-02-13-03
KUMI,BUKEDEA COUNTY,KACHUMBALA,KOTIA,KACHINGA (A-L),541,4,1,2,197,147,351,9,360,0,O-79-96-02-14-01
KUMI,BUKEDEA COUNTY,KACHUMBALA,KOTIA,MUKONGORO,624,14,2,9,253,183,461,31,492,0,O-79-96-02-14-02
KUMI,BUKEDEA COUNTY,KACHUMBALA,KOTIA,BUDUBA (M-Z),404,7,1,2,177,92,279,105,384,0,O-79-96-02-14-03
KUMI,BUKEDEA COUNTY,KACHUMBALA,KOUTULAI,KOUTULAI,598,7,1,7,323,127,465,17,482,0,O-79-96-02-15-01
KUMI,BUKEDEA COUNTY,KACHUMBALA,KWARIKWAR,KWARIKWAR,565,2,5,1,169,185,362,38,400,0,O-79-96-02-16-01
KUMI,BUKEDEA COUNTY,KACHUMBALA,KWARIKWAR,APUJAN,333,3,0,1,111,106,221,8,229,0,O-79-96-02-16-02
KUMI,BUKEDEA COUNTY,KACHUMBALA,NALUGAI,NALUGAI,300,2,1,1,151,72,227,12,239,0,O-79-96-02-17-01
KUMI,BUKEDEA COUNTY,KACHUMBALA,ONGAARA,ONGARA (A-L),478,3,2,5,211,126,347,26,373,0,O-79-96-02-18-01
KUMI,BUKEDEA COUNTY,KACHUMBALA,ONGAARA,OMONYONYO (M-Z),276,2,0,4,140,66,212,7,219,0,O-79-96-02-18-02
KUMI,BUKEDEA COUNTY,KACHUMBALA,OTIMONGA,OTIMONGA,458,9,3,6,232,88,338,7,345,0,O-79-96-02-19-01
KUMI,BUKEDEA COUNTY,KIDONGOLE,CHODONG,CHODONG P/S,521,11,7,13,278,82,391,22,413,0,O-79-96-03-01-01
KUMI,BUKEDEA COUNTY,KIDONGOLE,CHODONG,ODUSURA,493,6,4,3,253,90,356,19,375,0,O-79-96-03-01-02
KUMI,BUKEDEA COUNTY,KIDONGOLE,KAJAMAKA,KAJAMAKA (A-L),448,9,3,3,130,65,210,101,311,0,O-79-96-03-02-01
KUMI,BUKEDEA COUNTY,KIDONGOLE,KAJAMAKA,KOSIRE P/S (M-Z),332,5,1,1,195,55,257,10,267,0,O-79-96-03-02-02
KUMI,BUKEDEA COUNTY,KIDONGOLE,KALUPO,KALUPO,755,9,4,5,249,181,448,136,584,0,O-79-96-03-03-01
KUMI,BUKEDEA COUNTY,KIDONGOLE,KANYAMUTAMU,KANYAMUNTAMU,751,13,12,10,337,181,553,27,580,0,O-79-96-03-04-01
KUMI,BUKEDEA COUNTY,KIDONGOLE,KATEKWAN,KATEKWAN A,431,3,2,1,184,136,326,9,335,0,O-79-96-03-05-01
KUMI,BUKEDEA COUNTY,KIDONGOLE,KATEKWAN,KATEKWAN B,394,2,4,1,214,56,277,30,307,0,O-79-96-03-05-02
KUMI,BUKEDEA COUNTY,KIDONGOLE,KAWO,OLWA PILOT SC,841,11,4,23,437,131,606,70,676,0,O-79-96-03-06-01
KUMI,BUKEDEA COUNTY,KIDONGOLE,KIDONGOLE,KIDONGOLE,440,2,1,2,205,78,288,19,307,0,O-79-96-03-07-01
KUMI,BUKEDEA COUNTY,KIDONGOLE,KIDONGOLE,KOMOLO,452,6,4,3,171,80,264,94,358,0,O-79-96-03-07-02
KUMI,BUKEDEA COUNTY,KIDONGOLE,KOENA,KOENA,867,20,3,11,489,100,623,32,655,0,O-79-96-03-08-01
KUMI,BUKEDEA COUNTY,KOLIR,ABILAEP,ABILAEP,590,13,6,10,210,200,439,12,451,0,O-79-96-04-01-01
KUMI,BUKEDEA COUNTY,KOLIR,AMINIT,AMINIT,437,3,1,4,129,106,243,33,276,0,O-79-96-04-02-01
KUMI,BUKEDEA COUNTY,KOLIR,ANGANGAM,ANGANGAM,564,4,6,16,191,174,391,19,410,0,O-79-96-04-03-01
KUMI,BUKEDEA COUNTY,KOLIR,APOPONG,APOPONG,440,10,3,7,184,96,300,18,318,0,O-79-96-04-04-01
KUMI,BUKEDEA COUNTY,KOLIR,KAMUTUR,KAMUTUR,488,3,1,3,130,165,302,4,306,0,O-79-96-04-05-01
KUMI,BUKEDEA COUNTY,KOLIR,KANYIPA,KANYIPA,639,2,6,12,279,176,475,31,506,0,O-79-96-04-06-01
KUMI,BUKEDEA COUNTY,KOLIR,KOCUS,KOCUS,303,4,4,5,77,132,222,12,234,0,O-79-96-04-07-01
KUMI,BUKEDEA COUNTY,KOLIR,KODIATA,KODIATA,589,9,8,5,277,151,450,12,462,0,O-79-96-04-08-01
KUMI,BUKEDEA COUNTY,KOLIR,KOLIR,KOLIR (A-H),580,11,4,8,154,154,331,27,358,0,O-79-96-04-09-01
KUMI,BUKEDEA COUNTY,KOLIR,KOLIR,KAGOLOTO (I-Z),361,6,2,7,130,118,263,19,282,0,O-79-96-04-09-02
KUMI,BUKEDEA COUNTY,KOLIR,KOMOGOMERI,KOMOGOMERI,727,8,2,9,123,341,483,16,499,0,O-79-96-04-10-01
KUMI,BUKEDEA COUNTY,KOLIR,MIROI,MIROI,544,9,5,10,255,106,385,33,418,0,O-79-96-04-11-01
KUMI,BUKEDEA COUNTY,KOLIR,OKUM,OKUM A,639,18,2,13,244,142,419,15,434,0,O-79-96-04-12-01
KUMI,BUKEDEA COUNTY,KOLIR,OKUM,OKUM B,519,4,4,4,205,123,340,10,350,0,O-79-96-04-12-02
KUMI,BUKEDEA COUNTY,MALERA,KABARWA,KABARWA (A-J),537,12,5,13,151,131,312,29,341,0,O-79-96-05-01-01
KUMI,BUKEDEA COUNTY,MALERA,KABARWA,TOKOR (K-Z),302,8,1,0,89,89,187,10,197,0,O-79-96-05-01-02
KUMI,BUKEDEA COUNTY,MALERA,KABARWA,OUTSIDE Q.GUARD,95,0,0,0,10,44,54,2,56,0,O-79-96-05-01-03
KUMI,BUKEDEA COUNTY,MALERA,KACHEDE,KACHEDE (A-H),456,11,8,10,187,69,285,37,322,0,O-79-96-05-02-01
KUMI,BUKEDEA COUNTY,MALERA,KACHEDE,KACHABULE (I-Z),452,8,4,4,209,56,281,21,302,0,O-79-96-05-02-02
KUMI,BUKEDEA COUNTY,MALERA,KACHOC,KACHOC A,578,12,1,2,308,61,384,24,408,0,O-79-96-05-03-01
KUMI,BUKEDEA COUNTY,MALERA,KACHOC,KACHOC B,561,3,1,2,272,65,343,17,360,0,O-79-96-05-03-02
KUMI,BUKEDEA COUNTY,MALERA,KACHONGA,KACHONGA (A-H),464,9,3,2,193,97,304,0,304,0,O-79-96-05-04-01
KUMI,BUKEDEA COUNTY,MALERA,KACHONGA,KOKWECH P/SCHOOL (I-Z),397,4,4,1,182,80,271,47,318,0,O-79-96-05-04-02
KUMI,BUKEDEA COUNTY,MALERA,KAKORI,KAKORI (A-J),455,9,0,6,97,187,299,15,314,0,O-79-96-05-05-01
KUMI,BUKEDEA COUNTY,MALERA,KAKORI,MAGARA (K-Z),293,3,1,6,101,118,229,11,240,0,O-79-96-05-05-02
KUMI,BUKEDEA COUNTY,MALERA,KAKUTOT,KAKUTOT,382,11,3,6,171,69,260,24,284,0,O-79-96-05-06-01
KUMI,BUKEDEA COUNTY,MALERA,KALOU,KALOU,497,5,2,7,223,84,321,28,349,0,O-79-96-05-07-01
KUMI,BUKEDEA COUNTY,MALERA,KANGOLE,KANGOLE,408,16,7,9,103,120,255,30,285,0,O-79-96-05-08-01
KUMI,BUKEDEA COUNTY,MALERA,KOBAALE,KOBAALE,300,5,2,12,119,80,218,16,234,0,O-79-96-05-09-01
KUMI,BUKEDEA COUNTY,MALERA,KODIKE,KODIKE,493,20,10,6,194,77,307,71,378,0,O-79-96-05-10-01
KUMI,BUKEDEA COUNTY,MALERA,KORENG,KORENG A,554,16,8,17,250,98,389,15,404,0,O-79-96-05-11-01
KUMI,BUKEDEA COUNTY,MALERA,KORENG,KORENG B,617,6,5,1,240,58,310,145,455,0,O-79-96-05-11-02
KUMI,BUKEDEA COUNTY,MALERA,KOTIOKOT,KOTIOKOT,607,16,3,8,209,144,380,53,433,0,O-79-96-05-12-01
KUMI,BUKEDEA COUNTY,MALERA,MALERA,MALERA A,501,9,7,7,260,74,357,34,391,0,O-79-96-05-13-01
KUMI,BUKEDEA COUNTY,MALERA,MALERA,MALERA B,554,6,1,6,257,80,350,13,363,0,O-79-96-05-13-02
KUMI,BUKEDEA COUNTY,MALERA,OKOUBA,OKOUBA A,386,9,6,2,185,75,277,32,309,0,O-79-96-05-14-01
KUMI,BUKEDEA COUNTY,MALERA,OKOUBA,OKOUBA B,442,5,2,1,207,75,290,15,305,0,O-79-96-05-14-02
KUMI,BUKEDEA COUNTY,TOO,AKUORO,TOO,403,7,0,1,148,107,263,16,279,0,O-79-96-06-01-01
KUMI,BUKEDEA COUNTY,TOO,KAKERE,KAKERE I,607,10,5,7,270,114,406,20,426,0,O-79-96-06-02-01
KUMI,BUKEDEA COUNTY,TOO,KAKERE,KAKERE II,466,11,3,2,173,121,310,18,328,0,O-79-96-06-02-02
KAMULI,BUDIOPE COUNTY,BUGAYA,BUGAYA,BULEGEYA BOREHOLE,726,11,3,6,57,295,372,37,409,0,O-83-69-01-01-01
KAMULI,BUDIOPE COUNTY,BUGAYA,BUGAYA,NALWOSE P. SCHOOL,890,4,3,7,137,350,501,22,523,0,O-83-69-01-01-02
KAMULI,BUDIOPE COUNTY,BUGAYA,BUGAYA,BUSEMBERA/BUWAIDHAENO,419,1,0,3,28,174,206,91,297,0,O-83-69-01-01-03
KAMULI,BUDIOPE COUNTY,BUGAYA,BUGAYA,BUGAYA S/C HQRS,695,5,2,6,96,359,468,8,476,0,O-83-69-01-01-04
KAMULI,BUDIOPE COUNTY,BUGAYA,BUGAYA,NALUWERERE T C,296,2,0,0,17,205,224,10,234,0,O-83-69-01-01-05
KAMULI,BUDIOPE COUNTY,BUGAYA,BUGAYA,KIGWERI BORE HOLE,300,2,0,2,41,168,213,6,219,0,O-83-69-01-01-06
KAMULI,BUDIOPE COUNTY,BUGAYA,BUTASWA,BUTASWA/BUGWERI,285,1,0,3,30,175,209,15,224,0,O-83-69-01-02-01
KAMULI,BUDIOPE COUNTY,BUGAYA,BUTASWA,BUTASWA/BUKITIMBO,623,3,2,5,72,326,408,19,427,0,O-83-69-01-02-02
KAMULI,BUDIOPE COUNTY,BUGAYA,BUTASWA,NAMULIKYA P/S,426,3,0,5,41,256,305,13,318,0,O-83-69-01-02-03
KAMULI,BUDIOPE COUNTY,BUGAYA,GUMPI,GUMPI P/S,662,3,1,6,56,358,424,32,456,0,O-83-69-01-03-01
KAMULI,BUDIOPE COUNTY,BUGAYA,GUMPI,NAMWENDWA T.C,664,4,1,10,50,339,404,27,431,0,O-83-69-01-03-02
KAMULI,BUDIOPE COUNTY,BUGAYA,GUMPI,INNULA T.C,560,3,3,4,26,322,358,29,387,0,O-83-69-01-03-03
KAMULI,BUDIOPE COUNTY,BUGAYA,GUMPI,INNULA CATHOLIC P/S,376,5,2,5,44,182,238,24,262,0,O-83-69-01-03-04
KAMULI,BUDIOPE COUNTY,BUGAYA,GUMPI,KIMBAYA T.C,599,3,0,2,26,365,396,13,409,0,O-83-69-01-03-05
KAMULI,BUDIOPE COUNTY,BUGAYA,GUMPI,LUKOTAIME P/S,240,1,0,1,38,140,180,14,194,0,O-83-69-01-03-06
KAMULI,BUDIOPE COUNTY,BUGAYA,GWASE,GWASE P/S,786,3,0,7,77,376,463,34,497,0,O-83-69-01-04-01
KAMULI,BUDIOPE COUNTY,BUGAYA,GWASE,KIRIMBI,613,6,1,2,50,315,374,22,396,0,O-83-69-01-04-02
KAMULI,BUDIOPE COUNTY,BUGAYA,GWASE,KYABAZAALA T.C,553,6,0,2,44,252,304,18,322,0,O-83-69-01-04-03
KAMULI,BUDIOPE COUNTY,BUGAYA,KITUKIRO,KITUKIRO JUNCTION A,558,6,0,4,50,297,357,27,384,0,O-83-69-01-05-01
KAMULI,BUDIOPE COUNTY,BUGAYA,KITUKIRO,KITUKIRO JUNCTION,898,1,1,1,96,453,552,25,577,0,O-83-69-01-05-02
KAMULI,BUDIOPE COUNTY,BUGAYA,NABITULA,NABITULA P. SCHOOL,710,2,0,9,69,392,472,25,497,0,O-83-69-01-06-01
KAMULI,BUDIOPE COUNTY,BUGAYA,NABITULA,BUBEEKO BORE HOLE,462,2,0,5,72,229,308,14,322,0,O-83-69-01-06-02
KAMULI,BUDIOPE COUNTY,BUGAYA,NAMUSIKIZI,IRAAPA BULUBAALE A,406,0,1,3,34,252,290,19,309,0,O-83-69-01-07-01
KAMULI,BUDIOPE COUNTY,BUGAYA,NAMUSIKIZI,IRAAPA BULUBAALE B,361,0,0,4,64,154,222,8,230,0,O-83-69-01-07-02
KAMULI,BUDIOPE COUNTY,BUGAYA,NAMUSIKIZI,NAMUKUNYU P/SCHOOL,444,1,0,0,47,211,259,55,314,0,O-83-69-01-07-03
KAMULI,BUDIOPE COUNTY,BUGAYA,NAMUSIKIZI,NAMUKUNYU P. SCHOOL B,777,5,0,5,58,367,435,32,467,0,O-83-69-01-07-04
KAMULI,BUDIOPE COUNTY,BUGAYA,NAMUSIKIZI,NAMUSIKIZI BUSAAMA,583,1,1,3,27,396,428,28,456,0,O-83-69-01-07-05
KAMULI,BUDIOPE COUNTY,BUGAYA,NGANDHO,NGANDHO P/SCHOOL,545,3,1,2,48,306,360,12,372,0,O-83-69-01-08-01
KAMULI,BUDIOPE COUNTY,BUGAYA,NGANDHO,BUYAMBA P/S,566,1,0,2,59,338,400,19,419,0,O-83-69-01-08-02
KAMULI,BUDIOPE COUNTY,BUGAYA,NGANDHO,BUSEMBYA,187,0,0,0,21,118,139,5,144,0,O-83-69-01-08-03
KAMULI,BUDIOPE COUNTY,BUGAYA,WANDAGO,BUGE BUYEGA,486,2,2,0,33,277,314,26,340,0,O-83-69-01-09-01
KAMULI,BUDIOPE COUNTY,BUGAYA,WANDAGO,BULANGIRA BUSOOKO,424,3,1,1,28,254,287,19,306,0,O-83-69-01-09-02
KAMULI,BUDIOPE COUNTY,BUGAYA,WANDAGO,BUSUSWA,701,3,0,3,67,373,446,25,471,0,O-83-69-01-09-03
KAMULI,BUDIOPE COUNTY,BUGAYA,WANDAGO,BUGONDA BUGAGA,893,2,3,14,79,385,483,12,495,0,O-83-69-01-09-04
KAMULI,BUDIOPE COUNTY,BUGAYA,WANDAGO,BAGAYA BOREHOLE,160,0,0,1,24,90,115,9,124,0,O-83-69-01-09-05
KAMULI,BUDIOPE COUNTY,BUYENDE,BUYENDE,BUYENDE P. SCHOOL,403,1,0,0,48,207,256,7,263,0,O-83-69-02-01-01
KAMULI,BUDIOPE COUNTY,BUYENDE,BUYENDE,DEMA BOREHOLE AREA,430,1,0,3,27,247,278,18,296,0,O-83-69-02-01-02
KAMULI,BUDIOPE COUNTY,BUYENDE,IKANDA,IKANDA P. S.,557,4,1,6,33,317,361,29,390,0,O-83-69-02-02-01
KAMULI,BUDIOPE COUNTY,BUYENDE,IKANDA,BULONDO T.C,277,0,1,1,18,179,199,25,224,0,O-83-69-02-02-02
KAMULI,BUDIOPE COUNTY,BUYENDE,IKANDA,IGOMERO T.C,319,4,0,5,16,213,238,13,251,0,O-83-69-02-02-03
KAMULI,BUDIOPE COUNTY,BUYENDE,IKANDA,KALAMBO T.C,394,5,1,6,31,253,296,11,307,0,O-83-69-02-02-04
KAMULI,BUDIOPE COUNTY,BUYENDE,KINAMBOGO,BUGOGO MARKET,454,1,1,5,20,336,363,17,380,0,O-83-69-02-03-01
KAMULI,BUDIOPE COUNTY,BUYENDE,KINAMBOGO,KUKIPANDE,300,3,0,1,23,191,218,8,226,0,O-83-69-02-03-02
KAMULI,BUDIOPE COUNTY,BUYENDE,KINAMBOGO,MAKAYA T/C,316,0,0,0,20,206,226,4,230,0,O-83-69-02-03-03
KAMULI,BUDIOPE COUNTY,BUYENDE,KINAMBOGO,ST.KIZITO-NAMBULA,626,3,0,4,39,392,438,25,463,0,O-83-69-02-03-04
KAMULI,BUDIOPE COUNTY,BUYENDE,MANGO,MANGO P. SCHOOL A,403,6,1,2,32,255,296,21,317,0,O-83-69-02-04-01
KAMULI,BUDIOPE COUNTY,BUYENDE,MANGO,MANGO B,758,9,1,5,53,484,552,16,568,0,O-83-69-02-04-02
KAMULI,BUDIOPE COUNTY,BUYENDE,NAKABIRA,KISEGE,345,0,0,1,28,238,267,6,273,0,O-83-69-02-05-01
KAMULI,BUDIOPE COUNTY,BUYENDE,NAKABIRA,BUNANGWE,394,4,1,4,78,192,279,8,287,0,O-83-69-02-05-02
KAMULI,BUDIOPE COUNTY,BUYENDE,NAKABIRA,BUMYUKA,482,0,0,0,64,286,350,11,361,0,O-83-69-02-05-03
KAMULI,BUDIOPE COUNTY,BUYENDE,NAKABIRA,BUGASANI,287,1,0,0,9,221,231,20,251,0,O-83-69-02-05-04
KAMULI,BUDIOPE COUNTY,BUYENDE,NAKABIRA,BAGEYA CENTRE,242,0,1,3,39,137,180,10,190,0,O-83-69-02-05-05
KAMULI,BUDIOPE COUNTY,BUYENDE,NAMUSITA,BUNNABBALA,509,3,1,1,25,359,389,18,407,0,O-83-69-02-06-01
KAMULI,BUDIOPE COUNTY,BUYENDE,NAMUSITA,KAKOOGE PRIMARY SCHOOL,497,1,0,5,43,307,356,26,382,0,O-83-69-02-06-02
KAMULI,BUDIOPE COUNTY,BUYENDE,NAMUSITA,KAKOOGE TRADING CENTRE,544,3,1,3,25,367,399,20,419,0,O-83-69-02-06-03
KAMULI,BUDIOPE COUNTY,BUYENDE,NDOLWA,NAMUGONGO PRIMARY SCHOOL,399,0,0,2,22,293,317,15,332,0,O-83-69-02-07-01
KAMULI,BUDIOPE COUNTY,BUYENDE,NDOLWA,NDOLWA PRIMARY SCHOOL,481,0,2,2,37,335,376,9,385,0,O-83-69-02-07-02
KAMULI,BUDIOPE COUNTY,BUYENDE,NDOLWA,NDOLWA MARKET AREA,339,1,1,4,38,230,274,7,281,0,O-83-69-02-07-03
KAMULI,BUDIOPE COUNTY,BUYENDE,NDOLWA,KABISO MARKET AREA,256,0,0,2,9,163,174,35,209,0,O-83-69-02-07-04
KAMULI,BUDIOPE COUNTY,BUYENDE,NDOLWA,ZIRABA TRADING CENTRE,373,1,0,0,37,252,290,9,299,0,O-83-69-02-07-05
KAMULI,BUDIOPE COUNTY,BUYENDE,WESUNIRE,NAWANTALE P/SCHOOL,669,11,1,6,36,449,503,21,524,0,O-83-69-02-08-01
KAMULI,BUDIOPE COUNTY,BUYENDE,WESUNIRE,WESUNIRE P/SCHOOL,424,2,0,0,29,297,328,10,338,0,O-83-69-02-08-02
KAMULI,BUDIOPE COUNTY,BUYENDE,WESUNIRE,IREMERYA P. SCHOOL,365,3,0,2,15,287,307,8,315,0,O-83-69-02-08-03
KAMULI,BUDIOPE COUNTY,KAGULU,BUKUTULA,MPUNDE TRADING C.,512,2,2,5,50,294,353,12,365,0,O-83-69-03-01-01
KAMULI,BUDIOPE COUNTY,KAGULU,BUKUTULA,KYANJADE NAKALONGO,462,4,0,3,34,335,376,6,382,0,O-83-69-03-01-02
KAMULI,BUDIOPE COUNTY,KAGULU,BUKUTULA,BUKUTULA PARISH HQRS,386,3,1,2,45,221,272,18,290,0,O-83-69-03-01-03
KAMULI,BUDIOPE COUNTY,KAGULU,BUKUTULA,IGALAZA P. SCHOOL,714,1,2,1,67,482,553,24,577,0,O-83-69-03-01-04
KAMULI,BUDIOPE COUNTY,KAGULU,BUKUTULA,ISUBI FREEDOM TREE,284,1,0,7,19,206,233,11,244,0,O-83-69-03-01-05
KAMULI,BUDIOPE COUNTY,KAGULU,BUMUGOLI,KAMUGOYA,519,1,0,1,21,330,353,22,375,0,O-83-69-03-02-01
KAMULI,BUDIOPE COUNTY,KAGULU,BUMUGOLI,BUMOGOLI,286,0,2,1,11,188,202,16,218,0,O-83-69-03-02-02
KAMULI,BUDIOPE COUNTY,KAGULU,BUMUGOLI,NAKAWOLO,428,2,0,5,21,379,407,20,427,0,O-83-69-03-02-03
KAMULI,BUDIOPE COUNTY,KAGULU,IRUNDU,IRUNDU TOWNSHIP P/S,645,1,0,3,115,312,431,8,439,0,O-83-69-03-03-01
KAMULI,BUDIOPE COUNTY,KAGULU,IRUNDU,IRUNDU TRADING CENTRE,141,0,0,0,12,89,101,12,113,0,O-83-69-03-03-02
KAMULI,BUDIOPE COUNTY,KAGULU,IRUNDU,IRUNDU LANDING PLACE,404,2,0,2,20,315,339,2,341,0,O-83-69-03-03-03
KAMULI,BUDIOPE COUNTY,KAGULU,IRUNDU,NAMUNYINGI,519,1,0,2,48,355,406,26,432,0,O-83-69-03-03-04
KAMULI,BUDIOPE COUNTY,KAGULU,IRUNDU,NKODOKODO,501,3,0,5,46,346,400,11,411,0,O-83-69-03-03-05
KAMULI,BUDIOPE COUNTY,KAGULU,IYINGO,IYINGO PR. SCHOOL,686,5,0,4,56,468,533,27,560,0,O-83-69-03-04-01
KAMULI,BUDIOPE COUNTY,KAGULU,IYINGO,BUYUMBA MUWOLO,608,2,0,4,56,390,452,25,477,0,O-83-69-03-04-02
KAMULI,BUDIOPE COUNTY,KAGULU,IYINGO,KASANGA CHURCH/KASANGA,140,0,0,0,10,109,119,3,122,0,O-83-69-03-04-03
KAMULI,BUDIOPE COUNTY,KAGULU,IYINGO,IGWAYA CORNER/IGWAYA,284,0,0,2,13,197,212,5,217,0,O-83-69-03-04-04
KAMULI,BUDIOPE COUNTY,KAGULU,KABUKYE,KAKIRA / KAKIRA,527,1,0,9,45,381,436,10,446,0,O-83-69-03-05-01
KAMULI,BUDIOPE COUNTY,KAGULU,KABUKYE,BUSIGE CENTRE,769,1,1,6,62,457,527,27,554,0,O-83-69-03-05-02
KAMULI,BUDIOPE COUNTY,KAGULU,KABUKYE,NGOLE CHURCH / NGOLE,326,3,1,3,34,196,237,23,260,0,O-83-69-03-05-03
KAMULI,BUDIOPE COUNTY,KAGULU,KABUKYE,NGOLE CHURCH,338,1,1,3,42,216,263,15,278,0,O-83-69-03-05-04
KAMULI,BUDIOPE COUNTY,KAGULU,KAGULU,KAGULU P/S,489,3,0,3,49,294,349,15,364,0,O-83-69-03-06-01
KAMULI,BUDIOPE COUNTY,KAGULU,KAGULU,KIRIMWA MARKET,865,8,0,8,71,520,607,17,624,0,O-83-69-03-06-02
KAMULI,BUDIOPE COUNTY,KAGULU,KAGULU,MIRU P/S,585,4,0,0,58,333,395,20,415,0,O-83-69-03-06-03
KAMULI,BUDIOPE COUNTY,KAGULU,KAGULU,MIRU P/S MIRU II,447,2,0,3,30,289,324,8,332,0,O-83-69-03-06-04
KAMULI,BUDIOPE COUNTY,KAGULU,KAGULU,MULALI CATH CHURCH,644,3,0,7,61,398,469,16,485,0,O-83-69-03-06-05
KAMULI,BUDIOPE COUNTY,KAGULU,KAGULU,IGWAYA,346,2,0,2,23,266,293,7,300,0,O-83-69-03-06-06
KAMULI,BUDIOPE COUNTY,KAGULU,NKONE,BUTOOLI FREEDOM TREE,411,2,0,0,38,291,331,16,347,0,O-83-69-03-07-01
KAMULI,BUDIOPE COUNTY,KAGULU,NKONE,BULUNDA FREEDOM TREE,273,1,0,0,12,224,237,13,250,0,O-83-69-03-07-02
KAMULI,BUDIOPE COUNTY,KAGULU,NKONE,BUKYAALA,329,2,0,0,22,249,273,10,283,0,O-83-69-03-07-03
KAMULI,BUDIOPE COUNTY,KAGULU,NKONE,BUPYOKO,241,0,0,1,18,186,205,10,215,0,O-83-69-03-07-04
KAMULI,BUDIOPE COUNTY,KAGULU,NKONE,BUDIPA CENTRE,331,0,0,1,37,233,271,15,286,0,O-83-69-03-07-05
KAMULI,BUDIOPE COUNTY,KIDERA,BUKUNGU,BUKUNGU LUFULA,531,0,2,2,82,208,294,23,317,0,O-83-69-04-01-01
KAMULI,BUDIOPE COUNTY,KIDERA,BUKUNGU,BUKUNGU KYOGA,753,5,0,1,142,233,381,17,398,0,O-83-69-04-01-02
KAMULI,BUDIOPE COUNTY,KIDERA,BUKUNGU,BUKUNGU BUZAMA,448,4,0,5,67,165,241,14,255,0,O-83-69-04-01-03
KAMULI,BUDIOPE COUNTY,KIDERA,BUKUNGU,KIBAALE,614,0,2,4,19,509,534,3,537,0,O-83-69-04-01-04
KAMULI,BUDIOPE COUNTY,KIDERA,BUKUNGU,KIBAALE KANGANYANZA,361,1,1,1,12,291,306,19,325,0,O-83-69-04-01-05
KAMULI,BUDIOPE COUNTY,KIDERA,BUKUNGU,KAPIOKOLO,216,0,0,0,29,116,145,11,156,0,O-83-69-04-01-06
KAMULI,BUDIOPE COUNTY,KIDERA,BUKUNGU,KIWANTAMA,517,1,0,8,26,320,355,16,371,0,O-83-69-04-01-07
KAMULI,BUDIOPE COUNTY,KIDERA,BUYANJA,BUTAYUNJA P/SCHOOL,693,6,2,6,37,413,464,18,482,0,O-83-69-04-02-01
KAMULI,BUDIOPE COUNTY,KIDERA,BUYANJA,KIWONGOIRE LANDING,410,2,0,7,26,247,282,32,314,0,O-83-69-04-02-02
KAMULI,BUDIOPE COUNTY,KIDERA,BUYANJA,KABALONGO MARKET,291,1,0,1,30,179,211,13,224,0,O-83-69-04-02-03
KAMULI,BUDIOPE COUNTY,KIDERA,BUYANJA,BUYANDHA P/SCHOOL,457,3,1,2,22,298,326,15,341,0,O-83-69-04-02-04
KAMULI,BUDIOPE COUNTY,KIDERA,BUYANJA,KASATO NAWANSASO,523,1,1,7,32,331,372,30,402,0,O-83-69-04-02-05
KAMULI,BUDIOPE COUNTY,KIDERA,BUYANJA,KYANKOLE LANDING,473,0,1,0,19,305,325,26,351,0,O-83-69-04-02-06
KAMULI,BUDIOPE COUNTY,KIDERA,KASIIRA,KABUGUDHO,584,3,2,7,35,285,332,27,359,0,O-83-69-04-03-01
KAMULI,BUDIOPE COUNTY,KIDERA,KASIIRA,KAKIIKA / KIRIMUSENGE,579,3,0,5,43,349,400,11,411,0,O-83-69-04-03-02
KAMULI,BUDIOPE COUNTY,KIDERA,KASIIRA,BULEMBO MARKET,668,2,2,1,8,486,499,11,510,0,O-83-69-04-03-03
KAMULI,BUDIOPE COUNTY,KIDERA,KASIIRA,NAWANSEGA P/S BULEMBO,568,4,0,4,39,401,448,8,456,0,O-83-69-04-03-04
KAMULI,BUDIOPE COUNTY,KIDERA,KASIIRA,NABWEYO BOREHOLE,345,2,1,4,31,219,257,25,282,0,O-83-69-04-03-05
KAMULI,BUDIOPE COUNTY,KIDERA,KIDERA,KIDERA T.C (A-M),670,0,0,0,56,384,440,9,449,0,O-83-69-04-04-01
KAMULI,BUDIOPE COUNTY,KIDERA,KIDERA,KATOGWE R C I,442,2,1,0,25,289,317,9,326,0,O-83-69-04-04-02
KAMULI,BUDIOPE COUNTY,KIDERA,KIDERA,NAKIBENGO,392,1,0,0,21,235,257,34,291,0,O-83-69-04-04-03
KAMULI,BUDIOPE COUNTY,KIDERA,KIDERA,KIDERA S.S,238,2,0,2,6,159,169,7,176,0,O-83-69-04-04-04
KAMULI,BUDIOPE COUNTY,KIDERA,KIDERA,KIDERA T.C (N-Z),294,0,0,0,26,183,209,4,213,0,O-83-69-04-04-05
KAMULI,BUDIOPE COUNTY,KIDERA,MISERU,KIKONDO MARKET,453,1,0,3,12,334,350,18,368,0,O-83-69-04-05-01
KAMULI,BUDIOPE COUNTY,KIDERA,MISERU,MISERU P. SCHOOL,663,3,2,2,31,465,503,33,536,0,O-83-69-04-05-02
KAMULI,BUDIOPE COUNTY,KIDERA,MISERU,ITAMYA MARKET,622,5,3,4,71,394,477,9,486,0,O-83-69-04-05-03
KAMULI,BUDIOPE COUNTY,KIDERA,NTALA,KISAIKYE,687,2,1,3,50,394,450,22,472,0,O-83-69-04-06-01
KAMULI,BUDIOPE COUNTY,KIDERA,NTALA,NDUDDU,431,0,0,5,27,280,312,18,330,0,O-83-69-04-06-02
KAMULI,BUDIOPE COUNTY,KIDERA,NTALA,MIRENGEIZO,463,7,0,5,17,343,372,12,384,0,O-83-69-04-06-03
KAMULI,BUDIOPE COUNTY,KIDERA,NTALA,NAKAWA,731,1,0,5,25,515,546,16,562,0,O-83-69-04-06-04
KAMULI,BUDIOPE COUNTY,KIDERA,NTALA,NTAALA,660,0,2,2,42,384,430,24,454,0,O-83-69-04-06-05
KAMULI,BUDIOPE COUNTY,NKONDO,IMMERI,IMMERI PRIMARY SCHOOL,308,0,1,3,11,187,202,5,207,0,O-83-69-05-01-01
KAMULI,BUDIOPE COUNTY,NKONDO,IMMERI,UNIVERSAL APOSTLES CHURCH,796,1,1,8,66,408,484,10,494,0,O-83-69-05-01-02
KAMULI,BUDIOPE COUNTY,NKONDO,IMMERI,NANVUNANO,170,0,2,0,15,110,127,16,143,0,O-83-69-05-01-03
KAMULI,BUDIOPE COUNTY,NKONDO,IRINGA,WINYI'S MARKET/MANI,676,1,0,1,41,426,469,15,484,0,O-83-69-05-02-01
KAMULI,BUDIOPE COUNTY,NKONDO,IRINGA,IRINGA CATHOLIC CHURCH,495,3,2,1,65,187,258,52,310,0,O-83-69-05-02-02
KAMULI,BUDIOPE COUNTY,NKONDO,IRINGA,KALOGOI MARKET,416,0,1,0,82,183,266,19,285,0,O-83-69-05-02-03
KAMULI,BUDIOPE COUNTY,NKONDO,IRINGA,IRINGA P/S,240,2,0,1,19,133,155,4,159,0,O-83-69-05-02-04
KAMULI,BUDIOPE COUNTY,NKONDO,KIGINGI,BUSIGE MARKET KAKOGE,465,1,0,2,19,344,366,18,384,0,O-83-69-05-03-01
KAMULI,BUDIOPE COUNTY,NKONDO,KIGINGI,KIWOLOGOMA,531,0,3,5,42,328,378,18,396,0,O-83-69-05-03-02
KAMULI,BUDIOPE COUNTY,NKONDO,KIGINGI,LWEVOLA KAKOGE MARKET,675,2,0,2,44,393,441,23,464,0,O-83-69-05-03-03
KAMULI,BUDIOPE COUNTY,NKONDO,KIGINGI,KIGINGI P/S,573,0,0,3,26,394,423,29,452,0,O-83-69-05-03-04
KAMULI,BUDIOPE COUNTY,NKONDO,NDULYA,KAGUMA MARKET/KIWABA,362,1,0,1,29,267,298,18,316,0,O-83-69-05-04-01
KAMULI,BUDIOPE COUNTY,NKONDO,NDULYA,KIWABA AID POST,402,3,1,0,38,258,300,9,309,0,O-83-69-05-04-02
KAMULI,BUDIOPE COUNTY,NKONDO,NDULYA,NJWEJWE MARKET,385,2,1,5,13,298,319,11,330,0,O-83-69-05-04-03
KAMULI,BUDIOPE COUNTY,NKONDO,NDULYA,NDULYA P. SCHOOL,284,1,0,0,9,209,219,17,236,0,O-83-69-05-04-04
SIRONKO,BULAMBULI COUNTY,BUGINYANYA,BUMASIFWA,BUMUGIBOLE T.C.,737,2,1,6,66,426,501,13,514,0,O-89-130-01-01-01
SIRONKO,BULAMBULI COUNTY,BUGINYANYA,BUMASIFWA,BUGINYANYA T.T.C.,423,1,0,1,63,275,340,8,348,0,O-89-130-01-01-02
SIRONKO,BULAMBULI COUNTY,BUGINYANYA,BUMASIFWA,GIBUZALE P/S,436,2,0,1,55,348,406,6,412,0,O-89-130-01-01-03
SIRONKO,BULAMBULI COUNTY,BUGINYANYA,BUMASIFWA,MAYIYI CATHOLIC CHURCH,575,7,1,1,45,431,485,13,498,0,O-89-130-01-01-04
SIRONKO,BULAMBULI COUNTY,BUGINYANYA,BUMASIFWA,BUGINYANYA GCS,229,2,1,2,26,153,184,8,192,0,O-89-130-01-01-05
SIRONKO,BULAMBULI COUNTY,BUGINYANYA,BUMASIFWA,GABOYISI T/C,165,1,0,1,9,150,161,0,161,0,O-89-130-01-01-06
SIRONKO,BULAMBULI COUNTY,BUGINYANYA,KIRWALI,BUGINYANYA P.S.,328,1,2,1,65,139,208,10,218,0,O-89-130-01-02-01
SIRONKO,BULAMBULI COUNTY,BUGINYANYA,KIRWALI,GOOZI P.S.,483,0,1,6,58,400,465,16,481,0,O-89-130-01-02-02
SIRONKO,BULAMBULI COUNTY,BUGINYANYA,KIRWALI,KILWALI PARISH HQT,532,0,3,1,86,346,436,24,460,0,O-89-130-01-02-03
SIRONKO,BULAMBULI COUNTY,BUGINYANYA,KIRWALI,BUGINYAYA S/CTY HQTRS.,439,0,3,2,59,232,296,16,312,0,O-89-130-01-02-04
SIRONKO,BULAMBULI COUNTY,BUGINYANYA,KIRWALI,BUNATAGYI,276,0,0,0,13,246,259,4,263,0,O-89-130-01-02-05
SIRONKO,BULAMBULI COUNTY,BUKHALU,BUKHALU,BUKHALU PR. SCH (A - M),662,9,1,3,181,205,399,20,419,0,O-89-130-02-01-01
SIRONKO,BULAMBULI COUNTY,BUKHALU,BUKHALU,BUWAKHANYUNYI PR. SCH,391,4,0,1,101,136,242,11,253,0,O-89-130-02-01-02
SIRONKO,BULAMBULI COUNTY,BUKHALU,BUKHALU,BUNAMALIRO,310,3,1,2,96,124,226,21,247,0,O-89-130-02-01-03
SIRONKO,BULAMBULI COUNTY,BUKHALU,BUKHALU,BUKHALU PR. SCH (N - Z),729,5,0,7,254,194,460,20,480,0,O-89-130-02-01-04
SIRONKO,BULAMBULI COUNTY,BUKHALU,BUKHALU,SHILIMI'S PLACE,364,5,2,4,90,173,274,9,283,0,O-89-130-02-01-05
SIRONKO,BULAMBULI COUNTY,BUKHALU,BUNALWERE,BUNGWANYI T.C.,365,7,3,3,98,195,306,19,325,0,O-89-130-02-02-01
SIRONKO,BULAMBULI COUNTY,BUKHALU,BUNALWERE,BULUMERA MKT,444,2,2,3,129,161,297,23,320,0,O-89-130-02-02-02
SIRONKO,BULAMBULI COUNTY,BUKHALU,BUNALWERE,BUSHIENDE COU,460,3,1,7,170,104,285,14,299,0,O-89-130-02-02-03
SIRONKO,BULAMBULI COUNTY,BUKHALU,BUNALWERE,BUKHALU G.C.S.,616,1,2,2,220,196,421,13,434,0,O-89-130-02-02-04
SIRONKO,BULAMBULI COUNTY,BUKHALU,BUNALWERE,BUTSESOLI SUB SCH.,524,4,0,3,191,168,366,22,388,0,O-89-130-02-02-05
SIRONKO,BULAMBULI COUNTY,BUKHALU,BUYAGA,BUWANYANGA C/U,450,0,2,0,144,159,305,3,308,0,O-89-130-02-03-01
SIRONKO,BULAMBULI COUNTY,BUKHALU,BUYAGA,BUYAGA TOWNSHIP (A-M),492,1,2,0,167,152,322,9,331,0,O-89-130-02-03-02
SIRONKO,BULAMBULI COUNTY,BUKHALU,BUYAGA,BUWANYANGA CATHOLIC CHURC,520,2,1,0,97,232,332,8,340,0,O-89-130-02-03-03
SIRONKO,BULAMBULI COUNTY,BUKHALU,BUYAGA,BUYAGA CATHOLIC CHURCH (N-Z),489,0,0,1,161,166,328,14,342,0,O-89-130-02-03-04
SIRONKO,BULAMBULI COUNTY,BULAGO,BUMASUFWA,NABIWUTULU P.S.,455,1,0,1,56,387,445,6,451,0,O-89-130-03-01-01
SIRONKO,BULAMBULI COUNTY,BULAGO,BUMASUFWA,BUMUSAMALI PR SCH,454,0,0,3,9,365,377,2,379,0,O-89-130-03-01-02
SIRONKO,BULAMBULI COUNTY,BULAGO,BUMASUFWA,BUMASUFWA C.O.U,351,1,0,4,16,308,329,4,333,0,O-89-130-03-01-03
SIRONKO,BULAMBULI COUNTY,BULAGO,BUMASUFWA,BUGATISA CATHOLIC CHURCH,624,1,2,0,19,466,488,14,502,0,O-89-130-03-01-04
SIRONKO,BULAMBULI COUNTY,BULAGO,BUMWAMBU,BUMWAMBU PAR. HQT.,373,0,0,2,74,231,307,3,310,0,O-89-130-03-02-01
SIRONKO,BULAMBULI COUNTY,BULAGO,BUMWAMBU,BUMWAMBU P/S,448,2,0,1,52,232,287,12,299,0,O-89-130-03-02-02
SIRONKO,BULAMBULI COUNTY,BULAGO,BUMWAMBU,GABUSILONI C.O.U,589,0,2,0,84,333,419,9,428,0,O-89-130-03-02-03
SIRONKO,BULAMBULI COUNTY,BULAGO,BUNABUDE,BUNABUDE P.S.,509,0,0,2,34,455,491,3,494,0,O-89-130-03-03-01
SIRONKO,BULAMBULI COUNTY,BULAGO,BUNABUDE,GOMBE HEALTH CENTRE,499,0,1,1,23,376,401,2,403,0,O-89-130-03-03-02
SIRONKO,BULAMBULI COUNTY,BULAGO,BUSIYA,BULAGO S/C HQT,259,1,0,0,16,152,169,2,171,0,O-89-130-03-04-01
SIRONKO,BULAMBULI COUNTY,BULAGO,BUSIYA,BULAGO P.S.,368,0,1,2,47,297,347,3,350,0,O-89-130-03-04-02
SIRONKO,BULAMBULI COUNTY,BULAGO,BUSIYA,KISINA T/C,343,2,0,1,32,215,250,10,260,0,O-89-130-03-04-03
SIRONKO,BULAMBULI COUNTY,BULAGO,BUSIYA,BULAGO G.C.S,385,0,0,1,19,355,375,5,380,0,O-89-130-03-04-04
SIRONKO,BULAMBULI COUNTY,BULEGENI,BULEGENI,KAMUNDA P/S,581,2,2,1,81,322,408,4,412,0,O-89-130-04-01-01
SIRONKO,BULAMBULI COUNTY,BULEGENI,BULEGENI,MBIGI P/S,260,0,0,0,18,194,212,23,235,0,O-89-130-04-01-02
SIRONKO,BULAMBULI COUNTY,BULEGENI,BULEGENI,BULEGENI AID POST,259,0,1,2,31,159,193,4,197,0,O-89-130-04-01-03
SIRONKO,BULAMBULI COUNTY,BULEGENI,BULEGENI,D.F.I,732,1,1,2,80,444,528,7,535,0,O-89-130-04-01-04
SIRONKO,BULAMBULI COUNTY,BULEGENI,BULEGENI,BULEGENI P/S,294,1,2,0,14,269,286,8,294,0,O-89-130-04-01-05
SIRONKO,BULAMBULI COUNTY,BULEGENI,BULEGENI,KAPKWENI CATHOLIC CHURCH,322,0,0,2,28,152,182,5,187,0,O-89-130-04-01-06
SIRONKO,BULAMBULI COUNTY,BULEGENI,BULEGENI,KALEGENI P.A.G CHURCH,304,2,2,4,14,196,218,9,227,0,O-89-130-04-01-07
SIRONKO,BULAMBULI COUNTY,BULEGENI,NAMISUNI,KIKUYU CENTRE,805,1,0,0,28,767,796,8,804,0,O-89-130-04-02-01
SIRONKO,BULAMBULI COUNTY,BULEGENI,NAMISUNI,NAMBEKYE PR. SCH.,266,2,0,0,29,211,242,4,246,0,O-89-130-04-02-02
SIRONKO,BULAMBULI COUNTY,BULEGENI,NAMISUNI,GAMATEMBEYI G.C.S.,281,0,0,1,13,266,280,0,280,0,O-89-130-04-02-03
SIRONKO,BULAMBULI COUNTY,BULEGENI,SAMAZI,SAMAZI P/S A,679,3,1,3,85,564,656,12,668,0,O-89-130-04-03-01
SIRONKO,BULAMBULI COUNTY,BULEGENI,SAMAZI,SAMAZI P/S B,749,0,1,1,58,386,446,19,465,0,O-89-130-04-03-02
SIRONKO,BULAMBULI COUNTY,BULUGANYA,BULUGANYA,MASUGU P/S,790,7,1,7,68,439,522,10,532,0,O-89-130-05-01-01
SIRONKO,BULAMBULI COUNTY,BULUGANYA,BULUGANYA,ZEMA T.C.,643,4,1,2,105,488,600,30,630,0,O-89-130-05-01-02
SIRONKO,BULAMBULI COUNTY,BULUGANYA,BULUGANYA,BUKYAWO,679,2,0,4,99,298,403,1,404,0,O-89-130-05-01-03
SIRONKO,BULAMBULI COUNTY,BULUGANYA,BULUGANYA,SOTTI PRIMARY SCHOOL,526,0,0,1,65,310,376,9,385,0,O-89-130-05-01-04
SIRONKO,BULAMBULI COUNTY,BULUGANYA,BUMASOBO,BUWOKADALA P/S A,503,1,1,1,49,154,206,2,208,0,O-89-130-05-02-01
SIRONKO,BULAMBULI COUNTY,BULUGANYA,BUMASOBO,BUWOKADALA P.S.B,515,8,0,6,61,328,403,7,410,0,O-89-130-05-02-02
SIRONKO,BULAMBULI COUNTY,BULUGANYA,BUMASOBO,MAWULULU P.S,592,0,1,3,34,522,560,32,592,0,O-89-130-05-02-03
SIRONKO,BULAMBULI COUNTY,BULUGANYA,BUMASOBO,BUGIMWERA C/U,715,0,0,2,30,681,713,2,715,0,O-89-130-05-02-04
SIRONKO,BULAMBULI COUNTY,BULUGANYA,BUMASOBO,MABUGU P/S,521,0,0,1,81,427,509,0,509,0,O-89-130-05-02-05
SIRONKO,BULAMBULI COUNTY,BULUGANYA,BUMASOBO,NAZWAZWA,357,1,0,2,91,165,259,6,265,0,O-89-130-05-02-06
SIRONKO,BULAMBULI COUNTY,BULUGANYA,BUMASOBO,KAGOLO T.C.,320,0,0,1,39,274,314,5,319,0,O-89-130-05-02-07
SIRONKO,BULAMBULI COUNTY,BUNAMBUTYE,BULUGUYA,BUNAMBUTYE S/C,737,3,1,3,173,306,486,10,496,0,O-89-130-06-01-01
SIRONKO,BULAMBULI COUNTY,BUNAMBUTYE,BULUGUYA,BUCHEKELENYI,232,3,0,1,53,94,151,7,158,0,O-89-130-06-01-02
SIRONKO,BULAMBULI COUNTY,BUNAMBUTYE,BUMUFUNI,ATARI T/C,384,4,0,0,43,258,305,8,313,0,O-89-130-06-02-01
SIRONKO,BULAMBULI COUNTY,BUNAMBUTYE,BUMUFUNI,TABAGONYI T/C,573,0,3,4,92,263,362,18,380,0,O-89-130-06-02-02
SIRONKO,BULAMBULI COUNTY,BUNAMBUTYE,BWIKHONGE,BWIKHONGE PR. SCH,472,4,0,4,209,124,341,24,365,0,O-89-130-06-03-01
SIRONKO,BULAMBULI COUNTY,BUNAMBUTYE,BWIKHONGE,BUYAKA PR. SCH.,701,2,0,3,157,269,431,22,453,0,O-89-130-06-03-02
SIRONKO,BULAMBULI COUNTY,BUNAMBUTYE,BWIKHONGE,BWIKHONGE MARKET,667,8,1,8,178,199,394,20,414,0,O-89-130-06-03-03
SIRONKO,BULAMBULI COUNTY,BUNAMBUTYE,BWIKHONGE,BWIKHONGE DISPENSARY,371,2,3,3,188,72,268,10,278,0,O-89-130-06-03-04
SIRONKO,BULAMBULI COUNTY,MASIRA,BUFUMBO,DUBIKI TRADING CENTRE,269,1,1,0,19,185,206,8,214,0,O-89-130-07-01-01
SIRONKO,BULAMBULI COUNTY,MASIRA,BUFUMBO,DUNGA TRADING CENTRE,526,1,2,0,77,348,428,22,450,0,O-89-130-07-01-02
SIRONKO,BULAMBULI COUNTY,MASIRA,BUFUMBO,KISABASI T.C.,632,5,1,6,64,331,407,14,421,0,O-89-130-07-01-03
SIRONKO,BULAMBULI COUNTY,MASIRA,BUFUMBO,WOMUNGA P.S.,351,1,2,1,24,222,250,11,261,0,O-89-130-07-01-04
SIRONKO,BULAMBULI COUNTY,MASIRA,GABUGOTO,MASIRA P.S.,439,2,1,3,46,253,305,17,322,0,O-89-130-07-02-01
SIRONKO,BULAMBULI COUNTY,MASIRA,GABUGOTO,GABUGOTO P.S.,515,1,5,1,51,415,473,5,478,0,O-89-130-07-02-02
SIRONKO,BULAMBULI COUNTY,MASIRA,GABUGOTO,GABUGOTO C.O.U.,404,1,0,4,30,313,348,2,350,0,O-89-130-07-02-03
SIRONKO,BULAMBULI COUNTY,MASIRA,GABUGOTO,KITOBO,287,0,0,0,17,199,216,3,219,0,O-89-130-07-02-04
SIRONKO,BULAMBULI COUNTY,MUYEMBE,BUGWANYI,MUYEMBE BOYS PR SCH,1131,6,3,6,252,419,686,18,704,0,O-89-130-08-01-01
SIRONKO,BULAMBULI COUNTY,MUYEMBE,BUGWANYI,MUYEMBE OLD MKT.,345,1,0,2,101,126,230,6,236,0,O-89-130-08-01-02
SIRONKO,BULAMBULI COUNTY,MUYEMBE,BUGWANYI,NABBONGO C/U,658,2,1,3,73,359,438,10,448,0,O-89-130-08-01-03
SIRONKO,BULAMBULI COUNTY,MUYEMBE,BUGWANYI,SIMU CORNER,307,0,0,0,62,91,153,11,164,0,O-89-130-08-01-04
SIRONKO,BULAMBULI COUNTY,MUYEMBE,BUGWANYI,BUNGWANYI C/U,621,1,0,3,173,250,427,22,449,0,O-89-130-08-01-05
SIRONKO,BULAMBULI COUNTY,MUYEMBE,NABBONGO,BUNANGAKA MARKET,641,0,1,3,141,219,364,13,377,0,O-89-130-08-02-01
SIRONKO,BULAMBULI COUNTY,MUYEMBE,NABBONGO,NABBONGO PR. SCH.,574,1,0,0,147,213,361,22,383,0,O-89-130-08-02-02
SIRONKO,BULAMBULI COUNTY,MUYEMBE,NABBONGO,WALUBYA'S PLACE,393,6,2,4,163,58,233,19,252,0,O-89-130-08-02-03
SIRONKO,BULAMBULI COUNTY,MUYEMBE,NABBONGO,BUWASYEBA P/S,517,3,1,5,138,164,311,20,331,0,O-89-130-08-02-04
SIRONKO,BULAMBULI COUNTY,MUYEMBE,NABBONGO,WEKANDA'S PLACE,493,3,1,0,165,172,341,20,361,0,O-89-130-08-02-05
SIRONKO,BULAMBULI COUNTY,MUYEMBE,NABBONGO,WOKHULI'S PLACE,358,0,0,2,122,167,291,10,301,0,O-89-130-08-02-06
SIRONKO,BULAMBULI COUNTY,SISIYI,BUKIBOLOGOTO,BUKIBOLOGOTO PR. SCH.,656,1,0,9,120,508,638,11,649,0,O-89-130-09-01-01
SIRONKO,BULAMBULI COUNTY,SISIYI,BUKIBOLOGOTO,SIMU PRI. SCH,711,2,2,4,156,275,439,10,449,0,O-89-130-09-01-02
SIRONKO,BULAMBULI COUNTY,SISIYI,BUKIBOLOGOTO,KIDEGA,217,0,0,0,8,137,145,1,146,0,O-89-130-09-01-03
SIRONKO,BULAMBULI COUNTY,SISIYI,BUKIBOLOGOTO,KIKUYU,410,4,0,2,58,244,308,5,313,0,O-89-130-09-01-04
SIRONKO,BULAMBULI COUNTY,SISIYI,BUMUGUSHA,BUMUGUSYA PR. SCH.,533,0,0,0,28,502,530,3,533,0,O-89-130-09-02-01
SIRONKO,BULAMBULI COUNTY,SISIYI,BUMUGUSHA,LUZI PR SCH,685,1,0,3,33,434,471,6,477,0,O-89-130-09-02-02
SIRONKO,BULAMBULI COUNTY,SISIYI,BUMUGUSHA,KISUBI,411,1,0,0,12,395,408,1,409,0,O-89-130-09-02-03
SIRONKO,BULAMBULI COUNTY,SISIYI,GIBUZALE,BUMUIDYEKI PR. SCH.,490,3,1,4,27,285,320,6,326,0,O-89-130-09-03-01
SIRONKO,BULAMBULI COUNTY,SISIYI,GIBUZALE,BUGWA PR. SCH.,716,0,0,5,123,569,697,7,704,0,O-89-130-09-03-02
SIRONKO,BULAMBULI COUNTY,SISIYI,GIBUZALE,MABONO T/C,317,0,0,1,24,276,301,1,302,0,O-89-130-09-03-03
SIRONKO,BULAMBULI COUNTY,SISIYI,GIBUZALE,KIBANDA T/C,313,0,0,0,28,175,203,8,211,0,O-89-130-09-03-04
IGANGA,LUUKA COUNTY,BUKANGA,BUDONDO,KIMANTO TR/CENTRE,389,1,0,0,86,184,271,10,281,0,O-94-40-01-01-01
IGANGA,LUUKA COUNTY,BUKANGA,BUDONDO,KIMANTO PR/SCHOOL B,414,4,0,4,78,175,261,13,274,0,O-94-40-01-01-02
IGANGA,LUUKA COUNTY,BUKANGA,BUDONDO,BUDONDO PR/SCHOOL,257,0,0,0,38,123,161,7,168,0,O-94-40-01-01-03
IGANGA,LUUKA COUNTY,BUKANGA,BUDONDO,BUDONDO TR/CENTRE,452,3,0,4,78,229,314,12,326,0,O-94-40-01-01-04
IGANGA,LUUKA COUNTY,BUKANGA,BUDONDO,KIMANTO P/S A,461,0,1,2,92,232,327,26,353,0,O-94-40-01-01-05
IGANGA,LUUKA COUNTY,BUKANGA,BUSALAMU,TABINGWA P/S,490,2,0,1,72,238,313,18,331,0,O-94-40-01-02-01
IGANGA,LUUKA COUNTY,BUKANGA,BUSALAMU,BUSALAMU ADVESTIST CHURCH,633,11,3,3,154,222,393,10,403,0,O-94-40-01-02-02
IGANGA,LUUKA COUNTY,BUKANGA,BUSALAMU,BAMUSUTO'S JUNCTION,640,2,2,3,144,245,396,11,407,0,O-94-40-01-02-03
IGANGA,LUUKA COUNTY,BUKANGA,BUSALAMU,BUSALAMU PR/SCHOOL,520,3,1,1,135,215,355,7,362,0,O-94-40-01-02-04
IGANGA,LUUKA COUNTY,BUKANGA,BUWOLOGOMA,BUWOLOGOMA P/S A,326,1,0,0,41,138,180,4,184,0,O-94-40-01-03-01
IGANGA,LUUKA COUNTY,BUKANGA,BUWOLOGOMA,BUWOLOGOMA P/S B,395,0,0,0,31,172,203,7,210,0,O-94-40-01-03-02
IGANGA,LUUKA COUNTY,BUKANGA,BUWOLOGOMA,NDHOYA P/S,249,1,2,2,33,153,191,4,195,0,O-94-40-01-03-03
IGANGA,LUUKA COUNTY,BUKANGA,BUWOLOGOMA,BUKAADE P/S,537,1,0,5,60,313,379,22,401,0,O-94-40-01-03-04
IGANGA,LUUKA COUNTY,BUKANGA,BUWOLOGOMA,BUWOLOGOMA PR/SCHOOL C,557,2,0,7,78,292,379,12,391,0,O-94-40-01-03-05
IGANGA,LUUKA COUNTY,BUKANGA,BUWOLOGOMA,NDHOYA TR/CENTRE,411,1,1,1,62,213,278,16,294,0,O-94-40-01-03-06
IGANGA,LUUKA COUNTY,BUKANGA,KIROBA,BUDOMA CENTRE,609,2,0,1,91,294,388,13,401,0,O-94-40-01-04-01
IGANGA,LUUKA COUNTY,BUKANGA,KIROBA,NAWANTALE CENTRE (A-M),511,1,0,1,115,218,335,7,342,0,O-94-40-01-04-02
IGANGA,LUUKA COUNTY,BUKANGA,KIROBA,BUSANDO CENTRE,551,0,1,1,67,327,396,4,400,0,O-94-40-01-04-03
IGANGA,LUUKA COUNTY,BUKANGA,KIROBA,NAWANTALE CENTRE (N-Z),391,2,0,1,59,181,243,16,259,0,O-94-40-01-04-04
IGANGA,LUUKA COUNTY,BUKANGA,NABUBYA,NABUBYA T/CENTRE,457,2,0,1,76,205,284,12,296,0,O-94-40-01-05-01
IGANGA,LUUKA COUNTY,BUKANGA,NABUBYA,BUDOMA T/CENTRE (A-),466,3,0,2,125,157,287,3,290,0,O-94-40-01-05-02
IGANGA,LUUKA COUNTY,BUKANGA,NABUBYA,BUDOMA PR/SCHOOL,182,0,2,1,35,86,124,0,124,0,O-94-40-01-05-03
IGANGA,LUUKA COUNTY,BUKANGA,NABUBYA,NAKABONDO P/S,351,0,0,3,58,132,193,8,201,0,O-94-40-01-05-04
IGANGA,LUUKA COUNTY,BUKANGA,NABUBYA,BUDOMA T/CENTRE (N-Z),324,1,0,2,41,123,167,8,175,0,O-94-40-01-05-05
IGANGA,LUUKA COUNTY,BUKANGA,NAMUKUBEMBE,BUKANGA S/COUNTY HQRS,607,1,3,2,73,293,372,7,379,0,O-94-40-01-06-01
IGANGA,LUUKA COUNTY,BUKANGA,NAMUKUBEMBE,NAMUKUBEMBE T/CENTRE A,593,1,3,3,109,241,357,10,367,0,O-94-40-01-06-02
IGANGA,LUUKA COUNTY,BUKANGA,NAMUKUBEMBE,NAMUKUBEMBE T/CENTRE B,814,2,2,2,125,346,477,14,491,0,O-94-40-01-06-03
IGANGA,LUUKA COUNTY,BUKANGA,NAMUKUBEMBE,NAMUKUBEMBE T/CENTRE C,307,1,0,1,52,127,181,10,191,0,O-94-40-01-06-04
IGANGA,LUUKA COUNTY,BUKANGA,NAMUKUBEMBE,BUMANYA TC,301,1,1,2,53,124,181,9,190,0,O-94-40-01-06-05
IGANGA,LUUKA COUNTY,BUKOOMA,BUKOOMA,BUKOOMA CHURCH OF UGANDA,689,0,1,5,83,430,519,6,525,0,O-94-40-02-01-01
IGANGA,LUUKA COUNTY,BUKOOMA,BUKOOMA,BUKANHA P/S,535,0,0,0,58,269,327,71,398,0,O-94-40-02-01-02
IGANGA,LUUKA COUNTY,BUKOOMA,BUKYANGWA,BUDHANA CO-OP SOCIETY A,529,2,0,3,73,225,303,48,351,0,O-94-40-02-02-01
IGANGA,LUUKA COUNTY,BUKOOMA,BUKYANGWA,BUDHANA PALLISA T/CENTRE,321,2,1,0,54,135,192,42,234,0,O-94-40-02-02-02
IGANGA,LUUKA COUNTY,BUKOOMA,BUKYANGWA,BUKYANGWA PR/SCHOOL,612,0,0,2,59,362,423,17,440,0,O-94-40-02-02-03
IGANGA,LUUKA COUNTY,BUKOOMA,NABYOTO,BUKOOVA P/S,737,2,2,5,98,366,473,14,487,0,O-94-40-02-03-01
IGANGA,LUUKA COUNTY,BUKOOMA,NABYOTO,BUTESERWA T/CENTRE,504,1,1,0,67,286,355,16,371,0,O-94-40-02-03-02
IGANGA,LUUKA COUNTY,BUKOOMA,NABYOTO,BUSANDA P/S,682,2,0,4,70,416,492,6,498,0,O-94-40-02-03-03
IGANGA,LUUKA COUNTY,BUKOOMA,NABYOTO,NABYOTO PARISH HQRS,579,1,1,1,78,310,391,36,427,0,O-94-40-02-03-04
IGANGA,LUUKA COUNTY,BUKOOMA,NABYOTO,MAKUUTU PRIMARY SCHOOL,286,0,1,1,26,197,225,6,231,0,O-94-40-02-03-05
IGANGA,LUUKA COUNTY,BUKOOMA,NAIGOBYA,NAIGOBYA T/CENTRE,702,1,1,1,122,332,457,14,471,0,O-94-40-02-04-01
IGANGA,LUUKA COUNTY,BUKOOMA,NAIGOBYA,NAIRIKA P/S,815,2,0,3,110,427,542,37,579,0,O-94-40-02-04-02
IGANGA,LUUKA COUNTY,BUKOOMA,NAIGOBYA,NAIGOBYA PR/SCHOOL,400,1,2,1,71,224,299,14,313,0,O-94-40-02-04-03
IGANGA,LUUKA COUNTY,BUKOOMA,NAMASENDA,KIRIMWA P/S,426,0,1,1,130,179,311,10,321,0,O-94-40-02-05-01
IGANGA,LUUKA COUNTY,BUKOOMA,NAMASENDA,NAMASENDA PARISH HQRS,445,1,0,1,88,237,327,8,335,0,O-94-40-02-05-02
IGANGA,LUUKA COUNTY,BUKOOMA,NAMASENDA,BULALU T/C,246,0,0,2,60,129,191,1,192,0,O-94-40-02-05-03
IGANGA,LUUKA COUNTY,BUKOOMA,NAMASENDA,BUSAKU PRIMARY SCHOOL,288,0,3,2,45,155,205,11,216,0,O-94-40-02-05-04
IGANGA,LUUKA COUNTY,BUKOOMA,NAMULANDA,NAMULANDA P/S,440,0,0,5,62,253,320,18,338,0,O-94-40-02-06-01
IGANGA,LUUKA COUNTY,BUKOOMA,NAMULANDA,NAWANSENGA P/S,535,1,0,2,62,305,370,17,387,0,O-94-40-02-06-02
IGANGA,LUUKA COUNTY,BUKOOMA,NAMULANDA,GWEMBUZI PR/SCHOOL,536,2,5,1,97,302,407,15,422,0,O-94-40-02-06-03
IGANGA,LUUKA COUNTY,BULONGO,BUDHABANGULA,BUDHABANGULA P/S A,712,1,0,0,75,321,397,16,413,0,O-94-40-03-01-01
IGANGA,LUUKA COUNTY,BULONGO,BUDHABANGULA,BUDHABANGULA P/S B,590,4,2,0,71,297,374,12,386,0,O-94-40-03-01-02
IGANGA,LUUKA COUNTY,BULONGO,BUGONYOKA,BUGONYOKA CENTRE A,235,0,0,1,56,98,155,8,163,0,O-94-40-03-02-01
IGANGA,LUUKA COUNTY,BULONGO,BUGONYOKA,LWANDA CENTRE,400,3,0,2,59,213,277,5,282,0,O-94-40-03-02-02
IGANGA,LUUKA COUNTY,BULONGO,BUGONYOKA,BUSETE CENTRE,473,0,0,4,79,224,307,21,328,0,O-94-40-03-02-03
IGANGA,LUUKA COUNTY,BULONGO,BUGONYOKA,NAKISENYI CENTRE A,376,3,1,1,71,168,244,8,252,0,O-94-40-03-02-04
IGANGA,LUUKA COUNTY,BULONGO,BUGONYOKA,NAKISENYI CENTRE B,282,1,0,0,24,149,174,6,180,0,O-94-40-03-02-05
IGANGA,LUUKA COUNTY,BULONGO,BUGONYOKA,BUGONYOKA CENTRE B,273,1,0,2,49,126,178,7,185,0,O-94-40-03-02-06
IGANGA,LUUKA COUNTY,BULONGO,BUKENDI,BUKENDI CENTRE,270,1,0,2,39,153,195,8,203,0,O-94-40-03-03-01
IGANGA,LUUKA COUNTY,BULONGO,BUKENDI,BUGABULA CENTRE (A-M),511,0,1,0,96,219,316,8,324,0,O-94-40-03-03-02
IGANGA,LUUKA COUNTY,BULONGO,BUKENDI,KASOKOSO,539,3,3,9,75,301,391,23,414,0,O-94-40-03-03-03
IGANGA,LUUKA COUNTY,BULONGO,BUKENDI,BUGABULA CENTRE (N-Z),388,1,0,3,28,205,237,13,250,0,O-94-40-03-03-04
IGANGA,LUUKA COUNTY,BULONGO,BULONGO,KAMWIRUNGU P/S (A-M),482,1,0,1,80,205,287,5,292,0,O-94-40-03-04-01
IGANGA,LUUKA COUNTY,BULONGO,BULONGO,BULONGO S/COUNTY HQRS,376,0,3,0,42,222,267,4,271,0,O-94-40-03-04-02
IGANGA,LUUKA COUNTY,BULONGO,BULONGO,KIYUNGA DISPENSARY (A-M),632,1,1,0,108,231,341,6,347,0,O-94-40-03-04-03
IGANGA,LUUKA COUNTY,BULONGO,BULONGO,KIYUNGA COUNTY HQRS A,59,0,0,0,9,25,34,1,35,0,O-94-40-03-04-04
IGANGA,LUUKA COUNTY,BULONGO,BULONGO,KIYUNGA DISPENSARY B,406,0,0,1,46,198,245,13,258,0,O-94-40-03-04-05
IGANGA,LUUKA COUNTY,BULONGO,BULONGO,BUWAISWA TRADING CENTRE,369,0,0,1,55,208,264,4,268,0,O-94-40-03-04-06
IGANGA,LUUKA COUNTY,BULONGO,BULONGO,KAMWIRUNGU P/S (N-Z),366,1,0,2,38,179,220,5,225,0,O-94-40-03-04-07
IGANGA,LUUKA COUNTY,BULONGO,BULONGO,KIYUNGA DISPENSARY (N-Z),384,2,0,0,36,187,225,2,227,0,O-94-40-03-04-08
IGANGA,LUUKA COUNTY,BULONGO,NAKABUGU,NAKABUGU T/CENTRE (A-M),491,2,0,1,104,183,290,12,302,0,O-94-40-03-05-01
IGANGA,LUUKA COUNTY,BULONGO,NAKABUGU,KASANDA'S PLACE,629,1,1,4,86,353,445,6,451,0,O-94-40-03-05-02
IGANGA,LUUKA COUNTY,BULONGO,NAKABUGU,NAKABUGU T/CENTRE (N-Z),387,1,0,4,58,146,209,7,216,0,O-94-40-03-05-03
IGANGA,LUUKA COUNTY,BULONGO,NAMALEMBA,BUSALA P/SCHOOL,374,0,0,2,47,310,359,7,366,0,O-94-40-03-06-01
IGANGA,LUUKA COUNTY,BULONGO,NAMALEMBA,KASOZI PR/SCHOOL,538,0,0,2,37,310,349,7,356,0,O-94-40-03-06-02
IGANGA,LUUKA COUNTY,BULONGO,NAMALEMBA,NAMALEMBA-KASOKOS,556,1,0,2,90,253,346,9,355,0,O-94-40-03-06-03
IGANGA,LUUKA COUNTY,IKUMBYA,BUNAFU,BUNAFU CENTRE A,256,1,1,1,41,166,210,7,217,0,O-94-40-04-01-01
IGANGA,LUUKA COUNTY,IKUMBYA,BUNAFU,BUNAFU CENTRE B,545,1,0,0,28,392,421,7,428,0,O-94-40-04-01-02
IGANGA,LUUKA COUNTY,IKUMBYA,BUNAFU,NAWANYAGO HEALTH CENTRE II,282,0,0,2,19,196,217,6,223,0,O-94-40-04-01-03
IGANGA,LUUKA COUNTY,IKUMBYA,IKUMBYA,IKUMBYA T/CENTRE,736,3,1,1,115,352,472,20,492,0,O-94-40-04-02-01
IGANGA,LUUKA COUNTY,IKUMBYA,IKUMBYA,NSAMBYA CENTRE,417,0,0,0,33,259,292,13,305,0,O-94-40-04-02-02
IGANGA,LUUKA COUNTY,IKUMBYA,IKUMBYA,BUWUTU CENTRE,497,2,1,1,41,317,362,16,378,0,O-94-40-04-02-03
IGANGA,LUUKA COUNTY,IKUMBYA,IKUMBYA,WANDAGO,340,0,1,2,49,209,261,17,278,0,O-94-40-04-02-04
IGANGA,LUUKA COUNTY,IKUMBYA,INUULA,BUGAMBO CENTRE,417,0,0,2,53,245,300,19,319,0,O-94-40-04-03-01
IGANGA,LUUKA COUNTY,IKUMBYA,INUULA,INUULA CENTRE,330,1,0,1,63,192,257,5,262,0,O-94-40-04-03-02
IGANGA,LUUKA COUNTY,IKUMBYA,INUULA,BUDHUBA CENTRE,743,1,0,5,73,249,328,0,328,0,O-94-40-04-03-03
IGANGA,LUUKA COUNTY,IKUMBYA,NAWAKA,NANTAMALI PR/SCHOOL,644,1,0,3,66,393,463,8,471,0,O-94-40-04-04-01
IGANGA,LUUKA COUNTY,IKUMBYA,NAWAKA,NAWAKA CENTRE A,434,1,1,1,73,199,275,8,283,0,O-94-40-04-04-02
IGANGA,LUUKA COUNTY,IKUMBYA,NAWAKA,NAWAKA CENTRE B(A-M),463,4,4,2,98,211,319,0,319,0,O-94-40-04-04-03
IGANGA,LUUKA COUNTY,IKUMBYA,NAWAKA,NAWAKA CENTRE B(N-Z),316,0,0,1,37,155,193,9,202,0,O-94-40-04-04-04
IGANGA,LUUKA COUNTY,IKUMBYA,NTAYIGIRWA,IDOOME CENTRE,405,2,0,0,27,262,291,19,310,0,O-94-40-04-05-01
IGANGA,LUUKA COUNTY,IKUMBYA,NTAYIGIRWA,NTAYIGIRWA CENTRE,516,0,1,4,41,366,412,9,421,0,O-94-40-04-05-02
IGANGA,LUUKA COUNTY,IKUMBYA,NTAYIGIRWA,BULIKE CENTRE(A-M),497,2,0,1,31,341,375,12,387,0,O-94-40-04-05-03
IGANGA,LUUKA COUNTY,IKUMBYA,NTAYIGIRWA,BUKOBO CENTRE,383,5,0,1,50,202,258,15,273,0,O-94-40-04-05-04
IGANGA,LUUKA COUNTY,IKUMBYA,NTAYIGIRWA,BULIKE CENTRE (N-Z),319,2,3,1,6,196,208,7,215,0,O-94-40-04-05-05
IGANGA,LUUKA COUNTY,IRONGO,IRONGO,IRONGO S/COUNTY HQRS(A-M),497,3,0,0,94,203,300,16,316,0,O-94-40-05-01-01
IGANGA,LUUKA COUNTY,IRONGO,IRONGO,LAMBALA PR/SCHOOL,536,0,0,1,61,271,333,0,333,0,O-94-40-05-01-02
IGANGA,LUUKA COUNTY,IRONGO,IRONGO,IGANGA CENTRE,264,1,0,1,37,140,179,6,185,0,O-94-40-05-01-03
IGANGA,LUUKA COUNTY,IRONGO,IRONGO,NAIMULI P/S,544,1,1,0,106,222,330,15,345,0,O-94-40-05-01-04
IGANGA,LUUKA COUNTY,IRONGO,IRONGO,IRONGO S/COUNTY HQRS (N-Z),355,2,0,1,39,146,188,10,198,0,O-94-40-05-01-05
IGANGA,LUUKA COUNTY,IRONGO,KALYOWA,KALYOWA P/S,631,3,1,2,89,289,384,19,403,0,O-94-40-05-02-01
IGANGA,LUUKA COUNTY,IRONGO,KALYOWA,BUNIKO CATH CHURCH A,426,0,1,1,51,211,264,8,272,0,O-94-40-05-02-02
IGANGA,LUUKA COUNTY,IRONGO,KALYOWA,KIGUNGA RC. I OFFICE,567,1,0,1,53,192,247,16,263,0,O-94-40-05-02-03
IGANGA,LUUKA COUNTY,IRONGO,KIBINGA,NAKAVUMA P/S A,481,2,0,0,57,201,260,39,299,0,O-94-40-05-03-01
IGANGA,LUUKA COUNTY,IRONGO,KIBINGA,NAKAVUMA PR/SCHOOL B,315,0,1,3,37,168,209,11,220,0,O-94-40-05-03-02
IGANGA,LUUKA COUNTY,IRONGO,KIBINGA,KIBINGA CO-OPERATIVE SOCIETY,453,0,2,4,66,176,248,29,277,0,O-94-40-05-03-03
IGANGA,LUUKA COUNTY,IRONGO,KYANVUMA,KIWALAZI P/S,516,6,0,7,35,314,362,15,377,0,O-94-40-05-04-01
IGANGA,LUUKA COUNTY,IRONGO,KYANVUMA,NAKABALE PR/SCHOOL,660,1,0,0,113,216,330,50,380,0,O-94-40-05-04-02
IGANGA,LUUKA COUNTY,IRONGO,KYANVUMA,NAKABALE ORTHDOX CHURCH,538,0,0,1,62,261,324,10,334,0,O-94-40-05-04-03
IGANGA,LUUKA COUNTY,IRONGO,KYANVUMA,KYANVUMA S/COUNTY,480,1,0,2,90,155,248,5,253,0,O-94-40-05-04-04
IGANGA,LUUKA COUNTY,IRONGO,NAWANYAGO,NAWANYAGO CATH/CHURCH,652,2,2,2,91,305,402,28,430,0,O-94-40-05-05-01
IGANGA,LUUKA COUNTY,IRONGO,NAWANYAGO,NAWAMPITI CO-OP SOCIETY,477,2,3,4,87,209,305,14,319,0,O-94-40-05-05-02
IGANGA,LUUKA COUNTY,IRONGO,NAWANYAGO,BUYEMBA PR/SCHOOL,468,2,0,0,80,209,291,9,300,0,O-94-40-05-05-03
IGANGA,LUUKA COUNTY,IRONGO,NAWANYAGO,LUZINGA PARK,184,1,1,0,31,74,107,7,114,0,O-94-40-05-05-04
IGANGA,LUUKA COUNTY,NAWAMPITI,BUGOMBA,BUGOMBA P/S,255,3,0,1,40,161,205,5,210,0,O-94-40-06-01-01
IGANGA,LUUKA COUNTY,NAWAMPITI,BUGOMBA,BUWANDA P/S,316,0,0,2,34,185,221,1,222,0,O-94-40-06-01-02
IGANGA,LUUKA COUNTY,NAWAMPITI,BUGOMBA,NAWANDYO PRIMARY SCHOOL,260,1,0,1,34,147,183,1,184,0,O-94-40-06-01-03
IGANGA,LUUKA COUNTY,NAWAMPITI,BUYOOLA,IKONIA P/S B,378,1,0,0,79,187,267,2,269,0,O-94-40-06-02-01
IGANGA,LUUKA COUNTY,NAWAMPITI,BUYOOLA,BUNYOOLA S/GRADE SCH.,325,2,0,2,46,169,219,10,229,0,O-94-40-06-02-02
IGANGA,LUUKA COUNTY,NAWAMPITI,BUYOOLA,NAKYERE TR/CENTRE,245,1,0,0,48,134,183,4,187,0,O-94-40-06-02-03
IGANGA,LUUKA COUNTY,NAWAMPITI,BUYOOLA,IKONIA CO-OP SOCIETY,417,1,0,0,37,258,296,2,298,0,O-94-40-06-02-04
IGANGA,LUUKA COUNTY,NAWAMPITI,NAKISWIGA,BUWAMWA CO-OP SOCIETY,642,4,2,5,100,260,371,12,383,0,O-94-40-06-03-01
IGANGA,LUUKA COUNTY,NAWAMPITI,NAKISWIGA,NABIKUYI P/S,473,5,0,1,62,217,285,7,292,0,O-94-40-06-03-02
IGANGA,LUUKA COUNTY,NAWAMPITI,NAKISWIGA,NAKISWIGA T/CENTRE,684,3,2,2,61,345,413,9,422,0,O-94-40-06-03-03
IGANGA,LUUKA COUNTY,NAWAMPITI,NAWAMPITI,KITUTO P/S A,585,0,2,1,68,307,378,8,386,0,O-94-40-06-04-01
IGANGA,LUUKA COUNTY,NAWAMPITI,NAWAMPITI,KITUTO P/S B,224,1,0,0,28,95,124,6,130,0,O-94-40-06-04-02
IGANGA,LUUKA COUNTY,NAWAMPITI,NAWAMPITI,KITUTO P/S C,687,1,0,3,99,309,412,28,440,0,O-94-40-06-04-03
IGANGA,LUUKA COUNTY,NAWAMPITI,NAWANKOMPE,NAWANKOMPE P/S A,614,5,0,0,81,308,394,12,406,0,O-94-40-06-05-01
IGANGA,LUUKA COUNTY,NAWAMPITI,NAWANKOMPE,NAWANKOMPE PR/SCHOOL B,324,1,1,1,64,144,211,3,214,0,O-94-40-06-05-02
IGANGA,LUUKA COUNTY,WAIBUGA,BUSIIRO,BUSIIRO S. SCHOOL A,750,3,1,3,155,231,393,17,410,0,O-94-40-07-01-01
IGANGA,LUUKA COUNTY,WAIBUGA,BUSIIRO,BUSIIRO P/S (A-M),427,0,0,3,50,249,302,8,310,0,O-94-40-07-01-02
IGANGA,LUUKA COUNTY,WAIBUGA,BUSIIRO,BUSIIRO HEALTH CENTRE,325,1,1,1,36,146,185,17,202,0,O-94-40-07-01-03
IGANGA,LUUKA COUNTY,WAIBUGA,BUSIIRO,BULINDI CHURCH,294,1,0,0,42,149,192,8,200,0,O-94-40-07-01-04
IGANGA,LUUKA COUNTY,WAIBUGA,BUSIIRO,BUSIIRO S. SCHOOL B,225,0,0,3,38,97,138,4,142,0,O-94-40-07-01-05
IGANGA,LUUKA COUNTY,WAIBUGA,BUSIIRO,BUSIIRO P/S (N-Z),529,1,0,3,48,330,382,7,389,0,O-94-40-07-01-06
IGANGA,LUUKA COUNTY,WAIBUGA,BUTIMBWA,BUTIMBWA P/S,736,2,0,3,91,391,487,9,496,0,O-94-40-07-02-01
IGANGA,LUUKA COUNTY,WAIBUGA,BUTIMBWA,WAIBUGA S/COUNTY,708,1,1,4,131,314,451,6,457,0,O-94-40-07-02-02
IGANGA,LUUKA COUNTY,WAIBUGA,BUTIMBWA,NAMAKAKALO P/S,515,4,1,1,78,254,338,14,352,0,O-94-40-07-02-03
IGANGA,LUUKA COUNTY,WAIBUGA,BUTIMBWA,LWANIKA MUSLIM P/S,519,1,0,0,75,249,325,12,337,0,O-94-40-07-02-04
IGANGA,LUUKA COUNTY,WAIBUGA,ITAKAIBOLU,WAIBUGA P/S,411,1,2,1,48,255,307,5,312,0,O-94-40-07-03-01
IGANGA,LUUKA COUNTY,WAIBUGA,ITAKAIBOLU,KIGAYA T/CENTRE,759,2,1,5,143,298,449,22,471,0,O-94-40-07-03-02
IGANGA,LUUKA COUNTY,WAIBUGA,ITAKAIBOLU,NAKABALE MARKET,422,0,5,2,90,209,306,11,317,0,O-94-40-07-03-03
IGANGA,LUUKA COUNTY,WAIBUGA,ITAKAIBOLU,BWIRI CENTRE,160,0,0,1,40,72,113,5,118,0,O-94-40-07-03-04
IGANGA,LUUKA COUNTY,WAIBUGA,LWAKI,NAMADOPE P/S,705,2,0,1,111,302,416,13,429,0,O-94-40-07-04-01
IGANGA,LUUKA COUNTY,WAIBUGA,LWAKI,LWAKI P/S,430,0,0,1,57,224,282,6,288,0,O-94-40-07-04-02
IGANGA,LUUKA COUNTY,WAIBUGA,LWAKI,TWEWAIRE'S PLACE,323,0,1,3,81,140,225,12,237,0,O-94-40-07-04-03
IGANGA,LUUKA COUNTY,WAIBUGA,WALIBO,WALIBO P/S,488,5,1,2,109,203,320,18,338,0,O-94-40-07-05-01
IGANGA,LUUKA COUNTY,WAIBUGA,WALIBO,MAWUNDO PR/SCHOOL,653,5,2,5,166,272,450,15,465,0,O-94-40-07-05-02
IGANGA,LUUKA COUNTY,WAIBUGA,WALIBO,BULANGA P/S (A-M),375,3,0,2,105,119,229,5,234,0,O-94-40-07-05-03
IGANGA,LUUKA COUNTY,WAIBUGA,WALIBO,BULANGA TOWN,787,2,1,4,177,309,493,7,500,0,O-94-40-07-05-04
IGANGA,LUUKA COUNTY,WAIBUGA,WALIBO,BULANGA P/S (N-Z),356,0,4,0,60,125,189,11,200,0,O-94-40-07-05-05
BUGIRI,BUKOOLI SOUTH,BANDA,BUCHUMBA,BUSUMA PRI. SCHOOL,630,7,1,2,204,261,475,31,506,0,O-95-33-01-01-01
BUGIRI,BUKOOLI SOUTH,BANDA,BUCHUMBA,BUCHUMBA C.O.U,806,4,2,3,253,209,471,137,608,0,O-95-33-01-01-02
BUGIRI,BUKOOLI SOUTH,BANDA,BUCHUMBA,LUGALA PRI. SCHOOL,695,6,3,2,214,276,501,29,530,0,O-95-33-01-01-03
BUGIRI,BUKOOLI SOUTH,BANDA,BUJWANGA,BUJWANGA HEALTH CENTRE,630,4,1,2,111,289,407,79,486,0,O-95-33-01-02-01
BUGIRI,BUKOOLI SOUTH,BANDA,BUJWANGA,NAKUDI CATHOLIC CHURCH,302,4,1,1,98,134,238,25,263,0,O-95-33-01-02-02
BUGIRI,BUKOOLI SOUTH,BANDA,BUJWANGA,BUBANGI P/SCHOOL,129,1,1,0,9,59,70,26,96,0,O-95-33-01-02-03
BUGIRI,BUKOOLI SOUTH,BANDA,BUJWANGA,BUSIRO PRI. SCHOOL,786,4,1,0,184,290,479,73,552,0,O-95-33-01-02-04
BUGIRI,BUKOOLI SOUTH,BANDA,BUJWANGA,BUDUNGA C.O.U,724,6,2,2,235,279,524,18,542,0,O-95-33-01-02-05
BUGIRI,BUKOOLI SOUTH,BANDA,BUWOYA,BANDA P SCHOOL,550,8,1,4,202,189,404,18,422,0,O-95-33-01-03-01
BUGIRI,BUKOOLI SOUTH,BANDA,BUWOYA,BUWOYA C.O.U,493,7,2,7,218,138,372,16,388,0,O-95-33-01-03-02
BUGIRI,BUKOOLI SOUTH,BANDA,BUWOYA,NANJALA MIRACLE CENTRE,159,2,1,0,21,88,112,27,139,0,O-95-33-01-03-03
BUGIRI,BUKOOLI SOUTH,BANDA,BUWOYA,BUKEDA NEW APOSTOLIC CHURC,404,1,3,0,142,165,311,17,328,0,O-95-33-01-03-04
BUGIRI,BUKOOLI SOUTH,BANDA,BUWOYA,BUYOMBO HEALTH CENTRE,661,14,5,6,117,305,447,57,504,0,O-95-33-01-03-05
BUGIRI,BUKOOLI SOUTH,BANDA,BUWOYA,BUKEDA PENTECOSTAL CHURCH,271,4,0,1,61,135,201,17,218,0,O-95-33-01-03-06
BUGIRI,BUKOOLI SOUTH,BANDA,LUGALA,BUYUNDO P SCHOOL,724,8,3,2,224,278,515,51,566,0,O-95-33-01-04-01
BUGIRI,BUKOOLI SOUTH,BANDA,LUGALA,BUDALA PRI. SCHOOL,647,7,4,9,203,229,452,20,472,0,O-95-33-01-04-02
BUGIRI,BUKOOLI SOUTH,BANDA,LUGALA,MAYANJA PR. SCH.,590,4,1,1,174,152,332,89,421,0,O-95-33-01-04-03
BUGIRI,BUKOOLI SOUTH,BANDA,LUGALA,LUGALA HEALTH CENTRE,608,5,5,4,190,169,373,27,400,0,O-95-33-01-04-04
BUGIRI,BUKOOLI SOUTH,BANDA,LUTOLO,BUCHUNIA PR. SCH.,312,4,1,3,48,147,203,20,223,0,O-95-33-01-05-01
BUGIRI,BUKOOLI SOUTH,BANDA,LUTOLO,LUTOLO HEALTH CENTRE,726,7,2,6,169,295,479,27,506,0,O-95-33-01-05-02
BUGIRI,BUKOOLI SOUTH,BANDA,LUTOLO,NANGERA PR. SCH.,428,6,0,3,116,193,318,23,341,0,O-95-33-01-05-03
BUGIRI,BUKOOLI SOUTH,BANDA,LUTOLO,MAGOOLI CHURCH,376,4,4,1,92,171,272,25,297,0,O-95-33-01-05-04
BUGIRI,BUKOOLI SOUTH,BANDA,LUTOLO,BUCHUNIA CHURCH,406,6,0,2,86,165,259,58,317,0,O-95-33-01-05-05
BUGIRI,BUKOOLI SOUTH,BUSWALE,BUBANGO,BUBANGO BAPTIST SCHOOL,308,0,4,1,63,153,221,16,237,0,O-95-33-02-01-01
BUGIRI,BUKOOLI SOUTH,BUSWALE,BUBANGO,NALWIGI APOSTOLIC CHURCH,545,6,1,4,103,248,362,18,380,0,O-95-33-02-01-02
BUGIRI,BUKOOLI SOUTH,BUSWALE,BUNGECHA,BUNGECHA P SCHOOL,754,6,1,9,148,358,522,44,566,0,O-95-33-02-02-01
BUGIRI,BUKOOLI SOUTH,BUSWALE,BUNGECHA,BUHATANDU PR. SCH.,589,4,0,3,149,278,434,22,456,0,O-95-33-02-02-02
BUGIRI,BUKOOLI SOUTH,BUSWALE,BUSWALE,BUSWALE P. SCHOOL,825,5,6,4,212,367,594,2,596,0,O-95-33-02-03-01
BUGIRI,BUKOOLI SOUTH,BUSWALE,BUSWALE,NASISA P. SCHOOL,349,2,0,0,83,176,261,41,302,0,O-95-33-02-03-02
BUGIRI,BUKOOLI SOUTH,BUSWALE,BUSWALE,BUHUNYA PR. SCH.,263,6,1,1,75,131,214,8,222,0,O-95-33-02-03-03
BUGIRI,BUKOOLI SOUTH,BUSWALE,MADOWA,NAMIHINYA P/SCHOOL,729,4,2,5,115,325,451,36,487,0,O-95-33-02-04-01
BUGIRI,BUKOOLI SOUTH,BUSWALE,MADOWA,MADOWA PRI. SCHOOL,346,3,0,0,52,178,233,10,243,0,O-95-33-02-04-02
BUGIRI,BUKOOLI SOUTH,BUSWALE,MADOWA,NAMUNGODI MOSQUE,324,1,0,0,39,165,205,56,261,0,O-95-33-02-04-03
BUGIRI,BUKOOLI SOUTH,BUSWALE,NAMAYUGE,HABALA PRI. SCHOOL,583,9,7,10,57,315,398,21,419,0,O-95-33-02-05-01
BUGIRI,BUKOOLI SOUTH,BUSWALE,NAMAYUGE,NAMAYUGE PRI. SCHOOL,741,3,1,9,134,389,536,16,552,0,O-95-33-02-05-02
BUGIRI,BUKOOLI SOUTH,BUSWALE,NAMAYUGE,NAMAJI C.O.U,432,4,4,7,59,247,321,17,338,0,O-95-33-02-05-03
BUGIRI,BUKOOLI SOUTH,BUSWALE,NANSUMA,BUMOLI P SCHOOL,882,5,2,11,166,391,575,41,616,0,O-95-33-02-06-01
BUGIRI,BUKOOLI SOUTH,BUSWALE,NANSUMA,MUKOROBI PRI. SCHOOL,730,4,0,4,132,360,500,31,531,0,O-95-33-02-06-02
BUGIRI,BUKOOLI SOUTH,BUYINJA,BUHEMBA,BULUNDIRA C.O.U,428,5,2,5,63,242,317,12,329,0,O-95-33-03-01-01
BUGIRI,BUKOOLI SOUTH,BUYINJA,BUHEMBA,BUHEMBA PR. SCHOOL,441,3,0,4,84,222,313,15,328,0,O-95-33-03-01-02
BUGIRI,BUKOOLI SOUTH,BUYINJA,BUHEMBA,BULYALI HIGH SCHOOL,566,5,2,6,109,304,426,12,438,0,O-95-33-03-01-03
BUGIRI,BUKOOLI SOUTH,BUYINJA,BUKEWA,MARUBA BEACH CHURCH,354,4,0,1,83,146,234,10,244,0,O-95-33-03-02-01
BUGIRI,BUKOOLI SOUTH,BUYINJA,BUKEWA,BUKEWA GROUND,852,4,4,4,165,336,513,15,528,0,O-95-33-03-02-02
BUGIRI,BUKOOLI SOUTH,BUYINJA,BULAMBA,BULAMBA CO-OP SOCIETY,546,1,0,3,107,268,379,24,403,0,O-95-33-03-03-01
BUGIRI,BUKOOLI SOUTH,BUYINJA,BULAMBA,BUDIDI PR SCHOOL,606,5,0,4,128,351,488,13,501,0,O-95-33-03-03-02
BUGIRI,BUKOOLI SOUTH,BUYINJA,BULAMBA,BULAMBA PRI. SCHOOL,308,2,0,2,95,121,220,9,229,0,O-95-33-03-03-03
BUGIRI,BUKOOLI SOUTH,BUYINJA,BUWONGO,BUKIMBI T/CENTRE,478,7,0,5,61,250,323,16,339,0,O-95-33-03-04-01
BUGIRI,BUKOOLI SOUTH,BUYINJA,BUWONGO,BUWONGO PR. SCH.,358,4,2,2,94,159,261,17,278,0,O-95-33-03-04-02
BUGIRI,BUKOOLI SOUTH,BUYINJA,BUWONGO,MATIKO BEACH,226,0,0,1,45,105,151,7,158,0,O-95-33-03-04-03
BUGIRI,BUKOOLI SOUTH,BUYINJA,DOHWE,DOHWE PR SCHOOL,774,4,1,4,200,366,575,40,615,0,O-95-33-03-05-01
BUGIRI,BUKOOLI SOUTH,BUYINJA,DOHWE,LUWERERE T/CENTRE,377,0,1,1,83,206,291,18,309,0,O-95-33-03-05-02
BUGIRI,BUKOOLI SOUTH,BUYINJA,GONDOKERA,BUTAJA PR. SCH.,485,2,1,1,171,214,389,23,412,0,O-95-33-03-06-01
BUGIRI,BUKOOLI SOUTH,BUYINJA,GONDOKERA,BUNYIKA P. SCHOOL,481,2,1,1,176,185,365,16,381,0,O-95-33-03-06-02
BUGIRI,BUKOOLI SOUTH,BUYINJA,GONDOKERA,NASINU PR. SCHOOL,348,5,1,3,150,111,270,20,290,0,O-95-33-03-06-03
BUGIRI,BUKOOLI SOUTH,BUYINJA,KIFUYO,KIFUYO MOSQUE,763,4,5,6,168,322,505,45,550,0,O-95-33-03-07-01
BUGIRI,BUKOOLI SOUTH,BUYINJA,KIFUYO,KIFUYO PRI. SCHOOL,487,3,1,3,92,228,327,22,349,0,O-95-33-03-07-02
BUGIRI,BUKOOLI SOUTH,BUYINJA,LWANGOSIA,LWANGOSIA PR SCHOOL,952,1,2,4,318,331,656,15,671,0,O-95-33-03-08-01
BUGIRI,BUKOOLI SOUTH,BUYINJA,LWANGOSIA,BULOHA PRI. SCHOOL,218,0,1,1,96,70,168,6,174,0,O-95-33-03-08-02
BUGIRI,BUKOOLI SOUTH,BUYINJA,NAMAINGO,NAMAYINGO PR SCHOOL,691,2,6,1,160,293,462,20,482,0,O-95-33-03-09-01
BUGIRI,BUKOOLI SOUTH,BUYINJA,NAMAINGO,BUYINJA HEALTH CENTRE,576,1,2,2,124,168,297,10,307,0,O-95-33-03-09-02
BUGIRI,BUKOOLI SOUTH,BUYINJA,NAMAINGO,BUYINJA S/C/HQS,591,8,4,3,109,264,388,16,404,0,O-95-33-03-09-03
BUGIRI,BUKOOLI SOUTH,BUYINJA,NSONO,NSONO PR SCHOOL,701,4,3,4,161,337,509,22,531,0,O-95-33-03-10-01
BUGIRI,BUKOOLI SOUTH,BUYINJA,NSONO,BUGOMA P SCHOOL,499,1,1,5,131,218,356,11,367,0,O-95-33-03-10-02
BUGIRI,BUKOOLI SOUTH,BUYINJA,NSONO,NAMAVUNDU CATHOLIC CHURCH,488,2,3,3,96,219,323,25,348,0,O-95-33-03-10-03
BUGIRI,BUKOOLI SOUTH,BUYINJA,SINDE,SINDE P SCHOOL,350,2,1,2,81,154,240,15,255,0,O-95-33-03-11-01
BUGIRI,BUKOOLI SOUTH,BUYINJA,SINDE,SINDE WEST T.C,589,7,2,3,107,326,445,46,491,0,O-95-33-03-11-02
BUGIRI,BUKOOLI SOUTH,BUYINJA,SINDE,NAMUWOMBI APOSTOLIC CHURC,305,2,2,2,98,113,217,9,226,0,O-95-33-03-11-03
BUGIRI,BUKOOLI SOUTH,BUYINJA,SYANYONJA,HOHOMA PRI. SCHOOL,565,7,3,4,139,272,425,30,455,0,O-95-33-03-12-01
BUGIRI,BUKOOLI SOUTH,BUYINJA,SYANYONJA,SYANYONJA PRI. SCHOOL,624,4,0,2,154,312,472,27,499,0,O-95-33-03-12-02
BUGIRI,BUKOOLI SOUTH,BUYINJA,SYANYONJA,BUBOKO PR. SCH.,391,1,1,2,108,178,290,32,322,0,O-95-33-03-12-03
BUGIRI,BUKOOLI SOUTH,MUTUMBA,BUCHIMO,BUCHIMO PRI. SCHOOL,578,14,6,2,124,220,366,21,387,0,O-95-33-04-01-01
BUGIRI,BUKOOLI SOUTH,MUTUMBA,BUCHIMO,MUSOLI BEACH,167,1,1,0,38,68,108,6,114,0,O-95-33-04-01-02
BUGIRI,BUKOOLI SOUTH,MUTUMBA,BUCHIMO,BUMERU PRIMARY SCHOOL,1110,5,5,4,176,462,652,20,672,0,O-95-33-04-01-03
BUGIRI,BUKOOLI SOUTH,MUTUMBA,BULULE,NABUSERA TR. CENTRE A,840,3,4,8,82,446,543,49,592,0,O-95-33-04-02-01
BUGIRI,BUKOOLI SOUTH,MUTUMBA,BULULE,BULULE PRI SCHOOL,769,9,4,4,80,382,479,30,509,0,O-95-33-04-02-02
BUGIRI,BUKOOLI SOUTH,MUTUMBA,LUBANGO,MULWANDA BEACH,679,4,1,3,130,328,466,30,496,0,O-95-33-04-03-01
BUGIRI,BUKOOLI SOUTH,MUTUMBA,LUBANGO,LUBANGO T/CENTRE,702,4,0,2,143,277,426,26,452,0,O-95-33-04-03-02
BUGIRI,BUKOOLI SOUTH,MUTUMBA,LUBANGO,LUGAGA PR. SCH.,265,7,0,2,34,130,173,11,184,0,O-95-33-04-03-03
BUGIRI,BUKOOLI SOUTH,MUTUMBA,LUBIRA,BUGALI PRI. SCHOOL (N-Z),570,3,1,1,120,315,440,14,454,0,O-95-33-04-04-01
BUGIRI,BUKOOLI SOUTH,MUTUMBA,LUBIRA,MAWA NEW APOSTOLIC CHURCH,367,2,1,3,96,177,279,6,285,0,O-95-33-04-04-02
BUGIRI,BUKOOLI SOUTH,MUTUMBA,LUBIRA,LUFUDU PRIMARY SCHOOL,637,4,1,0,174,276,455,27,482,0,O-95-33-04-04-03
BUGIRI,BUKOOLI SOUTH,MUTUMBA,LUBIRA,BUGALI PRI. SCHOOL (A-M),512,5,1,4,99,268,377,22,399,0,O-95-33-04-04-04
BUGIRI,BUKOOLI SOUTH,MUTUMBA,LUBIRA,LUBIRA CATHOLIC CHURCH,563,4,0,5,9,318,336,39,375,0,O-95-33-04-04-05
BUGIRI,BUKOOLI SOUTH,MUTUMBA,MUTUMBA,SIDOME PRI. SCHOOL,262,1,0,0,35,105,141,7,148,0,O-95-33-04-05-01
BUGIRI,BUKOOLI SOUTH,MUTUMBA,MUTUMBA,MUTUMBA P. SCHOOL,830,3,3,5,152,381,544,39,583,0,O-95-33-04-05-02
BUGIRI,BUKOOLI SOUTH,MUTUMBA,MUTUMBA,MUTUMBA SUB COUNTY HQTRS,725,8,6,6,148,326,494,13,507,0,O-95-33-04-05-03
BUGIRI,BUKOOLI SOUTH,MUTUMBA,MWEMA,MULOMBI T/CENTRE,786,5,4,7,170,363,549,16,565,0,O-95-33-04-06-01
BUGIRI,BUKOOLI SOUTH,MUTUMBA,MWEMA,MULOMBI HEALTH UNIT,662,7,2,7,101,314,431,13,444,0,O-95-33-04-06-02
BUGIRI,BUKOOLI SOUTH,MUTUMBA,MWEMA,BULUNDIRA C.O.U,145,5,0,0,23,68,96,7,103,0,O-95-33-04-06-03
BUGIRI,BUKOOLI SOUTH,MUTUMBA,MWEMA,BUTEBEYI TRADING CENTRE,709,4,5,5,157,334,505,16,521,0,O-95-33-04-06-04
BUGIRI,BUKOOLI SOUTH,SIGULU ISLANDS,BIISA,BIISA PRI.SCHOOL,226,1,1,0,16,41,59,7,66,0,O-95-33-05-01-01
BUGIRI,BUKOOLI SOUTH,SIGULU ISLANDS,BUDUMA,BUDOMA P SCHOOL,517,0,0,2,67,218,287,13,300,0,O-95-33-05-02-01
BUGIRI,BUKOOLI SOUTH,SIGULU ISLANDS,BUDUMA,BUHOBI P. SCHOOL,89,0,0,0,19,32,51,3,54,0,O-95-33-05-02-02
BUGIRI,BUKOOLI SOUTH,SIGULU ISLANDS,BUGANA,BUBWIBO CATHOLIC CHURCH,462,8,0,2,76,200,286,19,305,0,O-95-33-05-03-01
BUGIRI,BUKOOLI SOUTH,SIGULU ISLANDS,BUGANA,BUGANA PRI. SCHOOL,534,2,0,1,110,282,395,30,425,0,O-95-33-05-03-02
BUGIRI,BUKOOLI SOUTH,SIGULU ISLANDS,BUMALENGE,BULAGAYE PR. SCHOOL,268,1,2,2,43,127,175,15,190,0,O-95-33-05-04-01
BUGIRI,BUKOOLI SOUTH,SIGULU ISLANDS,BUMALENGE,BUMALENGE PR. SCH.,338,1,0,1,85,134,221,6,227,0,O-95-33-05-04-02
BUGIRI,BUKOOLI SOUTH,SIGULU ISLANDS,HAMA,HAMA PRI. SCHOOL,602,0,0,3,125,218,346,17,363,0,O-95-33-05-05-01
BUGIRI,BUKOOLI SOUTH,SIGULU ISLANDS,HAMA,WAYASI PRI. SCHOOL,195,2,1,0,37,46,86,0,86,0,O-95-33-05-05-02
BUGIRI,BUKOOLI SOUTH,SIGULU ISLANDS,HAMA,SIRO PRI SCHOOL,270,3,1,1,51,64,120,5,125,0,O-95-33-05-05-03
BUGIRI,BUKOOLI SOUTH,SIGULU ISLANDS,LOLWE EAST,BUKANGAWA BEACH,177,2,0,0,30,76,108,7,115,0,O-95-33-05-06-01
BUGIRI,BUKOOLI SOUTH,SIGULU ISLANDS,LOLWE EAST,SINGILA/LOLWE PR. SCH.,983,5,0,1,256,184,446,9,455,0,O-95-33-05-06-02
BUGIRI,BUKOOLI SOUTH,SIGULU ISLANDS,LOLWE WEST,LOLWE ISLAND A,418,2,0,3,23,134,162,11,173,0,O-95-33-05-07-01
BUGIRI,BUKOOLI SOUTH,SIGULU ISLANDS,LOLWE WEST,MWANGO PRIMARY SCHOOL,558,0,0,1,60,71,132,27,159,0,O-95-33-05-07-02
BUGIRI,BUKOOLI SOUTH,SIGULU ISLANDS,LOLWE WEST,GOROFA PR. SCHOOL,779,1,2,5,225,131,364,1,365,0,O-95-33-05-07-03
BUGIRI,BUKOOLI SOUTH,SIGULU ISLANDS,LOLWE WEST,KANDEGE HEALTH CENTRE,889,4,1,1,73,263,342,11,353,0,O-95-33-05-07-04
BUGIRI,BUKOOLI SOUTH,SIGULU ISLANDS,LOLWE WEST,GOROFA TRUMPET CHURCH (A-N),759,4,0,4,204,139,351,2,353,0,O-95-33-05-07-05
BUGIRI,BUKOOLI SOUTH,SIGULU ISLANDS,LOLWE WEST,KANDEGE PRI. SCHOOL,99,0,0,0,13,23,36,3,39,0,O-95-33-05-07-06
BUGIRI,BUKOOLI SOUTH,SIGULU ISLANDS,LOLWE WEST,GOROFA TRUMPET CHURCH (O-Z,352,1,0,3,100,57,161,5,166,0,O-95-33-05-07-07
BUGIRI,BUKOOLI SOUTH,SIGULU ISLANDS,LOLWE WEST,BUTANIRA PRI. SCHOOL,429,2,0,0,42,109,153,36,189,0,O-95-33-05-07-08
BUGIRI,BUKOOLI SOUTH,SIGULU ISLANDS,NAMPONGWE,NAMUGONGO PRI. SCHOOL,259,1,0,0,54,113,168,10,178,0,O-95-33-05-08-01
BUGIRI,BUKOOLI SOUTH,SIGULU ISLANDS,NAMPONGWE,BUGOMA ACADEMY PRI. SCHOOL,377,1,0,1,43,182,227,9,236,0,O-95-33-05-08-02
BUGIRI,BUKOOLI SOUTH,SIGULU ISLANDS,RABACHI,RABACHI PRI. SCHOOL,466,2,0,3,66,298,369,21,390,0,O-95-33-05-09-01
BUGIRI,BUKOOLI SOUTH,SIGULU ISLANDS,RABACHI,BULARI APOSTOLIC CHURCH,143,1,0,0,16,68,85,7,92,0,O-95-33-05-09-02
BUGIRI,BUKOOLI SOUTH,SIGULU ISLANDS,SIGULU MANGA,SIGULU ISLAND PRI. SCHOOL,538,1,0,0,81,218,300,68,368,0,O-95-33-05-10-01
BUGIRI,BUKOOLI SOUTH,SIGULU ISLANDS,SIGULU MANGA,SYABALUBI PRI. SCHOOL,319,3,0,1,41,210,255,8,263,0,O-95-33-05-10-02
BUGIRI,BUKOOLI SOUTH,SIGULU ISLANDS,SIGULU MUKANI,BUHOBA PRI. SCH,742,6,2,2,222,194,426,27,453,0,O-95-33-05-11-01
SOROTI,SERERE COUNTY,ATIIRA,ALENGO,ALENGO PAG - CHURCH,841,8,8,2,445,131,594,89,683,0,O-97-204-01-01-01
SOROTI,SERERE COUNTY,ATIIRA,ALENGO,OGESEK CENTRE,587,8,3,1,341,63,416,74,490,0,O-97-204-01-01-02
SOROTI,SERERE COUNTY,ATIIRA,ALENGO,ALENGO PRIMARY SCHOOL,198,3,3,2,124,19,151,8,159,0,O-97-204-01-01-03
SOROTI,SERERE COUNTY,ATIIRA,APUURE,ADIPALA PRI SCHOOL,323,1,0,0,154,69,224,27,251,0,O-97-204-01-02-01
SOROTI,SERERE COUNTY,ATIIRA,APUURE,OPUURE P/SCH,608,14,2,7,391,54,468,26,494,0,O-97-204-01-02-02
SOROTI,SERERE COUNTY,ATIIRA,APUURE,OMUGENYA BORE HOLE,323,1,1,2,185,68,257,6,263,0,O-97-204-01-02-03
SOROTI,SERERE COUNTY,ATIIRA,ATIIRA,ACILO-APOKOR-OKWENY,403,4,3,0,267,48,322,9,331,0,O-97-204-01-03-01
SOROTI,SERERE COUNTY,ATIIRA,ATIIRA,ATIIRA P/SCH,723,8,6,5,400,102,521,21,542,0,O-97-204-01-03-02
SOROTI,SERERE COUNTY,ATIIRA,ATIIRA,ODOKAI - OKIMAI - OLUMOI,516,2,1,2,262,74,341,65,406,0,O-97-204-01-03-03
SOROTI,SERERE COUNTY,ATIIRA,ATIIRA,ASILANG PRI. SCHOOL,388,10,1,1,154,66,232,65,297,0,O-97-204-01-03-04
SOROTI,SERERE COUNTY,ATIIRA,ATIIRA,OBIT BORE HOLE,307,4,0,1,176,49,230,8,238,0,O-97-204-01-03-05
SOROTI,SERERE COUNTY,KATETA,KAMUSALA,KAMUSALA A And B,651,10,1,1,324,87,423,4,427,0,O-97-204-02-01-01
SOROTI,SERERE COUNTY,KATETA,KAMUSALA,KORUPE,679,7,2,7,331,122,469,40,509,0,O-97-204-02-01-02
SOROTI,SERERE COUNTY,KATETA,KAMUSALA,OBURIEKORI,558,10,2,3,286,117,418,15,433,0,O-97-204-02-01-03
SOROTI,SERERE COUNTY,KATETA,KAMUSALA,POKOR A,467,8,2,7,193,76,286,8,294,0,O-97-204-02-01-04
SOROTI,SERERE COUNTY,KATETA,KAMUSALA,POKOR B,401,5,3,5,218,67,298,8,306,0,O-97-204-02-01-05
SOROTI,SERERE COUNTY,KATETA,KANYANGAN,ININGO HEALTH UNIT,291,0,2,1,126,76,205,8,213,0,O-97-204-02-02-01
SOROTI,SERERE COUNTY,KATETA,KANYANGAN,AMINIT,405,6,0,2,265,23,296,55,351,0,O-97-204-02-02-02
SOROTI,SERERE COUNTY,KATETA,KANYANGAN,KANYANGAN P/SCH,591,4,3,6,365,70,448,13,461,0,O-97-204-02-02-03
SOROTI,SERERE COUNTY,KATETA,KANYANGAN,OEREERE OGUNAI,366,4,0,4,206,76,290,11,301,0,O-97-204-02-02-04
SOROTI,SERERE COUNTY,KATETA,KANYANGAN,OKODO,487,9,4,3,285,59,360,7,367,0,O-97-204-02-02-05
SOROTI,SERERE COUNTY,KATETA,KANYANGAN,OMUNIT CENTRE,325,0,1,6,177,48,232,6,238,0,O-97-204-02-02-06
SOROTI,SERERE COUNTY,KATETA,KATETA,ADELE CENTRE,353,1,1,1,225,47,275,2,277,0,O-97-204-02-03-01
SOROTI,SERERE COUNTY,KATETA,KATETA,AISIN,519,7,0,3,316,85,411,10,421,0,O-97-204-02-03-02
SOROTI,SERERE COUNTY,KATETA,KATETA,SUB COUNTY HQTRS,431,3,2,1,213,79,298,3,301,0,O-97-204-02-03-03
SOROTI,SERERE COUNTY,KATETA,KATETA,KACHOMIA,1103,14,10,11,516,253,804,0,804,0,O-97-204-02-03-04
SOROTI,SERERE COUNTY,KATETA,KATETA,OLORO'S PLACE,493,3,2,1,321,58,385,13,398,0,O-97-204-02-03-05
SOROTI,SERERE COUNTY,KATETA,KATETA,OMAGARA PRIMARY SCHOOL,1031,17,7,18,502,188,732,19,751,0,O-97-204-02-03-06
SOROTI,SERERE COUNTY,KATETA,KATETA,OSOKOTOIT PRIMARY SCHOOL,352,2,0,0,217,26,245,34,279,0,O-97-204-02-03-07
SOROTI,SERERE COUNTY,KATETA,OJETENYANGA,AGULE - OLAGARA,318,2,2,3,210,30,247,10,257,0,O-97-204-02-04-01
SOROTI,SERERE COUNTY,KATETA,OJETENYANGA,ALEPELEP - AEP,195,3,0,3,70,62,138,30,168,0,O-97-204-02-04-02
SOROTI,SERERE COUNTY,KATETA,OJETENYANGA,CAMULIKI,649,8,1,0,382,57,448,94,542,0,O-97-204-02-04-03
SOROTI,SERERE COUNTY,KATETA,OJETENYANGA,ONGAROT ADEU,422,2,0,0,241,74,317,42,359,0,O-97-204-02-04-04
SOROTI,SERERE COUNTY,KATETA,OJETENYANGA,OPAPA - ONYARA,436,11,1,4,209,62,287,65,352,0,O-97-204-02-04-05
SOROTI,SERERE COUNTY,KYERE,KAMUROJO,KAMUROJO A,742,24,1,14,401,92,532,27,559,0,O-97-204-03-01-01
SOROTI,SERERE COUNTY,KYERE,KAMUROJO,KAMUROJO B,567,11,5,6,301,70,393,16,409,0,O-97-204-03-01-02
SOROTI,SERERE COUNTY,KYERE,KAMUROJO,KAMUROJO C,767,12,3,11,405,114,545,17,562,0,O-97-204-03-01-03
SOROTI,SERERE COUNTY,KYERE,KAMUROJO,KAMUROJO D,656,3,0,3,377,91,474,27,501,0,O-97-204-03-01-04
SOROTI,SERERE COUNTY,KYERE,KANGODO,KANGODO A,542,8,3,7,327,80,425,15,440,0,O-97-204-03-02-01
SOROTI,SERERE COUNTY,KYERE,KANGODO,KANGODO B,799,7,3,9,447,111,577,13,590,0,O-97-204-03-02-02
SOROTI,SERERE COUNTY,KYERE,KELIM,KELIM A,893,11,10,15,568,63,667,40,707,0,O-97-204-03-03-01
SOROTI,SERERE COUNTY,KYERE,KELIM,KELIM PRIMARY SCHOOL,680,8,3,5,439,74,529,5,534,0,O-97-204-03-03-02
SOROTI,SERERE COUNTY,KYERE,KELIM,KELIM C,697,13,2,6,460,53,534,10,544,0,O-97-204-03-03-03
SOROTI,SERERE COUNTY,KYERE,KELIM,AGULE PRIMARY SCHOOL,259,2,1,4,163,41,211,6,217,0,O-97-204-03-03-04
SOROTI,SERERE COUNTY,KYERE,KYERE,ALILIMO - OMORIO,652,2,2,5,299,84,392,77,469,0,O-97-204-03-04-01
SOROTI,SERERE COUNTY,KYERE,KYERE,KAKUJA - ATOI - OLEP,778,11,4,15,539,72,641,20,661,0,O-97-204-03-04-02
SOROTI,SERERE COUNTY,KYERE,KYERE,SUB COUNTY HQTRS,888,14,3,9,435,108,569,27,596,0,O-97-204-03-04-03
SOROTI,SERERE COUNTY,KYERE,KYERE,OBWAKOL BORE HOLE,432,12,2,7,257,60,338,21,359,0,O-97-204-03-04-04
SOROTI,SERERE COUNTY,KYERE,OLUPE,OLUPE A,704,13,5,8,405,78,509,20,529,0,O-97-204-03-05-01
SOROTI,SERERE COUNTY,KYERE,OLUPE,OLUPE B,596,4,2,7,383,55,451,9,460,0,O-97-204-03-05-02
SOROTI,SERERE COUNTY,SERERE/OLIO,AKOBOI,ANYALAI PRI SCHOOL,663,6,4,3,462,50,525,1,526,0,O-97-204-04-01-01
SOROTI,SERERE COUNTY,SERERE/OLIO,AKOBOI,AKOBOI MARKET,556,6,9,1,324,88,428,8,436,0,O-97-204-04-01-02
SOROTI,SERERE COUNTY,SERERE/OLIO,AKOBOI,OPAULYENG T/C,419,2,1,7,256,66,332,9,341,0,O-97-204-04-01-03
SOROTI,SERERE COUNTY,SERERE/OLIO,OBURIN,JEJEL P/SCH,415,10,0,5,213,64,292,6,298,0,O-97-204-04-02-01
SOROTI,SERERE COUNTY,SERERE/OLIO,OBURIN,OBURIN PRI SCHOOL,777,17,3,4,401,112,537,36,573,0,O-97-204-04-02-02
SOROTI,SERERE COUNTY,SERERE/OLIO,OBURIN,IDUPA PRI SCHOOL,1043,13,3,10,558,107,691,22,713,0,O-97-204-04-02-03
SOROTI,SERERE COUNTY,SERERE/OLIO,OBURIN,ODUNGURA - JELEL,655,12,6,15,313,144,490,17,507,0,O-97-204-04-02-04
SOROTI,SERERE COUNTY,SERERE/OLIO,OKULONYO,AIMA,489,3,0,0,348,49,400,3,403,0,O-97-204-04-03-01
SOROTI,SERERE COUNTY,SERERE/OLIO,OKULONYO,IGOLA/OKULUNYO,266,0,4,0,159,34,197,3,200,0,O-97-204-04-03-02
SOROTI,SERERE COUNTY,SERERE/OLIO,OKULONYO,SERERE TOWNSHIP PRI SCH (A-M,1223,10,5,3,597,118,733,18,751,0,O-97-204-04-03-03
SOROTI,SERERE COUNTY,SERERE/OLIO,OKULONYO,OKULONYO PRI SCHOOL,768,11,2,2,353,68,436,164,600,0,O-97-204-04-03-04
SOROTI,SERERE COUNTY,SERERE/OLIO,OKULONYO,SERERE TOWNSHIP PRI SCH (N-Z,377,4,0,0,216,48,268,10,278,0,O-97-204-04-03-05
SOROTI,SERERE COUNTY,SERERE/OLIO,OKULONYO,AUJABULE TRADING CENTRE,184,4,0,0,107,37,148,12,160,0,O-97-204-04-03-06
SOROTI,SERERE COUNTY,SERERE/OLIO,OSUGURO,ABILAEP - OJUBURIN,243,1,4,1,149,36,191,2,193,0,O-97-204-04-04-01
SOROTI,SERERE COUNTY,SERERE/OLIO,OSUGURO,AOJAKUM COU,254,1,0,2,155,39,197,1,198,0,O-97-204-04-04-02
SOROTI,SERERE COUNTY,SERERE/OLIO,OSUGURO,KIKOTA,219,2,3,0,83,63,151,0,151,0,O-97-204-04-04-03
SOROTI,SERERE COUNTY,SERERE/OLIO,OSUGURO,OGOBAI - ADOKU,527,3,5,3,289,104,404,1,405,0,O-97-204-04-04-04
SOROTI,SERERE COUNTY,SERERE/OLIO,OSUGURO,OLIO P/SCH,447,1,2,1,180,76,260,6,266,0,O-97-204-04-04-05
SOROTI,SERERE COUNTY,SERERE/OLIO,OSUGURO,SERERE A,1743,11,9,9,718,198,945,33,978,0,O-97-204-04-04-06
SOROTI,KASILO COUNTY,BUGONDO,AGULE,AGULE PRIMARY SCHOOL,816,13,9,3,516,92,633,11,644,0,O-38-203-01-01-01
SOROTI,KASILO COUNTY,BUGONDO,AGULE,ALOR P/SCH,482,6,2,3,313,55,379,3,382,0,O-38-203-01-01-02
SOROTI,KASILO COUNTY,BUGONDO,AGULE,OBONGOI PAG CHURCH,225,0,2,0,155,22,179,9,188,0,O-38-203-01-01-03
SOROTI,KASILO COUNTY,BUGONDO,AGULE,OWII PAG CHURCH,215,0,0,1,148,17,166,13,179,0,O-38-203-01-01-04
SOROTI,KASILO COUNTY,BUGONDO,BUGONDO,BUGONDO GINNERY,399,3,1,5,251,56,316,11,327,0,O-38-203-01-02-01
SOROTI,KASILO COUNTY,BUGONDO,BUGONDO,OGELAK PRIMARY SCHOOL,818,11,1,7,564,68,651,19,670,0,O-38-203-01-02-02
SOROTI,KASILO COUNTY,BUGONDO,KAMOD,ATIRIR MANGO TREE,380,0,3,3,289,13,308,10,318,0,O-38-203-01-03-01
SOROTI,KASILO COUNTY,BUGONDO,KAMOD,KAMOD P/SCH,1073,9,6,3,584,94,696,28,724,0,O-38-203-01-03-02
SOROTI,KASILO COUNTY,BUGONDO,KAMOD,OCULURA P/SCH,598,3,4,4,398,54,463,18,481,0,O-38-203-01-03-03
SOROTI,KASILO COUNTY,BUGONDO,KAMOD,OGESEK MANGO TREES,291,4,3,3,206,24,240,3,243,0,O-38-203-01-03-04
SOROTI,KASILO COUNTY,BUGONDO,KAMOD,BUGONDO PRI. SCHOOL,120,1,0,1,67,15,84,7,91,0,O-38-203-01-03-05
SOROTI,KASILO COUNTY,BUGONDO,KONGOTO,APAPAI P/SCH,585,2,4,0,464,51,521,6,527,0,O-38-203-01-04-01
SOROTI,KASILO COUNTY,BUGONDO,KONGOTO,KONGOTO PRIMARY SCHOOL A,596,6,3,3,421,38,471,7,478,0,O-38-203-01-04-02
SOROTI,KASILO COUNTY,BUGONDO,KONGOTO,OLOBAI/KASILO P/SCH,753,4,1,2,540,64,611,21,632,0,O-38-203-01-04-03
SOROTI,KASILO COUNTY,BUGONDO,KONGOTO,OKOKOMA PAG CHURCH,274,2,0,0,169,32,203,11,214,0,O-38-203-01-04-04
SOROTI,KASILO COUNTY,BUGONDO,OGERA,KABOLA CHURCH OF UG,776,8,5,6,531,50,600,8,608,0,O-38-203-01-05-01
SOROTI,KASILO COUNTY,BUGONDO,OGERA,OMONGOLEM TRADINC CENTRE,606,4,2,3,408,44,461,31,492,0,O-38-203-01-05-02
SOROTI,KASILO COUNTY,BUGONDO,OGERA,TOROR P/SCH,645,7,2,4,445,34,492,29,521,0,O-38-203-01-05-03
SOROTI,KASILO COUNTY,KADUNGULU,IRUKO,AJUBA BOREHOLE,413,6,2,7,252,54,321,23,344,0,O-38-203-02-01-01
SOROTI,KASILO COUNTY,KADUNGULU,IRUKO,IRUKO COOPERATIVE SOCIETY,651,9,2,1,452,34,498,24,522,0,O-38-203-02-01-02
SOROTI,KASILO COUNTY,KADUNGULU,IRUKO,IRUKO PRIMARY SCHOOL,590,13,2,2,419,58,494,11,505,0,O-38-203-02-01-03
SOROTI,KASILO COUNTY,KADUNGULU,KADUNGULU,ADUKUT P/SCH,658,18,2,11,429,43,503,16,519,0,O-38-203-02-02-01
SOROTI,KASILO COUNTY,KADUNGULU,KADUNGULU,ADWENYI MANGO TREES,522,12,2,4,367,55,440,10,450,0,O-38-203-02-02-02
SOROTI,KASILO COUNTY,KADUNGULU,KADUNGULU,KADUNGULU S/C,654,5,3,4,342,80,434,22,456,0,O-38-203-02-02-03
SOROTI,KASILO COUNTY,KADUNGULU,KAGWARA,KABULABULA P/SCH,429,9,1,4,285,38,337,20,357,0,O-38-203-02-03-01
SOROTI,KASILO COUNTY,KADUNGULU,KAGWARA,KAGWARA A,193,2,0,0,71,46,119,10,129,0,O-38-203-02-03-02
SOROTI,KASILO COUNTY,KADUNGULU,KAGWARA,KAGWARA B,411,8,4,3,191,42,248,6,254,0,O-38-203-02-03-03
SOROTI,KASILO COUNTY,KADUNGULU,KAGWARA,KAGWARA C,541,7,4,3,222,141,377,26,403,0,O-38-203-02-03-04
SOROTI,KASILO COUNTY,KADUNGULU,KAGWARA,KAGWARA D,586,5,0,9,360,50,424,22,446,0,O-38-203-02-03-05
SOROTI,KASILO COUNTY,KADUNGULU,KAGWARA,KAGWARA E,457,9,3,4,267,43,326,20,346,0,O-38-203-02-03-06
SOROTI,KASILO COUNTY,KADUNGULU,KAGWARA,MATOKE'S PLACE,491,8,6,7,236,89,346,13,359,0,O-38-203-02-03-07
SOROTI,KASILO COUNTY,PINGIRE,AAROPOO,AAROPOO A,554,4,2,4,310,62,382,11,393,0,O-38-203-03-01-01
SOROTI,KASILO COUNTY,PINGIRE,AAROPOO,ASWII,627,2,3,1,343,90,439,17,456,0,O-38-203-03-01-02
SOROTI,KASILO COUNTY,PINGIRE,AAROPOO,MUGARAMA,474,8,2,2,274,63,349,6,355,0,O-38-203-03-01-03
SOROTI,KASILO COUNTY,PINGIRE,AAROPOO,MULONGE,229,1,1,0,111,36,149,8,157,0,O-38-203-03-01-04
SOROTI,KASILO COUNTY,PINGIRE,KADAPAKOL,AKUMOI,426,1,3,3,272,25,304,1,305,0,O-38-203-03-02-01
SOROTI,KASILO COUNTY,PINGIRE,KADAPAKOL,ODAPAKOL A,838,11,6,4,445,85,551,22,573,0,O-38-203-03-02-02
SOROTI,KASILO COUNTY,PINGIRE,KADAPAKOL,ODAPAKOL B,422,5,0,5,214,65,289,14,303,0,O-38-203-03-02-03
SOROTI,KASILO COUNTY,PINGIRE,KADAPAKOL,ODAPAKOL C,336,10,1,1,210,22,244,11,255,0,O-38-203-03-02-04
SOROTI,KASILO COUNTY,PINGIRE,KIDETOK,OGANGAI PRIMARY SCHOOL,389,2,1,0,213,38,254,19,273,0,O-38-203-03-03-01
SOROTI,KASILO COUNTY,PINGIRE,KIDETOK,ONGIA SPRING,938,7,6,4,370,112,499,33,532,0,O-38-203-03-03-02
SOROTI,KASILO COUNTY,PINGIRE,KIDETOK,AGONYO TREES,531,8,0,8,199,85,300,26,326,0,O-38-203-03-03-03
SOROTI,KASILO COUNTY,PINGIRE,KIDETOK,KIDETOK PRIMARY SCHOOL,370,10,2,2,163,95,272,9,281,0,O-38-203-03-03-04
SOROTI,KASILO COUNTY,PINGIRE,LABORI,LABORI - OTOBA,619,6,4,2,374,71,457,19,476,0,O-38-203-03-04-01
SOROTI,KASILO COUNTY,PINGIRE,LABORI,OPUNOI - OSAMITO - OBANGIN,950,8,9,13,461,211,702,27,729,0,O-38-203-03-04-02
SOROTI,KASILO COUNTY,PINGIRE,PINGIRE,AGULE,399,6,3,2,189,59,259,36,295,0,O-38-203-03-05-01
SOROTI,KASILO COUNTY,PINGIRE,PINGIRE,AMURIA - AGULE,900,17,3,6,410,133,569,31,600,0,O-38-203-03-05-02
SOROTI,KASILO COUNTY,PINGIRE,PINGIRE,KARAMOJONG,438,5,2,3,183,105,298,16,314,0,O-38-203-03-05-03
SOROTI,KASILO COUNTY,PINGIRE,PINGIRE,OKIDI,874,10,3,3,459,120,595,39,634,0,O-38-203-03-05-04
SOROTI,KASILO COUNTY,PINGIRE,PINGIRE,OKUMOI,399,2,4,2,271,33,312,9,321,0,O-38-203-03-05-05
SOROTI,KASILO COUNTY,PINGIRE,PINGIRE,OLWA,841,8,7,3,482,124,624,30,654,0,O-38-203-03-05-06
PALLISA,KIBUKU COUNTY,BULANGIRA,BULANGIRA,BULANGIRA SCTY HQRS,720,4,5,9,285,230,533,21,554,0,O-102-189-01-01-01
PALLISA,KIBUKU COUNTY,BULANGIRA,BULANGIRA,KAKUNYUMUNYU P/S,606,13,5,6,238,215,477,16,493,0,O-102-189-01-01-02
PALLISA,KIBUKU COUNTY,BULANGIRA,BULANGIRA,KANGALABA CHURCH,601,11,3,11,246,217,488,13,501,0,O-102-189-01-01-03
PALLISA,KIBUKU COUNTY,BULANGIRA,BULANGIRA,KADOTO TRADING CENTRE,601,0,0,5,323,144,472,6,478,0,O-102-189-01-01-04
PALLISA,KIBUKU COUNTY,BULANGIRA,KAKUTU,KAKUTA P/S (A-M),581,3,4,6,152,215,380,16,396,0,O-102-189-01-02-01
PALLISA,KIBUKU COUNTY,BULANGIRA,KAKUTU,KAKUTU P/S(N-Z),641,9,3,6,180,229,427,17,444,0,O-102-189-01-02-02
PALLISA,KIBUKU COUNTY,BULANGIRA,KAKUTU,KAKUBEKE,503,1,4,0,108,239,352,21,373,0,O-102-189-01-02-03
PALLISA,KIBUKU COUNTY,BULANGIRA,LYAMA,LYAMA PS,751,4,0,11,264,303,582,22,604,0,O-102-189-01-03-01
PALLISA,KIBUKU COUNTY,BULANGIRA,LYAMA,BUMBANTE,630,6,2,6,175,292,481,0,481,0,O-102-189-01-03-02
PALLISA,KIBUKU COUNTY,BULANGIRA,LYAMA,NEW APOSTOLIC CHURCH,409,8,0,7,100,171,286,7,293,0,O-102-189-01-03-03
PALLISA,KIBUKU COUNTY,BULANGIRA,PULAKA,KABIRIBITI MOSQUE(A-M),274,5,1,3,58,157,224,6,230,0,O-102-189-01-04-01
PALLISA,KIBUKU COUNTY,BULANGIRA,PULAKA,PULAKA G.C.S. LTD.,670,5,3,14,171,357,550,10,560,0,O-102-189-01-04-02
PALLISA,KIBUKU COUNTY,BULANGIRA,PULAKA,KAWUTUKWI IMMUNISATION CEN,425,0,1,6,112,213,332,2,334,0,O-102-189-01-04-03
PALLISA,KIBUKU COUNTY,BUSETA,BUGIRI,BUGIRI P.S.,930,2,1,0,183,617,803,47,850,0,O-102-189-02-01-01
PALLISA,KIBUKU COUNTY,BUSETA,BUGIRI,KAMIRA'S MANGO TREE,546,5,1,1,62,352,421,18,439,0,O-102-189-02-01-02
PALLISA,KIBUKU COUNTY,BUSETA,BUSETA,MIDIRI P.S. I (A-M),446,0,0,0,0,0,0,0,0,1,O-102-189-02-02-01
PALLISA,KIBUKU COUNTY,BUSETA,BUSETA,BUYELYA,502,2,4,3,90,256,355,29,384,0,O-102-189-02-02-02
PALLISA,KIBUKU COUNTY,BUSETA,BUSETA,NATOTO BATWALA'S MANGO TRE,709,2,3,1,216,240,462,41,503,0,O-102-189-02-02-03
PALLISA,KIBUKU COUNTY,BUSETA,BUSETA,MIDIRI P.S. I (N-Z),405,0,2,2,49,144,197,18,215,0,O-102-189-02-02-04
PALLISA,KIBUKU COUNTY,BUSETA,KAPYANI,NASOGOLA'S PLACE,242,4,1,1,46,98,150,33,183,0,O-102-189-02-03-01
PALLISA,KIBUKU COUNTY,BUSETA,KAPYANI,KAPYANI P.S. I,696,1,4,2,105,292,404,72,476,0,O-102-189-02-03-02
PALLISA,KIBUKU COUNTY,BUSETA,KAPYANI,DOKYA MANGO TREE,322,1,1,5,46,252,305,14,319,0,O-102-189-02-03-03
PALLISA,KIBUKU COUNTY,BUSETA,KASASIRA,KASASIRA P/S I,528,1,1,2,33,455,492,7,499,0,O-102-189-02-04-01
PALLISA,KIBUKU COUNTY,BUSETA,KASASIRA,KASASIRA P.S. II,723,3,2,1,107,333,446,9,455,0,O-102-189-02-04-02
PALLISA,KIBUKU COUNTY,BUSETA,KASASIRA,IDUBE'S TREE,335,1,0,0,47,166,214,42,256,0,O-102-189-02-04-03
PALLISA,KIBUKU COUNTY,BUSETA,KASASIRA,TEFIRO'S TREE,405,1,2,2,60,219,284,3,287,0,O-102-189-02-04-04
PALLISA,KIBUKU COUNTY,BUSETA,KITUTI,NAMEJE BORE HOLE,504,0,3,0,43,423,469,0,469,0,O-102-189-02-05-01
PALLISA,KIBUKU COUNTY,BUSETA,KITUTI,BUSETA SCTY HQRS,859,10,2,5,166,525,708,40,748,0,O-102-189-02-05-02
PALLISA,KIBUKU COUNTY,BUSETA,KITUTI,KITIRYO P.S. I,453,2,0,5,135,211,353,3,356,0,O-102-189-02-05-03
PALLISA,KIBUKU COUNTY,BUSETA,KITUTI,SANGO'S PLACE,582,3,1,1,137,279,421,13,434,0,O-102-189-02-05-04
PALLISA,KIBUKU COUNTY,BUSETA,NANKODO,SADIKI'S MANGO TREE,367,1,1,2,32,266,302,6,308,0,O-102-189-02-06-01
PALLISA,KIBUKU COUNTY,BUSETA,NANKODO,NANKONDO P/S I,586,1,1,2,33,455,492,7,499,0,O-102-189-02-06-02
PALLISA,KIBUKU COUNTY,BUSETA,NANKODO,NANKONDO CATHOLIC CHURCH,281,1,0,0,20,204,225,18,243,0,O-102-189-02-06-03
PALLISA,KIBUKU COUNTY,KADAMA,DODOI,DODOI C.O.U.,529,2,1,3,129,279,414,9,423,0,O-102-189-03-01-01
PALLISA,KIBUKU COUNTY,KADAMA,DODOI,DODOI C.O.U. TREE B,429,1,0,1,67,209,278,17,295,0,O-102-189-03-01-02
PALLISA,KIBUKU COUNTY,KADAMA,DODOI,DODOI HEALTH CENTRE,404,3,1,3,82,224,313,3,316,0,O-102-189-03-01-03
PALLISA,KIBUKU COUNTY,KADAMA,KABWERI,KABWERI REDCROSS,240,2,0,1,61,83,147,14,161,0,O-102-189-03-02-01
PALLISA,KIBUKU COUNTY,KADAMA,KABWERI,KABWERI P/S,725,4,4,2,202,233,445,20,465,0,O-102-189-03-02-02
PALLISA,KIBUKU COUNTY,KADAMA,KABWERI,KABWERI T.C.,597,3,2,0,124,218,347,17,364,0,O-102-189-03-02-03
PALLISA,KIBUKU COUNTY,KADAMA,KADAMA,KADAMA P.S.,556,3,3,6,97,231,340,0,340,0,O-102-189-03-03-01
PALLISA,KIBUKU COUNTY,KADAMA,KADAMA,LYADA G.C.S. LTD.,564,1,3,2,127,234,367,14,381,0,O-102-189-03-03-02
PALLISA,KIBUKU COUNTY,KADAMA,KADAMA,KADAMA S/CTY HQTS,418,1,1,0,104,145,251,7,258,0,O-102-189-03-03-03
PALLISA,KIBUKU COUNTY,KADAMA,KENKEBU,BULYABWITA T/C,417,6,10,7,130,264,417,0,417,0,O-102-189-03-04-01
PALLISA,KIBUKU COUNTY,KADAMA,KENKEBU,MOLOKOCHOMO C.O.U,349,3,0,1,76,180,260,9,269,0,O-102-189-03-04-02
PALLISA,KIBUKU COUNTY,KADAMA,KENKEBU,KENKEBU C.O.U.,505,1,4,3,118,236,362,14,376,0,O-102-189-03-04-03
PALLISA,KIBUKU COUNTY,KADAMA,KENKEBU,BULYAWITA T/C,611,3,1,2,128,182,316,13,329,0,O-102-189-03-04-04
PALLISA,KIBUKU COUNTY,KADAMA,MOLOKACHOMO,MOLOKOCHOMO MOSQUE,379,2,1,1,126,172,302,12,314,0,O-102-189-03-05-01
PALLISA,KIBUKU COUNTY,KADAMA,MOLOKACHOMO,MOLOKOCHOMO P/S,406,1,2,2,75,223,303,6,309,0,O-102-189-03-05-02
PALLISA,KIBUKU COUNTY,KADAMA,NANDERE,KATYAIME BORE-HOLE,334,1,4,1,34,192,232,19,251,0,O-102-189-03-06-01
PALLISA,KIBUKU COUNTY,KADAMA,NANDERE,BULUBA C.O.U.,622,3,1,2,101,381,488,20,508,0,O-102-189-03-06-02
PALLISA,KIBUKU COUNTY,KADAMA,NANDERE,NANDERE T.C.,661,3,1,2,87,460,553,12,565,0,O-102-189-03-06-03
PALLISA,KIBUKU COUNTY,KADAMA,NANDERE,NANDERE P.S.,479,1,0,3,51,313,368,10,378,0,O-102-189-03-06-04
PALLISA,KIBUKU COUNTY,KAGUMU,GOLIGOLI,NANGAIZA T. C.,658,4,7,11,199,276,497,17,514,0,O-102-189-04-01-01
PALLISA,KIBUKU COUNTY,KAGUMU,GOLIGOLI,GOLIGOLI T.C.,609,7,1,7,249,184,448,16,464,0,O-102-189-04-01-02
PALLISA,KIBUKU COUNTY,KAGUMU,GOLIGOLI,NABULANGANGA P/S,400,1,0,7,135,159,302,15,317,0,O-102-189-04-01-03
PALLISA,KIBUKU COUNTY,KAGUMU,GOLIGOLI,YOYO MOSQUE,416,4,2,3,194,124,327,5,332,0,O-102-189-04-01-04
PALLISA,KIBUKU COUNTY,KAGUMU,KAGUMU,KAGUMU P.S. (A-M),517,6,5,6,251,84,352,18,370,0,O-102-189-04-02-01
PALLISA,KIBUKU COUNTY,KAGUMU,KAGUMU,BUDUKULO IMMUNISATION CENT,205,2,1,3,78,58,142,14,156,0,O-102-189-04-02-02
PALLISA,KIBUKU COUNTY,KAGUMU,KAGUMU,NANKOMA JAMBULA TREE,725,8,8,16,280,248,560,13,573,0,O-102-189-04-02-03
PALLISA,KIBUKU COUNTY,KAGUMU,KAGUMU,KAGUMU P.S. (N-Z),361,1,6,10,133,95,245,9,254,0,O-102-189-04-02-04
PALLISA,KIBUKU COUNTY,KAGUMU,NABULI,NABULI,822,2,3,5,349,246,605,7,612,0,O-102-189-04-03-01
PALLISA,KIBUKU COUNTY,KAGUMU,NABULI,MAJALA TRADING CENTRE,550,2,1,3,158,250,414,24,438,0,O-102-189-04-03-02
PALLISA,KIBUKU COUNTY,KAGUMU,NABULI,KAMOLOKINI HEALTH CENTRE,627,4,0,12,216,192,424,4,428,0,O-102-189-04-03-03
PALLISA,KIBUKU COUNTY,KAGUMU,NANKOKOLI,KAGUMU C.O.U.,490,3,1,8,164,165,341,8,349,0,O-102-189-04-04-01
PALLISA,KIBUKU COUNTY,KAGUMU,NANKOKOLI,LAKANI'S GROUND,589,6,6,12,215,184,423,52,475,0,O-102-189-04-04-02
PALLISA,KIBUKU COUNTY,KAGUMU,NANKOKOLI,NAKITENDE BOREHOLE,428,3,3,5,146,146,303,12,315,0,O-102-189-04-04-03
PALLISA,KIBUKU COUNTY,KIBUKU,BUMIZA,BUMIZA (N-Z) COU,321,3,0,2,69,115,189,8,197,0,O-102-189-05-01-01
PALLISA,KIBUKU COUNTY,KIBUKU,BUMIZA,BUMIZA (A-M) P/S,609,10,3,8,153,182,356,5,361,0,O-102-189-05-01-02
PALLISA,KIBUKU COUNTY,KIBUKU,BUMIZA,NAMUSITA,554,1,1,5,154,224,385,10,395,0,O-102-189-05-01-03
PALLISA,KIBUKU COUNTY,KIBUKU,KIBUKU,KIBUKU S.S,696,4,3,2,153,271,433,15,448,0,O-102-189-05-02-01
PALLISA,KIBUKU COUNTY,KIBUKU,KIBUKU,KOBOLWA P.S,866,0,0,0,0,0,0,0,0,1,O-102-189-05-02-02
PALLISA,KIBUKU COUNTY,KIBUKU,NALUBEMBE,KANYOLO I BOREHOLE,692,3,3,4,178,298,486,22,508,0,O-102-189-05-03-01
PALLISA,KIBUKU COUNTY,KIBUKU,NALUBEMBE,NALUBEMBE P/S (N-Z),284,0,0,0,0,0,0,0,0,1,O-102-189-05-03-02
PALLISA,KIBUKU COUNTY,KIBUKU,NALUBEMBE,NALUBEMBE CATHOLIC CHURCH,376,1,2,3,69,216,291,3,294,0,O-102-189-05-03-03
PALLISA,KIBUKU COUNTY,KIBUKU,NALUBEMBE,NALUBEMBE P/S (A-M),533,2,0,2,92,282,378,17,395,0,O-102-189-05-03-04
PALLISA,KIBUKU COUNTY,KIBUKU,NALUBEMBE,NALUBEMBE COU,573,3,1,7,69,258,338,12,350,0,O-102-189-05-03-05
PALLISA,KIBUKU COUNTY,KIBUKU,NAMAWONDO,KIBUKU GINNERY,680,5,1,2,140,222,370,2,372,0,O-102-189-05-04-01
PALLISA,KIBUKU COUNTY,KIBUKU,NAMAWONDO,KIBUKU S/C HQRTS,293,5,2,2,49,117,175,12,187,0,O-102-189-05-04-02
PALLISA,KIBUKU COUNTY,KIRIKA,KAJOKO,KAJOKO P.S.,721,2,3,0,104,394,503,17,520,0,O-102-189-06-01-01
PALLISA,KIBUKU COUNTY,KIRIKA,KAJOKO,KAJOKO C.O.U. (TREE),649,2,7,0,94,388,491,10,501,0,O-102-189-06-01-02
PALLISA,KIBUKU COUNTY,KIRIKA,KAJOKO,MUGOLOBYAIRE'S TREE,509,1,2,0,123,224,350,6,356,0,O-102-189-06-01-03
PALLISA,KIBUKU COUNTY,KIRIKA,KIRIKA,KAVULE P.S.,385,2,2,1,60,218,283,15,298,0,O-102-189-06-02-01
PALLISA,KIBUKU COUNTY,KIRIKA,KIRIKA,KIRIKA BOREHOLE,735,1,3,0,87,467,558,8,566,0,O-102-189-06-02-02
PALLISA,KIBUKU COUNTY,KIRIKA,MIKOMBE,MIKOMBE BOREHOLE,569,1,0,1,48,341,391,6,397,0,O-102-189-06-03-01
PALLISA,KIBUKU COUNTY,KIRIKA,MIKOMBE,NAPETE'S FORMER CLINIC,465,2,0,2,134,188,326,1,327,0,O-102-189-06-03-02
PALLISA,KIBUKU COUNTY,KIRIKA,MIKOMBE,NAMIRU T/C,381,1,3,2,92,171,269,5,274,0,O-102-189-06-03-03
PALLISA,KIBUKU COUNTY,KIRIKA,MIKOMBE,KIRIKA P/S,353,1,0,2,59,186,248,7,255,0,O-102-189-06-03-04
PALLISA,KIBUKU COUNTY,KIRIKA,NABISWA,NABISWA P.S. I,681,4,6,8,102,310,430,9,439,0,O-102-189-06-04-01
PALLISA,KIBUKU COUNTY,KIRIKA,NABISWA,KOPOLINO BORE-HOLE,410,2,2,1,81,127,213,8,221,0,O-102-189-06-04-02
PALLISA,KIBUKU COUNTY,KIRIKA,NABISWA,KABISULE T/C,520,4,6,5,102,257,374,13,387,0,O-102-189-06-04-03
PALLISA,KIBUKU COUNTY,KIRIKA,NABISWA,KAPOLINO TREE,291,0,2,0,39,212,253,12,265,0,O-102-189-06-04-04
PALLISA,KIBUKU COUNTY,TIRINYI,KATAKA,KATAKA P/S,641,2,1,1,89,287,380,110,490,0,O-102-189-07-01-01
PALLISA,KIBUKU COUNTY,TIRINYI,KATAKA,KALAMPETE BOREHOLE,483,1,6,0,136,132,275,49,324,0,O-102-189-07-01-02
PALLISA,KIBUKU COUNTY,TIRINYI,KATAKA,KALAMPETE P/S,592,3,2,0,213,151,369,42,411,0,O-102-189-07-01-03
PALLISA,KIBUKU COUNTY,TIRINYI,KATAKA,NKOOLA'S PLACE,473,2,1,2,176,155,336,5,341,0,O-102-189-07-01-04
PALLISA,KIBUKU COUNTY,TIRINYI,KITANTALO,BUGWERE P/S,311,5,3,8,44,145,205,12,217,0,O-102-189-07-02-01
PALLISA,KIBUKU COUNTY,TIRINYI,KITANTALO,KITANTALO BOREHOLE,705,3,0,3,108,336,450,17,467,0,O-102-189-07-02-02
PALLISA,KIBUKU COUNTY,TIRINYI,KITANTALO,KIYALYO P/S,478,4,1,4,53,273,335,22,357,0,O-102-189-07-02-03
PALLISA,KIBUKU COUNTY,TIRINYI,LWATAMA,NAMBIRI,731,3,1,1,74,361,440,38,478,0,O-102-189-07-03-01
PALLISA,KIBUKU COUNTY,TIRINYI,LWATAMA,KIRYOLO C.O.U (N-Z),293,2,0,1,38,183,224,12,236,0,O-102-189-07-03-02
PALLISA,KIBUKU COUNTY,TIRINYI,LWATAMA,LWATAMA P/S,547,3,0,0,60,282,345,0,345,0,O-102-189-07-03-03
PALLISA,KIBUKU COUNTY,TIRINYI,LWATAMA,KIRYOLO C.O.U (A-M),577,8,2,4,108,250,372,4,376,0,O-102-189-07-03-04
PALLISA,KIBUKU COUNTY,TIRINYI,NANOKO,KAMPALA T/C,361,1,0,3,48,131,183,13,196,0,O-102-189-07-04-01
PALLISA,KIBUKU COUNTY,TIRINYI,NANOKO,NANOKO P/S,472,4,0,6,63,230,303,1,304,0,O-102-189-07-04-02
PALLISA,KIBUKU COUNTY,TIRINYI,NANOKO,MUKONGORO T/C,362,0,0,0,0,0,0,0,0,1,O-102-189-07-04-03
PALLISA,KIBUKU COUNTY,TIRINYI,TIRINYI,TIRINYI P/S - MANGO TREE,598,0,2,0,122,328,452,48,500,0,O-102-189-07-05-01
PALLISA,KIBUKU COUNTY,TIRINYI,TIRINYI,TIRINYI CATHOLIC CHURCH,670,1,0,1,90,318,410,11,421,0,O-102-189-07-05-02
PALLISA,KIBUKU COUNTY,TIRINYI,TIRINYI,TIRINYI S/C HQTS,310,3,1,1,30,148,183,16,199,0,O-102-189-07-05-03
KAPCHORWA,KWEEN COUNTY,BENET,KAPNGOTINY,KAPNGOTINY,594,1,2,2,49,432,486,27,513,0,O-104-75-01-01-01
KAPCHORWA,KWEEN COUNTY,BENET,KASEKO,CHEMWOM,629,2,1,0,109,318,430,53,483,0,O-104-75-01-02-01
KAPCHORWA,KWEEN COUNTY,BENET,KASEKO,KASEKO,520,2,0,2,70,246,320,64,384,0,O-104-75-01-02-02
KAPCHORWA,KWEEN COUNTY,BENET,KASEKO,TAMBAJJA,282,0,0,0,30,198,228,19,247,0,O-104-75-01-02-03
KAPCHORWA,KWEEN COUNTY,BENET,KERE,KABELYO,308,2,1,0,16,150,169,56,225,0,O-104-75-01-03-01
KAPCHORWA,KWEEN COUNTY,BENET,KERE,KERE,342,1,0,0,36,173,210,25,235,0,O-104-75-01-03-02
KAPCHORWA,KWEEN COUNTY,BENET,KITAWOI,KITAWOI,564,2,0,1,55,251,309,102,411,0,O-104-75-01-04-01
KAPCHORWA,KWEEN COUNTY,BENET,KITAWOI,TEREMPOY,442,1,0,0,46,258,305,44,349,0,O-104-75-01-04-02
KAPCHORWA,KWEEN COUNTY,BENET,KITAWOI,SUKUT,317,0,0,0,34,195,229,23,252,0,O-104-75-01-04-03
KAPCHORWA,KWEEN COUNTY,BENET,KWOSIR,CHEPTANDAN,614,1,1,3,41,354,400,39,439,0,O-104-75-01-05-01
KAPCHORWA,KWEEN COUNTY,BENET,KWOSIR,KWOSIR,457,1,1,1,22,213,238,68,306,0,O-104-75-01-05-02
KAPCHORWA,KWEEN COUNTY,BENET,LIKIL,LIKIL,799,5,1,4,97,381,488,15,503,0,O-104-75-01-06-01
KAPCHORWA,KWEEN COUNTY,BENET,PISWA,TARAGON,525,2,0,1,55,263,321,52,373,0,O-104-75-01-07-01
KAPCHORWA,KWEEN COUNTY,BENET,PISWA,MENGYA,571,4,0,1,86,300,391,48,439,0,O-104-75-01-07-02
KAPCHORWA,KWEEN COUNTY,BENET,TABAGON,SUMATON,199,1,0,0,19,135,155,22,177,0,O-104-75-01-08-01
KAPCHORWA,KWEEN COUNTY,BENET,TABAGON,TABAGON,528,4,0,1,85,220,310,105,415,0,O-104-75-01-08-02
KAPCHORWA,KWEEN COUNTY,BENET,TABAGON,TARAK,372,1,0,1,52,232,286,50,336,0,O-104-75-01-08-03
KAPCHORWA,KWEEN COUNTY,BENET,TUIKAT,TUIKAT,654,1,1,0,14,498,514,28,542,0,O-104-75-01-09-01
KAPCHORWA,KWEEN COUNTY,BENET,YATUI,CHEBEREN,437,2,0,1,49,201,253,17,270,0,O-104-75-01-10-01
KAPCHORWA,KWEEN COUNTY,BENET,YATUI,YATUI,723,4,1,1,66,450,522,0,522,0,O-104-75-01-10-02
KAPCHORWA,KWEEN COUNTY,BINYINY,KABKOCH,CHEMUNY,756,6,1,0,132,410,549,68,617,0,O-104-75-02-01-01
KAPCHORWA,KWEEN COUNTY,BINYINY,KABKOCH,KAPTENG,258,1,1,1,56,130,189,29,218,0,O-104-75-02-01-02
KAPCHORWA,KWEEN COUNTY,BINYINY,KAPTOYOY,KAPTEROR,482,0,1,0,36,346,383,46,429,0,O-104-75-02-02-01
KAPCHORWA,KWEEN COUNTY,BINYINY,KAPTOYOY,SENENDET,445,4,0,0,72,276,352,49,401,0,O-104-75-02-02-02
KAPCHORWA,KWEEN COUNTY,BINYINY,KONO,BINYINY,667,4,0,2,75,410,491,47,538,0,O-104-75-02-03-01
KAPCHORWA,KWEEN COUNTY,BINYINY,KONO,TUKUMO,293,0,0,0,55,180,235,22,257,0,O-104-75-02-03-02
KAPCHORWA,KWEEN COUNTY,BINYINY,KONO,KAMWALECH,310,0,0,0,41,218,259,20,279,0,O-104-75-02-03-03
KAPCHORWA,KWEEN COUNTY,BINYINY,TABAGON,KAPKWOROS,501,1,3,0,75,286,365,49,414,0,O-104-75-02-04-01
KAPCHORWA,KWEEN COUNTY,BINYINY,TABAGON,CHEPYAKANIET,575,1,0,0,41,401,443,65,508,0,O-104-75-02-04-02
KAPCHORWA,KWEEN COUNTY,BINYINY,TOSWO,CHESIMWO,631,3,0,2,58,399,462,60,522,0,O-104-75-02-05-01
KAPCHORWA,KWEEN COUNTY,BINYINY,TOSWO,KAPCHEMIRYOT,362,2,1,0,15,247,265,35,300,0,O-104-75-02-05-02
KAPCHORWA,KWEEN COUNTY,KAPRORON,CHEMINY,CHEMINY TRADING CENTRE,553,1,0,0,84,279,364,55,419,0,O-104-75-03-01-01
KAPCHORWA,KWEEN COUNTY,KAPRORON,CHEMINY,KAMAKUNGA,669,4,0,1,64,393,462,32,494,0,O-104-75-03-01-02
KAPCHORWA,KWEEN COUNTY,KAPRORON,CHEMINY,KAPSOMO,374,1,0,0,36,210,247,42,289,0,O-104-75-03-01-03
KAPCHORWA,KWEEN COUNTY,KAPRORON,CHEMINY,CHEMOLON P/S,256,0,0,0,22,152,174,20,194,0,O-104-75-03-01-04
KAPCHORWA,KWEEN COUNTY,KAPRORON,KAMWAM,KAPRORON,545,1,0,4,30,376,411,27,438,0,O-104-75-03-02-01
KAPCHORWA,KWEEN COUNTY,KAPRORON,KAMWAM,KOROSI,668,1,6,1,37,414,459,78,537,0,O-104-75-03-02-02
KAPCHORWA,KWEEN COUNTY,KAPRORON,KAMWAM,CHEMWANIA P/S,289,0,2,0,40,168,210,13,223,0,O-104-75-03-02-03
KAPCHORWA,KWEEN COUNTY,KAPRORON,KAPTUM,KONGLEL,438,7,0,0,20,271,298,39,337,0,O-104-75-03-03-01
KAPCHORWA,KWEEN COUNTY,KAPRORON,KAPTUM,KAPKWERE P/S,434,2,1,0,36,281,320,20,340,0,O-104-75-03-03-02
KAPCHORWA,KWEEN COUNTY,KAPRORON,KAPTUM,CHEBINYINY P/S,574,1,0,1,60,356,418,26,444,0,O-104-75-03-03-03
KAPCHORWA,KWEEN COUNTY,KWANYIY,KAPKWATA,KAPROTWO,388,1,1,0,17,272,291,9,300,0,O-104-75-04-01-01
KAPCHORWA,KWEEN COUNTY,KWANYIY,KAPKWATA,KWORUS,589,2,0,1,29,348,380,43,423,0,O-104-75-04-01-02
KAPCHORWA,KWEEN COUNTY,KWANYIY,KAPKWATA,TARAK,421,1,1,2,92,190,286,47,333,0,O-104-75-04-01-03
KAPCHORWA,KWEEN COUNTY,KWANYIY,MOYOK,CHEKWATA,671,6,5,0,79,348,438,85,523,0,O-104-75-04-02-01
KAPCHORWA,KWEEN COUNTY,KWANYIY,MOYOK,CHEKWIR,534,4,0,0,58,321,383,9,392,0,O-104-75-04-02-02
KAPCHORWA,KWEEN COUNTY,KWANYIY,MOYOK,MOYOK P/S,608,3,0,3,78,367,451,22,473,0,O-104-75-04-02-03
KAPCHORWA,KWEEN COUNTY,KWANYIY,NYIMEI,KAPKWATA FOREST (A-J),426,2,3,0,100,159,264,20,284,0,O-104-75-04-03-01
KAPCHORWA,KWEEN COUNTY,KWANYIY,NYIMEI,KAWUSWO,541,3,0,0,70,304,377,19,396,0,O-104-75-04-03-02
KAPCHORWA,KWEEN COUNTY,KWANYIY,NYIMEI,KAPLEGEP CHURCH,313,6,1,4,62,185,258,11,269,0,O-104-75-04-03-03
KAPCHORWA,KWEEN COUNTY,KWANYIY,NYIMEI,KAPKWATA FOREST (K-Z),412,1,0,0,65,170,236,14,250,0,O-104-75-04-03-04
KAPCHORWA,KWEEN COUNTY,NGENGE,GREEK RIVER,KIRIK,481,1,0,0,51,190,242,42,284,0,O-104-75-05-01-01
KAPCHORWA,KWEEN COUNTY,NGENGE,KAPKWOT,KAPTULEL,406,2,0,2,33,219,256,19,275,0,O-104-75-05-02-01
KAPCHORWA,KWEEN COUNTY,NGENGE,KAPKWOT,MAKUNGA,256,0,0,0,31,132,163,12,175,0,O-104-75-05-02-02
KAPCHORWA,KWEEN COUNTY,NGENGE,KAPKWOT,KABACHIRYA,371,0,2,1,40,154,197,38,235,0,O-104-75-05-02-03
KAPCHORWA,KWEEN COUNTY,NGENGE,KAPKWOT,ATARI,238,2,0,0,23,209,234,0,234,0,O-104-75-05-02-04
KAPCHORWA,KWEEN COUNTY,NGENGE,SUNDET,KAPKWARE,291,0,0,0,14,194,208,12,220,0,O-104-75-05-03-01
KAPCHORWA,KWEEN COUNTY,NGENGE,SUNDET,KAPKWICH,238,4,0,1,13,144,162,14,176,0,O-104-75-05-03-02
KUMI,NGORA COUNTY,KAPIR,ABATAI,ABATAI,538,9,5,9,220,152,395,25,420,0,O-108-98-01-01-01
KUMI,NGORA COUNTY,KAPIR,AGIRIGIROI,AGIRIGIROI,370,6,7,5,208,45,271,23,294,0,O-108-98-01-02-01
KUMI,NGORA COUNTY,KAPIR,AGULE,AGULE,817,13,11,10,474,61,569,61,630,0,O-108-98-01-03-01
KUMI,NGORA COUNTY,KAPIR,AJELO,AJELO,359,4,4,6,208,63,285,16,301,0,O-108-98-01-04-01
KUMI,NGORA COUNTY,KAPIR,AJESA,AJESA,480,5,7,2,247,60,321,16,337,0,O-108-98-01-05-01
KUMI,NGORA COUNTY,KAPIR,AJUKET,AJUKET,367,6,9,1,200,53,269,11,280,0,O-108-98-01-06-01
KUMI,NGORA COUNTY,KAPIR,AKARUKEI,AKARUKEI,563,10,10,15,321,75,431,15,446,0,O-108-98-01-07-01
KUMI,NGORA COUNTY,KAPIR,AKISIM,AKISIM,397,6,5,2,182,92,287,9,296,0,O-108-98-01-08-01
KUMI,NGORA COUNTY,KAPIR,ATAPAR,ATAPAR,739,10,8,9,500,34,561,19,580,0,O-108-98-01-09-01
KUMI,NGORA COUNTY,KAPIR,KAPIR,KAPIR,1010,9,9,12,599,121,750,18,768,0,O-108-98-01-10-01
KUMI,NGORA COUNTY,KAPIR,KOKONG,KOKONG,493,15,9,3,265,87,379,21,400,0,O-108-98-01-11-01
KUMI,NGORA COUNTY,KAPIR,KOLOIN,KOLOIN,574,4,8,2,316,82,412,17,429,0,O-108-98-01-12-01
KUMI,NGORA COUNTY,KAPIR,OLWA,OLWA,493,6,6,2,250,122,386,18,404,0,O-108-98-01-13-01
KUMI,NGORA COUNTY,KAPIR,OMIITO,OMIITO,529,12,6,6,314,53,391,24,415,0,O-108-98-01-14-01
KUMI,NGORA COUNTY,KAPIR,OMIITO,KAKOR,309,10,3,2,199,23,237,18,255,0,O-108-98-01-14-02
KUMI,NGORA COUNTY,KAPIR,OMURIANA,OMURIANA,564,15,11,18,306,64,414,10,424,0,O-108-98-01-15-01
KUMI,NGORA COUNTY,KAPIR,ORISAI,ORISAI,508,5,1,3,327,43,379,14,393,0,O-108-98-01-16-01
KUMI,NGORA COUNTY,KOBUIN,ACIISA,ACIISA,490,5,9,9,320,48,391,22,413,0,O-108-98-02-01-01
KUMI,NGORA COUNTY,KOBUIN,AGULE,AGULE,493,9,2,4,341,44,400,7,407,0,O-108-98-02-02-01
KUMI,NGORA COUNTY,KOBUIN,AKARUKEI,AKARUKEI,427,10,1,5,261,52,329,25,354,0,O-108-98-02-03-01
KUMI,NGORA COUNTY,KOBUIN,ATOOT,ATOOT A,807,13,2,6,524,56,601,15,616,0,O-108-98-02-04-01
KUMI,NGORA COUNTY,KOBUIN,ATOOT,ATOOT B,526,4,5,6,287,31,333,26,359,0,O-108-98-02-04-02
KUMI,NGORA COUNTY,KOBUIN,KADERUN,KADERUN,552,8,4,9,332,72,425,31,456,0,O-108-98-02-05-01
KUMI,NGORA COUNTY,KOBUIN,KADOK,KADOK A,595,5,6,6,418,35,470,29,499,0,O-108-98-02-06-01
KUMI,NGORA COUNTY,KOBUIN,KADOK,KADOK B,387,6,0,3,264,24,297,20,317,0,O-108-98-02-06-02
KUMI,NGORA COUNTY,KOBUIN,KALENGO,KALENGO,316,3,2,6,215,29,255,6,261,0,O-108-98-02-07-01
KUMI,NGORA COUNTY,KOBUIN,KOBWIN,KOBWIN,427,11,1,1,207,63,283,39,322,0,O-108-98-02-08-01
KUMI,NGORA COUNTY,KOBUIN,KOCOCWA,KOCOCWA,626,6,6,3,465,29,509,9,518,0,O-108-98-02-09-01
KUMI,NGORA COUNTY,KOBUIN,KODIKE,KODIKE,556,7,5,3,351,76,442,19,461,0,O-108-98-02-10-01
KUMI,NGORA COUNTY,KOBUIN,OKAPEL,OKAPEL,684,10,2,10,348,183,553,26,579,0,O-108-98-02-11-01
KUMI,NGORA COUNTY,KOBUIN,OMOO,OMOO,504,7,3,3,350,40,403,15,418,0,O-108-98-02-12-01
KUMI,NGORA COUNTY,KOBUIN,OPOT,OPOT,445,2,3,6,294,39,344,18,362,0,O-108-98-02-13-01
KUMI,NGORA COUNTY,KOBUIN,OSWARA,OSWARA,535,3,3,9,334,59,408,20,428,0,O-108-98-02-14-01
KUMI,NGORA COUNTY,KOBUIN,POKOR,POKOR,285,7,3,1,170,51,232,21,253,0,O-108-98-02-15-01
KUMI,NGORA COUNTY,KOBUIN,TILLING,TILLING,666,15,2,8,409,84,518,36,554,0,O-108-98-02-16-01
KUMI,NGORA COUNTY,MUKURA,ADULI,ADULI,710,6,9,6,303,161,485,40,525,0,O-108-98-03-01-01
KUMI,NGORA COUNTY,MUKURA,AGOGOMIT,AGOGOMIT,637,14,7,9,362,75,467,44,511,0,O-108-98-03-02-01
KUMI,NGORA COUNTY,MUKURA,AJELUK,AJELUK,544,6,10,4,316,68,404,15,419,0,O-108-98-03-03-01
KUMI,NGORA COUNTY,MUKURA,AKIET,AKEIT,618,7,10,9,353,86,465,25,490,0,O-108-98-03-04-01
KUMI,NGORA COUNTY,MUKURA,AKUBUI,AKABUI A,987,15,8,9,497,126,655,59,714,0,O-108-98-03-05-01
KUMI,NGORA COUNTY,MUKURA,ARIET,ARIET A,460,6,4,4,298,36,348,33,381,0,O-108-98-03-06-01
KUMI,NGORA COUNTY,MUKURA,ARIET,ARIET B,351,3,1,1,200,27,232,18,250,0,O-108-98-03-06-02
KUMI,NGORA COUNTY,MUKURA,KALER,KALER,349,3,7,6,156,69,241,10,251,0,O-108-98-03-07-01
KUMI,NGORA COUNTY,MUKURA,KAMODOKIMA,KAMODOKIMA,226,10,9,1,116,29,165,9,174,0,O-108-98-03-08-01
KUMI,NGORA COUNTY,MUKURA,KAMODOKIMA,KAMODOKIMA A,699,20,15,11,344,119,509,41,550,0,O-108-98-03-08-02
KUMI,NGORA COUNTY,MUKURA,KEES,KEES,405,5,1,3,268,52,329,8,337,0,O-108-98-03-09-01
KUMI,NGORA COUNTY,MUKURA,KOKODU,KOKODU,920,9,14,10,592,75,700,15,715,0,O-108-98-03-10-01
KUMI,NGORA COUNTY,MUKURA,KUMEL,KUMEL,531,8,4,6,356,43,417,13,430,0,O-108-98-03-11-01
KUMI,NGORA COUNTY,MUKURA,MADOCH,MADOCH,690,12,3,5,402,87,509,24,533,0,O-108-98-03-12-01
KUMI,NGORA COUNTY,MUKURA,MORUKAKISE,MORUKAKISE,588,12,5,1,382,45,445,17,462,0,O-108-98-03-13-01
KUMI,NGORA COUNTY,MUKURA,MUKURA,MUKURA A,694,16,2,8,362,111,499,31,530,0,O-108-98-03-14-01
KUMI,NGORA COUNTY,MUKURA,OKUNGURO,OKUNGURO A,565,8,5,1,232,111,357,20,377,0,O-108-98-03-15-01
KUMI,NGORA COUNTY,MUKURA,OKUNGURO,OKUNGURO B,501,8,11,1,216,132,368,15,383,0,O-108-98-03-15-02
KUMI,NGORA COUNTY,NGORA,AGU,AGU,433,3,2,7,136,154,302,29,331,0,O-108-98-04-01-01
KUMI,NGORA COUNTY,NGORA,ANGOD,ANGOD,494,8,3,6,220,94,331,43,374,0,O-108-98-04-02-01
KUMI,NGORA COUNTY,NGORA,APAMA,APAMA,507,6,4,5,311,78,404,7,411,0,O-108-98-04-03-01
KUMI,NGORA COUNTY,NGORA,INSTITUTIONAL COM,COMPLEX (NGORA HIGH),374,3,2,1,157,35,198,5,203,0,O-108-98-04-04-01
KUMI,NGORA COUNTY,NGORA,KACHINGA,ACINGA,819,12,3,3,446,106,570,23,593,0,O-108-98-04-05-01
KUMI,NGORA COUNTY,NGORA,KALENGO,KALENGO,843,22,8,14,486,61,591,7,598,0,O-108-98-04-06-01
KUMI,NGORA COUNTY,NGORA,KALENGO,AGOLITOM,432,10,2,4,269,29,314,6,320,0,O-108-98-04-06-02
KUMI,NGORA COUNTY,NGORA,KOBUIN,KOBUIN,609,3,6,3,295,68,375,7,382,0,O-108-98-04-07-01
KUMI,NGORA COUNTY,NGORA,KOBUKU,KOBUKU,832,8,8,7,454,86,563,14,577,0,O-108-98-04-08-01
KUMI,NGORA COUNTY,NGORA,KOMODO,KOMODO,410,9,6,3,259,43,320,17,337,0,O-108-98-04-09-01
KUMI,NGORA COUNTY,NGORA,KOPEGE,KOPEGE,631,9,3,15,327,109,463,24,487,0,O-108-98-04-10-01
KUMI,NGORA COUNTY,NGORA,NGORA,NGORA,754,20,3,0,396,69,488,8,496,0,O-108-98-04-11-01
KUMI,NGORA COUNTY,NGORA,NYAMONGO,NYAMONGO,845,16,5,7,377,163,568,66,634,0,O-108-98-04-12-01
KUMI,NGORA COUNTY,NGORA,ODWARAT,ODWARAT,774,18,1,9,453,76,557,32,589,0,O-108-98-04-13-01
KUMI,NGORA COUNTY,NGORA,OKOBOI,OKOBOI,427,7,5,7,186,105,310,24,334,0,O-108-98-04-14-01
KUMI,NGORA COUNTY,NGORA,OMADITOK,OMADITOK A,462,10,3,5,262,57,337,26,363,0,O-108-98-04-15-01
KUMI,NGORA COUNTY,NGORA,OMADITOK,OMADITOK B,625,12,1,2,336,54,405,9,414,0,O-108-98-04-15-02
KUMI,NGORA COUNTY,NGORA,OTETEEN,OTETEEN,519,3,3,3,380,51,440,9,449,0,O-108-98-04-16-01
KUMI,NGORA COUNTY,NGORA,ST. ALOYSUIS,ST ALOYSIUS,35,0,0,0,13,11,24,0,24,0,O-108-98-04-17-01
KUMI,NGORA COUNTY,NGORA,TIDIDIEK,TIDIDIEK,1024,29,4,8,539,111,691,16,707,0,O-108-98-04-18-01
KUMI,NGORA COUNTY,NGORA,TOWNSHIP,TOWNSHIP,460,2,1,1,227,89,320,12,332,0,O-108-98-04-19-01
MANAFWA,BUBULO COUNTY EAST,BUBUTU,BUMITYERO,MAGALE INSTITUTE,419,1,0,0,68,211,280,0,280,0,O-117-127-01-01-01
MANAFWA,BUBULO COUNTY EAST,BUBUTU,BUMITYERO,MAGALE MIXED,522,4,2,2,128,184,320,26,346,0,O-117-127-01-01-02
MANAFWA,BUBULO COUNTY EAST,BUBUTU,BUMITYERO,TSERONO PR SCHOOL,745,8,3,3,116,415,545,12,557,0,O-117-127-01-01-03
MANAFWA,BUBULO COUNTY EAST,BUBUTU,BUMUKULUMA,BUKHONTSO P/S,519,2,2,2,71,278,355,6,361,0,O-117-127-01-02-01
MANAFWA,BUBULO COUNTY EAST,BUBUTU,BUMUKULUMA,NAMBOKO PR SCH,524,9,1,1,76,272,359,20,379,0,O-117-127-01-02-02
MANAFWA,BUBULO COUNTY EAST,BUBUTU,BUMUKULUMA,NABITSEKHI,780,2,1,2,125,440,570,31,601,0,O-117-127-01-02-03
MANAFWA,BUBULO COUNTY EAST,BUBUTU,BUMUKULUMA,BUWAMBINGWA T/C,661,3,1,2,96,372,474,0,474,0,O-117-127-01-02-04
MANAFWA,BUBULO COUNTY EAST,BUBUTU,BUMULIKA,NEMBA P/S I,668,3,0,5,105,270,383,18,401,0,O-117-127-01-03-01
MANAFWA,BUBULO COUNTY EAST,BUBUTU,BUMULIKA,NEMBA P/S II,627,1,0,1,103,413,518,57,575,0,O-117-127-01-03-02
MANAFWA,BUBULO COUNTY EAST,BUBUTU,BUMULIKA,BUKIKAYI P/S,671,2,0,0,33,434,469,12,481,0,O-117-127-01-03-03
MANAFWA,BUBULO COUNTY EAST,BUBUTU,BUMULIKA,BUTSEMAYI P/S,445,1,5,1,64,348,419,11,430,0,O-117-127-01-03-04
MANAFWA,BUBULO COUNTY EAST,BUBUTU,BUMULIKA,WEKELEHA P/S,514,2,1,2,59,280,344,14,358,0,O-117-127-01-03-05
MANAFWA,BUBULO COUNTY EAST,BUBUTU,BUMUSOMI,MUSIYE PR SCH,423,2,1,0,59,226,288,10,298,0,O-117-127-01-04-01
MANAFWA,BUBULO COUNTY EAST,BUBUTU,BUMUSOMI,BUBUTU SOCIAL CENTRE,564,3,1,1,77,246,328,24,352,0,O-117-127-01-04-02
MANAFWA,BUBULO COUNTY EAST,BUBUTU,BUMUSOMI,BUMALANGA CHURCH,448,1,4,2,90,194,291,0,291,0,O-117-127-01-04-03
MANAFWA,BUBULO COUNTY EAST,BUBUTU,BUMUSOMI,SDA CHURCH MAALA,583,17,2,2,126,378,525,0,525,0,O-117-127-01-04-04
MANAFWA,BUBULO COUNTY EAST,BUBUTU,BUMUSOMI,SIBANGA P/S,381,1,1,2,99,226,329,15,344,0,O-117-127-01-04-05
MANAFWA,BUBULO COUNTY EAST,BUBUTU,BUMUYONGA,SIBUSE PRIMARY SCHOOL,422,0,0,0,72,185,257,45,302,0,O-117-127-01-05-01
MANAFWA,BUBULO COUNTY EAST,BUBUTU,BUMUYONGA,SIBEMBE PR/ SCHOOL,273,0,0,1,55,172,228,10,238,0,O-117-127-01-05-02
MANAFWA,BUBULO COUNTY EAST,BUBUTU,BUMUYONGA,MARESI,576,0,1,1,105,316,423,12,435,0,O-117-127-01-05-03
MANAFWA,BUBULO COUNTY EAST,BUBUTU,BUMUYONGA,NASERE CATHOLIC CHURCH,653,1,2,2,50,382,437,15,452,0,O-117-127-01-05-04
MANAFWA,BUBULO COUNTY EAST,BUBUTU,BUMUYONGA,MUKHUYU T/C,387,5,2,0,73,214,294,2,296,0,O-117-127-01-05-05
MANAFWA,BUBULO COUNTY EAST,BUBUTU,BUMUYONGA,BULATSE P/S,650,1,3,4,76,324,408,6,414,0,O-117-127-01-05-06
MANAFWA,BUBULO COUNTY EAST,BUBUTU,BUMUYONGA,BUKIBETI CHURCH,116,0,0,1,7,104,112,3,115,0,O-117-127-01-05-07
MANAFWA,BUBULO COUNTY EAST,BUBUTU,BUSIMAOLYA,MAGALE CO-OP SOCIETY,533,2,0,2,124,202,330,11,341,0,O-117-127-01-06-01
MANAFWA,BUBULO COUNTY EAST,BUBUTU,BUSIMAOLYA,MAGALE PARENTS BUTINGO,517,2,0,1,107,239,349,15,364,0,O-117-127-01-06-02
MANAFWA,BUBULO COUNTY EAST,BUBUTU,BUSIMAOLYA,BUWAMBINGWA,705,3,1,3,105,263,375,123,498,0,O-117-127-01-06-03
MANAFWA,BUBULO COUNTY EAST,BUBUTU,BUSIMAOLYA,MAKUNYA P/S,208,0,0,1,64,129,194,7,201,0,O-117-127-01-06-04
MANAFWA,BUBULO COUNTY EAST,BUBUTU,BUSIMAOLYA,MAALA PR SCHOOL,635,3,3,3,101,346,456,13,469,0,O-117-127-01-06-05
MANAFWA,BUBULO COUNTY EAST,BUBUTU,BUSIMAOLYA,NALUWANDE,490,3,0,1,63,217,284,62,346,0,O-117-127-01-06-06
MANAFWA,BUBULO COUNTY EAST,BUBUTU,BUSIMAOLYA,SITUYI P/S,323,0,0,1,36,203,240,42,282,0,O-117-127-01-06-07
MANAFWA,BUBULO COUNTY EAST,BUMBO,BUKOKHO,BUWUNDU GCS,487,2,0,0,23,455,480,6,486,0,O-117-127-02-01-01
MANAFWA,BUBULO COUNTY EAST,BUMBO,BUKOKHO,BUMAKHAME P/S,172,2,0,1,20,104,127,9,136,0,O-117-127-02-01-02
MANAFWA,BUBULO COUNTY EAST,BUMBO,BUKOKHO,MAKENYA,640,1,0,4,68,377,450,28,478,0,O-117-127-02-01-03
MANAFWA,BUBULO COUNTY EAST,BUMBO,BUKOKHO,BUNAMULINGI,680,9,3,12,155,315,494,35,529,0,O-117-127-02-01-04
MANAFWA,BUBULO COUNTY EAST,BUMBO,BUKOKHO,BUKOKHO,693,0,6,2,56,626,690,3,693,0,O-117-127-02-01-05
MANAFWA,BUBULO COUNTY EAST,BUMBO,BUNANYAMA,SHARAMUKA MKT,489,2,0,2,40,281,325,18,343,0,O-117-127-02-02-01
MANAFWA,BUBULO COUNTY EAST,BUMBO,BUNANYAMA,BUMWALI PR SCH,441,2,0,5,37,343,387,12,399,0,O-117-127-02-02-02
MANAFWA,BUBULO COUNTY EAST,BUMBO,BUNANYAMA,MUKHUYU T/C,362,2,1,0,14,256,273,24,297,0,O-117-127-02-02-03
MANAFWA,BUBULO COUNTY EAST,BUMBO,BUTETEYA,BUTETEYA G.C.S.,471,0,0,0,38,374,412,11,423,0,O-117-127-02-03-01
MANAFWA,BUBULO COUNTY EAST,BUMBO,BUTETEYA,MUFUTU PR SCHOOL,553,4,0,3,108,278,393,18,411,0,O-117-127-02-03-02
MANAFWA,BUBULO COUNTY EAST,BUMBO,BUTETEYA,SIBUMBA BABONO B,233,0,1,0,27,193,221,9,230,0,O-117-127-02-03-03
MANAFWA,BUBULO COUNTY EAST,BUMBO,BUTETEYA,MULONDO P/S,665,3,5,5,1,461,475,5,480,0,O-117-127-02-03-04
MANAFWA,BUBULO COUNTY EAST,BUMBO,BUWUNDU,NAKAWA T.C,546,2,1,3,41,457,504,11,515,0,O-117-127-02-04-01
MANAFWA,BUBULO COUNTY EAST,BUMBO,BUWUNDU,LIRIMA P/S,650,1,1,1,40,474,517,24,541,0,O-117-127-02-04-02
MANAFWA,BUBULO COUNTY EAST,BUMBO,BUWUNDU,BUMBO T/C,546,0,3,2,53,398,456,10,466,0,O-117-127-02-04-03
MANAFWA,BUBULO COUNTY EAST,BUMBO,BUWUNDU,BUKIMUNA,472,0,2,3,67,379,451,3,454,0,O-117-127-02-04-04
MANAFWA,BUBULO COUNTY EAST,BUMBO,BUWUNDU,SOOSHO,268,2,1,0,14,202,219,16,235,0,O-117-127-02-04-05
MANAFWA,BUBULO COUNTY EAST,BUMBO,SOONO,BUNJOSI (A-M),381,1,0,2,63,165,231,3,234,0,O-117-127-02-05-01
MANAFWA,BUBULO COUNTY EAST,BUMBO,SOONO,BUNJOSI (N-Z),652,1,1,1,82,260,345,4,349,0,O-117-127-02-05-02
MANAFWA,BUBULO COUNTY EAST,BUMBO,SOONO,SOONO SALVATION ARMY,245,1,1,0,40,119,161,16,177,0,O-117-127-02-05-03
MANAFWA,BUBULO COUNTY EAST,BUMBO,SOONO,KABOOLE (A-M),600,1,2,7,51,535,596,3,599,0,O-117-127-02-05-04
MANAFWA,BUBULO COUNTY EAST,BUMBO,SOONO,KABOOLE P/S,720,1,2,3,61,555,622,26,648,0,O-117-127-02-05-05
MANAFWA,BUBULO COUNTY EAST,BUMBO,SOONO,BUTEMULANI,328,3,0,0,20,268,291,10,301,0,O-117-127-02-05-06
MANAFWA,BUBULO COUNTY EAST,BUMWONI,BUKHOMA,LWAKHAKHA P/S 'A',565,5,1,1,121,164,292,6,298,0,O-117-127-03-01-01
MANAFWA,BUBULO COUNTY EAST,BUMWONI,BUKHOMA,BUWUMA P/S,580,4,2,1,50,268,325,21,346,0,O-117-127-03-01-02
MANAFWA,BUBULO COUNTY EAST,BUMWONI,BUKHOMA,LWAKHAKHA P/S,208,1,0,1,51,50,103,7,110,0,O-117-127-03-01-03
MANAFWA,BUBULO COUNTY EAST,BUMWONI,BUKHOMA,LWAKHAKHA SS 'A',433,0,2,2,84,113,201,21,222,0,O-117-127-03-01-04
MANAFWA,BUBULO COUNTY EAST,BUMWONI,BUKHOMA,LWAKHAKHA P/S 'B',344,0,1,0,65,84,150,3,153,0,O-117-127-03-01-05
MANAFWA,BUBULO COUNTY EAST,BUMWONI,BUKHOMA,ZAKARIA COU,328,1,0,1,52,117,171,6,177,0,O-117-127-03-01-06
MANAFWA,BUBULO COUNTY EAST,BUMWONI,BUKHOMA,LWAKHAKHA SS 'B',631,1,2,1,112,227,343,1,344,0,O-117-127-03-01-07
MANAFWA,BUBULO COUNTY EAST,BUMWONI,BUKIABI,KABOYE PR SCH I (A-M),536,0,1,2,51,286,340,10,350,0,O-117-127-03-02-01
MANAFWA,BUBULO COUNTY EAST,BUMWONI,BUKIABI,KABOYE PR. SCH II,393,0,0,0,47,334,381,9,390,0,O-117-127-03-02-02
MANAFWA,BUBULO COUNTY EAST,BUMWONI,BUKIABI,KABOYE PR SCH I (N-Z),688,3,2,1,85,334,425,1,426,0,O-117-127-03-02-03
MANAFWA,BUBULO COUNTY EAST,BUMWONI,BUTEMULANI,KISAWAYI PR SCH (A-M),728,3,1,5,107,530,646,17,663,0,O-117-127-03-03-01
MANAFWA,BUBULO COUNTY EAST,BUMWONI,BUTEMULANI,BWIRI PR SCH (A-M),562,5,0,1,46,438,490,27,517,0,O-117-127-03-03-02
MANAFWA,BUBULO COUNTY EAST,BUMWONI,BUTEMULANI,BWIRI PR SCH (N),626,1,0,1,14,496,512,19,531,0,O-117-127-03-03-03
MANAFWA,BUBULO COUNTY EAST,BUMWONI,BUTEMULANI,KISAWAYI PR SCH (N),606,3,1,0,47,352,403,89,492,0,O-117-127-03-03-04
MANAFWA,BUBULO COUNTY EAST,BUMWONI,BUTEMULANI,KISAWAYI PR SCH (O-Z),437,2,1,2,83,343,431,4,435,0,O-117-127-03-03-05
MANAFWA,BUBULO COUNTY EAST,BUMWONI,BUTEMULANI,BWIRI PR SCH (O-Z),453,2,2,1,58,374,437,11,448,0,O-117-127-03-03-06
MANAFWA,BUBULO COUNTY EAST,BUMWONI,BUTEMULANI,KOLOLO,209,0,0,0,9,193,202,2,204,0,O-117-127-03-03-07
MANAFWA,BUBULO COUNTY EAST,BUMWONI,MAKHONGE,BUKOKHO TC A (A-N),573,1,1,1,43,505,551,22,573,0,O-117-127-03-04-01
MANAFWA,BUBULO COUNTY EAST,BUMWONI,MAKHONGE,BUKOKHO T.C. B,730,0,1,0,104,600,705,5,710,0,O-117-127-03-04-02
MANAFWA,BUBULO COUNTY EAST,BUMWONI,MAKHONGE,BUKHAYAKI PR SCH (A-M),477,0,0,0,12,421,433,19,452,0,O-117-127-03-04-03
MANAFWA,BUBULO COUNTY EAST,BUMWONI,MAKHONGE,BUKOKHO TC A (O-Z),585,1,0,1,87,474,563,3,566,0,O-117-127-03-04-04
MANAFWA,BUBULO COUNTY EAST,BUMWONI,MAKHONGE,BUKHAYAKI PR SCH (N),650,1,0,0,35,552,588,60,648,0,O-117-127-03-04-05
MANAFWA,BUBULO COUNTY EAST,BUMWONI,MAKHONGE,BUKHAYAKI PR SCH (O-Z),515,0,0,0,0,0,0,0,0,1,O-117-127-03-04-06
MANAFWA,BUBULO COUNTY EAST,BUMWONI,MAKHONGE,BUSERELI P/S,271,0,1,0,48,198,247,14,261,0,O-117-127-03-04-07
MANAFWA,BUBULO COUNTY EAST,BUMWONI,MAKHONGE,NABUTORO P/S,210,0,0,0,6,200,206,0,206,0,O-117-127-03-04-08
MANAFWA,BUBULO COUNTY EAST,BUMWONI,MAKHONGE,BUKHAYAKI P.S B,344,0,0,1,5,310,316,15,331,0,O-117-127-03-04-09
MANAFWA,BUBULO COUNTY EAST,BUPOTO,BUKHAWEKA,TOMA PR SCHOOL,483,3,1,3,121,215,343,31,374,0,O-117-127-04-01-01
MANAFWA,BUBULO COUNTY EAST,BUPOTO,BUKHAWEKA,BUKHAWEKA G.C.S. A,472,0,1,6,86,199,292,27,319,0,O-117-127-04-01-02
MANAFWA,BUBULO COUNTY EAST,BUPOTO,BUKHAWEKA,BUKHAWEKA GCS B,258,1,1,2,63,104,171,17,188,0,O-117-127-04-01-03
MANAFWA,BUBULO COUNTY EAST,BUPOTO,BUKHAWEKA,BUNANGANDA CHURCH,280,3,0,1,83,131,218,12,230,0,O-117-127-04-01-04
MANAFWA,BUBULO COUNTY EAST,BUPOTO,BUKHAWEKA,BUBIKALA CHURCH,632,0,1,3,85,343,432,27,459,0,O-117-127-04-01-05
MANAFWA,BUBULO COUNTY EAST,BUPOTO,BUKHAWEKA,SITUMI P/S,426,2,1,4,88,161,256,34,290,0,O-117-127-04-01-06
MANAFWA,BUBULO COUNTY EAST,BUPOTO,BUKHAWEKA,BUKHONZO CATHOLIC CHURCH,175,0,0,0,26,99,125,8,133,0,O-117-127-04-01-07
MANAFWA,BUBULO COUNTY EAST,BUPOTO,BUKHAWEKA,SIPAPALI DELIVERANCE CHURCH,422,3,2,2,67,192,266,37,303,0,O-117-127-04-01-08
MANAFWA,BUBULO COUNTY EAST,BUPOTO,BUWASUNGUYI,NAMIRAMA PR SCH,569,5,0,3,141,227,376,22,398,0,O-117-127-04-02-01
MANAFWA,BUBULO COUNTY EAST,BUPOTO,BUWASUNGUYI,BUWASUNGUYI G.C.S.,779,7,3,1,144,356,511,19,530,0,O-117-127-04-02-02
MANAFWA,BUBULO COUNTY EAST,BUPOTO,BUWASUNGUYI,MASAKA PR SCHOOL,558,4,1,1,82,325,413,21,434,0,O-117-127-04-02-03
MANAFWA,BUBULO COUNTY EAST,BUPOTO,BUWASUNGUYI,SIIBI'S SIBANGA,423,0,1,0,87,147,235,77,312,0,O-117-127-04-02-04
MANAFWA,BUBULO COUNTY EAST,BUPOTO,BUWASUNGUYI,MUTONGO,411,4,1,1,58,230,294,21,315,0,O-117-127-04-02-05
MANAFWA,BUBULO COUNTY EAST,BUPOTO,BUWASUNGUYI,KIWATSALA T/C,391,5,0,3,144,151,303,13,316,0,O-117-127-04-02-06
MANAFWA,BUBULO COUNTY EAST,BUPOTO,BUWASUNGUYI,BUMABENTSU DELIVERANCE CHU,320,3,0,0,47,142,192,35,227,0,O-117-127-04-02-07
MANAFWA,BUBULO COUNTY EAST,BUPOTO,BUYAKA,BUWERE,563,2,1,1,43,266,313,57,370,0,O-117-127-04-03-01
MANAFWA,BUBULO COUNTY EAST,BUPOTO,BUYAKA,BUWASIBA P/S,300,2,0,0,38,131,171,49,220,0,O-117-127-04-03-02
MANAFWA,BUBULO COUNTY EAST,BUPOTO,BUYAKA,NAMISINDWA PR. SCH. 1,509,1,0,4,53,260,318,6,324,0,O-117-127-04-03-03
MANAFWA,BUBULO COUNTY EAST,BUPOTO,BUYAKA,NAMISINDWA PR. SCH. 2,584,4,0,1,61,289,355,20,375,0,O-117-127-04-03-04
MANAFWA,BUBULO COUNTY EAST,BUPOTO,NAMISINDWA,MATUWA PRIMARY SCHOOL,516,1,2,1,36,458,498,9,507,0,O-117-127-04-04-01
MANAFWA,BUBULO COUNTY EAST,BUPOTO,NAMISINDWA,BUWANYAMBI PR SCH,627,4,1,1,90,344,440,26,466,0,O-117-127-04-04-02
MANAFWA,BUBULO COUNTY EAST,BUPOTO,NAMISINDWA,NAMISINDWA GCS,470,2,0,0,55,273,330,21,351,0,O-117-127-04-04-03
MANAFWA,BUBULO COUNTY EAST,BUPOTO,NAMISINDWA,BUNAMUNZU C.O.U,571,2,0,0,29,515,546,3,549,0,O-117-127-04-04-04
MANAFWA,BUBULO COUNTY EAST,BUPOTO,NAMISINDWA,BWAKWAMBEYI P/S,378,1,3,1,19,291,315,30,345,0,O-117-127-04-04-05
MANAFWA,BUBULO COUNTY EAST,BUWABWALA,BUKHABUSI,BUKHABUSI - BUUNGA,538,5,1,4,79,325,414,16,430,0,O-117-127-05-01-01
MANAFWA,BUBULO COUNTY EAST,BUWABWALA,BUKHABUSI,BUKHABUSI-BUMATANDA,484,0,0,2,57,257,316,35,351,0,O-117-127-05-01-02
MANAFWA,BUBULO COUNTY EAST,BUWABWALA,BUKHABUSI,NAMAWONDO,419,0,0,1,49,240,290,17,307,0,O-117-127-05-01-03
MANAFWA,BUBULO COUNTY EAST,BUWABWALA,BUKHABUSI,MURUMBA PRIMARY SCHOOL,512,1,0,0,42,209,252,76,328,0,O-117-127-05-01-04
MANAFWA,BUBULO COUNTY EAST,BUWABWALA,BUKHABUSI,BUKIMWANGA P/S,385,2,0,0,30,277,309,7,316,0,O-117-127-05-01-05
MANAFWA,BUBULO COUNTY EAST,BUWABWALA,BUKHABUSI,BUNAMITSA C.O.U,279,0,0,0,19,175,194,8,202,0,O-117-127-05-01-06
MANAFWA,BUBULO COUNTY EAST,BUWABWALA,BUKHABUSI,BUNAMITSA P/S,305,1,0,1,86,185,273,10,283,0,O-117-127-05-01-07
MANAFWA,BUBULO COUNTY EAST,BUWABWALA,BUMUMALI,BUNASAKA,131,0,0,0,3,124,127,4,131,0,O-117-127-05-02-01
MANAFWA,BUBULO COUNTY EAST,BUWABWALA,BUMUMALI,BUTINGU P/S,335,2,1,1,20,294,318,5,323,0,O-117-127-05-02-02
MANAFWA,BUBULO COUNTY EAST,BUWABWALA,BUMUMALI,BUMUMALI,602,1,1,0,41,522,565,32,597,0,O-117-127-05-02-03
MANAFWA,BUBULO COUNTY EAST,BUWABWALA,BUMUMALI,BUSEKELE-BUMUMALI,349,1,0,0,25,284,310,10,320,0,O-117-127-05-02-04
MANAFWA,BUBULO COUNTY EAST,BUWABWALA,BUMUMALI,BUNASAKA P/S,198,0,1,1,14,175,191,4,195,0,O-117-127-05-02-05
MANAFWA,BUBULO COUNTY EAST,BUWABWALA,BUNAMBALE,BUSULWA PR/SCHOOL,453,1,0,1,38,274,314,40,354,0,O-117-127-05-03-01
MANAFWA,BUBULO COUNTY EAST,BUWABWALA,BUNAMBALE,NAMBALE G.C.S.,594,2,3,3,61,514,583,2,585,0,O-117-127-05-03-02
MANAFWA,BUBULO COUNTY EAST,BUWABWALA,BUNAMBALE,BUNGATI C/U,695,1,2,2,70,387,462,2,464,0,O-117-127-05-03-03
MANAFWA,BUBULO COUNTY EAST,BUWABWALA,BUNAMBALE,BUNABITU SDA,609,5,0,0,114,409,528,17,545,0,O-117-127-05-03-04
MANAFWA,BUBULO COUNTY EAST,BUWABWALA,BUNAMBALE,BUNAMBALE,411,2,0,0,32,351,385,12,397,0,O-117-127-05-03-05
MANAFWA,BUBULO COUNTY EAST,BUWABWALA,BUNAMULUNYI,NANGETSA P/S,228,0,0,1,23,151,175,0,175,0,O-117-127-05-04-01
MANAFWA,BUBULO COUNTY EAST,BUWABWALA,BUNAMULUNYI,NABUSOLO PR. SCH. I,502,2,1,4,68,271,346,17,363,0,O-117-127-05-04-02
MANAFWA,BUBULO COUNTY EAST,BUWABWALA,BUNAMULUNYI,BUNAMBOBI P/S,464,1,1,6,36,243,287,30,317,0,O-117-127-05-04-03
MANAFWA,BUBULO COUNTY EAST,BUWABWALA,BUNAMULUNYI,BUKAKALA G.C.S,524,3,1,2,69,280,355,18,373,0,O-117-127-05-04-04
MANAFWA,BUBULO COUNTY EAST,BUWABWALA,BUNAMULUNYI,KUTUYI C.O.U,464,1,0,0,39,278,318,48,366,0,O-117-127-05-04-05
MANAFWA,BUBULO COUNTY EAST,BUWABWALA,BUSAMBATSA,BUWASU PR SCH,636,2,0,1,77,422,502,19,521,0,O-117-127-05-05-01
MANAFWA,BUBULO COUNTY EAST,BUWABWALA,BUSAMBATSA,BUWABWALA S/C HQTRS,748,5,0,3,56,457,521,9,530,0,O-117-127-05-05-02
MANAFWA,BUBULO COUNTY EAST,BUWABWALA,BUSAMBATSA,ROKHO C.O.U,367,2,0,3,37,175,217,23,240,0,O-117-127-05-05-03
MANAFWA,BUBULO COUNTY EAST,BUWABWALA,BUSAMBATSA,WEKELE P/S,516,1,0,0,34,354,389,10,399,0,O-117-127-05-05-04
PALLISA,BUTEBO COUNTY,BUTEBO,BUTEBO,BUTEBO SUB-DISPENSARY,806,3,1,3,313,224,544,19,563,0,O-119-188-01-01-01
PALLISA,BUTEBO COUNTY,BUTEBO,BUTEBO,BUTEBO S.S.,417,3,3,6,131,147,290,5,295,0,O-119-188-01-01-02
PALLISA,BUTEBO COUNTY,BUTEBO,BUTEBO,BUTEBO S.S. B,254,2,5,0,68,118,193,7,200,0,O-119-188-01-01-03
PALLISA,BUTEBO COUNTY,BUTEBO,BUTEBO,MATAKORE P.S.,497,3,1,3,194,146,347,19,366,0,O-119-188-01-01-04
PALLISA,BUTEBO COUNTY,BUTEBO,BUTEBO,KAMENYAMUGONGO T.C.,277,3,2,3,57,158,223,9,232,0,O-119-188-01-01-05
PALLISA,BUTEBO COUNTY,BUTEBO,BUTEBO,KAPKWATAI TRADING CENTRE,438,6,0,3,135,190,334,16,350,0,O-119-188-01-01-06
PALLISA,BUTEBO COUNTY,BUTEBO,KABERAI,GAYAZA TRADING CENTRE,556,2,1,9,189,205,406,11,417,0,O-119-188-01-02-01
PALLISA,BUTEBO COUNTY,BUTEBO,KABERAI,KABELAI P.S.,542,5,1,9,146,228,389,14,403,0,O-119-188-01-02-02
PALLISA,BUTEBO COUNTY,BUTEBO,KABERAI,MUBI'S PLACE,321,4,1,4,58,180,247,14,261,0,O-119-188-01-02-03
PALLISA,BUTEBO COUNTY,BUTEBO,KANYUM,OBOY'S CORNER,688,13,6,11,228,222,480,33,513,0,O-119-188-01-03-01
PALLISA,BUTEBO COUNTY,BUTEBO,KANYUM,OBONG'S PLACE,514,4,1,9,243,166,423,6,429,0,O-119-188-01-03-02
PALLISA,BUTEBO COUNTY,BUTEBO,KANYUM,KANYUM P/S,480,6,2,8,138,210,364,19,383,0,O-119-188-01-03-03
PALLISA,BUTEBO COUNTY,BUTEBO,KASYEBAI,SOLONKO CHURCH,611,7,2,5,224,187,425,21,446,0,O-119-188-01-04-01
PALLISA,BUTEBO COUNTY,BUTEBO,KASYEBAI,KALAKALA GCS LTD,635,6,5,5,204,233,453,16,469,0,O-119-188-01-04-02
PALLISA,BUTEBO COUNTY,BUTEBO,KASYEBAI,LATE SHABANI'S TREE,361,2,10,3,164,160,339,20,359,0,O-119-188-01-04-03
PALLISA,BUTEBO COUNTY,BUTEBO,KASYEBAI,AKOBOI TRADING CENTRE,184,0,2,1,107,40,150,6,156,0,O-119-188-01-04-04
PALLISA,BUTEBO COUNTY,BUTEBO,KASYEBAI,ODIPANYA PRIMARY SCHOOL,478,3,2,0,133,197,335,30,365,0,O-119-188-01-04-05
PALLISA,BUTEBO COUNTY,KABWANGASI,KABWANGASI,KASEKENYI COLLEGE STATION,604,4,1,7,214,155,381,25,406,0,O-119-188-02-01-01
PALLISA,BUTEBO COUNTY,KABWANGASI,KABWANGASI,OGOSOI KAYIMA'S PLACE,425,3,0,5,125,152,285,20,305,0,O-119-188-02-01-02
PALLISA,BUTEBO COUNTY,KABWANGASI,KABWANGASI,KABWANGASI S.S,593,1,0,1,171,187,360,39,399,0,O-119-188-02-01-03
PALLISA,BUTEBO COUNTY,KABWANGASI,KABWANGASI,KABWANGASI P/S,275,3,2,1,116,60,182,19,201,0,O-119-188-02-01-04
PALLISA,BUTEBO COUNTY,KABWANGASI,KACHURU,KACHURU P/S,750,7,3,13,186,329,538,39,577,0,O-119-188-02-02-01
PALLISA,BUTEBO COUNTY,KABWANGASI,KACHURU,LATE OCHOM'S MANGO TREE,600,8,6,7,208,231,460,18,478,0,O-119-188-02-02-02
PALLISA,BUTEBO COUNTY,KABWANGASI,MAIZIMASA,MAIZIMASA P/S,454,3,1,3,147,130,284,24,308,0,O-119-188-02-03-01
PALLISA,BUTEBO COUNTY,KABWANGASI,MAIZIMASA,NAKAWA SOCIAL CENTRE,634,10,0,9,213,216,448,29,477,0,O-119-188-02-03-02
PALLISA,BUTEBO COUNTY,KABWANGASI,MAIZIMASA,KAWOJANI P/S,521,9,5,4,147,243,408,21,429,0,O-119-188-02-03-03
PALLISA,BUTEBO COUNTY,KABWANGASI,MAIZIMASA,KITAWOMA'S MANGO TREE,331,2,0,6,145,95,248,17,265,0,O-119-188-02-03-04
PALLISA,BUTEBO COUNTY,KABWANGASI,MAIZIMASA,WAMIKA'S PLACE,227,3,1,1,84,78,167,3,170,0,O-119-188-02-03-05
PALLISA,BUTEBO COUNTY,KABWANGASI,NASENYI,DOKO,493,10,0,6,145,154,315,39,354,0,O-119-188-02-04-01
PALLISA,BUTEBO COUNTY,KABWANGASI,NASENYI,NASENYI,542,3,6,6,148,239,402,34,436,0,O-119-188-02-04-02
PALLISA,BUTEBO COUNTY,KABWANGASI,NASENYI,NAME_MISSING,511,8,5,4,146,226,389,35,424,0,O-119-188-02-04-03
PALLISA,BUTEBO COUNTY,KABWANGASI,PUTTI,PUTTI P/S,495,8,2,4,138,191,343,28,371,0,O-119-188-02-05-01
PALLISA,BUTEBO COUNTY,KABWANGASI,PUTTI,PUTTI CATH. CHURCH,651,12,3,18,181,251,465,25,490,0,O-119-188-02-05-02
PALLISA,BUTEBO COUNTY,KABWANGASI,PUTTI,OKIRING'S MANGO TREE,325,3,2,1,79,136,221,9,230,0,O-119-188-02-05-03
PALLISA,BUTEBO COUNTY,KABWANGASI,PUTTI,NAUMA'S MANGO TREE,219,3,1,1,43,114,162,11,173,0,O-119-188-02-05-04
PALLISA,BUTEBO COUNTY,KAKORO,KADOKOLENE,KADOKOLENE P/S,453,2,2,5,89,256,354,19,373,0,O-119-188-03-01-01
PALLISA,BUTEBO COUNTY,KAKORO,KADOKOLENE,KADOKOLENE T/C,631,3,4,3,122,334,466,32,498,0,O-119-188-03-01-02
PALLISA,BUTEBO COUNTY,KAKORO,KAITISYA,KAYITISYA MUKONGE TREE,424,5,1,2,125,164,297,12,309,0,O-119-188-03-02-01
PALLISA,BUTEBO COUNTY,KAKORO,KAITISYA,KANITISYA JUNCTION,433,6,2,6,181,158,353,0,353,0,O-119-188-03-02-02
PALLISA,BUTEBO COUNTY,KAKORO,KAKORO,KABULO MANGO TREE,267,6,0,3,93,90,192,1,193,0,O-119-188-03-03-01
PALLISA,BUTEBO COUNTY,KAKORO,KAKORO,NDEGE'S GROUND,311,6,3,1,77,126,213,30,243,0,O-119-188-03-03-02
PALLISA,BUTEBO COUNTY,KAKORO,KAKORO,KAKORO T/C,710,3,4,5,153,316,481,15,496,0,O-119-188-03-03-03
PALLISA,BUTEBO COUNTY,KAKORO,KAKORO,KAKORO HEALTH CENTRE,507,5,5,1,153,171,335,26,361,0,O-119-188-03-03-04
PALLISA,BUTEBO COUNTY,KAKORO,KANGINIMA,KANGINIMA P.S.,524,7,1,4,108,208,328,17,345,0,O-119-188-03-04-01
PALLISA,BUTEBO COUNTY,KAKORO,KANGINIMA,KANGINIMA T/C,433,4,1,3,88,254,350,10,360,0,O-119-188-03-04-02
PALLISA,BUTEBO COUNTY,KAKORO,KASAJJA,KALECHERU P/S,396,11,4,5,115,143,278,0,278,0,O-119-188-03-05-01
PALLISA,BUTEBO COUNTY,KAKORO,KASAJJA,KAKORO GINNERY,402,4,0,3,109,162,278,14,292,0,O-119-188-03-05-02
PALLISA,BUTEBO COUNTY,KAKORO,KITOIKA WONONI,TINGORI C/U,698,7,1,7,128,390,533,14,547,0,O-119-188-03-06-01
PALLISA,BUTEBO COUNTY,KAKORO,KITOIKA WONONI,NALIDI P/S,749,8,2,8,172,365,555,16,571,0,O-119-188-03-06-02
PALLISA,BUTEBO COUNTY,KAKORO,TEKWANA,TEKWAN SDA CHURCH,479,3,3,9,65,257,337,32,369,0,O-119-188-03-07-01
PALLISA,BUTEBO COUNTY,KAKORO,TEKWANA,KATEKWANA P/S,595,5,3,5,122,304,439,34,473,0,O-119-188-03-07-02
PALLISA,BUTEBO COUNTY,KIBALE,KADESOKO,KADESOK PRIMARY SCH.,509,5,2,10,179,176,372,35,407,0,O-119-188-04-01-01
PALLISA,BUTEBO COUNTY,KIBALE,KADESOKO,OLADOT GINNERY,502,1,1,3,89,177,271,10,281,0,O-119-188-04-01-02
PALLISA,BUTEBO COUNTY,KIBALE,KADESOKO,OKIRUKET,367,0,0,0,0,0,0,0,0,1,O-119-188-04-01-03
PALLISA,BUTEBO COUNTY,KIBALE,KAPUAI,KAPUWAI P.S.,533,3,4,9,277,117,410,14,424,0,O-119-188-04-02-01
PALLISA,BUTEBO COUNTY,KIBALE,KAPUAI,OTAMIRIO T/C,738,24,2,18,384,160,588,12,600,0,O-119-188-04-02-02
PALLISA,BUTEBO COUNTY,KIBALE,KAPUAI,KAPUWAI C.G.S. LTD,388,4,1,9,147,174,335,13,348,0,O-119-188-04-02-03
PALLISA,BUTEBO COUNTY,KIBALE,KAPUAI,ABILA P/S,302,4,1,2,129,97,233,2,235,0,O-119-188-04-02-04
PALLISA,BUTEBO COUNTY,KIBALE,KIBALE,OMATAKOJO G.C.S. LTD,714,5,1,8,492,62,568,8,576,0,O-119-188-04-03-01
PALLISA,BUTEBO COUNTY,KIBALE,KIBALE,AUK'S MANGO TREE,640,4,2,3,336,116,461,14,475,0,O-119-188-04-03-02
PALLISA,BUTEBO COUNTY,KIBALE,OMUKULAI,KIBALE P/S,402,3,5,10,239,64,321,31,352,0,O-119-188-04-04-01
PALLISA,BUTEBO COUNTY,KIBALE,OMUKULAI,OLEPUSI MANGO TREE,585,10,18,19,371,138,556,20,576,0,O-119-188-04-04-02
PALLISA,BUTEBO COUNTY,KIBALE,OPOGONO,OPOGONO P.S.,801,11,3,19,284,285,602,34,636,0,O-119-188-04-05-01
PALLISA,BUTEBO COUNTY,KIBALE,OPOGONO,AKIBOIBON ROCK A,592,9,0,10,204,278,501,23,524,0,O-119-188-04-05-02
PALLISA,BUTEBO COUNTY,KIBALE,OPOGONO,AKIBOIBON ROCK B,68,0,0,0,43,23,66,2,68,0,O-119-188-04-05-03
PALLISA,BUTEBO COUNTY,KIBALE,OPWATETA,OPWATETA P/S,740,15,0,10,298,213,536,13,549,0,O-119-188-04-06-01
PALLISA,BUTEBO COUNTY,KIBALE,OPWATETA,OKWAJA'S MANGO TREE,253,12,1,10,101,71,195,15,210,0,O-119-188-04-06-02
PALLISA,BUTEBO COUNTY,KIBALE,OPWATETA,RWATAMA,631,11,1,13,292,158,475,10,485,0,O-119-188-04-06-03
PALLISA,BUTEBO COUNTY,KIBALE,OPWATETA,OKARACHA,313,4,0,4,92,177,277,9,286,0,O-119-188-04-06-04
PALLISA,BUTEBO COUNTY,PETETE,KACHABALI,NADOGHA'S CORNER,724,5,0,3,254,269,531,9,540,0,O-119-188-05-01-01
PALLISA,BUTEBO COUNTY,PETETE,KACHABALI,MABERE'S MANGO TREE,222,4,0,0,98,57,159,4,163,0,O-119-188-05-01-02
PALLISA,BUTEBO COUNTY,PETETE,KACHOCHA,KABELEKEKE,371,5,0,2,153,130,290,50,340,0,O-119-188-05-02-01
PALLISA,BUTEBO COUNTY,PETETE,KACHOCHA,NAMUSWATA,333,4,0,1,163,106,274,8,282,0,O-119-188-05-02-02
PALLISA,BUTEBO COUNTY,PETETE,KACHOCHA,KACHOCA P.S.,443,8,2,3,146,169,328,13,341,0,O-119-188-05-02-03
PALLISA,BUTEBO COUNTY,PETETE,KACHOCHA,KONYANGA'S CORNER,435,8,1,4,160,139,312,14,326,0,O-119-188-05-02-04
PALLISA,BUTEBO COUNTY,PETETE,KAPUNYASI,ST.ANTHREM BUYEDA,685,10,2,6,174,316,508,16,524,0,O-119-188-05-03-01
PALLISA,BUTEBO COUNTY,PETETE,KAPUNYASI,MBOLERE'S MANGO TREE,336,0,1,6,62,168,237,12,249,0,O-119-188-05-03-02
PALLISA,BUTEBO COUNTY,PETETE,KAPUNYASI,MANYOBE,277,0,0,0,0,0,0,0,0,1,O-119-188-05-03-03
PALLISA,BUTEBO COUNTY,PETETE,KAPUNYASI,KAPUNYASI C.O.U,466,3,0,2,82,113,200,13,213,0,O-119-188-05-03-04
PALLISA,BUTEBO COUNTY,PETETE,KAPUNYASI,NASULETA TC,625,7,1,16,171,303,498,15,513,0,O-119-188-05-03-05
PALLISA,BUTEBO COUNTY,PETETE,PETETE,KABULYAI P/S,456,6,0,5,166,170,347,11,358,0,O-119-188-05-04-01
PALLISA,BUTEBO COUNTY,PETETE,PETETE,PETETE P.S.,278,3,0,2,82,113,200,13,213,0,O-119-188-05-04-02
PALLISA,BUTEBO COUNTY,PETETE,PETETE,PETETE T.C. A,517,4,4,1,202,271,482,16,498,0,O-119-188-05-04-03
PALLISA,BUTEBO COUNTY,PETETE,PETETE,KOSINGE MANGO TREE,418,6,1,6,124,171,308,23,331,0,O-119-188-05-04-04
PALLISA,BUTEBO COUNTY,PETETE,SIDANYI,KABUSULE,248,2,3,1,126,51,183,14,197,0,O-119-188-05-05-01
PALLISA,BUTEBO COUNTY,PETETE,SIDANYI,YAKOBO'S MANGO TREE,570,9,6,4,255,122,396,30,426,0,O-119-188-05-05-02
IGANGA,BUGWERI COUNTY,BUSEMBATIA TOWN COUNCIL,BUSEMBATIA CENTR,BUSEMBATIA GINNERY,392,1,1,0,106,133,241,6,247,0,O-124-30-01-01-01
IGANGA,BUGWERI COUNTY,BUSEMBATIA TOWN COUNCIL,BUSEMBATIA CENTR,BUSEMBATIA PR SCHOOL A,299,1,1,1,83,94,180,1,181,0,O-124-30-01-01-02
IGANGA,BUGWERI COUNTY,BUSEMBATIA TOWN COUNCIL,BUSEMBATIA MARKE,BUSEMBATIA DISPENSARY A,542,1,3,1,151,189,345,14,359,0,O-124-30-01-02-01
IGANGA,BUGWERI COUNTY,BUSEMBATIA TOWN COUNCIL,BUSEMBATIA MARKE,BUSEMBATIA DISPENSARY B,394,2,0,0,120,135,257,5,262,0,O-124-30-01-02-02
IGANGA,BUGWERI COUNTY,BUSEMBATIA TOWN COUNCIL,BUYIRIMA,RAILWAY STATION GROUND A,548,1,3,0,129,199,332,15,347,0,O-124-30-01-03-01
IGANGA,BUGWERI COUNTY,BUSEMBATIA TOWN COUNCIL,BUYIRIMA,RAILWAY STATION GROUND B,354,3,1,2,107,118,231,7,238,0,O-124-30-01-03-02
IGANGA,BUGWERI COUNTY,BUSEMBATIA TOWN COUNCIL,KAKOGE,BUSEMBATIA P SCH B,653,0,4,2,191,218,415,5,420,0,O-124-30-01-04-01
IGANGA,BUGWERI COUNTY,BUSEMBATIA TOWN COUNCIL,MAJENGO,MAJENGO CENTRE,647,2,2,2,245,208,459,4,463,0,O-124-30-01-05-01
IGANGA,BUGWERI COUNTY,BUYANGA,BULUNGULI,KIWANYI CATHOLIC CHURCH A,281,1,1,1,56,136,195,4,199,0,O-124-30-02-01-01
IGANGA,BUGWERI COUNTY,BUYANGA,BULUNGULI,KIWANYI CATHOLIC CHURCH B,534,1,0,2,56,325,384,11,395,0,O-124-30-02-01-02
IGANGA,BUGWERI COUNTY,BUYANGA,BULUNGULI,BULUNGULI MOSQUE,448,4,5,0,119,210,338,16,354,0,O-124-30-02-01-03
IGANGA,BUGWERI COUNTY,BUYANGA,BUMOOZI,BUWANGA COUNTY CENTRE,188,0,0,3,62,91,156,12,168,0,O-124-30-02-02-01
IGANGA,BUGWERI COUNTY,BUYANGA,BUMOOZI,BUMOZI PR SCH,290,7,4,1,74,135,221,3,224,0,O-124-30-02-02-02
IGANGA,BUGWERI COUNTY,BUYANGA,BUMOOZI,NKOMBE CENTRE,518,2,1,3,235,164,405,12,417,0,O-124-30-02-02-03
IGANGA,BUGWERI COUNTY,BUYANGA,BUMOOZI,BUPALA CENTRE,579,2,1,4,200,275,482,18,500,0,O-124-30-02-02-04
IGANGA,BUGWERI COUNTY,BUYANGA,BUMOOZI,NSOZIBIRI MOSQUE,285,1,1,3,49,171,225,7,232,0,O-124-30-02-02-05
IGANGA,BUGWERI COUNTY,BUYANGA,BUWOOYA,BUYANGA P/S A BUWOLA,626,4,3,0,172,265,444,10,454,0,O-124-30-02-03-01
IGANGA,BUGWERI COUNTY,BUYANGA,BUWOOYA,BUYANGA PR SCH BUWOYA/BUYI,558,1,0,1,144,228,374,4,378,0,O-124-30-02-03-02
IGANGA,BUGWERI COUNTY,BUYANGA,BUWOOYA,BUYANGA JUNCTION,469,0,0,0,0,0,0,0,0,1,O-124-30-02-03-03
IGANGA,BUGWERI COUNTY,BUYANGA,BUWOOYA,NALUSWA P SCHOOL,627,3,1,5,183,226,418,8,426,0,O-124-30-02-03-04
IGANGA,BUGWERI COUNTY,BUYANGA,BUWOOYA,SUB-PARISH HQS BUDUBYE,496,4,3,2,148,201,358,12,370,0,O-124-30-02-03-05
IGANGA,BUGWERI COUNTY,BUYANGA,BWIGULA,BUTABA P. SCHOOL,499,3,1,2,140,162,308,57,365,0,O-124-30-02-04-01
IGANGA,BUGWERI COUNTY,BUYANGA,BWIGULA,NAKAWOIZA,479,1,2,1,147,181,332,18,350,0,O-124-30-02-04-02
IGANGA,BUGWERI COUNTY,BUYANGA,BWIGULA,BWIGULA,555,1,4,2,166,228,401,8,409,0,O-124-30-02-04-03
IGANGA,BUGWERI COUNTY,BUYANGA,IDUDI,NAKAWALA'S PLACE(A-M),635,2,2,0,257,145,406,9,415,0,O-124-30-02-05-01
IGANGA,BUGWERI COUNTY,BUYANGA,IDUDI,IDUDI MARKET,1323,5,0,4,423,224,656,29,685,0,O-124-30-02-05-02
IGANGA,BUGWERI COUNTY,BUYANGA,IDUDI,IDUDI FOUNDATION SCHOOL,595,3,0,3,158,176,340,16,356,0,O-124-30-02-05-03
IGANGA,BUGWERI COUNTY,BUYANGA,IDUDI,MUFUMI MOSQUE,527,3,0,5,223,132,363,14,377,0,O-124-30-02-05-04
IGANGA,BUGWERI COUNTY,BUYANGA,IDUDI,NAKAWALA'S PLACE(N-Z),462,1,0,0,144,123,268,7,275,0,O-124-30-02-05-05
IGANGA,BUGWERI COUNTY,BUYANGA,KALALU,KALALU CO-OP SOCIETY (A - M),406,0,1,0,85,238,324,8,332,0,O-124-30-02-06-01
IGANGA,BUGWERI COUNTY,BUYANGA,KALALU,KALALU CO-OP SOCIETY (N - Z),353,0,0,1,38,203,242,11,253,0,O-124-30-02-06-02
IGANGA,BUGWERI COUNTY,BUYANGA,KALALU,KALALU CENTRE B (A - M),418,4,1,2,133,162,302,31,333,0,O-124-30-02-06-03
IGANGA,BUGWERI COUNTY,BUYANGA,KALALU,KALALU CENTRE B (N - Z),364,2,0,3,98,142,245,7,252,0,O-124-30-02-06-04
IGANGA,BUGWERI COUNTY,BUYANGA,LUBIRA,LUBIRA PR SCHOOL,686,3,7,4,127,355,496,11,507,0,O-124-30-02-07-01
IGANGA,BUGWERI COUNTY,BUYANGA,LUBIRA,MPOYA'S PLACE,435,1,5,4,88,220,318,18,336,0,O-124-30-02-07-02
IGANGA,BUGWERI COUNTY,IBULANKU,BUBENGE,BUBENGE PR SCHOOL A,706,3,0,4,280,213,500,8,508,0,O-124-30-03-01-01
IGANGA,BUGWERI COUNTY,IBULANKU,BUBENGE,BUBENGE PR SCHOOL B,489,4,3,1,199,148,355,14,369,0,O-124-30-03-01-02
IGANGA,BUGWERI COUNTY,IBULANKU,BUBENGE,WALANGA PR SCHOOL B,623,1,2,1,185,274,463,10,473,0,O-124-30-03-01-03
IGANGA,BUGWERI COUNTY,IBULANKU,BUBENGE,NAWAMPENDO PR SCHOOL B,293,1,1,2,41,174,219,7,226,0,O-124-30-03-01-04
IGANGA,BUGWERI COUNTY,IBULANKU,BUBENGE,MATOVU JUNCTION,61,0,0,0,26,14,40,2,42,0,O-124-30-03-01-05
IGANGA,BUGWERI COUNTY,IBULANKU,BUNYANTOLE,BUNYANTOLE PR SCHOOL,387,1,0,0,98,132,231,5,236,0,O-124-30-03-02-01
IGANGA,BUGWERI COUNTY,IBULANKU,BUNYANTOLE,NAKIVUMBI TC,380,4,0,1,106,111,222,7,229,0,O-124-30-03-02-02
IGANGA,BUGWERI COUNTY,IBULANKU,BUTENDE,BUKOTERA PR SCHOOL,360,3,1,2,94,182,282,11,293,0,O-124-30-03-03-01
IGANGA,BUGWERI COUNTY,IBULANKU,BUTENDE,BUTENDE PR SCHOOL,1046,4,2,5,359,185,555,12,567,0,O-124-30-03-03-02
IGANGA,BUGWERI COUNTY,IBULANKU,BUTENDE,LUSAGHA JUNCTION,441,0,0,1,123,185,309,14,323,0,O-124-30-03-03-03
IGANGA,BUGWERI COUNTY,IBULANKU,BUTENDE,BUTENDE ISLAMIC PR SCHOOL,50,0,0,0,19,4,23,0,23,0,O-124-30-03-03-04
IGANGA,BUGWERI COUNTY,IBULANKU,IBAAKO,BUSESA MIXED SCHOOL,575,4,1,3,145,234,387,12,399,0,O-124-30-03-04-01
IGANGA,BUGWERI COUNTY,IBULANKU,IBAAKO,IBAAKO PR SCHOOL,647,3,4,3,195,237,442,18,460,0,O-124-30-03-04-02
IGANGA,BUGWERI COUNTY,IBULANKU,IBAAKO,BUGWERI COUNTY HQS,724,1,6,3,140,267,417,9,426,0,O-124-30-03-04-03
IGANGA,BUGWERI COUNTY,IBULANKU,IBULANKU,IBULANKU S/COUNTY HQS A,539,0,6,0,220,161,387,11,398,0,O-124-30-03-05-01
IGANGA,BUGWERI COUNTY,IBULANKU,IBULANKU,IBULANKU S/COUNTY HQS B,603,2,3,1,216,139,361,9,370,0,O-124-30-03-05-02
IGANGA,BUGWERI COUNTY,IBULANKU,IBULANKU,MULANGA PR SCHOOL,419,2,1,0,158,142,303,5,308,0,O-124-30-03-05-03
IGANGA,BUGWERI COUNTY,IBULANKU,IBULANKU,KIIGE'S PLACE,354,2,0,9,132,127,270,6,276,0,O-124-30-03-05-04
IGANGA,BUGWERI COUNTY,IBULANKU,IGOMBE,IGOMBE CENTRE,700,3,3,5,208,254,473,22,495,0,O-124-30-03-06-01
IGANGA,BUGWERI COUNTY,IBULANKU,IGOMBE,BULYANSIME P/S A,550,2,1,1,158,194,356,18,374,0,O-124-30-03-06-02
IGANGA,BUGWERI COUNTY,IBULANKU,IGOMBE,BULYANSIME PR SCH B,446,3,1,0,102,199,305,12,317,0,O-124-30-03-06-03
IGANGA,BUGWERI COUNTY,IBULANKU,KIKUNYU,BUSINDA CENTRE,783,2,5,4,164,346,521,7,528,0,O-124-30-03-07-01
IGANGA,BUGWERI COUNTY,IBULANKU,KIKUNYU,BUBONGHE CENTRE,436,1,0,1,121,207,330,2,332,0,O-124-30-03-07-02
IGANGA,BUGWERI COUNTY,IBULANKU,KIKUNYU,KIKUNYU CENTRE,205,2,0,1,47,63,113,27,140,0,O-124-30-03-07-03
IGANGA,BUGWERI COUNTY,IBULANKU,NAMIGANDA,NAKIVUMBI P SCHOOL,380,3,0,3,123,182,311,14,325,0,O-124-30-03-08-01
IGANGA,BUGWERI COUNTY,IBULANKU,NAMIGANDA,RC I OFFICE NAMIGANDA,330,1,1,1,91,170,264,12,276,0,O-124-30-03-08-02
IGANGA,BUGWERI COUNTY,IBULANKU,NAWANSEGA,BUMPINGO PR SCHOOL,773,13,1,5,333,207,559,13,572,0,O-124-30-03-09-01
IGANGA,BUGWERI COUNTY,IBULANKU,NAWANSEGA,NAWANSEGA CO-OP SOCIETY,597,3,0,2,263,144,412,25,437,0,O-124-30-03-09-02
IGANGA,BUGWERI COUNTY,IBULANKU,NAWANSEGA,NAKISENYE MOSQUE,196,0,0,0,59,87,146,12,158,0,O-124-30-03-09-03
IGANGA,BUGWERI COUNTY,IBULANKU,NSAALE,BUWABE PR SCHOOL,658,2,2,1,102,351,458,26,484,0,O-124-30-03-10-01
IGANGA,BUGWERI COUNTY,IBULANKU,NSAALE,NAKIBEMBE P/S A,382,1,2,0,168,107,278,1,279,0,O-124-30-03-10-02
IGANGA,BUGWERI COUNTY,IBULANKU,NSAALE,BUWABE CO-OP SOCIETY,709,3,1,3,291,213,511,0,511,0,O-124-30-03-10-03
IGANGA,BUGWERI COUNTY,IBULANKU,NSAALE,NAKIBEMBE P/S B,390,4,1,1,121,148,275,14,289,0,O-124-30-03-10-04
IGANGA,BUGWERI COUNTY,IBULANKU,NSAALE,NAKASUBI MOSQUE,377,1,0,1,151,127,280,8,288,0,O-124-30-03-10-05
IGANGA,BUGWERI COUNTY,MAKUUTU,KASOZI,KASOZI RC OFFICE,762,4,2,5,262,224,497,21,518,0,O-124-30-04-01-01
IGANGA,BUGWERI COUNTY,MAKUUTU,KASOZI,NONDWE T CENTRE,1011,6,1,4,209,390,610,18,628,0,O-124-30-04-01-02
IGANGA,BUGWERI COUNTY,MAKUUTU,KASOZI,BUSIMO P SCHOOL,439,4,0,1,105,178,288,11,299,0,O-124-30-04-01-03
IGANGA,BUGWERI COUNTY,MAKUUTU,KASOZI,NAMAVUNDU PR SCHOOL,476,0,0,0,85,275,360,9,369,0,O-124-30-04-01-04
IGANGA,BUGWERI COUNTY,MAKUUTU,KASOZI,BUKOSE IMUNISATION CENTRE,333,2,2,1,68,137,210,11,221,0,O-124-30-04-01-05
IGANGA,BUGWERI COUNTY,MAKUUTU,KIGULAMO,KIGULAMO CENTRE,476,1,2,0,115,208,326,42,368,0,O-124-30-04-02-01
IGANGA,BUGWERI COUNTY,MAKUUTU,KIGULAMO,NAITANDU CENTRE(A-M),419,1,0,0,97,208,306,9,315,0,O-124-30-04-02-02
IGANGA,BUGWERI COUNTY,MAKUUTU,KIGULAMO,NAITANDU CENTRE(N-Z),336,1,0,1,52,198,252,9,261,0,O-124-30-04-02-03
IGANGA,BUGWERI COUNTY,MAKUUTU,MAKANDWA,MAWOLOLO ISLAMIC SCHOOL,641,4,0,4,196,239,443,15,458,0,O-124-30-04-03-01
IGANGA,BUGWERI COUNTY,MAKUUTU,MAKANDWA,MAKANDWA PR SCHOOL (A-M),423,2,0,4,86,215,307,11,318,0,O-124-30-04-03-02
IGANGA,BUGWERI COUNTY,MAKUUTU,MAKANDWA,NABWEYA CATHOLIC CHURCH,397,2,1,3,94,187,287,11,298,0,O-124-30-04-03-03
IGANGA,BUGWERI COUNTY,MAKUUTU,MAKANDWA,MAKANDWA PR SCHOOL (N-Z),416,2,0,0,45,201,248,34,282,0,O-124-30-04-03-04
IGANGA,BUGWERI COUNTY,MAKUUTU,MAKUUTU,MAKUUTU CENTRE,703,2,2,4,150,307,465,5,470,0,O-124-30-04-04-01
IGANGA,BUGWERI COUNTY,MAKUUTU,MAKUUTU,BUWONGO CENTRE,423,5,1,6,99,180,291,8,299,0,O-124-30-04-04-02
IGANGA,BUGWERI COUNTY,MAKUUTU,MAKUUTU,BUNALWENYI CENTRE A,447,3,3,5,113,203,327,14,341,0,O-124-30-04-04-03
IGANGA,BUGWERI COUNTY,MAKUUTU,MAKUUTU,BUNALWENYI CENTRE B,407,2,2,2,79,198,283,7,290,0,O-124-30-04-04-04
IGANGA,BUGWERI COUNTY,MAKUUTU,MAKUUTU,NAKADULI NURSERY SCHOOL,293,0,3,2,58,140,203,13,216,0,O-124-30-04-04-05
IGANGA,BUGWERI COUNTY,NAMALEMBA,IDINDA,NABIRERE RCM SCHOOL A,522,4,5,6,202,122,339,19,358,0,O-124-30-05-01-01
IGANGA,BUGWERI COUNTY,NAMALEMBA,IDINDA,NABIRERE RCM SCHOOL B,503,3,0,1,113,185,302,62,364,0,O-124-30-05-01-02
IGANGA,BUGWERI COUNTY,NAMALEMBA,IDINDA,IDINDA PR SCHOOL,627,5,3,3,160,262,433,20,453,0,O-124-30-05-01-03
IGANGA,BUGWERI COUNTY,NAMALEMBA,IDINDA,BUSWIGA RC OFFICE,191,0,0,1,58,73,132,13,145,0,O-124-30-05-01-04
IGANGA,BUGWERI COUNTY,NAMALEMBA,MINANI,MINANI PR SCHOOL A,635,4,0,5,176,220,405,29,434,0,O-124-30-05-02-01
IGANGA,BUGWERI COUNTY,NAMALEMBA,MINANI,MINANI PR SCHOOL B,659,3,1,4,123,341,472,24,496,0,O-124-30-05-02-02
IGANGA,BUGWERI COUNTY,NAMALEMBA,MINANI,BUKAKAIRE PR SCHOOL A,551,0,2,0,110,244,356,18,374,0,O-124-30-05-02-03
IGANGA,BUGWERI COUNTY,NAMALEMBA,NAMALEMBA,BUTONGOLE T. CENTRE,367,1,0,2,101,170,274,12,286,0,O-124-30-05-03-01
IGANGA,BUGWERI COUNTY,NAMALEMBA,NAMALEMBA,NAWANGISA T CENTRE,668,5,0,2,113,383,503,14,517,0,O-124-30-05-03-02
IGANGA,BUGWERI COUNTY,NAMALEMBA,NAMALEMBA,BUTAKANIRA CENTRE,434,0,0,3,82,261,346,11,357,0,O-124-30-05-03-03
IGANGA,BUGWERI COUNTY,NAMALEMBA,NAMALEMBA,NAMALEMBA PR SCHOOL,630,2,3,2,111,300,418,12,430,0,O-124-30-05-03-04
IGANGA,BUGWERI COUNTY,NAMALEMBA,NAMUNYUMYA,DHIKUSOKA'S PLACE,450,0,0,2,93,186,281,8,289,0,O-124-30-05-04-01
IGANGA,BUGWERI COUNTY,NAMALEMBA,NAMUNYUMYA,NAMUNYUMYA C.O.U.,672,0,3,4,168,281,456,16,472,0,O-124-30-05-04-02
AMURIA,KAPELEBYONG,ACOWA,ACOWA,OCITO,861,0,213,9,16,31,269,54,323,0,O-127-202-01-01-01
AMURIA,KAPELEBYONG,ACOWA,ACOWA,OCITO S/COUNTY HQRS,810,20,9,28,278,172,507,38,545,0,O-127-202-01-01-02
AMURIA,KAPELEBYONG,ACOWA,AKOROMIT,OLEKAT A,805,12,5,7,380,81,485,24,509,0,O-127-202-01-02-01
AMURIA,KAPELEBYONG,ACOWA,AKOROMIT,OTUNGUL,314,6,1,0,191,20,218,3,221,0,O-127-202-01-02-02
AMURIA,KAPELEBYONG,ACOWA,AKOROMIT,TOBORA MANGO TREE,477,10,3,6,209,66,294,11,305,0,O-127-202-01-02-03
AMURIA,KAPELEBYONG,ACOWA,AKOROMIT,OITELAIKILILIOK B/H,418,3,4,3,198,14,222,1,223,0,O-127-202-01-02-04
AMURIA,KAPELEBYONG,ACOWA,AKUM,AJELEIK,711,27,12,25,326,167,557,28,585,0,O-127-202-01-03-01
AMURIA,KAPELEBYONG,ACOWA,AKUM,ATIRAI,580,20,3,10,329,86,448,19,467,0,O-127-202-01-03-02
AMURIA,KAPELEBYONG,ACOWA,AMERO,ADODOI P/S,105,0,1,1,17,41,60,4,64,0,O-127-202-01-04-01
AMURIA,KAPELEBYONG,ACOWA,AMERO,AMERO A,813,6,6,32,160,295,499,76,575,0,O-127-202-01-04-02
AMURIA,KAPELEBYONG,ACOWA,AMERO,AMUGE 1,300,6,6,3,68,120,203,18,221,0,O-127-202-01-04-03
AMURIA,KAPELEBYONG,ACOWA,ANGOLEBWAL,ANGOLEBWAL FARMER SOCIETY,486,13,4,17,113,213,360,1,361,0,O-127-202-01-05-01
AMURIA,KAPELEBYONG,ACOWA,ANGOLEBWAL,ANGOLEBWAL ONGAEWA OMASA,351,2,4,3,40,203,252,11,263,0,O-127-202-01-05-02
AMURIA,KAPELEBYONG,ACOWA,KOBUIN,KOBUIN A (LOROBLRITO),715,14,4,6,500,15,539,11,550,0,O-127-202-01-06-01
AMURIA,KAPELEBYONG,ACOWA,KOBUIN,KOBUIN B,702,11,0,2,385,59,457,16,473,0,O-127-202-01-06-02
AMURIA,KAPELEBYONG,ACOWA,KOBUIN,KOBUIN B (ABOLOT),431,5,5,7,215,103,335,15,350,0,O-127-202-01-06-03
AMURIA,KAPELEBYONG,ACOWA,KOBUIN,KOBUIN C (ANGEREPO),526,14,10,17,217,100,358,31,389,0,O-127-202-01-06-04
AMURIA,KAPELEBYONG,KAPELEBYONG,AIRABET,AIRABET,520,16,2,7,276,82,383,8,391,0,O-127-202-02-01-01
AMURIA,KAPELEBYONG,KAPELEBYONG,AIRABET,ODIDING,456,11,2,7,220,74,314,8,322,0,O-127-202-02-01-02
AMURIA,KAPELEBYONG,KAPELEBYONG,AMASENIKO,ACUMET (AMASENIKO B),644,21,6,20,198,145,390,19,409,0,O-127-202-02-02-01
AMURIA,KAPELEBYONG,KAPELEBYONG,AMASENIKO,AMASENIKO A,455,10,4,10,241,57,322,23,345,0,O-127-202-02-02-02
AMURIA,KAPELEBYONG,KAPELEBYONG,KAPELEBYONG,KAPELEBYONG,513,10,1,3,193,73,280,16,296,0,O-127-202-02-03-01
AMURIA,KAPELEBYONG,KAPELEBYONG,KAPELEBYONG,ODUKULU PRI. SCHOOL,350,9,5,6,125,106,251,4,255,0,O-127-202-02-03-02
AMURIA,KAPELEBYONG,KAPELEBYONG,KAPELEBYONG,OLOBAI P/SCH,115,1,2,5,61,17,86,2,88,0,O-127-202-02-03-03
AMURIA,KAPELEBYONG,KAPELEBYONG,KAPELEBYONG,OUTSIDE Q. GUARD,434,1,1,0,42,32,76,0,76,0,O-127-202-02-03-04
AMURIA,KAPELEBYONG,KAPELEBYONG,NYADA,MAMBASA II (NYADA II),560,14,2,4,289,41,350,10,360,0,O-127-202-02-04-01
AMURIA,KAPELEBYONG,KAPELEBYONG,NYADA,NAMABASAI I-NYADA I,951,23,7,11,446,147,634,26,660,0,O-127-202-02-04-02
AMURIA,KAPELEBYONG,KAPELEBYONG,OKOBOI,OKOBOI,259,2,2,6,84,94,188,8,196,0,O-127-202-02-05-01
AMURIA,KAPELEBYONG,KAPELEBYONG,OKOBOI,OUTSIDE Q. GUARD,142,1,0,0,29,6,36,0,36,0,O-127-202-02-05-02
AMURIA,KAPELEBYONG,OBALANGA,AGONGA,AGONGA PRIMARY SCHOOL,635,11,4,2,275,79,371,9,380,0,O-127-202-03-01-01
AMURIA,KAPELEBYONG,OBALANGA,AGONGA,AMONI P/S,451,4,2,2,251,40,299,5,304,0,O-127-202-03-01-02
AMURIA,KAPELEBYONG,OBALANGA,ALITO,ALITO A,830,15,2,9,338,71,435,14,449,0,O-127-202-03-02-01
AMURIA,KAPELEBYONG,OBALANGA,ALITO,ALITO B,663,12,4,6,252,34,308,22,330,0,O-127-202-03-02-02
AMURIA,KAPELEBYONG,OBALANGA,ALITO,MATILONG B,289,7,2,0,182,14,205,6,211,0,O-127-202-03-02-03
AMURIA,KAPELEBYONG,OBALANGA,AMOOTOME,AMOOTOME - (APOPONG VILLAGE,468,9,2,5,253,23,292,6,298,0,O-127-202-03-03-01
AMURIA,KAPELEBYONG,OBALANGA,AMOOTOME,AMOOTOME-ORIGINAL,107,4,3,3,43,7,60,9,69,0,O-127-202-03-03-02
AMURIA,KAPELEBYONG,OBALANGA,OBALANGA,AMENANGURA-OKOLAS,381,6,0,3,204,42,255,6,261,0,O-127-202-03-04-01
AMURIA,KAPELEBYONG,OBALANGA,OBALANGA,OBALANGA,755,7,5,4,314,52,382,11,393,0,O-127-202-03-04-02
AMURIA,KAPELEBYONG,OBALANGA,OBALANGA,ANGATUNYU,405,8,1,1,265,13,288,8,296,0,O-127-202-03-04-03
AMURIA,KAPELEBYONG,OBALANGA,OBALANGA,ANGARO TRADING CENTRE,124,4,0,0,60,2,66,1,67,0,O-127-202-03-04-04
AMURIA,KAPELEBYONG,OBALANGA,OPOT,ALUPE BOREHOLE B,541,12,4,4,258,63,341,14,355,0,O-127-202-03-05-01
AMURIA,KAPELEBYONG,OBALANGA,OPOT,APOLOROS CENTRE,583,9,3,0,329,56,397,9,406,0,O-127-202-03-05-02
AMURIA,KAPELEBYONG,OBALANGA,OPOT,OPOT P/SCH,353,2,3,1,202,27,235,7,242,0,O-127-202-03-05-03
APAC,MARUZI COUNTY,AKOKORO,AKOKORO,ALUGA P.7 SCHOOL,529,8,113,3,75,149,348,57,405,0,O-1-3-01-01-01
APAC,MARUZI COUNTY,AKOKORO,AKOKORO,AKOKORO S.S.S.,451,3,90,3,95,94,285,11,296,0,O-1-3-01-01-02
APAC,MARUZI COUNTY,AKOKORO,AKOKORO,LIRA ISLAND,32,0,0,0,0,4,4,0,4,0,O-1-3-01-01-03
APAC,MARUZI COUNTY,AKOKORO,ALARO,WANSOLO FISHING CAMP,328,0,7,1,142,24,174,7,181,0,O-1-3-01-02-01
APAC,MARUZI COUNTY,AKOKORO,ALARO,ALARO P.7 SCHOOL,418,6,96,3,85,39,229,48,277,0,O-1-3-01-02-02
APAC,MARUZI COUNTY,AKOKORO,ALARO,BAROKWORO P.7 SCHOOL,339,4,45,0,85,42,176,42,218,0,O-1-3-01-02-03
APAC,MARUZI COUNTY,AKOKORO,ALARO,KAWEMPE ISLAND,213,2,2,1,32,12,49,1,50,0,O-1-3-01-02-04
APAC,MARUZI COUNTY,AKOKORO,ALARO,KIGA LANDING SITE,164,1,15,2,65,16,99,6,105,0,O-1-3-01-02-05
APAC,MARUZI COUNTY,AKOKORO,AMUN,AMUN P.7 SCHOOL,582,7,60,1,127,145,340,0,340,0,O-1-3-01-03-01
APAC,MARUZI COUNTY,AKOKORO,AMUN,AMUN TRADING CENTER,217,6,29,1,50,52,138,40,178,0,O-1-3-01-03-02
APAC,MARUZI COUNTY,AKOKORO,APOI,ONYANY,317,5,20,2,86,48,161,11,172,0,O-1-3-01-04-01
APAC,MARUZI COUNTY,AKOKORO,APOI,DIPI ISLAND,376,0,1,1,68,9,79,1,80,0,O-1-3-01-04-02
APAC,MARUZI COUNTY,AKOKORO,APOI,APOI P.7 SCHOOL,583,3,61,2,223,50,339,12,351,0,O-1-3-01-04-03
APAC,MARUZI COUNTY,AKOKORO,AWILA,OTWONO-GWEN MARKET,528,5,39,1,123,156,324,40,364,0,O-1-3-01-05-01
APAC,MARUZI COUNTY,AKOKORO,AWILA,ATEK CENTRAL MARKET,657,6,57,2,202,134,401,110,511,0,O-1-3-01-05-02
APAC,MARUZI COUNTY,AKOKORO,AYAGO,OBANGA KURA,632,0,48,3,181,219,451,9,460,0,O-1-3-01-06-01
APAC,MARUZI COUNTY,AKOKORO,AYAGO,ABONGOKONGO P.7 SCHOOL,124,0,4,1,17,67,89,9,98,0,O-1-3-01-06-02
APAC,MARUZI COUNTY,AKOKORO,AYAGO,AYAGO P 7 SCHOOL,395,3,22,0,56,186,267,44,311,0,O-1-3-01-06-03
APAC,MARUZI COUNTY,AKOKORO,AYEOLYEC,KWIBALE P.7 SCHOOL,307,2,23,2,90,43,160,7,167,0,O-1-3-01-07-01
APAC,MARUZI COUNTY,AKOKORO,AYEOLYEC,AYEI A,581,2,5,0,129,59,195,45,240,0,O-1-3-01-07-02
APAC,MARUZI COUNTY,AKOKORO,AYEOLYEC,ZAZAMWANGA ISLAND,412,4,4,0,99,29,136,2,138,0,O-1-3-01-07-03
APAC,MARUZI COUNTY,AKOKORO,AYEOLYEC,AYEI B,359,3,7,3,88,33,134,7,141,0,O-1-3-01-07-04
APAC,MARUZI COUNTY,AKOKORO,AYEOLYEC,KWIBALE MARKET,483,7,14,6,119,116,262,57,319,0,O-1-3-01-07-05
APAC,MARUZI COUNTY,AKOKORO,KUNGU,KUNGU P 7 SCHOOL,630,8,8,7,249,117,389,22,411,0,O-1-3-01-08-01
APAC,MARUZI COUNTY,AKOKORO,KUNGU,ACHOLI INN,357,4,2,0,104,37,147,5,152,0,O-1-3-01-08-02
APAC,MARUZI COUNTY,APAC,ABEDI,ADAG-AYELA,478,10,30,4,268,25,337,13,350,0,O-1-3-02-01-01
APAC,MARUZI COUNTY,APAC,ABEDI,OMER P.7 SCHOOL,346,4,8,2,205,22,241,18,259,0,O-1-3-02-01-02
APAC,MARUZI COUNTY,APAC,ABEDI,WITIM,416,14,35,7,195,54,305,16,321,0,O-1-3-02-01-03
APAC,MARUZI COUNTY,APAC,ABEDI,ACANDYANG CENTRE,503,9,32,4,300,22,367,7,374,0,O-1-3-02-01-04
APAC,MARUZI COUNTY,APAC,ABEDI,ATAR P.7 SCHOOL,470,1,12,4,225,29,271,63,334,0,O-1-3-02-01-05
APAC,MARUZI COUNTY,APAC,ABEDI,AKWALKWALA TRADING CENTER,225,5,6,3,152,10,176,5,181,0,O-1-3-02-01-06
APAC,MARUZI COUNTY,APAC,AKERE,ATUDU P7 SCHOOL,460,9,19,8,187,57,280,16,296,0,O-1-3-02-02-01
APAC,MARUZI COUNTY,APAC,AKERE,TE - IBUK P A G CHURCH,544,4,29,7,272,57,369,12,381,0,O-1-3-02-02-02
APAC,MARUZI COUNTY,APAC,AKERE,OLEL PEK P 7   SCHOOL,647,4,53,7,203,150,417,41,458,0,O-1-3-02-02-03
APAC,MARUZI COUNTY,APAC,AKERE,OGEI BOREHOLE,136,1,4,0,46,20,71,12,83,0,O-1-3-02-02-04
APAC,MARUZI COUNTY,APAC,ATANA,AWIR P.7 SCHOOL,642,4,41,2,329,36,412,32,444,0,O-1-3-02-03-01
APAC,MARUZI COUNTY,APAC,ATANA,ODOKOMAC P. SCHOOL,413,8,15,10,225,37,295,11,306,0,O-1-3-02-03-02
APAC,MARUZI COUNTY,APAC,ATANA,AYOM JERI P. SCHOOL,445,5,28,2,185,26,246,60,306,0,O-1-3-02-03-03
APAC,MARUZI COUNTY,APAC,ATANA,ABULI MARKET,732,9,80,5,320,92,506,7,513,0,O-1-3-02-03-04
APAC,MARUZI COUNTY,APAC,ATANA,OMUKOWIE T.C,322,5,27,0,166,29,227,22,249,0,O-1-3-02-03-05
APAC,MARUZI COUNTY,APAC,ATIK,OWANG,692,9,28,6,343,86,472,10,482,0,O-1-3-02-04-01
APAC,MARUZI COUNTY,APAC,ATIK,BARDEK,532,14,22,10,266,53,365,16,381,0,O-1-3-02-04-02
APAC,MARUZI COUNTY,APAC,ATIK,MATIMI AMOR,407,5,17,2,252,28,304,7,311,0,O-1-3-02-04-03
APAC,MARUZI COUNTY,APAC,ATIK,AWIRI,447,5,35,4,204,38,286,14,300,0,O-1-3-02-04-04
APAC,MARUZI COUNTY,APAC,ATIK,AWIRI PRI. SCHOOL,413,6,39,2,215,28,290,0,290,0,O-1-3-02-04-05
APAC,MARUZI COUNTY,APAC,ATOPI,ATOPI P7 SCHOOL,720,7,63,11,327,73,481,12,493,0,O-1-3-02-05-01
APAC,MARUZI COUNTY,APAC,ATOPI,ALAYEC MARKET,426,1,21,2,171,27,222,60,282,0,O-1-3-02-05-02
APAC,MARUZI COUNTY,APAC,ATOPI,ANYAI MARKET,453,10,35,5,221,35,306,8,314,0,O-1-3-02-05-03
APAC,MARUZI COUNTY,APAC,ATOPI,AYERA BOREHOLE,264,4,13,5,133,16,171,16,187,0,O-1-3-02-05-04
APAC,MARUZI COUNTY,APAC TOWN COUNCIL,EASTERN WARD,AGULU MARKET,778,4,45,3,243,108,403,120,523,0,O-1-3-03-01-01
APAC,MARUZI COUNTY,APAC TOWN COUNCIL,EASTERN WARD,UPPER CENTRE,519,4,31,4,205,85,329,6,335,0,O-1-3-03-01-02
APAC,MARUZI COUNTY,APAC TOWN COUNCIL,EASTERN WARD,APAC MODEL P.7,584,2,49,3,224,81,359,16,375,0,O-1-3-03-01-03
APAC,MARUZI COUNTY,APAC TOWN COUNCIL,WESTERN WARD,AROCHA P.7 SCHOOL,858,10,58,8,399,98,573,10,583,0,O-1-3-03-02-01
APAC,MARUZI COUNTY,APAC TOWN COUNCIL,WESTERN WARD,APAC P.7 SCHOOL,496,3,40,0,196,58,297,0,297,0,O-1-3-03-02-02
APAC,MARUZI COUNTY,APAC TOWN COUNCIL,WESTERN WARD,TEMOGO,608,2,33,1,215,75,326,8,334,0,O-1-3-03-02-03
APAC,MARUZI COUNTY,APAC TOWN COUNCIL,WESTERN WARD,TUNG-ODYEK,532,2,30,1,208,58,299,8,307,0,O-1-3-03-02-04
APAC,MARUZI COUNTY,APAC TOWN COUNCIL,WESTERN WARD,BARODONG,351,1,22,3,139,40,205,0,205,0,O-1-3-03-02-05
APAC,MARUZI COUNTY,CHEGERE,ATIGOLWOK,AJALIA MARKET,721,5,43,4,270,70,392,73,465,0,O-1-3-04-01-01
APAC,MARUZI COUNTY,CHEGERE,ATIGOLWOK,ATIGOLWOK P.7 SCHOOL,566,5,28,3,224,57,317,55,372,0,O-1-3-04-01-02
APAC,MARUZI COUNTY,CHEGERE,ATIGOLWOK,TE-ITEK TUNGO OBIL,462,6,17,6,246,53,328,5,333,0,O-1-3-04-01-03
APAC,MARUZI COUNTY,CHEGERE,BARODILO,OKUTAGWE P.7 SCHOOL,265,10,14,12,88,34,158,5,163,0,O-1-3-04-02-01
APAC,MARUZI COUNTY,CHEGERE,BARODILO,OLOLANGO P.7 SCHOOL,638,6,41,5,315,34,401,23,424,0,O-1-3-04-02-02
APAC,MARUZI COUNTY,CHEGERE,BARODILO,BARODILO P.7 SCHOOL,483,5,16,2,181,46,250,64,314,0,O-1-3-04-02-03
APAC,MARUZI COUNTY,CHEGERE,CHEGERE,ADEM P.7 SCHOOL,564,4,22,3,220,70,319,109,428,0,O-1-3-04-03-01
APAC,MARUZI COUNTY,CHEGERE,CHEGERE,CHEGERE P.7 SCHOOL,614,1,20,1,275,107,404,44,448,0,O-1-3-04-03-02
APAC,MARUZI COUNTY,CHEGERE,CHEGERE,ABUTABER P.7 SCHOOL,656,8,54,1,304,83,450,35,485,0,O-1-3-04-03-03
APAC,MARUZI COUNTY,CHEGERE,ILEE,BARDYANG,312,3,18,1,113,62,197,56,253,0,O-1-3-04-04-01
APAC,MARUZI COUNTY,CHEGERE,ILEE,ILEE P 7   SCHOOL,458,0,59,1,202,48,310,50,360,0,O-1-3-04-04-02
APAC,MARUZI COUNTY,CHEGERE,KIDILANI,KIDILANI P.7 SCHOOL,479,3,50,0,209,49,311,37,348,0,O-1-3-04-05-01
APAC,MARUZI COUNTY,CHEGERE,KIDILANI,ADIR P 7   SCHOOL,615,13,31,5,242,61,352,111,463,0,O-1-3-04-05-02
APAC,MARUZI COUNTY,CHEGERE,TEBOKE,TEBOKE P.7 SCHOOL,532,4,44,2,228,61,339,61,400,0,O-1-3-04-06-01
APAC,MARUZI COUNTY,CHEGERE,TEBOKE,ABOLO P7,397,8,15,2,209,29,263,53,316,0,O-1-3-04-06-02
APAC,MARUZI COUNTY,CHEGERE,TEBOKE,AGONG TRADING CENTRE,515,3,28,2,285,21,339,54,393,0,O-1-3-04-06-03
APAC,MARUZI COUNTY,IBUJE,AGANGA,ALWALA,389,1,5,2,190,38,236,50,286,0,O-1-3-05-01-01
APAC,MARUZI COUNTY,IBUJE,AGANGA,AGANGA,297,2,14,0,69,93,178,41,219,0,O-1-3-05-01-02
APAC,MARUZI COUNTY,IBUJE,AGANGA,WAITUMBA MARKET,189,1,3,0,77,33,114,20,134,0,O-1-3-05-01-03
APAC,MARUZI COUNTY,IBUJE,AGANGA,IGOTI,325,1,9,1,165,55,231,29,260,0,O-1-3-05-01-04
APAC,MARUZI COUNTY,IBUJE,AKETO,OMULU AKERE OJAA,325,8,22,2,126,83,241,5,246,0,O-1-3-05-02-01
APAC,MARUZI COUNTY,IBUJE,AKETO,LANGODYANG,477,12,17,1,168,109,307,49,356,0,O-1-3-05-02-02
APAC,MARUZI COUNTY,IBUJE,AKETO,GINERY,423,4,15,1,102,197,319,11,330,0,O-1-3-05-02-03
APAC,MARUZI COUNTY,IBUJE,AKETO,OJAA,472,4,11,2,173,99,289,67,356,0,O-1-3-05-02-04
APAC,MARUZI COUNTY,IBUJE,ALWOROCENG,ALEK-OLIL P.7 SCHOOL,502,6,23,2,206,89,326,170,496,0,O-1-3-05-03-01
APAC,MARUZI COUNTY,IBUJE,ALWOROCENG,APELE P.7 SCHOOL,374,1,19,0,145,72,237,74,311,0,O-1-3-05-03-02
APAC,MARUZI COUNTY,IBUJE,ALWOROCENG,ALWOROCENG P.7 SCHOOL,451,3,7,5,167,61,243,95,338,0,O-1-3-05-03-03
APAC,MARUZI COUNTY,IBUJE,ALWOROCENG,AJODYEK TRADING CENTER,162,0,7,1,46,39,93,27,120,0,O-1-3-05-03-04
APAC,MARUZI COUNTY,IBUJE,ALWOROCENG,AMIA MOLA TRADING CENTER,230,2,11,2,112,31,158,27,185,0,O-1-3-05-03-05
APAC,MARUZI COUNTY,IBUJE,AMII,IBUJE SUB-COUNTY HQRS,668,3,36,2,218,163,422,49,471,0,O-1-3-05-04-01
APAC,MARUZI COUNTY,IBUJE,AMII,ALADO AID POST,399,5,20,2,106,116,249,48,297,0,O-1-3-05-04-02
APAC,MARUZI COUNTY,IBUJE,AMILO,APALAMIO,339,4,16,5,183,21,229,12,241,0,O-1-3-05-05-01
APAC,MARUZI COUNTY,IBUJE,AMILO,AMILO P7 SCHOOL,675,4,25,1,362,79,471,32,503,0,O-1-3-05-05-02
APAC,MARUZI COUNTY,IBUJE,AMILO,AMOCAL P.7 SCHOOL,593,7,34,4,308,40,393,16,409,0,O-1-3-05-05-03
APAC,MARUZI COUNTY,IBUJE,AMILO,AMII CENTER,368,5,20,2,169,71,267,14,281,0,O-1-3-05-05-04
APAC,MARUZI COUNTY,IBUJE,TAROGALI,CHAKALI P.7,584,5,33,2,279,91,410,10,420,0,O-1-3-05-06-01
APAC,MARUZI COUNTY,IBUJE,TAROGALI,ALENGA P.7 SCHOOL,546,1,29,1,258,76,365,52,417,0,O-1-3-05-06-02
APAC,MARUZI COUNTY,IBUJE,TAROGALI,TAROGALI TRADING CENTER,474,0,25,1,207,98,331,39,370,0,O-1-3-05-06-03
ARUA,ARUA MUNICIPALITY,ARUA HILL,AWINDIRI,NSAMBYA A (A-J),1463,4,9,3,517,155,688,11,699,0,O-2-13-01-01-01
ARUA,ARUA MUNICIPALITY,ARUA HILL,AWINDIRI,NSAMBYA B (K-Z),1061,1,8,0,388,125,522,31,553,0,O-2-13-01-01-02
ARUA,ARUA MUNICIPALITY,ARUA HILL,AWINDIRI,NSAMBYA/NIVA C (AA-AL),349,2,2,1,131,37,173,7,180,0,O-2-13-01-01-03
ARUA,ARUA MUNICIPALITY,ARUA HILL,AWINDIRI,NSAMBYA/NIVA D (AM-AZ),401,1,0,0,162,69,232,2,234,0,O-2-13-01-01-04
ARUA,ARUA MUNICIPALITY,ARUA HILL,AWINDIRI,NSAMBYA/NIVA E (B-E),426,2,0,0,156,48,206,13,219,0,O-2-13-01-01-05
ARUA,ARUA MUNICIPALITY,ARUA HILL,AWINDIRI,NSAMBYA/NIVA F (F-N),385,1,2,0,128,73,204,8,212,0,O-2-13-01-01-06
ARUA,ARUA MUNICIPALITY,ARUA HILL,AWINDIRI,NSAMBYA/NIVA G (O-Z),523,0,2,1,201,81,285,9,294,0,O-2-13-01-01-07
ARUA,ARUA MUNICIPALITY,ARUA HILL,AWINDIRI,DRAJINI/WINDRI OUTSIDE Q.GUA,850,1,3,1,181,104,290,22,312,0,O-2-13-01-01-08
ARUA,ARUA MUNICIPALITY,ARUA HILL,BASAAR,BASAAR EAST/POLICE GROUND A,442,1,2,0,166,47,216,5,221,0,O-2-13-01-02-01
ARUA,ARUA MUNICIPALITY,ARUA HILL,BASAAR,ARUA PUBLIC A (A-A),961,0,3,0,388,111,502,14,516,0,O-2-13-01-02-02
ARUA,ARUA MUNICIPALITY,ARUA HILL,BASAAR,ARUA PUBLIC B (B-Z),372,0,1,0,115,51,167,21,188,0,O-2-13-01-02-03
ARUA,ARUA MUNICIPALITY,ARUA HILL,BASAAR,BASAAR EAST/POLICE GROUND B,546,1,0,0,203,74,278,11,289,0,O-2-13-01-02-04
ARUA,ARUA MUNICIPALITY,ARUA HILL,BASAAR,ARUA PUBLIC C (A-L),520,2,0,0,182,78,262,9,271,0,O-2-13-01-02-05
ARUA,ARUA MUNICIPALITY,ARUA HILL,BASAAR,BASAAR EAST/POLICE GROUND A,563,0,2,0,200,54,256,6,262,0,O-2-13-01-02-06
ARUA,ARUA MUNICIPALITY,ARUA HILL,BASAAR,BASAAR EAST/POLICE GROUND B,511,2,3,0,171,73,249,3,252,0,O-2-13-01-02-07
ARUA,ARUA MUNICIPALITY,ARUA HILL,BASAAR,ARUA PUBLIC D (M-Z),834,2,2,0,287,153,444,16,460,0,O-2-13-01-02-08
ARUA,ARUA MUNICIPALITY,ARUA HILL,BASAAR,BASAAR EAST/POLICE GROUND C,517,0,0,0,193,54,247,10,257,0,O-2-13-01-02-09
ARUA,ARUA MUNICIPALITY,ARUA HILL,MVARA,MVARA A (A-A),926,2,6,1,412,122,543,17,560,0,O-2-13-01-03-01
ARUA,ARUA MUNICIPALITY,ARUA HILL,MVARA,ANYAFIO A (A-A),717,2,2,1,271,100,376,5,381,0,O-2-13-01-03-02
ARUA,ARUA MUNICIPALITY,ARUA HILL,MVARA,MVARA B (B-L),684,1,5,0,286,136,428,21,449,0,O-2-13-01-03-03
ARUA,ARUA MUNICIPALITY,ARUA HILL,MVARA,ANYAFIO B (B-L),551,1,2,1,187,93,284,4,288,0,O-2-13-01-03-04
ARUA,ARUA MUNICIPALITY,ARUA HILL,MVARA,MVARA C (M-Z)),691,1,1,0,309,104,415,10,425,0,O-2-13-01-03-05
ARUA,ARUA MUNICIPALITY,ARUA HILL,MVARA,ANYAFIO C (M-Z),542,2,3,1,199,79,284,3,287,0,O-2-13-01-03-06
ARUA,ARUA MUNICIPALITY,OLI RIVER,KENYA,KEBIRI A (A-L),778,2,3,1,320,101,427,23,450,0,O-2-13-02-01-01
ARUA,ARUA MUNICIPALITY,OLI RIVER,KENYA,LUMUMBA  A,816,3,2,3,300,128,436,18,454,0,O-2-13-02-01-02
ARUA,ARUA MUNICIPALITY,OLI RIVER,KENYA,LUMUMBA (A-L),600,2,2,2,219,103,328,16,344,0,O-2-13-02-01-03
ARUA,ARUA MUNICIPALITY,OLI RIVER,KENYA,KEBIRI B (A-L),669,2,2,2,286,105,397,23,420,0,O-2-13-02-01-04
ARUA,ARUA MUNICIPALITY,OLI RIVER,KENYA,KEBIRI C (A-L),688,6,2,3,280,90,381,22,403,0,O-2-13-02-01-05
ARUA,ARUA MUNICIPALITY,OLI RIVER,KENYA,KEBIRI A (M-Z),391,2,0,1,172,56,231,17,248,0,O-2-13-02-01-06
ARUA,ARUA MUNICIPALITY,OLI RIVER,KENYA,LUMUMBA (M-Z),277,0,0,1,97,55,153,2,155,0,O-2-13-02-01-07
ARUA,ARUA MUNICIPALITY,OLI RIVER,KENYA,KEBIRI B (M-Z),332,1,3,0,145,44,193,17,210,0,O-2-13-02-01-08
ARUA,ARUA MUNICIPALITY,OLI RIVER,KENYA,KEBIRI (M-Z),368,0,2,0,137,44,183,8,191,0,O-2-13-02-01-09
ARUA,ARUA MUNICIPALITY,OLI RIVER,PANGISA,BARUKU A (A-C),329,3,1,1,165,54,224,7,231,0,O-2-13-02-02-01
ARUA,ARUA MUNICIPALITY,OLI RIVER,PANGISA,BARUKU B (A-C),423,3,3,2,194,56,258,4,262,0,O-2-13-02-02-02
ARUA,ARUA MUNICIPALITY,OLI RIVER,PANGISA,BARUKU C,400,3,2,0,160,43,208,14,222,0,O-2-13-02-02-03
ARUA,ARUA MUNICIPALITY,OLI RIVER,PANGISA,BARUKU D,688,2,2,0,326,115,445,16,461,0,O-2-13-02-02-04
ARUA,ARUA MUNICIPALITY,OLI RIVER,PANGISA,BIBIA A (A-C),434,3,1,0,167,55,226,5,231,0,O-2-13-02-02-05
ARUA,ARUA MUNICIPALITY,OLI RIVER,PANGISA,BIBIA B (A-C),507,3,1,0,231,74,309,13,322,0,O-2-13-02-02-06
ARUA,ARUA MUNICIPALITY,OLI RIVER,PANGISA,BIBIA C,918,2,3,2,321,128,456,9,465,0,O-2-13-02-02-07
ARUA,ARUA MUNICIPALITY,OLI RIVER,PANGISA,BARUKU A (D-Z),420,2,2,3,201,62,270,8,278,0,O-2-13-02-02-08
ARUA,ARUA MUNICIPALITY,OLI RIVER,PANGISA,BARUKU B (D-Z),559,3,1,1,256,95,356,12,368,0,O-2-13-02-02-09
ARUA,ARUA MUNICIPALITY,OLI RIVER,PANGISA,BIBIA A (D-Z),547,3,1,2,166,66,238,12,250,0,O-2-13-02-02-10
ARUA,ARUA MUNICIPALITY,OLI RIVER,PANGISA,BIBIA B (D-Z),671,1,5,2,271,114,393,17,410,0,O-2-13-02-02-11
ARUA,ARUA MUNICIPALITY,OLI RIVER,TANGANYIKA,OBOLOKOFUKO A,553,2,4,0,193,89,288,14,302,0,O-2-13-02-03-01
ARUA,ARUA MUNICIPALITY,OLI RIVER,TANGANYIKA,OLI PARENTS P/S A (D-Z),664,7,3,1,264,86,361,9,370,0,O-2-13-02-03-02
ARUA,ARUA MUNICIPALITY,OLI RIVER,TANGANYIKA,OLI PARENTS P/S A (A-C),529,2,1,0,219,72,294,17,311,0,O-2-13-02-03-03
ARUA,ARUA MUNICIPALITY,OLI RIVER,TANGANYIKA,OLI PARENTS P/S B (A-C),516,2,1,2,225,92,322,5,327,0,O-2-13-02-03-04
ARUA,ARUA MUNICIPALITY,OLI RIVER,TANGANYIKA,OLI PARENTS P/S C (A-C),526,0,1,2,219,72,294,12,306,0,O-2-13-02-03-05
ARUA,ARUA MUNICIPALITY,OLI RIVER,TANGANYIKA,OBOLOKOFUKO A,620,0,4,0,221,138,363,28,391,0,O-2-13-02-03-06
ARUA,ARUA MUNICIPALITY,OLI RIVER,TANGANYIKA,OBOLOKOFUKO B,759,2,1,2,250,143,398,20,418,0,O-2-13-02-03-07
ARUA,ARUA MUNICIPALITY,OLI RIVER,TANGANYIKA,OLI PARENTS P/S B (D-Z),695,4,2,2,293,105,406,15,421,0,O-2-13-02-03-08
ARUA,ARUA MUNICIPALITY,OLI RIVER,TANGANYIKA,OLI PARENTS P/S C (D-Z),712,4,1,2,289,111,407,12,419,0,O-2-13-02-03-09
ARUA,AYIVU COUNTY,ADUMI,ANYARA,KIGO,833,10,12,25,189,383,619,31,650,0,O-2-7-01-01-01
ARUA,AYIVU COUNTY,ADUMI,ANYARA,COPE CENTRE,322,6,3,9,71,140,229,30,259,0,O-2-7-01-01-02
ARUA,AYIVU COUNTY,ADUMI,ANZU,KULIRI,360,5,4,14,57,163,243,22,265,0,O-2-7-01-02-01
ARUA,AYIVU COUNTY,ADUMI,ANZU,AYIVUNI,572,10,7,8,126,225,376,33,409,0,O-2-7-01-02-02
ARUA,AYIVU COUNTY,ADUMI,ANZU,KIJORO ODRUA,331,7,1,4,81,150,243,7,250,0,O-2-7-01-02-03
ARUA,AYIVU COUNTY,ADUMI,ANZU,ABIRIA (A-J),682,5,5,5,115,293,423,18,441,0,O-2-7-01-02-04
ARUA,AYIVU COUNTY,ADUMI,ANZU,ABIRIA (K-Z),308,4,4,7,60,150,225,16,241,0,O-2-7-01-02-05
ARUA,AYIVU COUNTY,ADUMI,KATI,KOVA,357,4,2,3,158,78,245,13,258,0,O-2-7-01-03-01
ARUA,AYIVU COUNTY,ADUMI,KATI,OZU,523,9,4,5,228,102,348,33,381,0,O-2-7-01-03-02
ARUA,AYIVU COUNTY,ADUMI,KATI,OUKO CUU,608,2,4,8,317,86,417,21,438,0,O-2-7-01-03-03
ARUA,AYIVU COUNTY,ADUMI,KUBO,ODRAMACAKU,679,5,3,13,146,172,339,23,362,0,O-2-7-01-04-01
ARUA,AYIVU COUNTY,ADUMI,MBARAKA,MALUKU,499,7,5,11,89,245,357,20,377,0,O-2-7-01-05-01
ARUA,AYIVU COUNTY,ADUMI,MBARAKA,BARIZE,294,7,4,2,68,124,205,31,236,0,O-2-7-01-05-02
ARUA,AYIVU COUNTY,ADUMI,MBARAKA,ANZU,712,10,4,11,115,315,455,63,518,0,O-2-7-01-05-03
ARUA,AYIVU COUNTY,ADUMI,MITE,OLEDRI,636,6,8,11,94,326,445,29,474,0,O-2-7-01-06-01
ARUA,AYIVU COUNTY,ADUMI,MITE,LIA,933,7,8,15,196,348,574,37,611,0,O-2-7-01-06-02
ARUA,AYIVU COUNTY,ADUMI,MITE,PANDURU,224,2,2,7,32,130,173,9,182,0,O-2-7-01-06-03
ARUA,AYIVU COUNTY,ADUMI,NYIOVURA,ARIPEZU,624,17,13,14,142,258,444,42,486,0,O-2-7-01-07-01
ARUA,AYIVU COUNTY,ADUMI,NYIOVURA,EWANYAPA,550,18,10,9,120,261,418,23,441,0,O-2-7-01-07-02
ARUA,AYIVU COUNTY,ADUMI,NYIOVURA,LUKUWIRI,752,8,10,22,186,287,513,57,570,0,O-2-7-01-07-03
ARUA,AYIVU COUNTY,ADUMI,NYIOVURA,DRICIRI,579,8,12,7,230,181,438,33,471,0,O-2-7-01-07-04
ARUA,AYIVU COUNTY,ADUMI,OLEVU,EDRONI,582,4,7,8,183,244,446,27,473,0,O-2-7-01-08-01
ARUA,AYIVU COUNTY,ADUMI,OLEVU,OMOO,466,5,5,6,268,71,355,12,367,0,O-2-7-01-08-02
ARUA,AYIVU COUNTY,ADUMI,OLEVU,OPERE,333,3,5,7,154,83,252,7,259,0,O-2-7-01-08-03
ARUA,AYIVU COUNTY,ADUMI,OMBACHI,ETOCAKA,385,7,0,4,69,184,264,21,285,0,O-2-7-01-09-01
ARUA,AYIVU COUNTY,ADUMI,OMBACHI,ORIA,675,8,3,5,322,163,501,25,526,0,O-2-7-01-09-02
ARUA,AYIVU COUNTY,ADUMI,OMBACHI,KATIKU,345,6,0,1,131,106,244,12,256,0,O-2-7-01-09-03
ARUA,AYIVU COUNTY,AROI,ALIBA,Mori A,845,10,5,5,259,92,371,33,404,0,O-2-7-02-01-01
ARUA,AYIVU COUNTY,AROI,ALIBA,MORI B,505,19,4,4,202,75,304,25,329,0,O-2-7-02-01-02
ARUA,AYIVU COUNTY,AROI,ALIVU,ALARAVA A,673,13,6,11,330,93,453,15,468,0,O-2-7-02-02-01
ARUA,AYIVU COUNTY,AROI,ALIVU,ALARAVA B,699,6,3,6,343,117,475,17,492,0,O-2-7-02-02-02
ARUA,AYIVU COUNTY,AROI,BURA,MARACHA,724,19,8,7,261,181,476,15,491,0,O-2-7-02-03-01
ARUA,AYIVU COUNTY,AROI,BURA,ARARA,598,7,2,5,245,114,373,55,428,0,O-2-7-02-03-02
ARUA,AYIVU COUNTY,AROI,KAMULE,KAMULE,798,14,7,12,357,135,525,20,545,0,O-2-7-02-04-01
ARUA,AYIVU COUNTY,AROI,MICU,MINYAKO,841,15,8,10,375,157,565,42,607,0,O-2-7-02-05-01
ARUA,AYIVU COUNTY,AROI,MICU,MINYAKO/NYAI,896,9,8,2,354,163,536,18,554,0,O-2-7-02-05-02
ARUA,AYIVU COUNTY,AROI,ROBU,ROBU A,673,10,2,6,314,99,431,15,446,0,O-2-7-02-06-01
ARUA,AYIVU COUNTY,AROI,ROBU,ROBU B,467,4,3,1,210,83,301,21,322,0,O-2-7-02-06-02
ARUA,AYIVU COUNTY,DADAMU,ARIVU,ARIVU A,404,10,2,0,148,122,282,37,319,0,O-2-7-03-01-01
ARUA,AYIVU COUNTY,DADAMU,ARIVU,ARIVUB,326,2,0,0,147,66,215,14,229,0,O-2-7-03-01-02
ARUA,AYIVU COUNTY,DADAMU,ARIVU,OLI A,345,6,1,1,140,93,241,16,257,0,O-2-7-03-01-03
ARUA,AYIVU COUNTY,DADAMU,ARIVU,OLI B,322,4,1,2,123,55,185,12,197,0,O-2-7-03-01-04
ARUA,AYIVU COUNTY,DADAMU,ARIWALA,ARIWARA A,1047,5,4,7,355,266,637,24,661,0,O-2-7-03-02-01
ARUA,AYIVU COUNTY,DADAMU,ARIWALA,ARIWARA B,410,2,3,0,150,119,274,9,283,0,O-2-7-03-02-02
ARUA,AYIVU COUNTY,DADAMU,LUVU,LUVU A,470,10,11,9,181,121,332,30,362,0,O-2-7-03-03-01
ARUA,AYIVU COUNTY,DADAMU,LUVU,LUVU B,404,11,5,3,150,120,289,29,318,0,O-2-7-03-03-02
ARUA,AYIVU COUNTY,DADAMU,ODRAVU,ODRAVU A,399,12,1,3,161,85,262,29,291,0,O-2-7-03-04-01
ARUA,AYIVU COUNTY,DADAMU,ODRAVU,ODRAVU B,793,29,18,9,402,104,562,19,581,0,O-2-7-03-04-02
ARUA,AYIVU COUNTY,DADAMU,ODULUBA,ODULUBA A,476,7,7,2,152,92,260,13,273,0,O-2-7-03-05-01
ARUA,AYIVU COUNTY,DADAMU,ODULUBA,ODULUBA B,523,3,4,9,178,129,323,13,336,0,O-2-7-03-05-02
ARUA,AYIVU COUNTY,DADAMU,TANGANYIKA,KOMENDAKU,216,2,1,0,113,18,134,9,143,0,O-2-7-03-06-01
ARUA,AYIVU COUNTY,DADAMU,TANGANYIKA,TANGANYIKA,854,5,2,2,419,103,531,30,561,0,O-2-7-03-06-02
ARUA,AYIVU COUNTY,DADAMU,YAPI,YAPI A,582,8,2,7,297,91,405,29,434,0,O-2-7-03-07-01
ARUA,AYIVU COUNTY,DADAMU,YAPI,YAPI B,354,1,4,4,175,81,265,14,279,0,O-2-7-03-07-02
ARUA,AYIVU COUNTY,MANIBE,ELEKU,OCOPI,590,14,7,7,320,85,433,21,454,0,O-2-7-04-01-01
ARUA,AYIVU COUNTY,MANIBE,ELEKU,ODRAVU,781,12,3,8,386,118,527,36,563,0,O-2-7-04-01-02
ARUA,AYIVU COUNTY,MANIBE,EWADRI,ARIEPI B,437,6,1,7,210,76,300,32,332,0,O-2-7-04-02-01
ARUA,AYIVU COUNTY,MANIBE,EWADRI,ARIEPI A,732,5,5,4,399,90,503,23,526,0,O-2-7-04-02-02
ARUA,AYIVU COUNTY,MANIBE,LUFE,MINGORO,703,10,6,12,303,73,404,27,431,0,O-2-7-04-03-01
ARUA,AYIVU COUNTY,MANIBE,LUFE,RIGBO,783,15,13,12,353,112,505,22,527,0,O-2-7-04-03-02
ARUA,AYIVU COUNTY,MANIBE,ODRAVU,ODRAVU A,589,11,2,8,324,81,426,22,448,0,O-2-7-04-04-01
ARUA,AYIVU COUNTY,MANIBE,ODRAVU,ODRAVU B,431,10,4,7,221,70,312,9,321,0,O-2-7-04-04-02
ARUA,AYIVU COUNTY,MANIBE,OMBACHI,VURA (A-D),471,9,2,6,188,123,328,9,337,0,O-2-7-04-05-01
ARUA,AYIVU COUNTY,MANIBE,OMBACHI,VURA (E-Z),467,13,3,6,176,135,333,7,340,0,O-2-7-04-05-02
ARUA,AYIVU COUNTY,MANIBE,OMBOKORO,OMBOKORO,628,12,4,5,259,116,396,27,423,0,O-2-7-04-06-01
ARUA,AYIVU COUNTY,MANIBE,OMBOKORO,OMBOKORO/VURA,679,2,0,5,290,128,425,13,438,0,O-2-7-04-06-02
ARUA,AYIVU COUNTY,MANIBE,OREKU,ANDRUVU A,579,7,4,4,312,61,388,15,403,0,O-2-7-04-07-01
ARUA,AYIVU COUNTY,MANIBE,OREKU,ANDRUVU B,715,0,4,5,301,150,460,26,486,0,O-2-7-04-07-02
ARUA,AYIVU COUNTY,MANIBE,ROBU,ROBU,784,12,4,13,295,168,492,21,513,0,O-2-7-04-08-01
ARUA,AYIVU COUNTY,OLUKO,AMBEKO,AMBEKO,605,7,9,3,271,132,422,2,424,0,O-2-7-05-01-01
ARUA,AYIVU COUNTY,OLUKO,ANIPI,ANIPI,778,16,7,5,320,129,477,69,546,0,O-2-7-05-02-01
ARUA,AYIVU COUNTY,OLUKO,BUNYU,BUNYU,570,6,3,6,218,158,391,7,398,0,O-2-7-05-03-01
ARUA,AYIVU COUNTY,OLUKO,NYIO,NYIO A (A-C),625,2,7,1,165,184,359,33,392,0,O-2-7-05-04-01
ARUA,AYIVU COUNTY,OLUKO,NYIO,MUNI B,364,5,4,4,109,116,238,19,257,0,O-2-7-05-04-02
ARUA,AYIVU COUNTY,OLUKO,NYIO,NYIO A (D-Z),401,4,3,0,98,145,250,14,264,0,O-2-7-05-04-03
ARUA,AYIVU COUNTY,OLUKO,OMBOKORO,OMBOKORO A,599,8,6,6,185,161,366,24,390,0,O-2-7-05-05-01
ARUA,AYIVU COUNTY,OLUKO,OMBOKORO,OMBOKORO B,351,10,6,2,124,75,217,14,231,0,O-2-7-05-05-02
ARUA,AYIVU COUNTY,OLUKO,ONZIVU,ABIRICI,541,2,7,1,245,95,350,14,364,0,O-2-7-05-06-01
ARUA,AYIVU COUNTY,OLUKO,ONZIVU,ONZIVU A (A-L),773,2,3,0,259,65,329,86,415,0,O-2-7-05-06-02
ARUA,AYIVU COUNTY,OLUKO,ONZIVU,ONZIVU A (M-Z),306,0,3,0,109,52,164,10,174,0,O-2-7-05-06-03
ARUA,AYIVU COUNTY,OLUKO,TURU,TURU,713,13,2,9,267,121,412,0,412,0,O-2-7-05-07-01
ARUA,AYIVU COUNTY,OLUKO,TURU,WANDI/TURU,253,5,4,7,93,59,168,5,173,0,O-2-7-05-07-02
ARUA,AYIVU COUNTY,OLUKO,WANDI,WANDI,601,9,10,4,193,158,374,42,416,0,O-2-7-05-08-01
ARUA,AYIVU COUNTY,OLUKO,YABIAVOKO,YABIA VOKO   A,937,10,5,15,302,296,628,44,672,0,O-2-7-05-09-01
ARUA,AYIVU COUNTY,OLUKO,YABIAVOKO,YABIA VOKO   B,399,4,2,3,132,111,252,43,295,0,O-2-7-05-09-02
ARUA,AYIVU COUNTY,PAJULU,ADALAFU,OKALIBA (A-D),657,1,4,2,282,125,414,31,445,0,O-2-7-06-01-01
ARUA,AYIVU COUNTY,PAJULU,ADALAFU,OMBOKORO (A-D),561,0,1,1,248,82,332,16,348,0,O-2-7-06-01-02
ARUA,AYIVU COUNTY,PAJULU,ADALAFU,OKALIBA (E-Z),304,1,1,2,114,71,189,15,204,0,O-2-7-06-01-03
ARUA,AYIVU COUNTY,PAJULU,ADALAFU,OMBOKORO (E-Z),456,2,2,2,180,71,257,21,278,0,O-2-7-06-01-04
ARUA,AYIVU COUNTY,PAJULU,ALIVU,ALIVU A,663,5,0,4,211,133,353,107,460,0,O-2-7-06-02-01
ARUA,AYIVU COUNTY,PAJULU,ALIVU,ALIVU B,671,4,2,8,266,154,434,39,473,0,O-2-7-06-02-02
ARUA,AYIVU COUNTY,PAJULU,DRIWALA,ALIVU,945,7,5,4,219,164,399,156,555,0,O-2-7-06-03-01
ARUA,AYIVU COUNTY,PAJULU,DRIWALA,ALIVU/JIAKO,389,7,5,4,165,81,262,11,273,0,O-2-7-06-03-02
ARUA,AYIVU COUNTY,PAJULU,ETORI,EGOO,719,6,12,11,218,294,541,17,558,0,O-2-7-06-04-01
ARUA,AYIVU COUNTY,PAJULU,ETORI,OMOO,589,8,9,10,142,242,411,25,436,0,O-2-7-06-04-02
ARUA,AYIVU COUNTY,PAJULU,KOMITE,KOMITE A,699,5,5,4,216,234,464,38,502,0,O-2-7-06-05-01
ARUA,AYIVU COUNTY,PAJULU,KOMITE,KOMITE B,598,1,0,4,195,205,405,35,440,0,O-2-7-06-05-02
ARUA,AYIVU COUNTY,PAJULU,NYARACU,NYARACU,514,6,7,8,182,218,421,5,426,0,O-2-7-06-06-01
ARUA,AYIVU COUNTY,PAJULU,ORUGBO,NUNU,582,7,4,5,120,245,381,16,397,0,O-2-7-06-07-01
ARUA,AYIVU COUNTY,PAJULU,ORUGBO,OMI,529,4,4,7,109,222,346,16,362,0,O-2-7-06-07-02
ARUA,AYIVU COUNTY,PAJULU,POKEA,POKEA  A,947,6,8,8,378,206,606,15,621,0,O-2-7-06-08-01
ARUA,AYIVU COUNTY,PAJULU,POKEA,POKEA B,838,8,3,1,353,181,546,19,565,0,O-2-7-06-08-02
ARUA,AYIVU COUNTY,PAJULU,YIVU,ONIVU A,510,11,0,5,146,160,322,45,367,0,O-2-7-06-09-01
ARUA,AYIVU COUNTY,PAJULU,YIVU,ONIVU B,594,12,4,17,176,158,367,27,394,0,O-2-7-06-09-02
ARUA,AYIVU COUNTY,PAJULU,YIVU,KOO,530,4,6,11,168,154,343,33,376,0,O-2-7-06-09-03
ARUA,TEREGO COUNTY,AII-VU/AJIVU,ALIA,ALIA A,598,12,6,9,256,155,438,23,461,0,O-2-11-01-01-01
ARUA,TEREGO COUNTY,AII-VU/AJIVU,ALIA,ALIA B,584,11,4,14,298,116,443,39,482,0,O-2-11-01-01-02
ARUA,TEREGO COUNTY,AII-VU/AJIVU,ARIPIA,AAWA (A-A),472,7,1,8,275,42,333,17,350,0,O-2-11-01-02-01
ARUA,TEREGO COUNTY,AII-VU/AJIVU,ARIPIA,OROGBO,594,19,5,14,291,55,384,33,417,0,O-2-11-01-02-02
ARUA,TEREGO COUNTY,AII-VU/AJIVU,ARIPIA,AAWA/OROGBO,504,9,5,6,296,43,359,11,370,0,O-2-11-01-02-03
ARUA,TEREGO COUNTY,AII-VU/AJIVU,ARIPIA,AAWA (B-Z),507,8,5,9,250,54,326,20,346,0,O-2-11-01-02-04
ARUA,TEREGO COUNTY,AII-VU/AJIVU,AYURI,AYURI A (D-Z),473,7,10,10,208,104,339,27,366,0,O-2-11-01-03-01
ARUA,TEREGO COUNTY,AII-VU/AJIVU,AYURI,AYURI A (A-C),536,5,5,3,233,128,374,20,394,0,O-2-11-01-03-02
ARUA,TEREGO COUNTY,AII-VU/AJIVU,AYURI,AYURI B,333,6,3,1,175,41,226,21,247,0,O-2-11-01-03-03
ARUA,TEREGO COUNTY,AII-VU/AJIVU,EDAYI,OWAFA/IDAYI,870,12,3,5,422,125,567,16,583,0,O-2-11-01-04-01
ARUA,TEREGO COUNTY,AII-VU/AJIVU,EDAYI,IDAYI,698,10,4,15,440,80,549,20,569,0,O-2-11-01-04-02
ARUA,TEREGO COUNTY,AII-VU/AJIVU,EREA,ODRAVU,704,18,7,17,290,138,470,33,503,0,O-2-11-01-05-01
ARUA,TEREGO COUNTY,AII-VU/AJIVU,EREA,ORINJI,588,12,10,71,9,434,536,35,571,0,O-2-11-01-05-02
ARUA,TEREGO COUNTY,AII-VU/AJIVU,EREA,OLEYI,280,3,0,12,151,38,204,27,231,0,O-2-11-01-05-03
ARUA,TEREGO COUNTY,AII-VU/AJIVU,ONAYI,ONIA A,686,14,9,15,257,194,489,44,533,0,O-2-11-01-06-01
ARUA,TEREGO COUNTY,AII-VU/AJIVU,ONAYI,ONAI B,530,7,4,12,219,110,352,45,397,0,O-2-11-01-06-02
ARUA,TEREGO COUNTY,AII-VU/AJIVU,ONZORO,ALIA A (A-B),499,10,3,2,281,49,345,22,367,0,O-2-11-01-07-01
ARUA,TEREGO COUNTY,AII-VU/AJIVU,ONZORO,AWOGO,688,16,4,15,338,83,456,32,488,0,O-2-11-01-07-02
ARUA,TEREGO COUNTY,AII-VU/AJIVU,ONZORO,ALIA B,611,10,4,5,259,45,323,22,345,0,O-2-11-01-07-03
ARUA,TEREGO COUNTY,AII-VU/AJIVU,ONZORO,ALIA A (C-Z),516,8,3,6,266,52,335,33,368,0,O-2-11-01-07-04
ARUA,TEREGO COUNTY,AII-VU/AJIVU,OTREVU,EREWA A,557,6,6,8,245,130,395,22,417,0,O-2-11-01-08-01
ARUA,TEREGO COUNTY,AII-VU/AJIVU,OTREVU,EREWA B,672,16,6,15,310,101,448,58,506,0,O-2-11-01-08-02
ARUA,TEREGO COUNTY,AII-VU/AJIVU,PARANGA,MBENJO A,570,6,9,3,349,28,395,25,420,0,O-2-11-01-09-01
ARUA,TEREGO COUNTY,AII-VU/AJIVU,PARANGA,MBENJO B,570,4,10,15,330,66,425,20,445,0,O-2-11-01-09-02
ARUA,TEREGO COUNTY,BELEAFE,ABINDI,ABINDI A (A-B),670,6,5,7,361,85,464,17,481,0,O-2-11-02-01-01
ARUA,TEREGO COUNTY,BELEAFE,ABINDI,ABINDI B,554,7,4,3,284,102,400,3,403,0,O-2-11-02-01-02
ARUA,TEREGO COUNTY,BELEAFE,ABINDI,ABINDI A (C-Z),601,10,9,11,283,95,408,10,418,0,O-2-11-02-01-03
ARUA,TEREGO COUNTY,BELEAFE,ADRIPI,ADRIPI (A-A),562,5,1,2,267,97,372,15,387,0,O-2-11-02-02-01
ARUA,TEREGO COUNTY,BELEAFE,ADRIPI,ADRIPI (B-Z),649,11,0,11,330,92,444,6,450,0,O-2-11-02-02-02
ARUA,TEREGO COUNTY,BELEAFE,AJIRAKU,AJIRAKU,631,8,4,11,426,81,530,15,545,0,O-2-11-02-03-01
ARUA,TEREGO COUNTY,BELEAFE,NICU,NICU A (B-Z),485,2,2,4,296,82,386,9,395,0,O-2-11-02-04-01
ARUA,TEREGO COUNTY,BELEAFE,NICU,NICU A (A-A),438,4,2,6,271,67,350,7,357,0,O-2-11-02-04-02
ARUA,TEREGO COUNTY,BELEAFE,NICU,NICU B,348,6,1,5,133,122,267,15,282,0,O-2-11-02-04-03
ARUA,TEREGO COUNTY,BELEAFE,NICU,NICU C,391,14,6,7,173,110,310,5,315,0,O-2-11-02-04-04
ARUA,TEREGO COUNTY,KATRINI,ANAVU,ONZORO A (A-B),577,7,4,5,245,135,396,6,402,0,O-2-11-03-01-01
ARUA,TEREGO COUNTY,KATRINI,ANAVU,ONZORO B,262,0,2,2,143,33,180,15,195,0,O-2-11-03-01-02
ARUA,TEREGO COUNTY,KATRINI,ANAVU,ONZORO C,213,3,0,1,127,32,163,5,168,0,O-2-11-03-01-03
ARUA,TEREGO COUNTY,KATRINI,ANAVU,ONZORO A (C-Z),503,6,4,2,205,146,363,12,375,0,O-2-11-03-01-04
ARUA,TEREGO COUNTY,KATRINI,OCOPI,ARE,697,8,3,9,415,62,497,28,525,0,O-2-11-03-02-01
ARUA,TEREGO COUNTY,KATRINI,OCOPI,BIRA,695,10,4,5,353,63,435,29,464,0,O-2-11-03-02-02
ARUA,TEREGO COUNTY,KATRINI,OCOPI,BIRA/ARE,540,9,5,5,260,65,344,17,361,0,O-2-11-03-02-03
ARUA,TEREGO COUNTY,KATRINI,OKAVU,OKAVU A (A-B),543,7,2,8,249,83,349,22,371,0,O-2-11-03-03-01
ARUA,TEREGO COUNTY,KATRINI,OKAVU,OKAVU B,555,5,6,12,282,71,376,15,391,0,O-2-11-03-03-02
ARUA,TEREGO COUNTY,KATRINI,OKAVU,OKAVU A (C-Z),537,4,1,11,238,83,337,28,365,0,O-2-11-03-03-03
ARUA,TEREGO COUNTY,KATRINI,OLEA,OLEA A (C-Z),503,12,2,14,302,32,362,18,380,0,O-2-11-03-04-01
ARUA,TEREGO COUNTY,KATRINI,OLEA,OLEA A (A-B),499,9,7,12,268,35,331,24,355,0,O-2-11-03-04-02
ARUA,TEREGO COUNTY,KATRINI,OLEA,OLEA B,492,9,1,8,293,28,339,18,357,0,O-2-11-03-04-03
ARUA,TEREGO COUNTY,KATRINI,OLUA,ADRAVU A,826,7,11,18,433,126,595,15,610,0,O-2-11-03-05-01
ARUA,TEREGO COUNTY,KATRINI,OLUA,ADRAVU B,341,7,2,8,204,45,266,7,273,0,O-2-11-03-05-02
ARUA,TEREGO COUNTY,KATRINI,OLUA,OBAYIA A,1027,12,12,11,456,105,596,48,644,0,O-2-11-03-05-03
ARUA,TEREGO COUNTY,KATRINI,OLUA,OBAYIA B (A-B),114,5,0,2,70,18,95,2,97,0,O-2-11-03-05-04
ARUA,TEREGO COUNTY,KATRINI,OLUA,OBAYIA A (C-Z),621,5,4,10,278,79,376,45,421,0,O-2-11-03-05-05
ARUA,TEREGO COUNTY,KATRINI,ONZORO,ANIVU A (C-Z),487,3,0,1,127,32,163,5,168,0,O-2-11-03-06-01
ARUA,TEREGO COUNTY,KATRINI,ONZORO,ANIVU A (A-B),520,4,4,0,300,78,386,18,404,0,O-2-11-03-06-02
ARUA,TEREGO COUNTY,KATRINI,ONZORO,ANIVU B,178,1,1,0,129,23,154,2,156,0,O-2-11-03-06-03
ARUA,TEREGO COUNTY,OMUGO,ANGAZI,AZOKO (A-B),459,3,0,8,211,69,291,25,316,0,O-2-11-04-01-01
ARUA,TEREGO COUNTY,OMUGO,ANGAZI,ELEPI (A-B),417,9,1,5,200,74,289,29,318,0,O-2-11-04-01-02
ARUA,TEREGO COUNTY,OMUGO,ANGAZI,AZOKO (C-Z),455,8,2,10,203,59,282,16,298,0,O-2-11-04-01-03
ARUA,TEREGO COUNTY,OMUGO,ANGAZI,ELEPI (C-Z),360,3,0,10,176,83,272,23,295,0,O-2-11-04-01-04
ARUA,TEREGO COUNTY,OMUGO,ANUFIRA,ARIPI A,503,8,2,9,280,55,354,26,380,0,O-2-11-04-02-01
ARUA,TEREGO COUNTY,OMUGO,ANUFIRA,VURA A,574,13,6,11,282,46,358,55,413,0,O-2-11-04-02-02
ARUA,TEREGO COUNTY,OMUGO,ANUFIRA,VURA B,288,13,2,9,169,24,217,22,239,0,O-2-11-04-02-03
ARUA,TEREGO COUNTY,OMUGO,ANUFIRA,ARIPI B,386,6,4,5,206,59,280,27,307,0,O-2-11-04-02-04
ARUA,TEREGO COUNTY,OMUGO,BURA,TATIRO A,840,20,7,22,478,83,610,51,661,0,O-2-11-04-03-01
ARUA,TEREGO COUNTY,OMUGO,BURA,TATIRO B,664,15,4,20,402,74,515,26,541,0,O-2-11-04-03-02
ARUA,TEREGO COUNTY,OMUGO,BURA,GODIA,504,11,4,15,238,123,391,30,421,0,O-2-11-04-03-03
ARUA,TEREGO COUNTY,OMUGO,BURA,TATIRO/GODIA A,467,5,3,9,190,122,329,19,348,0,O-2-11-04-03-04
ARUA,TEREGO COUNTY,OMUGO,BURA,TATIRO/GODIA B,513,9,7,21,197,133,367,20,387,0,O-2-11-04-03-05
ARUA,TEREGO COUNTY,OMUGO,DUKU,NYANGILA A,790,14,7,27,299,204,551,57,608,0,O-2-11-04-04-01
ARUA,TEREGO COUNTY,OMUGO,DUKU,NYANGILA B,468,13,5,17,189,141,365,15,380,0,O-2-11-04-04-02
ARUA,TEREGO COUNTY,OMUGO,NDAAPI,NDAAPI A,643,13,4,17,240,198,472,40,512,0,O-2-11-04-05-01
ARUA,TEREGO COUNTY,OMUGO,NDAAPI,NDAAPI B,486,14,4,8,252,84,362,14,376,0,O-2-11-04-05-02
ARUA,TEREGO COUNTY,OMUGO,OBI,ROI-LANGI A,433,10,5,14,216,88,333,12,345,0,O-2-11-04-06-01
ARUA,TEREGO COUNTY,OMUGO,OBI,ROI-LANGI B,437,12,4,8,204,79,307,20,327,0,O-2-11-04-06-02
ARUA,TEREGO COUNTY,OMUGO,OBI,IBIA - ORIVU A,481,8,4,6,248,84,350,13,363,0,O-2-11-04-06-03
ARUA,TEREGO COUNTY,OMUGO,OBI,IBIA - ORIVU B,454,9,3,3,209,93,317,25,342,0,O-2-11-04-06-04
ARUA,TEREGO COUNTY,OMUGO,OWAYI,ILI A,674,8,7,15,282,135,447,34,481,0,O-2-11-04-07-01
ARUA,TEREGO COUNTY,OMUGO,OWAYI,ILI B,544,14,3,9,318,47,391,46,437,0,O-2-11-04-07-02
ARUA,TEREGO COUNTY,OMUGO,YIDDU,JILLA A,801,22,4,20,346,164,556,40,596,0,O-2-11-04-08-01
ARUA,TEREGO COUNTY,OMUGO,YIDDU,JILLA B (A-B),393,4,3,6,156,138,307,5,312,0,O-2-11-04-08-02
ARUA,TEREGO COUNTY,OMUGO,YIDDU,JILLA B (C-Z),410,13,4,9,141,112,279,26,305,0,O-2-11-04-08-03
ARUA,TEREGO COUNTY,UDUPI,AZAPI,ANDIKU A,450,7,1,9,231,74,322,18,340,0,O-2-11-05-01-01
ARUA,TEREGO COUNTY,UDUPI,AZAPI,ANDIKU B,584,10,4,10,276,106,406,10,416,0,O-2-11-05-01-02
ARUA,TEREGO COUNTY,UDUPI,AZAPI,DONDI A,779,19,6,27,275,245,572,47,619,0,O-2-11-05-01-03
ARUA,TEREGO COUNTY,UDUPI,AZAPI,DONDI B,666,15,8,26,234,224,507,32,539,0,O-2-11-05-01-04
ARUA,TEREGO COUNTY,UDUPI,IMVEPI,ENVEPI A,392,9,5,9,82,161,266,9,275,0,O-2-11-05-02-01
ARUA,TEREGO COUNTY,UDUPI,IMVEPI,ENVEPI B,1151,19,3,16,379,225,642,22,664,0,O-2-11-05-02-02
ARUA,TEREGO COUNTY,UDUPI,LUGBARI,OMBIA A (A-B),356,3,7,7,47,204,268,4,272,0,O-2-11-05-03-01
ARUA,TEREGO COUNTY,UDUPI,LUGBARI,OMBIA B,809,16,6,16,81,532,651,27,678,0,O-2-11-05-03-02
ARUA,TEREGO COUNTY,UDUPI,LUGBARI,OMBIA A (C-Z),361,8,10,13,30,219,280,23,303,0,O-2-11-05-03-03
ARUA,TEREGO COUNTY,UDUPI,OKAVU,AJIVU A,546,15,5,8,182,186,396,6,402,0,O-2-11-05-04-01
ARUA,TEREGO COUNTY,UDUPI,OKAVU,AJIVU B,605,5,3,5,99,376,488,14,502,0,O-2-11-05-04-02
ARUA,TEREGO COUNTY,UDUPI,OMBOKORO,ALIA A,593,6,5,10,217,234,472,23,495,0,O-2-11-05-05-01
ARUA,TEREGO COUNTY,UDUPI,OMBOKORO,ALIA B,741,11,7,10,248,260,536,17,553,0,O-2-11-05-05-02
ARUA,TEREGO COUNTY,UDUPI,ORIVU,ORUBE A (A-B),567,10,4,13,241,169,437,7,444,0,O-2-11-05-06-01
ARUA,TEREGO COUNTY,UDUPI,ORIVU,ORUBE A (C-Z),588,13,2,9,232,174,430,27,457,0,O-2-11-05-06-02
ARUA,TEREGO COUNTY,UDUPI,OTUMBARI,ELEFE A,514,13,4,7,258,91,373,21,394,0,O-2-11-05-07-01
ARUA,TEREGO COUNTY,UDUPI,OTUMBARI,ELEFE B,465,11,6,17,206,92,332,26,358,0,O-2-11-05-07-02
ARUA,TEREGO COUNTY,URIAMA,AKINO,VURRA,785,0,3,11,229,236,479,16,495,0,O-2-11-06-01-01
ARUA,TEREGO COUNTY,URIAMA,EJOME,EJOME A (A-B),549,10,2,10,247,154,423,15,438,0,O-2-11-06-02-01
ARUA,TEREGO COUNTY,URIAMA,EJOME,EJOME B,299,3,3,5,186,60,257,5,262,0,O-2-11-06-02-02
ARUA,TEREGO COUNTY,URIAMA,EJOME,EJOME A (C-Z),528,3,3,14,212,179,411,24,435,0,O-2-11-06-02-03
ARUA,TEREGO COUNTY,URIAMA,KATIKU,KATIKU (A-D),519,8,4,2,239,61,314,13,327,0,O-2-11-06-03-01
ARUA,TEREGO COUNTY,URIAMA,KATIKU,KATIKU (E-Z),368,3,4,1,150,50,208,13,221,0,O-2-11-06-03-02
ARUA,TEREGO COUNTY,URIAMA,MARAJU,MARAJU A,581,7,3,14,271,138,433,24,457,0,O-2-11-06-04-01
ARUA,TEREGO COUNTY,URIAMA,MARAJU,MARAJU B,566,15,3,11,143,238,410,9,419,0,O-2-11-06-04-02
ARUA,TEREGO COUNTY,URIAMA,OTUMBARI,OTUMBARI A,864,8,9,13,368,254,652,35,687,0,O-2-11-06-05-01
ARUA,TEREGO COUNTY,URIAMA,OTUMBARI,OTUMBARI B,245,2,3,3,90,93,191,7,198,0,O-2-11-06-05-02
ARUA,VURRA COUNTY,AJIA,AJIA,AJIA C,600,18,4,17,243,156,438,16,454,0,O-2-12-01-01-01
ARUA,VURRA COUNTY,AJIA,AYAA,OREVU,669,13,3,23,259,98,396,50,446,0,O-2-12-01-02-01
ARUA,VURRA COUNTY,AJIA,AYA-YIA,AYA-YIA,738,14,10,11,254,135,424,25,449,0,O-2-12-01-03-01
ARUA,VURRA COUNTY,AJIA,EWAA,ALIKU/ALIVU,606,5,3,5,232,120,365,6,371,0,O-2-12-01-04-01
ARUA,VURRA COUNTY,AJIA,NYIRIVU,OLEVU C,725,25,9,19,207,304,564,24,588,0,O-2-12-01-05-01
ARUA,VURRA COUNTY,AJIA,OCHOKO,OLEVU/PAJULU,619,7,5,9,296,85,402,18,420,0,O-2-12-01-06-01
ARUA,VURRA COUNTY,AJIA,OCHOKO,ABIRA/EMBARIO/ERUBA,420,3,3,1,144,130,281,22,303,0,O-2-12-01-06-02
ARUA,VURRA COUNTY,AJIA,OCHOKO,OLIVU/ADRARIO/LUYI,449,4,3,10,193,80,290,13,303,0,O-2-12-01-06-03
ARUA,VURRA COUNTY,AJIA,OLEVU,OLEVU A,529,7,4,5,207,134,357,22,379,0,O-2-12-01-07-01
ARUA,VURRA COUNTY,AJIA,OLEVU,OLEVU B,183,7,3,2,41,105,158,13,171,0,O-2-12-01-07-02
ARUA,VURRA COUNTY,AJIA,OMBOKORO,AJIA A,770,6,5,26,183,312,532,18,550,0,O-2-12-01-08-01
ARUA,VURRA COUNTY,AJIA,OMBOKORO,AJIA B,309,5,3,3,78,121,210,15,225,0,O-2-12-01-08-02
ARUA,VURRA COUNTY,ARIVU,AWIKA,CINYA (A-D),511,9,6,7,114,238,374,15,389,0,O-2-12-02-01-01
ARUA,VURRA COUNTY,ARIVU,AWIKA,JIAKO/CINYA A,287,5,3,7,35,170,220,27,247,0,O-2-12-02-01-02
ARUA,VURRA COUNTY,ARIVU,AWIKA,JIAKO/CINYA B,273,3,4,3,31,172,213,10,223,0,O-2-12-02-01-03
ARUA,VURRA COUNTY,ARIVU,AWIKA,CINYA (E-Z),412,4,7,8,67,223,309,17,326,0,O-2-12-02-01-04
ARUA,VURRA COUNTY,ARIVU,AWIKA,AWIKA OUTSIDE Q.GUARD,316,0,0,0,33,77,110,6,116,0,O-2-12-02-01-05
ARUA,VURRA COUNTY,ARIVU,BONDO,ECEKU,713,13,3,23,332,155,526,13,539,0,O-2-12-02-02-01
ARUA,VURRA COUNTY,ARIVU,BONDO,PAJURU,868,6,6,20,110,534,676,27,703,0,O-2-12-02-02-02
ARUA,VURRA COUNTY,ARIVU,OMBAVU,ARIN TRADING CENTRE,267,3,1,4,76,76,160,3,163,0,O-2-12-02-03-01
ARUA,VURRA COUNTY,ARIVU,OMBAVU,OMBAVU (A-D),498,7,3,1,152,188,351,15,366,0,O-2-12-02-03-02
ARUA,VURRA COUNTY,ARIVU,OMBAVU,OMBAVU,549,11,3,3,157,159,333,17,350,0,O-2-12-02-03-03
ARUA,VURRA COUNTY,ARIVU,OMO,OMO,1195,9,8,6,162,245,430,14,444,0,O-2-12-02-04-01
ARUA,VURRA COUNTY,ARIVU,ULUPI,OKAZARA,786,9,1,12,173,400,595,28,623,0,O-2-12-02-05-01
ARUA,VURRA COUNTY,ARIVU,ULUPI,OLEVU,422,8,4,5,178,119,314,18,332,0,O-2-12-02-05-02
ARUA,VURRA COUNTY,LOGIRI,ANYAVU,ANYAVU NORTH,769,15,13,16,98,349,491,56,547,0,O-2-12-03-01-01
ARUA,VURRA COUNTY,LOGIRI,ANYAVU,ANYAVU SOUTH A,809,5,11,13,237,272,538,47,585,0,O-2-12-03-01-02
ARUA,VURRA COUNTY,LOGIRI,ANYAVU,ANYAVU SOUTH B,407,9,5,4,90,167,275,25,300,0,O-2-12-03-01-03
ARUA,VURRA COUNTY,LOGIRI,CHIABA,CHIABA A,536,5,7,8,60,299,379,16,395,0,O-2-12-03-02-01
ARUA,VURRA COUNTY,LOGIRI,CHIABA,CHIABA B,208,3,2,4,12,147,168,3,171,0,O-2-12-03-02-02
ARUA,VURRA COUNTY,LOGIRI,JIKI,JIKI B,702,8,8,11,77,418,522,34,556,0,O-2-12-03-03-01
ARUA,VURRA COUNTY,LOGIRI,LAZEBU,LAZEBU WEST,518,23,10,12,153,131,329,25,354,0,O-2-12-03-04-01
ARUA,VURRA COUNTY,LOGIRI,LAZEBU,LAZEBU EAST,633,14,7,15,159,227,422,28,450,0,O-2-12-03-04-02
ARUA,VURRA COUNTY,LOGIRI,OKAVU,MBARU A,554,19,13,18,96,218,364,52,416,0,O-2-12-03-05-01
ARUA,VURRA COUNTY,LOGIRI,OKAVU,MBARU B,769,18,14,28,188,266,514,50,564,0,O-2-12-03-05-02
ARUA,VURRA COUNTY,LOGIRI,OKAVU,MBARU C,736,17,7,20,108,401,553,33,586,0,O-2-12-03-05-03
ARUA,VURRA COUNTY,LOGIRI,OLIBA,OLIBA (A-E),481,9,3,7,49,236,304,18,322,0,O-2-12-03-06-01
ARUA,VURRA COUNTY,LOGIRI,OLIBA,OLIBA (F-Z),330,4,4,5,27,161,201,29,230,0,O-2-12-03-06-02
ARUA,VURRA COUNTY,LOGIRI,OZOO,OMBOKORO A (A-D),581,9,9,10,62,356,446,14,460,0,O-2-12-03-07-01
ARUA,VURRA COUNTY,LOGIRI,OZOO,ADRAVU A,604,10,5,13,95,253,376,37,413,0,O-2-12-03-07-02
ARUA,VURRA COUNTY,LOGIRI,OZOO,ADRAVU B,324,4,6,3,47,186,246,8,254,0,O-2-12-03-07-03
ARUA,VURRA COUNTY,LOGIRI,OZOO,OMBOKORO A (E-Z),615,10,8,12,64,327,421,48,469,0,O-2-12-03-07-04
ARUA,VURRA COUNTY,VURRA,AJONO,AJONO P7 SCHOOL,605,9,1,12,189,225,436,31,467,0,O-2-12-04-01-01
ARUA,VURRA COUNTY,VURRA,AJONO,OKUFURA,305,4,3,7,57,158,229,10,239,0,O-2-12-04-01-02
ARUA,VURRA COUNTY,VURRA,AJONO,KAWUANJETI,491,14,5,8,172,162,361,11,372,0,O-2-12-04-01-03
ARUA,VURRA COUNTY,VURRA,AJONO,ADIA C/U,269,2,2,0,92,104,200,15,215,0,O-2-12-04-01-04
ARUA,VURRA COUNTY,VURRA,ANZUU,OFFA,391,2,0,5,41,252,300,8,308,0,O-2-12-04-02-01
ARUA,VURRA COUNTY,VURRA,ANZUU,ANZU B,601,5,6,4,98,364,477,10,487,0,O-2-12-04-02-02
ARUA,VURRA COUNTY,VURRA,AYAVU,OPIA PRI SCH,861,15,12,2,164,408,601,26,627,0,O-2-12-04-03-01
ARUA,VURRA COUNTY,VURRA,AYAVU,AYAVU B,287,4,3,9,38,155,209,9,218,0,O-2-12-04-03-02
ARUA,VURRA COUNTY,VURRA,ERUBA,EUTA,460,3,4,2,217,99,325,16,341,0,O-2-12-04-04-01
ARUA,VURRA COUNTY,VURRA,ERUBA,EWUATA,346,3,3,0,98,107,211,6,217,0,O-2-12-04-04-02
ARUA,VURRA COUNTY,VURRA,ERUBA,ERUBA P7 SCHOOL,1023,8,9,6,284,326,633,13,646,0,O-2-12-04-04-03
ARUA,VURRA COUNTY,VURRA,EZUKU,EZUKU PRI SCH,768,8,4,7,96,416,531,26,557,0,O-2-12-04-05-01
ARUA,VURRA COUNTY,VURRA,EZUKU,DIVISION HQTRS [MOGORO],648,3,4,2,130,289,428,10,438,0,O-2-12-04-05-02
ARUA,VURRA COUNTY,VURRA,EZUKU,COUNTY HQRS /ODUMI,387,5,1,3,71,174,254,35,289,0,O-2-12-04-05-03
ARUA,VURRA COUNTY,VURRA,I-RINGILI,LUMARA,356,1,5,5,103,134,248,16,264,0,O-2-12-04-06-01
ARUA,VURRA COUNTY,VURRA,I-RINGILI,ANDIFEKU,325,7,7,4,110,121,249,15,264,0,O-2-12-04-06-02
ARUA,VURRA COUNTY,VURRA,KULUVA,ERUBA LOWER A (A-D),471,3,3,1,131,121,259,51,310,0,O-2-12-04-07-01
ARUA,VURRA COUNTY,VURRA,KULUVA,ERUBA LOWER A (E-Z),449,3,6,6,129,168,312,5,317,0,O-2-12-04-07-02
ARUA,VURRA COUNTY,VURRA,KULUVA,ADUNIAVA,349,3,2,1,90,94,190,44,234,0,O-2-12-04-07-03
ARUA,VURRA COUNTY,VURRA,NYIO,NYIO,442,2,1,7,26,314,350,7,357,0,O-2-12-04-08-01
ARUA,VURRA COUNTY,VURRA,NYIO,AYIVU,676,13,2,10,163,372,560,29,589,0,O-2-12-04-08-02
ARUA,VURRA COUNTY,VURRA,NYIO,LAA CHURCH OF UGANDA,438,2,1,2,63,274,342,6,348,0,O-2-12-04-08-03
ARUA,VURRA COUNTY,VURRA,OPIA,OPIA DISPENSARY,598,10,7,7,80,301,405,25,430,0,O-2-12-04-09-01
ARUA,VURRA COUNTY,VURRA,OPIA,OYOO PRI SCH,519,11,10,5,89,283,398,16,414,0,O-2-12-04-09-02
ARUA,VURRA COUNTY,VURRA,TILEVU,TILEVU (A-D),426,5,0,5,53,237,300,19,319,0,O-2-12-04-10-01
ARUA,VURRA COUNTY,VURRA,TILEVU,TILEVU (E-Z),393,4,4,3,59,201,271,23,294,0,O-2-12-04-10-02
GULU,ASWA COUNTY,ANGAYA,KAL-ALII,ANGAYA P.7 SCHOOL A,640,3,1,7,369,22,402,21,423,0,O-5-23-01-01-01
GULU,ASWA COUNTY,ANGAYA,KAL-ALII,ANGAYA P.7 SCHOOL B,463,6,0,9,301,13,329,13,342,0,O-5-23-01-01-02
GULU,ASWA COUNTY,ANGAYA,KAL-ALII,ANGAYA  P 7 SCHOOL C,377,4,0,2,235,9,250,0,250,0,O-5-23-01-01-03
GULU,ASWA COUNTY,ANGAYA,KAL-ALII,CO-OPIL P 7 SCHOOL,676,6,4,7,454,5,476,17,493,0,O-5-23-01-01-04
GULU,ASWA COUNTY,ANGAYA,KAL-ALII,AGANYA OUTSIDE Q. GUARD,179,3,0,0,28,41,72,2,74,0,O-5-23-01-01-05
GULU,ASWA COUNTY,ATIABAR,AGONGA,LOYO ALERO CO-OP  I,500,2,2,6,250,43,303,10,313,0,O-5-23-02-01-01
GULU,ASWA COUNTY,ATIABAR,AGONGA,CETKANA A,465,7,2,5,165,39,218,8,226,0,O-5-23-02-01-02
GULU,ASWA COUNTY,ATIABAR,AGONGA,LOYO ALERO CO-OP  III,679,6,8,6,375,28,423,24,447,0,O-5-23-02-01-03
GULU,ASWA COUNTY,ATIABAR,AGONGA,CETKANA B,549,3,2,1,196,63,265,4,269,0,O-5-23-02-01-04
GULU,ASWA COUNTY,AWACH,BURCORO,GWENGDIYA  COOPERATIVE SO,511,5,4,3,272,26,310,27,337,0,O-5-23-03-01-01
GULU,ASWA COUNTY,AWACH,GWENGDIYA,GWENGDIYA P 7 SCHOOL,687,14,4,4,416,47,485,17,502,0,O-5-23-03-02-01
GULU,ASWA COUNTY,AWACH,PADUNY,AWACH P 7 SCHOOL,681,5,1,7,337,51,401,35,436,0,O-5-23-03-03-01
GULU,ASWA COUNTY,AWACH,PADUNY,AWACH CENTRAL P 7 SCH(A-L),493,4,4,4,264,29,305,25,330,0,O-5-23-03-03-02
GULU,ASWA COUNTY,AWACH,PADUNY,AWACH CENTRAL P 7 SCHOOL B,129,0,0,1,47,8,56,3,59,0,O-5-23-03-03-03
GULU,ASWA COUNTY,AWACH,PADUNY,AWACH CENTRAL P 7 SCH (M-Z),258,3,2,1,157,19,182,6,188,0,O-5-23-03-03-04
GULU,ASWA COUNTY,AWACH,PADUNY,PADUNY OUTSIDE Q. GUARD,1106,5,3,1,143,185,337,7,344,0,O-5-23-03-03-05
GULU,ASWA COUNTY,AWACH,PAIBONA,PAIBONA P 7 SCHOOL I (A-K),344,4,1,2,199,15,221,5,226,0,O-5-23-03-04-01
GULU,ASWA COUNTY,AWACH,PAIBONA,PAIBONA P 7 SCHOOL,712,11,3,5,412,34,465,27,492,0,O-5-23-03-04-02
GULU,ASWA COUNTY,AWACH,PAIBONA,ACUTOMERGEM,185,1,2,1,105,13,122,9,131,0,O-5-23-03-04-03
GULU,ASWA COUNTY,AWACH,PAIBONA,PAIBONA P 7 SCHOOL I (L-Z),329,1,1,0,222,17,241,9,250,0,O-5-23-03-04-04
GULU,ASWA COUNTY,AWACH,PUKONY,AWACH COOPERATIVE SOCIETY,545,6,4,5,305,55,375,16,391,0,O-5-23-03-05-01
GULU,ASWA COUNTY,BUNGATIRA,AGONGA,OKOT'S HOME,658,6,3,7,415,27,458,17,475,0,O-5-23-04-01-01
GULU,ASWA COUNTY,BUNGATIRA,AGONGA,BUNGATIRA TRADING CENTRE I,410,0,2,0,228,23,253,15,268,0,O-5-23-04-01-02
GULU,ASWA COUNTY,BUNGATIRA,AGONGA,OWAK'S HOME,145,1,0,0,87,2,90,5,95,0,O-5-23-04-01-03
GULU,ASWA COUNTY,BUNGATIRA,AGONGA,ALWIZI'S HOME,348,3,1,3,208,18,233,9,242,0,O-5-23-04-01-04
GULU,ASWA COUNTY,BUNGATIRA,AGONGA,BUNGATIRA TRADING CENTRE II,378,3,5,0,240,24,272,3,275,0,O-5-23-04-01-05
GULU,ASWA COUNTY,KALUMU,KAL-ALII,PAICHO P 7 SCHOOL I,501,4,0,2,301,30,337,9,346,0,O-5-23-05-01-01
GULU,ASWA COUNTY,KALUMU,KAL-ALII,PAICHO P.7 SCHOOL II,732,7,3,3,392,58,463,27,490,0,O-5-23-05-01-02
GULU,ASWA COUNTY,KALUMU,KAL-ALII,TEGOT ATO P 7 SCHOOL I,366,3,1,5,200,33,242,9,251,0,O-5-23-05-01-03
GULU,ASWA COUNTY,KALUMU,KAL-ALII,TEGOT ATO P 7 II,470,9,4,2,236,12,263,21,284,0,O-5-23-05-01-04
GULU,ASWA COUNTY,KALUMU,KAL-ALII,TEGOT ATO HEALTH CENTRE II,230,1,1,1,113,10,126,0,126,0,O-5-23-05-01-05
GULU,ASWA COUNTY,LALIYA,AGONGA,TOL-MANWANG MARKET I,596,1,2,2,361,25,391,19,410,0,O-5-23-06-01-01
GULU,ASWA COUNTY,LALIYA,AGONGA,TOL-MANWANG MARKET II,381,5,1,3,241,15,265,9,274,0,O-5-23-06-01-02
GULU,ASWA COUNTY,LALIYA,AGONGA,TOL-MANWANG MARKET III,292,1,1,3,191,7,203,7,210,0,O-5-23-06-01-03
GULU,ASWA COUNTY,LALIYA,AGONGA,TOL-MANWANG MARKET IV,526,5,4,5,285,37,336,9,345,0,O-5-23-06-01-04
GULU,ASWA COUNTY,LALIYA,AGONGA,JOHN LAKWO'S HOME,223,0,8,0,155,7,170,8,178,0,O-5-23-06-01-05
GULU,ASWA COUNTY,LALIYA,AGONGA,OKOT TAA'S HOME,386,3,2,4,220,34,263,11,274,0,O-5-23-06-01-06
GULU,ASWA COUNTY,LAROO,AGONGA,ALWIZI ORINGA'S HOME I,502,0,3,0,300,28,331,12,343,0,O-5-23-07-01-07
GULU,ASWA COUNTY,LAROO,AGONGA,ALWIZI ORINGA'S HOME II,626,3,2,3,357,37,402,16,418,0,O-5-23-07-01-08
GULU,ASWA COUNTY,MEDE,LABWORUMOR,OROKO CENTRE,319,3,5,3,176,51,238,9,247,0,O-5-23-08-01-01
GULU,ASWA COUNTY,MEDE,LABWORUMOR,MEDE CENTRE,512,12,3,9,264,51,339,10,349,0,O-5-23-08-01-02
GULU,ASWA COUNTY,OITINO,AGONGA,PAMINANO P.7 SCHOOL I,438,4,2,3,226,26,261,6,267,0,O-5-23-09-01-01
GULU,ASWA COUNTY,OITINO,AGONGA,PAMINANO P 7 SCHOOL II,513,3,1,2,320,9,335,30,365,0,O-5-23-09-01-02
GULU,ASWA COUNTY,OMEL,KAL-ALII,APEM CENTRE A,538,10,3,5,290,42,350,29,379,0,O-5-23-10-01-01
GULU,ASWA COUNTY,OMEL,KAL-ALII,APEM CENTRE B,238,3,2,2,131,5,143,8,151,0,O-5-23-10-01-02
GULU,ASWA COUNTY,OMEL,KAL-ALII,OPEM CENTRE OUTSIDE Q. GUAR,259,1,0,1,17,178,197,3,200,0,O-5-23-10-01-03
GULU,ASWA COUNTY,OWALO,LABWORUMOR,LUGORE MARKET I,602,9,7,4,192,36,248,8,256,0,O-5-23-11-01-01
GULU,ASWA COUNTY,OWALO,LABWORUMOR,LUGORE MARKET II,391,3,2,1,114,22,142,7,149,0,O-5-23-11-01-02
GULU,ASWA COUNTY,OWALO,LABWORUMOR,LUGORE MARKET III,855,12,1,9,313,76,411,23,434,0,O-5-23-11-01-03
GULU,ASWA COUNTY,OWALO,LABWORUMOR,MARKET I OUTSIDE GUARD,671,0,0,1,11,32,44,0,44,0,O-5-23-11-01-04
GULU,ASWA COUNTY,PABWO,AGONGA,KULUKENO P 7   SCHOOL I,800,4,0,6,454,53,517,6,523,0,O-5-23-12-01-01
GULU,ASWA COUNTY,PABWO,AGONGA,KULUKENO P.7 SCHOOL II,488,4,2,1,323,15,345,11,356,0,O-5-23-12-01-02
GULU,ASWA COUNTY,PAGIK,KAL-ALII,CWERO COUNTY HEADQUATERS,368,3,3,5,216,17,244,13,257,0,O-5-23-13-01-01
GULU,ASWA COUNTY,PAGIK,KAL-ALII,DWERE CO-OPERATIVE SOCIETY,361,3,5,1,211,15,235,13,248,0,O-5-23-13-01-02
GULU,ASWA COUNTY,PAGIK,KAL-ALII,DWERE CO-OPERATIVE SOCIETY,400,9,5,6,218,18,256,19,275,0,O-5-23-13-01-03
GULU,ASWA COUNTY,PAICHO,KAL-ALII,PAICHO DIVISION HEADQUATER,417,5,4,3,257,17,286,25,311,0,O-5-23-14-01-04
GULU,ASWA COUNTY,PAICHO,KAL-ALII,LALWORO CO-OP SOCIETY,681,12,2,5,381,51,451,15,466,0,O-5-23-14-01-05
GULU,ASWA COUNTY,PAICHO,KAL-ALII,PAICHO DIVISION HEADQUATER,444,1,6,9,247,12,275,6,281,0,O-5-23-14-01-06
GULU,ASWA COUNTY,PAICHO,KAL-ALII,KAL-ALII OUTSIDE Q.GUARD,549,6,3,6,77,67,159,7,166,0,O-5-23-14-01-07
GULU,ASWA COUNTY,PAKWELO,KAL-ALII,UNYAMA NATIONAL TEACHERS,553,5,5,2,311,20,343,22,365,0,O-5-23-15-01-08
GULU,ASWA COUNTY,PAKWELO,KAL-ALII,NAME_MISSING,447,4,3,2,266,12,287,9,296,0,O-5-23-15-01-09
GULU,ASWA COUNTY,PAKWELO,KAL-ALII,AKONYI BEDO PRI SCH,413,5,2,2,260,5,274,17,291,0,O-5-23-15-01-10
GULU,ASWA COUNTY,PAKWELO,KAL-ALII,ADOKONYAKO MKT,363,3,1,0,232,15,251,0,251,0,O-5-23-15-01-11
GULU,ASWA COUNTY,PALARO,LABWORUMOR,LABWOROMOR CENTRE I,660,9,6,3,246,42,306,9,315,0,O-5-23-16-01-01
GULU,ASWA COUNTY,PALARO,LABWORUMOR,LABWOROMOR CENTRE II,412,3,4,3,223,34,267,16,283,0,O-5-23-16-01-02
GULU,ASWA COUNTY,PALARO,LABWORUMOR,LABWOROMOR CENTRE III,276,4,1,4,152,24,185,11,196,0,O-5-23-16-01-03
GULU,ASWA COUNTY,PATIKO,KAL,PATIKOKAL DIV. HQTRS,796,14,7,7,306,85,419,26,445,0,O-5-23-17-01-01
GULU,ASWA COUNTY,PATIKO,KAL,PURUDI KOMAKECH EROSS'S HO,541,12,3,14,309,57,395,12,407,0,O-5-23-17-01-02
GULU,ASWA COUNTY,PATIKO,KAL,NAME_MISSING,318,4,4,6,156,33,203,13,216,0,O-5-23-17-01-03
GULU,ASWA COUNTY,PATIKO,KAL,PATIKOKAL DIV. HQTRS II,250,1,5,7,121,12,146,12,158,0,O-5-23-17-01-04
GULU,ASWA COUNTY,PAWEL,KAL,WILSON OKELLO'S HOME,482,5,5,5,261,57,333,21,354,0,O-5-23-18-01-05
GULU,ASWA COUNTY,PAWEL,KAL,ANGANY P 7 SCHOOL,646,8,6,11,388,24,437,12,449,0,O-5-23-18-01-06
GULU,ASWA COUNTY,PUGWENYI,KAL,KUL-OPAL P.7 SCHOOL I,705,9,1,8,396,24,438,14,452,0,O-5-23-19-01-07
GULU,ASWA COUNTY,PUGWENYI,KAL,KUL-OPAL P.7 SCHOOL II,492,12,2,6,242,10,272,31,303,0,O-5-23-19-01-08
GULU,ASWA COUNTY,PUGWENYI,KAL,AWOOYIM P.7 SCH,597,3,1,3,348,18,373,11,384,0,O-5-23-19-01-09
GULU,ASWA COUNTY,PUGWENYI,KAL,KUL-OPAL P.7 SCHOOL III,300,4,1,1,199,3,208,7,215,0,O-5-23-19-01-10
GULU,ASWA COUNTY,PUNENA,AGONGA,ST MARTIN'S P 7 SCHOOL   I,671,6,5,6,407,28,452,13,465,0,O-5-23-20-01-01
GULU,ASWA COUNTY,PUNENA,AGONGA,NAME_MISSING,667,8,5,8,380,27,428,25,453,0,O-5-23-20-01-02
GULU,ASWA COUNTY,UNYAMA,KAL-ALII,GULU TEACHERS TRAINING COLL,778,9,4,4,382,35,434,14,448,0,O-5-23-21-01-01
GULU,ASWA COUNTY,UNYAMA,KAL-ALII,NAME_MISSING,674,7,3,2,359,37,408,6,414,0,O-5-23-21-01-02
GULU,GULU MUNICIPAL COUNCIL,BAR-DEGE,BAR-DEGE,TEOCHIBI,300,4,1,2,204,10,221,10,231,0,O-5-27-01-01-01
GULU,GULU MUNICIPAL COUNCIL,BAR-DEGE,BAR-DEGE,BAR-DEGE ORPHANS HOME,1051,5,5,0,415,75,500,14,514,0,O-5-27-01-01-02
GULU,GULU MUNICIPAL COUNCIL,BAR-DEGE,FOR GOD,ST JOE P7 SCHOOL,712,6,3,0,358,38,405,8,413,0,O-5-27-01-02-01
GULU,GULU MUNICIPAL COUNCIL,BAR-DEGE,FOR GOD,LACOR HOSPITAL A (A-J),513,2,3,1,244,23,273,7,280,0,O-5-27-01-02-02
GULU,GULU MUNICIPAL COUNCIL,BAR-DEGE,FOR GOD,LACOR HOSPITAL B (K-Z),538,3,2,0,286,26,317,2,319,0,O-5-27-01-02-03
GULU,GULU MUNICIPAL COUNCIL,BAR-DEGE,FOR GOD,CHRIST THE KING T.T.C,742,5,5,3,326,24,363,21,384,0,O-5-27-01-02-04
GULU,GULU MUNICIPAL COUNCIL,BAR-DEGE,KANYAGOGA,MICAN,572,6,5,4,277,42,334,5,339,0,O-5-27-01-03-01
GULU,GULU MUNICIPAL COUNCIL,BAR-DEGE,KANYAGOGA,GREEN VALLEY A,959,4,2,1,351,76,434,6,440,0,O-5-27-01-03-02
GULU,GULU MUNICIPAL COUNCIL,BAR-DEGE,KANYAGOGA,GREEN VALLEY B,849,1,6,2,361,71,441,3,444,0,O-5-27-01-03-03
GULU,GULU MUNICIPAL COUNCIL,BAR-DEGE,KANYAGOGA,KASUBI P7 SCH,321,2,1,2,135,24,164,15,179,0,O-5-27-01-03-04
GULU,GULU MUNICIPAL COUNCIL,BAR-DEGE,KANYAGOGA,GREEN VALLEY C,710,2,3,0,299,54,358,4,362,0,O-5-27-01-03-05
GULU,GULU MUNICIPAL COUNCIL,BAR-DEGE,KANYAGOGA,MICAN B,295,2,5,2,162,35,206,1,207,0,O-5-27-01-03-06
GULU,GULU MUNICIPAL COUNCIL,BAR-DEGE,KASUBI,GOAN QUARTERS (A-K),669,6,6,2,289,66,369,12,381,0,O-5-27-01-04-01
GULU,GULU MUNICIPAL COUNCIL,BAR-DEGE,KASUBI,LALIA P.7 SCHOOL 1,302,2,1,1,140,19,163,10,173,0,O-5-27-01-04-02
GULU,GULU MUNICIPAL COUNCIL,BAR-DEGE,KASUBI,LALIA P 7 SCHOOL 2,396,2,2,3,201,28,236,6,242,0,O-5-27-01-04-03
GULU,GULU MUNICIPAL COUNCIL,BAR-DEGE,KASUBI,BAT I (A-J),509,1,4,3,239,49,296,5,301,0,O-5-27-01-04-04
GULU,GULU MUNICIPAL COUNCIL,BAR-DEGE,KASUBI,GOAN QUARTERS (L-Z),691,1,4,2,288,43,338,8,346,0,O-5-27-01-04-05
GULU,GULU MUNICIPAL COUNCIL,BAR-DEGE,KASUBI,BAT I (K-Z),442,0,4,2,221,41,268,6,274,0,O-5-27-01-04-06
GULU,GULU MUNICIPAL COUNCIL,BAR-DEGE,KASUBI,KASUBI (A-AL),725,4,3,2,101,158,268,11,279,0,O-5-27-01-04-07
GULU,GULU MUNICIPAL COUNCIL,BAR-DEGE,KASUBI,KASUBI (AM-AZ),580,1,2,2,87,127,219,8,227,0,O-5-27-01-04-08
GULU,GULU MUNICIPAL COUNCIL,BAR-DEGE,KASUBI,KASUBI (B-J),681,0,2,1,79,150,232,8,240,0,O-5-27-01-04-09
GULU,GULU MUNICIPAL COUNCIL,BAR-DEGE,KASUBI,KASUBI (K-L),565,1,2,0,69,146,218,4,222,0,O-5-27-01-04-10
GULU,GULU MUNICIPAL COUNCIL,BAR-DEGE,KASUBI,KASUBI (M-N),604,2,0,0,60,149,211,1,212,0,O-5-27-01-04-11
GULU,GULU MUNICIPAL COUNCIL,BAR-DEGE,KASUBI,KASUBI (O-ON),801,2,4,0,122,123,251,3,254,0,O-5-27-01-04-12
GULU,GULU MUNICIPAL COUNCIL,BAR-DEGE,KASUBI,KASUBI (OO-Z),753,1,2,0,90,137,230,0,230,0,O-5-27-01-04-13
GULU,GULU MUNICIPAL COUNCIL,LAROO,AGWEE,LIMU (A-K),546,1,1,1,261,44,308,16,324,0,O-5-27-02-01-01
GULU,GULU MUNICIPAL COUNCIL,LAROO,AGWEE,GULU TOWN PR. SCH. A,766,1,8,1,359,45,414,18,432,0,O-5-27-02-01-02
GULU,GULU MUNICIPAL COUNCIL,LAROO,AGWEE,GULU TOWN PR. SCH. B,481,3,3,2,267,32,307,16,323,0,O-5-27-02-01-03
GULU,GULU MUNICIPAL COUNCIL,LAROO,AGWEE,LIMU (L-Z),540,2,2,0,305,41,350,10,360,0,O-5-27-02-01-04
GULU,GULU MUNICIPAL COUNCIL,LAROO,IRIAGA,OBIYA P 7 SCH,517,2,1,4,280,36,323,31,354,0,O-5-27-02-02-01
GULU,GULU MUNICIPAL COUNCIL,LAROO,IRIAGA,ACHOLI INN A (A-L),429,2,1,0,186,48,237,3,240,0,O-5-27-02-02-02
GULU,GULU MUNICIPAL COUNCIL,LAROO,IRIAGA,ACHOLI INN B,967,3,3,4,434,69,513,12,525,0,O-5-27-02-02-03
GULU,GULU MUNICIPAL COUNCIL,LAROO,IRIAGA,LAROO P7 SCH,540,3,0,3,266,38,310,24,334,0,O-5-27-02-02-04
GULU,GULU MUNICIPAL COUNCIL,LAROO,IRIAGA,ACHOLI INN A (M-Z),615,2,3,0,250,73,328,4,332,0,O-5-27-02-02-05
GULU,GULU MUNICIPAL COUNCIL,LAROO,PECE PRISONS,PECE PRISONS A,580,5,2,2,336,26,371,21,392,0,O-5-27-02-03-01
GULU,GULU MUNICIPAL COUNCIL,LAROO,PECE PRISONS,PECE PRISONS B,635,1,3,3,358,16,381,23,404,0,O-5-27-02-03-02
GULU,GULU MUNICIPAL COUNCIL,LAROO,PECE PRISONS,PAUL LAKONY'S HOME,488,3,3,2,296,16,320,22,342,0,O-5-27-02-03-03
GULU,GULU MUNICIPAL COUNCIL,LAROO,QUEENS AVENUE,HOLY ROSARY A,706,2,5,0,324,28,359,2,361,0,O-5-27-02-04-01
GULU,GULU MUNICIPAL COUNCIL,LAROO,QUEENS AVENUE,HOLY ROSARY B,561,1,2,1,246,55,305,2,307,0,O-5-27-02-04-02
GULU,GULU MUNICIPAL COUNCIL,LAROO,QUEENS AVENUE,HOLY ROSARY C,492,1,2,0,242,34,279,1,280,0,O-5-27-02-04-03
GULU,GULU MUNICIPAL COUNCIL,LAROO,QUEENS AVENUE,LOROO DIV. HQRS (A-K),476,1,1,0,174,35,211,4,215,0,O-5-27-02-04-04
GULU,GULU MUNICIPAL COUNCIL,LAROO,QUEENS AVENUE,HOLY ROSARY D,192,0,1,0,69,22,92,0,92,0,O-5-27-02-04-05
GULU,GULU MUNICIPAL COUNCIL,LAROO,QUEENS AVENUE,LOROO DIV. HQRS (L-Z),512,1,0,0,228,27,256,0,256,0,O-5-27-02-04-06
GULU,GULU MUNICIPAL COUNCIL,LAYIBI,KIROMBE,CUSTOM CORNER A,561,9,6,6,291,28,340,6,346,0,O-5-27-03-01-01
GULU,GULU MUNICIPAL COUNCIL,LAYIBI,KIROMBE,CUSTOM CORNER B,527,2,3,3,291,33,332,8,340,0,O-5-27-03-01-02
GULU,GULU MUNICIPAL COUNCIL,LAYIBI,KIROMBE,RAILWAYS QUARTERS,211,0,2,0,99,7,108,2,110,0,O-5-27-03-01-03
GULU,GULU MUNICIPAL COUNCIL,LAYIBI,KIROMBE,GULU PUBLIC P7 SCH A,439,4,1,0,180,29,214,3,217,0,O-5-27-03-01-04
GULU,GULU MUNICIPAL COUNCIL,LAYIBI,KIROMBE,GULU PUBLIC P7 SCH B,438,2,3,2,199,22,228,6,234,0,O-5-27-03-01-05
GULU,GULU MUNICIPAL COUNCIL,LAYIBI,LIBRARY,UHURU'S PLACE A (A-A),869,3,1,4,370,29,407,33,440,0,O-5-27-03-02-01
GULU,GULU MUNICIPAL COUNCIL,LAYIBI,LIBRARY,LIBRARY,924,1,1,0,331,76,409,5,414,0,O-5-27-03-02-02
GULU,GULU MUNICIPAL COUNCIL,LAYIBI,LIBRARY,UHURU'S PLACE B,999,2,3,2,403,31,441,21,462,0,O-5-27-03-02-03
GULU,GULU MUNICIPAL COUNCIL,LAYIBI,LIBRARY,UHURU'S PLACE A (B-Z),455,1,0,1,188,17,207,5,212,0,O-5-27-03-02-04
GULU,GULU MUNICIPAL COUNCIL,LAYIBI,LIBRARY,PRISONS P SCH,178,1,1,1,68,21,92,4,96,0,O-5-27-03-02-05
GULU,GULU MUNICIPAL COUNCIL,LAYIBI,PATUDA,OKECH ANDREW'S HOME  I,479,2,4,2,273,30,311,0,311,0,O-5-27-03-03-01
GULU,GULU MUNICIPAL COUNCIL,LAYIBI,PATUDA,OKECH ANDREW' S HOME II,406,3,2,3,217,27,252,13,265,0,O-5-27-03-03-02
GULU,GULU MUNICIPAL COUNCIL,LAYIBI,PATUDA,LACOR MARKET A,821,7,6,3,431,34,481,0,481,0,O-5-27-03-03-03
GULU,GULU MUNICIPAL COUNCIL,LAYIBI,PATUDA,LACOR MARKET B,700,1,2,0,394,32,429,10,439,0,O-5-27-03-03-04
GULU,GULU MUNICIPAL COUNCIL,LAYIBI,TECHO,LAYIBI P 7 SCHOOL A,712,2,3,3,393,42,443,10,453,0,O-5-27-03-04-01
GULU,GULU MUNICIPAL COUNCIL,LAYIBI,TECHO,LAYIBI P 7 SCHOOL B,690,5,6,3,346,34,394,24,418,0,O-5-27-03-04-02
GULU,GULU MUNICIPAL COUNCIL,LAYIBI,TECHO,GULU RAILWAYS STATION A,421,3,2,3,209,27,244,9,253,0,O-5-27-03-04-03
GULU,GULU MUNICIPAL COUNCIL,LAYIBI,TECHO,GULU RAILWAY STATION B,549,4,2,2,273,21,302,0,302,0,O-5-27-03-04-04
GULU,GULU MUNICIPAL COUNCIL,PECE,LABOURLINE,NAKASERO A,1048,4,4,2,390,84,484,8,492,0,O-5-27-04-01-01
GULU,GULU MUNICIPAL COUNCIL,PECE,LABOURLINE,NAKASERO B,589,0,1,0,224,57,282,5,287,0,O-5-27-04-01-02
GULU,GULU MUNICIPAL COUNCIL,PECE,LABOURLINE,NAKASERO C,374,0,3,0,147,27,177,2,179,0,O-5-27-04-01-03
GULU,GULU MUNICIPAL COUNCIL,PECE,LABOURLINE,PECE DIV HQRS,415,1,2,0,114,19,136,1,137,0,O-5-27-04-01-04
GULU,GULU MUNICIPAL COUNCIL,PECE,LABOURLINE,TE-KITUBA,553,3,3,0,249,38,293,2,295,0,O-5-27-04-01-05
GULU,GULU MUNICIPAL COUNCIL,PECE,LABOURLINE,LABOURLINE P 7 SCH,442,2,0,1,209,27,239,5,244,0,O-5-27-04-01-06
GULU,GULU MUNICIPAL COUNCIL,PECE,PAWEL,PECE P7 SCHOOL I,780,6,2,5,361,37,411,10,421,0,O-5-27-04-02-01
GULU,GULU MUNICIPAL COUNCIL,PECE,PAWEL,PECE P.7 SCHOOL II,530,3,1,3,268,25,300,8,308,0,O-5-27-04-02-02
GULU,GULU MUNICIPAL COUNCIL,PECE,PAWEL,PECE P .7 SCHOOL III,403,2,3,2,210,20,237,8,245,0,O-5-27-04-02-03
GULU,GULU MUNICIPAL COUNCIL,PECE,PAWEL,PECE P7 SCHOOL IV,598,4,2,0,317,32,355,7,362,0,O-5-27-04-02-04
GULU,GULU MUNICIPAL COUNCIL,PECE,TEGWANA,KELI'S HOME A (A-B),605,1,5,2,270,42,320,7,327,0,O-5-27-04-03-01
GULU,GULU MUNICIPAL COUNCIL,PECE,TEGWANA,KELI'S HOME B,448,4,2,0,234,27,267,8,275,0,O-5-27-04-03-02
GULU,GULU MUNICIPAL COUNCIL,PECE,TEGWANA,LAYIBI MARKET,570,1,6,2,294,33,336,0,336,0,O-5-27-04-03-03
GULU,GULU MUNICIPAL COUNCIL,PECE,TEGWANA,LAYIBI CENTRAL P7 SCHOOL,1243,2,5,1,574,33,615,12,627,0,O-5-27-04-03-04
GULU,GULU MUNICIPAL COUNCIL,PECE,TEGWANA,AYWEE P7 SCH,524,2,5,5,297,18,327,19,346,0,O-5-27-04-03-05
GULU,GULU MUNICIPAL COUNCIL,PECE,TEGWANA,KELI'S HOME A (C-Z),432,0,2,2,206,24,234,6,240,0,O-5-27-04-03-06
GULU,GULU MUNICIPAL COUNCIL,PECE,VANGUARD,PECE STADIUM A1,925,1,3,0,360,50,414,4,418,0,O-5-27-04-04-01
GULU,GULU MUNICIPAL COUNCIL,PECE,VANGUARD,PECE STADIUM B,275,2,0,1,120,14,137,4,141,0,O-5-27-04-04-02
GULU,GULU MUNICIPAL COUNCIL,PECE,VANGUARD,PECE STADIUM C,729,1,5,3,332,40,381,13,394,0,O-5-27-04-04-03
GULU,GULU MUNICIPAL COUNCIL,PECE,VANGUARD,PECE STADIUM D,752,1,4,1,296,42,344,5,349,0,O-5-27-04-04-04
GULU,GULU MUNICIPAL COUNCIL,PECE,VANGUARD,PECE STADIUM A2,615,4,2,0,252,30,288,1,289,0,O-5-27-04-04-05
GULU,GULU MUNICIPAL COUNCIL,PECE,VANGUARD,POLICE PRI. SCH II,703,5,3,0,325,27,360,9,369,0,O-5-27-04-04-06
KITGUM,CHUA COUNTY,AKWANG,LAMIT,TUMANGU,409,12,8,2,242,19,283,13,296,0,O-19-91-01-01-01
KITGUM,CHUA COUNTY,AKWANG,LAMIT,BARJERE (A-L),635,10,5,8,228,50,301,19,320,0,O-19-91-01-01-02
KITGUM,CHUA COUNTY,AKWANG,LAMIT,LAMIT LIBA,493,10,5,9,280,16,320,30,350,0,O-19-91-01-01-03
KITGUM,CHUA COUNTY,AKWANG,LAMIT,BARJERE (M-Z),345,6,3,3,187,23,222,7,229,0,O-19-91-01-01-04
KITGUM,CHUA COUNTY,AKWANG,LUGWAR,OKWICI P7 SCH,502,13,8,10,292,55,378,14,392,0,O-19-91-01-02-01
KITGUM,CHUA COUNTY,AKWANG,LUGWAR,AKADO P7 SCH,544,11,8,11,260,94,384,13,397,0,O-19-91-01-02-02
KITGUM,CHUA COUNTY,AKWANG,LUGWAR,PAJIMO BARRACKS( A -- L),664,4,4,3,42,169,222,5,227,0,O-19-91-01-02-03
KITGUM,CHUA COUNTY,AKWANG,LUGWAR,PAJIMO BARRACKS (M -- Z),343,0,2,0,16,115,133,4,137,0,O-19-91-01-02-04
KITGUM,CHUA COUNTY,AKWANG,PAJIMO,PAJIMO MISSION,504,4,6,0,327,39,376,12,388,0,O-19-91-01-03-01
KITGUM,CHUA COUNTY,AKWANG,PAJIMO,PAJIMO P7 SCHOOL,522,9,4,5,214,61,293,21,314,0,O-19-91-01-03-02
KITGUM,CHUA COUNTY,AKWANG,PAJIMO,PANYKEL P7 SCH,380,4,11,11,258,10,294,10,304,0,O-19-91-01-03-03
KITGUM,CHUA COUNTY,AKWANG,PAJIMO,APWOYO,331,11,2,6,201,17,237,29,266,0,O-19-91-01-03-04
KITGUM,CHUA COUNTY,AKWANG,PAJIMO,AGWENG,363,5,6,6,199,46,262,8,270,0,O-19-91-01-03-05
KITGUM,CHUA COUNTY,KITGUM MATIDI,IBAKARA,KITGUM MATIDI P.7 SCHOOL,370,8,3,9,200,23,243,12,255,0,O-19-91-02-01-01
KITGUM,CHUA COUNTY,KITGUM MATIDI,IBAKARA,PAKUMU,404,1,2,3,242,51,299,6,305,0,O-19-91-02-01-02
KITGUM,CHUA COUNTY,KITGUM MATIDI,IBAKARA,PAGWAAWERE,442,6,4,6,263,65,344,7,351,0,O-19-91-02-01-03
KITGUM,CHUA COUNTY,KITGUM MATIDI,IBAKARA,KITGUM MATIDI SUBCTY HQS,439,5,2,1,139,33,180,5,185,0,O-19-91-02-01-04
KITGUM,CHUA COUNTY,KITGUM MATIDI,IBAKARA,PARWECH CENTER,307,4,4,3,205,15,231,10,241,0,O-19-91-02-01-05
KITGUM,CHUA COUNTY,KITGUM MATIDI,LUMULE,LUMULE P.7 SCHOOL,558,2,10,6,364,14,396,20,416,0,O-19-91-02-02-01
KITGUM,CHUA COUNTY,KITGUM MATIDI,LUMULE,BOLKOL,318,4,2,2,191,15,214,8,222,0,O-19-91-02-02-02
KITGUM,CHUA COUNTY,KITGUM MATIDI,LUMULE,TONGROM,387,2,1,7,234,13,257,9,266,0,O-19-91-02-02-03
KITGUM,CHUA COUNTY,KITGUM MATIDI,ORYANGA B,OPIKA OPOKA'S HOME (A-K),489,2,1,4,301,12,320,16,336,0,O-19-91-02-03-01
KITGUM,CHUA COUNTY,KITGUM MATIDI,ORYANGA B,OPIKA OPOKA'S HOME (L-Z),387,4,8,4,232,29,277,12,289,0,O-19-91-02-03-02
KITGUM,CHUA COUNTY,KITGUM MATIDI,PAIBONY,OBYEN,641,3,2,11,410,44,470,7,477,0,O-19-91-02-04-01
KITGUM,CHUA COUNTY,KITGUM MATIDI,PAIBONY,DOG TUNY,522,6,3,8,328,29,374,17,391,0,O-19-91-02-04-02
KITGUM,CHUA COUNTY,KITGUM TOWN COUNCIL,ALANGO,CORNER ALANGO,696,6,1,6,385,46,444,9,453,0,O-19-91-03-01-01
KITGUM,CHUA COUNTY,KITGUM TOWN COUNCIL,ALANGO,RAINBOW SCHOOL,347,0,4,1,172,13,190,7,197,0,O-19-91-03-01-02
KITGUM,CHUA COUNTY,KITGUM TOWN COUNCIL,GUU,C/KAMDINI TE CWA (A-K),663,3,2,1,318,33,357,7,364,0,O-19-91-03-02-01
KITGUM,CHUA COUNTY,KITGUM TOWN COUNCIL,GUU,C/KAMDINI TE FENE,628,2,6,1,330,34,373,3,376,0,O-19-91-03-02-02
KITGUM,CHUA COUNTY,KITGUM TOWN COUNCIL,GUU,C/KAMDINI TE CWA (L-Z),447,1,7,0,243,28,279,3,282,0,O-19-91-03-02-03
KITGUM,CHUA COUNTY,KITGUM TOWN COUNCIL,GUU,GINNERY TE CWA,657,5,3,4,387,30,429,16,445,0,O-19-91-03-02-04
KITGUM,CHUA COUNTY,KITGUM TOWN COUNCIL,GUU,OUTSIDE Q.GUARD,495,1,0,0,30,138,169,10,179,0,O-19-91-03-02-05
KITGUM,CHUA COUNTY,KITGUM TOWN COUNCIL,PAGER,AYUL CORNER A (A-L),645,0,3,5,271,28,307,26,333,0,O-19-91-03-03-01
KITGUM,CHUA COUNTY,KITGUM TOWN COUNCIL,PAGER,AYUL CORNER B,708,2,3,2,358,23,388,9,397,0,O-19-91-03-03-02
KITGUM,CHUA COUNTY,KITGUM TOWN COUNCIL,PAGER,AYUL CORNER A (M-Z),308,1,3,0,145,10,159,4,163,0,O-19-91-03-03-03
KITGUM,CHUA COUNTY,KITGUM TOWN COUNCIL,PAGER,KITGUM P.7 SCHOOL,597,2,18,3,354,25,402,11,413,0,O-19-91-03-03-04
KITGUM,CHUA COUNTY,KITGUM TOWN COUNCIL,PANDWONG,S/QS TE KIBUU (L-Z),366,0,3,0,214,18,235,2,237,0,O-19-91-03-04-01
KITGUM,CHUA COUNTY,KITGUM TOWN COUNCIL,PANDWONG,PANDWONG P7 SCH,501,2,2,0,260,21,285,11,296,0,O-19-91-03-04-02
KITGUM,CHUA COUNTY,KITGUM TOWN COUNCIL,PANDWONG,S/QS TE KIBUU (A-K),696,4,5,2,340,37,388,6,394,0,O-19-91-03-04-03
KITGUM,CHUA COUNTY,KITGUM TOWN COUNCIL,PONGDWONGO,KITGUM T.T.C.(N) (M-Z),531,2,2,0,267,24,295,9,304,0,O-19-91-03-05-01
KITGUM,CHUA COUNTY,KITGUM TOWN COUNCIL,PONGDWONGO,KITGUM BOYS SCH (L-Z),522,1,3,3,319,15,341,9,350,0,O-19-91-03-05-02
KITGUM,CHUA COUNTY,KITGUM TOWN COUNCIL,PONGDWONGO,KITGUM BOYS SCH (A-K),474,1,1,2,258,11,273,10,283,0,O-19-91-03-05-03
KITGUM,CHUA COUNTY,KITGUM TOWN COUNCIL,PONGDWONGO,KITGUM T.T.C.(N) (A-L),677,1,1,5,344,15,366,14,380,0,O-19-91-03-05-04
KITGUM,CHUA COUNTY,KITGUM TOWN COUNCIL,TOWN,COURT HALL (B-L),540,1,1,0,214,30,246,1,247,0,O-19-91-03-06-01
KITGUM,CHUA COUNTY,KITGUM TOWN COUNCIL,TOWN,COURT HALL (M-Z),299,0,1,1,124,21,147,1,148,0,O-19-91-03-06-02
KITGUM,CHUA COUNTY,KITGUM TOWN COUNCIL,TOWN,KITGUM PUBLIC SCHOOL,865,3,6,2,341,61,413,8,421,0,O-19-91-03-06-03
KITGUM,CHUA COUNTY,KITGUM TOWN COUNCIL,TOWN,COURT HALL (A-A),539,1,1,1,187,49,239,3,242,0,O-19-91-03-06-04
KITGUM,CHUA COUNTY,KITGUM TOWN COUNCIL,WESTLAND,PRISON HQRS A (M-Z),795,3,5,2,331,51,392,9,401,0,O-19-91-03-07-01
KITGUM,CHUA COUNTY,KITGUM TOWN COUNCIL,WESTLAND,PRISON HQRS A (A-L),1288,7,5,12,563,93,680,21,701,0,O-19-91-03-07-02
KITGUM,CHUA COUNTY,KITGUM TOWN COUNCIL,WESTLAND,PRISON HQS B (A-L),414,0,1,1,183,29,214,5,219,0,O-19-91-03-07-03
KITGUM,CHUA COUNTY,KITGUM TOWN COUNCIL,WESTLAND,PRISON HQS B (M-Z),270,1,3,0,135,16,155,3,158,0,O-19-91-03-07-04
KITGUM,CHUA COUNTY,LABONGO-AMIDA,AKWORO,AKWORO P/S,635,5,6,3,388,25,427,0,427,0,O-19-91-04-01-01
KITGUM,CHUA COUNTY,LABONGO-AMIDA,AKWORO,MANWOKO,232,3,2,0,157,6,168,4,172,0,O-19-91-04-01-02
KITGUM,CHUA COUNTY,LABONGO-AMIDA,KOCH,ALERO P/S,274,5,9,3,177,3,197,7,204,0,O-19-91-04-02-01
KITGUM,CHUA COUNTY,LABONGO-AMIDA,KOCH,OYURU TEKWORO,412,3,3,3,283,7,299,10,309,0,O-19-91-04-02-02
KITGUM,CHUA COUNTY,LABONGO-AMIDA,LAMOLA,LAYIKKOCO(A-L),615,1,2,7,374,22,406,15,421,0,O-19-91-04-03-01
KITGUM,CHUA COUNTY,LABONGO-AMIDA,LAMOLA,LAYIKKOCO (M-Z),336,5,5,0,229,14,253,11,264,0,O-19-91-04-03-02
KITGUM,CHUA COUNTY,LABONGO-AMIDA,LUKWOR,OPETTE P.7 SCHOOL,289,5,1,2,206,9,223,5,228,0,O-19-91-04-04-01
KITGUM,CHUA COUNTY,LABONGO-AMIDA,LUKWOR,LUKWOR EAST-TEECWA,323,3,2,0,215,4,224,14,238,0,O-19-91-04-04-02
KITGUM,CHUA COUNTY,LABONGO-AMIDA,LUKWOR,LUKIRA P7 SCH,254,1,0,4,182,2,189,13,202,0,O-19-91-04-04-03
KITGUM,CHUA COUNTY,LABONGO-AMIDA,OKIDI,CAI,529,8,5,7,307,35,362,24,386,0,O-19-91-04-05-01
KITGUM,CHUA COUNTY,LABONGO-AMIDA,OKIDI,OKIDI P7 SCH,389,9,5,1,230,14,259,14,273,0,O-19-91-04-05-02
KITGUM,CHUA COUNTY,LABONGO-AMIDA,ORYANG A,TANGI AGORO,516,5,3,3,303,13,327,4,331,0,O-19-91-04-06-01
KITGUM,CHUA COUNTY,LABONGO-LAYAMO,OCETOKE,OCETOKE P.7 SCHOOL,726,9,11,6,461,58,545,11,556,0,O-19-91-05-01-01
KITGUM,CHUA COUNTY,LABONGO-LAYAMO,PAGEN,PAGEN P.7 SCHOOL,574,7,6,3,371,33,420,22,442,0,O-19-91-05-02-01
KITGUM,CHUA COUNTY,LABONGO-LAYAMO,PAGEN,GWENG AJUT,526,4,6,6,381,7,404,10,414,0,O-19-91-05-02-02
KITGUM,CHUA COUNTY,LABONGO-LAYAMO,PAIBWOR,ODUNGLE P.7 SCHOOL,989,8,2,7,688,39,744,13,757,0,O-19-91-05-03-01
KITGUM,CHUA COUNTY,LABONGO-LAYAMO,PAMOLO,AYOMA P.7 'A' SCHOOL,441,4,1,3,267,30,305,36,341,0,O-19-91-05-04-01
KITGUM,CHUA COUNTY,LABONGO-LAYAMO,PAMOLO,AYOMA P.7 'B' SCHOOL,389,5,8,5,242,20,280,9,289,0,O-19-91-05-04-02
KITGUM,CHUA COUNTY,LAGORO,LABER,AKUNNA P7 SCH,724,7,4,16,456,23,506,13,519,0,O-19-91-06-01-01
KITGUM,CHUA COUNTY,LAGORO,LABER,BULUZI P6 SCH,622,10,10,12,357,45,434,11,445,0,O-19-91-06-01-02
KITGUM,CHUA COUNTY,LAGORO,LAKWOR,LAKWOR P7 SCH,722,9,3,6,425,55,498,11,509,0,O-19-91-06-02-01
KITGUM,CHUA COUNTY,LAGORO,ORYANG-LALANO,KULU KWAC,617,1,5,5,359,17,387,23,410,0,O-19-91-06-03-01
KITGUM,CHUA COUNTY,LAGORO,ORYANG-LALANO,ACALERI'S HOME,433,4,2,3,267,17,293,17,310,0,O-19-91-06-03-02
KITGUM,CHUA COUNTY,LAGORO,PAWIDI,OGUDA,261,0,0,2,141,24,167,7,174,0,O-19-91-06-04-01
KITGUM,CHUA COUNTY,LAGORO,PAWIDI,ALEL,646,16,3,14,368,28,429,17,446,0,O-19-91-06-04-02
KITGUM,CHUA COUNTY,LAGORO,PAWIDI,ORUA,438,3,0,3,219,52,277,6,283,0,O-19-91-06-04-03
KITGUM,CHUA COUNTY,MUCHWINI,AKARA,AKARA P.7 SCHOOL,369,3,3,2,218,24,250,7,257,0,O-19-91-07-01-01
KITGUM,CHUA COUNTY,MUCHWINI,AKARA,OMENY TANGY,574,10,3,16,308,31,368,5,373,0,O-19-91-07-01-02
KITGUM,CHUA COUNTY,MUCHWINI,BURA,MUCWINI P7 SCH,606,4,6,3,342,46,401,14,415,0,O-19-91-07-02-01
KITGUM,CHUA COUNTY,MUCHWINI,BURA,ALIKITONI'S HOME,270,4,5,4,149,22,184,13,197,0,O-19-91-07-02-02
KITGUM,CHUA COUNTY,MUCHWINI,OGWAL POKE,IKOROM T/C,600,8,9,11,278,65,371,33,404,0,O-19-91-07-03-01
KITGUM,CHUA COUNTY,MUCHWINI,OKOL,OKOL P.7 SCHOOL,470,5,0,10,278,34,327,20,347,0,O-19-91-07-04-01
KITGUM,CHUA COUNTY,MUCHWINI,PACHUA,DOG TANGI KABETE,352,6,4,7,204,24,245,24,269,0,O-19-91-07-05-01
KITGUM,CHUA COUNTY,MUCHWINI,PAJONG,PAJONG P.7 SCHOOL,412,6,11,6,251,25,299,8,307,0,O-19-91-07-06-01
KITGUM,CHUA COUNTY,MUCHWINI,PAJONG,AGWOKO TANGY,533,2,3,12,320,36,373,6,379,0,O-19-91-07-06-02
KITGUM,CHUA COUNTY,MUCHWINI,PUBECH,LAGOTCUGU P/S,711,7,7,8,250,188,460,0,460,0,O-19-91-07-07-01
KITGUM,CHUA COUNTY,MUCHWINI,PUBECH,LARAKA P4 SCHOOL,379,5,3,5,281,20,314,10,324,0,O-19-91-07-07-02
KITGUM,CHUA COUNTY,MUCHWINI,PUBECH,DANIEL COMBONI,227,5,4,2,130,16,157,13,170,0,O-19-91-07-07-03
KITGUM,CHUA COUNTY,MUCHWINI,PUDO,TECUKPUDO,648,6,5,17,388,42,458,14,472,0,O-19-91-07-08-01
KITGUM,CHUA COUNTY,MUCHWINI,PUDO,TEKIBU PACHUA,292,1,3,3,158,41,206,10,216,0,O-19-91-07-08-02
KITGUM,CHUA COUNTY,MUCHWINI,YEPA,YEPA SCHOOL,679,8,6,4,324,121,463,47,510,0,O-19-91-07-09-01
KITGUM,CHUA COUNTY,NAM-OKORA,KALABONG,TIBAK,399,10,2,9,232,21,274,5,279,0,O-19-91-08-01-01
KITGUM,CHUA COUNTY,NAM-OKORA,KALABONG,KALABONG P7 SCH,446,4,1,5,258,22,290,7,297,0,O-19-91-08-01-02
KITGUM,CHUA COUNTY,NAM-OKORA,PAGWOK,NAMOKORA P.7 SCHOOL (A-K),513,11,3,10,274,35,333,17,350,0,O-19-91-08-02-01
KITGUM,CHUA COUNTY,NAM-OKORA,PAGWOK,TE YAT-TOO,414,7,2,3,199,8,219,8,227,0,O-19-91-08-02-02
KITGUM,CHUA COUNTY,NAM-OKORA,PAGWOK,ONYALA P.7 SCHOOL,410,9,3,3,250,17,282,11,293,0,O-19-91-08-02-03
KITGUM,CHUA COUNTY,NAM-OKORA,PAGWOK,NAMOKORA P.7 SCHOOL (L-Z),481,2,5,1,247,42,297,16,313,0,O-19-91-08-02-04
KITGUM,CHUA COUNTY,NAM-OKORA,PUGODA EAST,NAMOKORA SUBCOUNTY HQS (A-,477,7,3,7,208,43,268,21,289,0,O-19-91-08-03-01
KITGUM,CHUA COUNTY,NAM-OKORA,PUGODA EAST,GUDA P7 SCH,628,7,4,7,352,58,428,25,453,0,O-19-91-08-03-02
KITGUM,CHUA COUNTY,NAM-OKORA,PUGODA EAST,LAPANA PRI.SCHOOL,260,2,1,3,86,86,178,6,184,0,O-19-91-08-03-03
KITGUM,CHUA COUNTY,NAM-OKORA,PUGODA EAST,NAMOKORA SUBCOUNTY HQS (L-,340,2,0,1,184,34,221,12,233,0,O-19-91-08-03-04
KITGUM,CHUA COUNTY,NAM-OKORA,PUGODA WEST,BOLA P7 SCH,464,8,3,14,258,27,310,10,320,0,O-19-91-08-04-01
KITGUM,CHUA COUNTY,OMIA ANYIMA,AKOBI,PEDARYAM (M-Z),284,4,0,3,173,12,192,7,199,0,O-19-91-09-01-01
KITGUM,CHUA COUNTY,OMIA ANYIMA,AKOBI,PEDARYAM (A-L),501,7,7,13,268,14,309,13,322,0,O-19-91-09-01-02
KITGUM,CHUA COUNTY,OMIA ANYIMA,AKOBI,LABWOROMOR (A-L),518,3,1,15,260,11,290,13,303,0,O-19-91-09-01-03
KITGUM,CHUA COUNTY,OMIA ANYIMA,AKOBI,LABWOROMOR (M-Z),274,2,3,4,170,18,197,2,199,0,O-19-91-09-01-04
KITGUM,CHUA COUNTY,OMIA ANYIMA,PALWO,LOPUR P.7 (A-L),631,14,12,18,329,18,391,21,412,0,O-19-91-09-02-01
KITGUM,CHUA COUNTY,OMIA ANYIMA,PALWO,LOPUR P.7 (M-Z),344,4,2,4,238,16,264,5,269,0,O-19-91-09-02-02
KITGUM,CHUA COUNTY,OMIA ANYIMA,PALWO,WINGWENG P7 SCHOOL,703,18,7,27,401,29,482,24,506,0,O-19-91-09-02-03
KITGUM,CHUA COUNTY,OMIA ANYIMA,PANYUM PELA,OMIYA ANYIMA T/C A (A-L),727,14,7,12,319,16,368,18,386,0,O-19-91-09-03-01
KITGUM,CHUA COUNTY,OMIA ANYIMA,PANYUM PELA,OMIYA ANYIMA T/C A (M-Z),454,5,1,3,227,10,246,13,259,0,O-19-91-09-03-02
KITGUM,CHUA COUNTY,OMIA ANYIMA,PANYUM PELA,PELLA SCH B,687,11,7,12,351,22,403,13,416,0,O-19-91-09-03-03
KITGUM,CHUA COUNTY,OMIA ANYIMA,PANYUM-MELONG,KUMELLE PRI.SCHOOL,356,12,6,10,187,14,229,21,250,0,O-19-91-09-04-01
KITGUM,CHUA COUNTY,OMIA ANYIMA,PANYUM-MELONG,OMIYA ANYIMA T/C B,459,6,4,11,252,9,282,25,307,0,O-19-91-09-04-02
KITGUM,CHUA COUNTY,OMIA ANYIMA,PANYUM-MELONG,PELLA SCH A,738,12,7,20,364,32,435,28,463,0,O-19-91-09-04-03
KITGUM,CHUA COUNTY,OROM,AKURIMO,LUCHOMO P7 SCH,562,19,22,28,64,203,336,42,378,0,O-19-91-10-01-01
KITGUM,CHUA COUNTY,OROM,AKURIMO,LODWAR,117,0,4,5,19,41,69,4,73,0,O-19-91-10-01-02
KITGUM,CHUA COUNTY,OROM,AKURIMO,NABOLO PRI.SCHOOL,135,1,5,5,73,17,101,6,107,0,O-19-91-10-01-03
KITGUM,CHUA COUNTY,OROM,KATWOTWO,LOLOKO   P7 SCHOOL,333,2,1,2,182,14,201,6,207,0,O-19-91-10-02-01
KITGUM,CHUA COUNTY,OROM,KATWOTWO,MORUCOLONG,293,1,1,6,156,54,218,11,229,0,O-19-91-10-02-02
KITGUM,CHUA COUNTY,OROM,KATWOTWO,OLAYA,291,7,6,14,115,59,201,20,221,0,O-19-91-10-02-03
KITGUM,CHUA COUNTY,OROM,KITENY,KWARAYO APIMOTUR,496,12,7,22,214,24,279,29,308,0,O-19-91-10-03-01
KITGUM,CHUA COUNTY,OROM,KITENY,LALEKAN,256,5,1,2,133,13,154,11,165,0,O-19-91-10-03-02
KITGUM,CHUA COUNTY,OROM,KITENY,LADOTONEN P/S,351,6,3,9,157,18,193,10,203,0,O-19-91-10-03-03
KITGUM,CHUA COUNTY,OROM,KITENY,BONGOPII,391,8,4,4,212,13,241,4,245,0,O-19-91-10-03-04
KITGUM,CHUA COUNTY,OROM,KITENY,LAKONGERA PR SCH,168,3,1,4,88,4,100,7,107,0,O-19-91-10-03-05
KITGUM,CHUA COUNTY,OROM,KITENY,AKURUCUK,246,6,2,3,115,9,135,5,140,0,O-19-91-10-03-06
KITGUM,CHUA COUNTY,OROM,LOLIA,OROM SUBCOUNTY HQS,591,8,5,7,255,34,309,21,330,0,O-19-91-10-04-01
KITGUM,CHUA COUNTY,OROM,LOLIA,CAMGWENG P. SCHOOL,345,5,8,19,169,25,226,8,234,0,O-19-91-10-04-02
KITGUM,CHUA COUNTY,OROM,LOLIA,RUKUK,147,4,1,3,91,6,105,10,115,0,O-19-91-10-04-03
KITGUM,CHUA COUNTY,OROM,LOLIA,LAPEITAK CHURCH,312,8,3,12,155,41,219,11,230,0,O-19-91-10-04-04
KITGUM,CHUA COUNTY,OROM,LOLIA,ORM OUTSIDE Q.GUARD,56,0,0,0,3,0,3,0,3,0,O-19-91-10-04-05
KITGUM,CHUA COUNTY,OROM,LOLWA,KAMADING,265,13,7,8,135,27,190,13,203,0,O-19-91-10-05-01
KITGUM,CHUA COUNTY,OROM,LOLWA,AGOROMIN P7 SCH,305,4,2,0,151,59,216,5,221,0,O-19-91-10-05-02
KITGUM,CHUA COUNTY,OROM,LOLWA,LAGWELIMA CENTRAL WARD,277,3,4,10,178,18,213,10,223,0,O-19-91-10-05-03
KITGUM,CHUA COUNTY,OROM,LOLWA,LONGANYURA PR. SCH,352,6,4,10,170,44,234,14,248,0,O-19-91-10-05-04
KITGUM,CHUA COUNTY,OROM,OKUTI,AKILOK P/S,369,11,4,14,100,64,193,30,223,0,O-19-91-10-06-01
KITGUM,CHUA COUNTY,OROM,OKUTI,LOCOM P4 SCH,384,8,2,4,204,29,247,5,252,0,O-19-91-10-06-02
KITGUM,CHUA COUNTY,OROM,OKUTI,LOKOM,397,5,5,7,143,15,175,9,184,0,O-19-91-10-06-03
KOTIDO,JIE COUNTY,KACHERI,KACHERI I,S/COUNTY H/QRS I (A-K),309,2,4,1,4,114,125,11,136,0,O-20-94-01-01-01
KOTIDO,JIE COUNTY,KACHERI,KACHERI I,KACHERI P/S (A-L),572,8,7,19,11,222,267,31,298,0,O-20-94-01-01-02
KOTIDO,JIE COUNTY,KACHERI,KACHERI I,S/COUNTY H/QRS I (L-Z),676,2,2,15,70,179,268,30,298,0,O-20-94-01-01-03
KOTIDO,JIE COUNTY,KACHERI,KACHERI I,KACHERI P/S (M-Z),386,8,11,9,10,183,221,26,247,0,O-20-94-01-01-04
KOTIDO,JIE COUNTY,KACHERI,KACHERI III,LOKIDING,595,1,0,7,1,319,328,16,344,0,O-20-94-01-02-01
KOTIDO,JIE COUNTY,KACHERI,KACHERI III,NARIAMATOLIM,522,4,5,12,4,294,319,35,354,0,O-20-94-01-02-02
KOTIDO,JIE COUNTY,KACHERI,LOKIDING/KANAMERI,KALOGWEL,666,0,1,7,1,421,430,15,445,0,O-20-94-01-03-01
KOTIDO,JIE COUNTY,KACHERI,LOKIDING/KANAMERI,LOKIDING P/S,446,2,1,2,5,426,436,2,438,0,O-20-94-01-03-02
KOTIDO,JIE COUNTY,KACHERI,LOTHAKUCHA,KOKORIA CHAPEL,812,2,4,6,2,270,284,27,311,0,O-20-94-01-04-01
KOTIDO,JIE COUNTY,KACHERI,LOTHAKUCHA,LOTHAKUCHA P/S,468,3,5,16,6,374,404,35,439,0,O-20-94-01-04-02
KOTIDO,JIE COUNTY,KOTIDO,KANAWAT,WUM WUM I (KANAWIT),410,3,3,3,21,96,126,6,132,0,O-20-94-02-01-01
KOTIDO,JIE COUNTY,KOTIDO,KANAWAT,KAWALAPEI,399,1,1,3,25,180,210,30,240,0,O-20-94-02-01-02
KOTIDO,JIE COUNTY,KOTIDO,KANAWAT,WUM WUM III,1260,10,2,32,9,376,429,32,461,0,O-20-94-02-01-03
KOTIDO,JIE COUNTY,KOTIDO,LOKITALAEBU,LOKITELAEBU PR SCH,215,2,0,1,5,112,120,11,131,0,O-20-94-02-02-01
KOTIDO,JIE COUNTY,KOTIDO,LOKITALAEBU,LOMUDIT,876,5,1,14,12,338,370,68,438,0,O-20-94-02-02-02
KOTIDO,JIE COUNTY,KOTIDO,LOKITALAEBU,KAIPOO,196,2,1,2,1,69,75,30,105,0,O-20-94-02-02-03
KOTIDO,JIE COUNTY,KOTIDO,LOKITALAEBU,OUTSIDE QUARTER GUARD,158,0,3,2,34,107,146,1,147,0,O-20-94-02-02-04
KOTIDO,JIE COUNTY,KOTIDO,LOPEI/ROM-ROM,WUM WUM I (KANAWIT),568,1,3,5,10,61,80,74,154,0,O-20-94-02-03-01
KOTIDO,JIE COUNTY,KOTIDO,LOPEI/ROM-ROM,MERIWALA,499,0,8,4,3,232,247,62,309,0,O-20-94-02-03-02
KOTIDO,JIE COUNTY,KOTIDO,LOSILANG,KOTIDO GIRLS P. SCHOOL I,530,2,3,13,12,170,200,21,221,0,O-20-94-02-04-01
KOTIDO,JIE COUNTY,KOTIDO,LOSILANG,KOTIDO GIRLS P. SCHOOL II,868,6,4,22,17,350,399,52,451,0,O-20-94-02-04-02
KOTIDO,JIE COUNTY,KOTIDO,LOSILANG,NAGEEM P. SCHOOL,326,10,5,17,8,244,284,20,304,0,O-20-94-02-04-03
KOTIDO,JIE COUNTY,KOTIDO,NAWII II,LOYOROIT,251,1,0,2,2,114,119,10,129,0,O-20-94-02-05-01
KOTIDO,JIE COUNTY,KOTIDO TOWN COUNCIL,KOTIDO CENTRAL,MINISTRY OF WORKS,640,5,2,6,158,91,262,19,281,0,O-20-94-03-01-01
KOTIDO,JIE COUNTY,KOTIDO TOWN COUNCIL,KOTIDO CENTRAL,ACHOLI INN,371,0,0,2,67,54,123,5,128,0,O-20-94-03-01-02
KOTIDO,JIE COUNTY,KOTIDO TOWN COUNCIL,KOTIDO EAST,ACHOLI QUARTERS,809,3,4,4,142,128,281,6,287,0,O-20-94-03-02-01
KOTIDO,JIE COUNTY,KOTIDO TOWN COUNCIL,KOTIDO EAST,ENTEBBE AREA,395,3,2,2,51,127,185,7,192,0,O-20-94-03-02-02
KOTIDO,JIE COUNTY,KOTIDO TOWN COUNCIL,KOTIDO NORTH,COUNTY HEAD QUARTERS,485,3,5,3,73,183,267,14,281,0,O-20-94-03-03-01
KOTIDO,JIE COUNTY,KOTIDO TOWN COUNCIL,KOTIDO RURAL,LOMUKURA P SCHOOL I,511,2,0,7,8,145,162,47,209,0,O-20-94-03-04-01
KOTIDO,JIE COUNTY,KOTIDO TOWN COUNCIL,KOTIDO RURAL,LOMUKURA P SCHOOL II,548,7,4,19,8,278,316,31,347,0,O-20-94-03-04-02
KOTIDO,JIE COUNTY,KOTIDO TOWN COUNCIL,KOTIDO WEST,OLD ADMINISTRATION BUILDING,363,1,1,1,64,132,199,5,204,0,O-20-94-03-05-01
KOTIDO,JIE COUNTY,KOTIDO TOWN COUNCIL,NARIKAPET,NARIKAPET VILLAGE,724,3,2,6,149,183,343,16,359,0,O-20-94-03-06-01
KOTIDO,JIE COUNTY,KOTIDO TOWN COUNCIL,NAWII III,LOKIPACHA,389,4,1,13,5,215,238,19,257,0,O-20-94-03-07-01
KOTIDO,JIE COUNTY,NAKAPERIMORU,LOKOROK,LOGUMATUM,895,3,8,7,1,451,470,21,491,0,O-20-94-04-01-01
KOTIDO,JIE COUNTY,NAKAPERIMORU,NAWII IV,KAMORUMOR,488,18,20,36,14,344,432,56,488,0,O-20-94-04-02-01
KOTIDO,JIE COUNTY,NAKAPERIMORU,NAWII IV,AYOLLO,345,5,0,5,2,92,104,22,126,0,O-20-94-04-02-02
KOTIDO,JIE COUNTY,NAKAPERIMORU,POTONGOR,LONGELEP,845,11,5,36,7,380,439,18,457,0,O-20-94-04-03-01
KOTIDO,JIE COUNTY,NAKAPERIMORU,WATAKAU,LOKORE I,707,16,12,32,29,317,406,57,463,0,O-20-94-04-04-01
KOTIDO,JIE COUNTY,NAKAPERIMORU,WATAKAU,LOKORE II,593,6,3,13,11,404,437,33,470,0,O-20-94-04-04-02
KOTIDO,JIE COUNTY,NAKAPERIMORU,WATAKAU,OUTSIDE Q. GUARD,437,1,2,0,126,99,228,4,232,0,O-20-94-04-04-03
KOTIDO,JIE COUNTY,PANYANGARA,KAMOR,KAMOR CENTRAL,719,0,0,2,0,258,260,76,336,0,O-20-94-05-01-01
KOTIDO,JIE COUNTY,PANYANGARA,KAMOR,NAKABUURU,418,3,2,12,16,160,193,39,232,0,O-20-94-05-01-02
KOTIDO,JIE COUNTY,PANYANGARA,KAMOR,NAMOGOSIT,452,4,8,11,8,243,274,27,301,0,O-20-94-05-01-03
KOTIDO,JIE COUNTY,PANYANGARA,LOLETIO,KADOKINI CENTRAL WARD,626,7,5,23,8,327,370,14,384,0,O-20-94-05-02-01
KOTIDO,JIE COUNTY,PANYANGARA,LOLETIO,PANYANGARA P. SCHOOL II,498,3,3,8,34,142,190,13,203,0,O-20-94-05-02-02
KOTIDO,JIE COUNTY,PANYANGARA,LOLETIO,PANYANGARA P. SCHOOL III,1016,10,5,18,8,198,239,57,296,0,O-20-94-05-02-03
KOTIDO,JIE COUNTY,PANYANGARA,LOPOSA,KAMOR CENTRAL WARD,21,0,0,0,0,10,10,0,10,0,O-20-94-05-03-01
KOTIDO,JIE COUNTY,PANYANGARA,LOPOSA,KONGESIA I,72,0,0,1,1,31,33,2,35,0,O-20-94-05-03-02
KOTIDO,JIE COUNTY,PANYANGARA,LOPOSA,KONGESIA II,1246,4,1,6,4,331,346,24,370,0,O-20-94-05-03-03
KOTIDO,JIE COUNTY,PANYANGARA,LOPOSA,NAPUM - PUM PRI. SCHOOL,674,0,1,2,3,188,194,25,219,0,O-20-94-05-03-04
KOTIDO,JIE COUNTY,PANYANGARA,NAWII I,KOPUWA,411,0,1,3,8,100,112,14,126,0,O-20-94-05-04-01
KOTIDO,JIE COUNTY,PANYANGARA,RIKITAE,DIRA PRIMARY SCHOOL,383,10,5,10,11,89,125,13,138,0,O-20-94-05-05-01
KOTIDO,JIE COUNTY,PANYANGARA,RIKITAE,RIKITAE HEALTH UNIT,508,3,0,13,5,211,232,33,265,0,O-20-94-05-05-02
KOTIDO,JIE COUNTY,PANYANGARA,RIKITAE,LOMOKORI PRI. SCHOOL,536,1,2,8,27,197,235,130,365,0,O-20-94-05-05-03
KOTIDO,JIE COUNTY,RENGEN,KOTYANG,NAPONG/KADUKAN,344,0,0,1,0,212,213,12,225,0,O-20-94-06-01-01
KOTIDO,JIE COUNTY,RENGEN,KOTYANG,KAKULOI LOKALE,523,0,2,3,2,339,346,7,353,0,O-20-94-06-01-02
KOTIDO,JIE COUNTY,RENGEN,KOTYANG,LOMERILENG,435,2,0,0,0,326,328,16,344,0,O-20-94-06-01-03
KOTIDO,JIE COUNTY,RENGEN,LOKADELI,RENGEN PR SCH,159,2,1,4,3,35,45,4,49,0,O-20-94-06-02-01
KOTIDO,JIE COUNTY,RENGEN,LOKADELI,LOOI,534,4,2,11,17,244,278,17,295,0,O-20-94-06-02-02
KOTIDO,JIE COUNTY,RENGEN,LOKADELI,RETAE LOKALE,419,5,8,24,7,198,242,26,268,0,O-20-94-06-02-03
KOTIDO,JIE COUNTY,RENGEN,LOPUYO,NAKWALET (WUM WUM) II,820,3,2,5,3,319,332,51,383,0,O-20-94-06-03-01
KOTIDO,JIE COUNTY,RENGEN,LOPUYO,NAKWALET [WUM WUM] I,287,1,0,3,1,151,156,2,158,0,O-20-94-06-03-02
KOTIDO,JIE COUNTY,RENGEN,NAKWAKWA,NAKORETO CHAPEL,640,2,5,5,2,328,342,19,361,0,O-20-94-06-04-01
KOTIDO,JIE COUNTY,RENGEN,NAKWAKWA,NAKWAKWA,571,0,1,7,1,415,424,9,433,0,O-20-94-06-04-02
KOTIDO,JIE COUNTY,RENGEN,NAKWAKWA,KANALOBAE,652,0,0,0,0,588,588,5,593,0,O-20-94-06-04-03
KOTIDO,JIE COUNTY,RENGEN,NAPONGA,NAPONGA,823,0,3,6,2,589,600,7,607,0,O-20-94-06-05-01
KOTIDO,JIE COUNTY,RENGEN,NAWII V,LONGOR DAM,224,6,4,4,0,175,189,8,197,0,O-20-94-06-06-01
LIRA,ERUTE CTY NORTH,AROMO,ACUTKUMU,ACUTKUMU P 7 SCHOOL,486,3,10,0,304,2,319,30,349,0,O-22-100-01-01-01
LIRA,ERUTE CTY NORTH,AROMO,ACUTKUMU,OMOLO,572,13,20,2,334,13,382,12,394,0,O-22-100-01-01-02
LIRA,ERUTE CTY NORTH,AROMO,APUA,APUA TRADING CENTRE,668,20,18,8,399,14,459,8,467,0,O-22-100-01-02-01
LIRA,ERUTE CTY NORTH,AROMO,APUA,APUA P 7 SCHOOL,535,15,19,2,379,6,421,14,435,0,O-22-100-01-02-02
LIRA,ERUTE CTY NORTH,AROMO,APUA,ALOC MARKET,455,9,18,6,230,11,274,5,279,0,O-22-100-01-02-03
LIRA,ERUTE CTY NORTH,AROMO,APUA,ODORO P 7 SCHOOL,417,6,21,7,175,9,218,9,227,0,O-22-100-01-02-04
LIRA,ERUTE CTY NORTH,AROMO,APUCE,APUCE STORE,580,0,3,1,131,1,136,0,136,0,O-22-100-01-03-01
LIRA,ERUTE CTY NORTH,AROMO,APUCE,AYAMI P 7   SCHOOL,753,17,43,9,409,16,494,20,514,0,O-22-100-01-03-02
LIRA,ERUTE CTY NORTH,AROMO,ARWOT-OMITO,AKORE P.7 SCHOOL,725,2,40,3,374,14,433,1,434,0,O-22-100-01-04-01
LIRA,ERUTE CTY NORTH,AROMO,ARWOT-OMITO,AGAK P.7 SCHOOLI,581,6,19,7,352,10,394,2,396,0,O-22-100-01-04-02
LIRA,ERUTE CTY NORTH,AROMO,ARWOT-OMITO,AKORE TRADING CENTRE,454,7,9,4,312,6,338,3,341,0,O-22-100-01-04-03
LIRA,ERUTE CTY NORTH,AROMO,BAR-PII,AROMO P.7 SCHOOL,582,6,11,1,300,12,330,44,374,0,O-22-100-01-05-01
LIRA,ERUTE CTY NORTH,AROMO,BAR-PII,DAM ODOCA,455,11,12,8,292,7,330,9,339,0,O-22-100-01-05-02
LIRA,ERUTE CTY NORTH,AROMO,BAR-PII,OPOK,315,4,12,0,184,4,204,28,232,0,O-22-100-01-05-03
LIRA,ERUTE CTY NORTH,AROMO,OTARA,OKETKWER,306,4,10,5,192,17,228,3,231,0,O-22-100-01-06-01
LIRA,ERUTE CTY NORTH,AROMO,OTARA,AROMO SUBCOUNTY HQRS,628,5,12,6,351,17,391,9,400,0,O-22-100-01-06-02
LIRA,ERUTE CTY NORTH,AROMO,OTARA,OTARA  P 7 SCHOOL,279,9,9,1,156,10,185,5,190,0,O-22-100-01-06-03
LIRA,ERUTE CTY NORTH,AROMO,WALELA,WAWELA P 7 SCHOOL I,647,1,14,1,324,12,352,75,427,0,O-22-100-01-07-01
LIRA,ERUTE CTY NORTH,AROMO,WALELA,WAWELA P 7 SCHOOL II,392,4,4,2,198,7,215,39,254,0,O-22-100-01-07-02
LIRA,ERUTE CTY NORTH,AROMO,WALELA,AYILE  P 7 SCHOOL,611,2,21,0,478,13,514,3,517,0,O-22-100-01-07-03
LIRA,ERUTE CTY NORTH,LIRA,AMUCA,AWITA ST MARYS CHAPEL (A-A),506,3,37,2,178,14,234,68,302,0,O-22-100-02-01-01
LIRA,ERUTE CTY NORTH,LIRA,AMUCA,AMUCHA P7 SCH,722,22,45,22,417,25,531,14,545,0,O-22-100-02-01-02
LIRA,ERUTE CTY NORTH,LIRA,AMUCA,TE-OKOLE P7 SCH,610,16,58,20,349,21,464,10,474,0,O-22-100-02-01-03
LIRA,ERUTE CTY NORTH,LIRA,AMUCA,AWITA ST MARYS CHAPEL (B-Z),433,5,30,1,224,22,282,9,291,0,O-22-100-02-01-04
LIRA,ERUTE CTY NORTH,LIRA,ANAI,ANAI P 7 SCHOOL,722,6,77,1,286,16,386,95,481,0,O-22-100-02-02-01
LIRA,ERUTE CTY NORTH,LIRA,ANAI,ANAI P.7 SCHOOL II,769,8,72,5,301,35,421,93,514,0,O-22-100-02-02-02
LIRA,ERUTE CTY NORTH,LIRA,ANAI,ANAI IDP (A-B),405,1,13,0,85,1,100,2,102,0,O-22-100-02-02-03
LIRA,ERUTE CTY NORTH,LIRA,ANAI,ANAI IDP (C-Z),270,0,4,0,51,0,55,1,56,0,O-22-100-02-02-04
LIRA,ERUTE CTY NORTH,LIRA,BAR-APWO,BAR APWO P 7 SCHOOL,484,4,61,1,198,17,281,41,322,0,O-22-100-02-03-01
LIRA,ERUTE CTY NORTH,LIRA,BAR-APWO,NEW SITE,504,11,72,4,160,5,252,73,325,0,O-22-100-02-03-02
LIRA,ERUTE CTY NORTH,LIRA,BAR-APWO,BAR APWO T.C,504,4,39,5,214,11,273,76,349,0,O-22-100-02-03-03
LIRA,ERUTE CTY NORTH,LIRA,BAR-APWO,BAR APWO SUB-CTY HRS,395,11,35,1,160,11,218,84,302,0,O-22-100-02-03-04
LIRA,ERUTE CTY NORTH,LIRA,BAR-APWO,TELELA CAMP,181,0,18,0,55,0,73,1,74,0,O-22-100-02-03-05
LIRA,ERUTE CTY NORTH,LIRA,OMITO,OMITO P.7 SCHOOL,311,2,16,2,142,10,172,63,235,0,O-22-100-02-04-01
LIRA,ERUTE CTY NORTH,LIRA,OMITO,ADER,888,6,70,2,354,37,469,160,629,0,O-22-100-02-04-02
LIRA,ERUTE CTY NORTH,LIRA,OMITO,ST JOSEPH CHAPEL,196,5,11,6,137,18,177,7,184,0,O-22-100-02-04-03
LIRA,ERUTE CTY NORTH,LIRA,OMITO,ATODI,278,2,18,2,170,13,205,8,213,0,O-22-100-02-04-04
LIRA,ERUTE CTY NORTH,OGUR,ABALA,ABALA P 7 SCHOOL,645,13,87,3,329,8,440,9,449,0,O-22-100-03-01-01
LIRA,ERUTE CTY NORTH,OGUR,ABALA,CUK OKIKO,634,12,71,3,276,12,374,59,433,0,O-22-100-03-01-02
LIRA,ERUTE CTY NORTH,OGUR,ABALA,ODYEK MER,417,9,32,1,220,9,271,62,333,0,O-22-100-03-01-03
LIRA,ERUTE CTY NORTH,OGUR,ADWOA,COOROM,465,11,23,10,232,12,288,8,296,0,O-22-100-03-02-01
LIRA,ERUTE CTY NORTH,OGUR,ADWOA,AYANGONGEC,376,7,23,4,138,7,179,12,191,0,O-22-100-03-02-02
LIRA,ERUTE CTY NORTH,OGUR,ADWOA,TE-ADWA,396,3,41,7,195,1,247,0,247,0,O-22-100-03-02-03
LIRA,ERUTE CTY NORTH,OGUR,AKANGI,AKANGI P 7 SCHOOL I,723,8,37,4,571,3,623,7,630,0,O-22-100-03-03-01
LIRA,ERUTE CTY NORTH,OGUR,AKANGI,AKANGI P.7 SCHOOL II,636,4,30,0,454,4,492,0,492,0,O-22-100-03-03-02
LIRA,ERUTE CTY NORTH,OGUR,AKANGI,AKOR,728,3,18,7,521,11,560,3,563,0,O-22-100-03-03-03
LIRA,ERUTE CTY NORTH,OGUR,AKANO,AKANO P 7 SCHOOL I,746,4,43,6,533,12,598,7,605,0,O-22-100-03-04-01
LIRA,ERUTE CTY NORTH,OGUR,AKANO,AKANO P 7 SCHOOL II,460,6,37,5,305,9,362,4,366,0,O-22-100-03-04-02
LIRA,ERUTE CTY NORTH,OGUR,AKANO,LWALA P 7 SCHOOL,649,9,39,11,338,5,402,15,417,0,O-22-100-03-04-03
LIRA,ERUTE CTY NORTH,OGUR,ANGOLOCOM,AMIABIL,289,8,12,5,184,8,217,4,221,0,O-22-100-03-05-01
LIRA,ERUTE CTY NORTH,OGUR,ANGOLOCOM,WIAKOT,584,5,25,5,305,16,356,27,383,0,O-22-100-03-05-02
LIRA,ERUTE CTY NORTH,OGUR,ANGOLOCOM,AGAK,540,7,16,14,322,9,368,19,387,0,O-22-100-03-05-03
LIRA,ERUTE CTY NORTH,OGUR,ANGOLOCOM,AULEIMALO,663,9,31,11,524,6,581,10,591,0,O-22-100-03-05-04
LIRA,ERUTE CTY NORTH,OGUR,ANGOLOCOM,ADWOGO ILERO,234,3,6,6,126,3,144,4,148,0,O-22-100-03-05-05
LIRA,ERUTE CTY NORTH,OGUR,APOKA,OGUR P 7 SCHOOL,718,9,78,12,340,27,466,20,486,0,O-22-100-03-06-01
LIRA,ERUTE CTY NORTH,OGUR,APOKA,ALER P.7 SCHOOL,493,4,24,1,305,8,342,8,350,0,O-22-100-03-06-02
LIRA,ERUTE CTY NORTH,OGUR,APOKA,NGINGINYA,652,7,60,18,313,20,418,14,432,0,O-22-100-03-06-03
LIRA,ERUTE CTY NORTH,OGUR,APOKA,CUK OKIKO,595,6,43,5,294,24,372,138,510,0,O-22-100-03-06-04
LIRA,ERUTE CTY NORTH,OGUR,OGUR,OKWALO AMARA,761,10,40,20,365,9,444,31,475,0,O-22-100-03-07-01
LIRA,ERUTE CTY NORTH,OGUR,OGUR,OGUR HEALTH CENTRE,665,10,64,11,342,70,497,18,515,0,O-22-100-03-07-02
LIRA,ERUTE CTY NORTH,OGUR,OGUR,OGUR TRADING CENTRE,523,7,24,15,307,4,357,19,376,0,O-22-100-03-07-03
LIRA,ERUTE CTY NORTH,OGUR,OGUR,OGUR SUB-COUNTY HEADQUART,600,4,69,8,344,21,446,19,465,0,O-22-100-03-07-04
LIRA,ERUTE CTY NORTH,OGUR,ORIT,ORIT P7 SCHOOL,805,8,57,9,451,10,535,13,548,0,O-22-100-03-08-01
LIRA,ERUTE CTY NORTH,OGUR,ORIT,AGWENG P 7 SCHOOL,574,13,25,10,270,25,343,12,355,0,O-22-100-03-08-02
LIRA,ERUTE CTY NORTH,OGUR,ORIT,OCANOYERE SOCIETY,573,7,27,8,294,15,351,4,355,0,O-22-100-03-08-03
LIRA,ERUTE CTY NORTH,OGUR,ORIT,BARLONYO,346,6,27,3,203,4,243,24,267,0,O-22-100-03-08-04
LIRA,ERUTE CTY SOUTH,ADEKOKWOK,ADEKOKWOK,ABONYO P 7 SCHOOL,519,12,40,18,315,23,408,9,417,0,O-22-101-01-01-01
LIRA,ERUTE CTY SOUTH,ADEKOKWOK,ADEKOKWOK,BARACACI,738,17,44,18,434,37,550,23,573,0,O-22-101-01-01-02
LIRA,ERUTE CTY SOUTH,ADEKOKWOK,AKIA,AMOLEL CHURCH OF UGANDA,634,8,27,10,432,29,506,6,512,0,O-22-101-01-02-01
LIRA,ERUTE CTY SOUTH,ADEKOKWOK,AKIA,AKIA P 7 SCHOOL,525,12,22,12,261,24,331,19,350,0,O-22-101-01-02-02
LIRA,ERUTE CTY SOUTH,ADEKOKWOK,AKIA,BUR-LOBO P.7 SCHOOL,480,7,32,11,326,16,392,26,418,0,O-22-101-01-02-03
LIRA,ERUTE CTY SOUTH,ADEKOKWOK,ANYANGAPUC,COMBONI COLLEGE,676,4,20,5,337,21,387,34,421,0,O-22-101-01-03-01
LIRA,ERUTE CTY SOUTH,ADEKOKWOK,ANYANGAPUC,N.T.C NGETTA I,730,12,22,5,435,17,491,18,509,0,O-22-101-01-03-02
LIRA,ERUTE CTY SOUTH,ADEKOKWOK,ANYANGAPUC,N.T.C NGETTA II,636,5,31,5,344,34,419,6,425,0,O-22-101-01-03-03
LIRA,ERUTE CTY SOUTH,ADEKOKWOK,ANYANGAPUC,ALER FARM,661,4,23,1,327,18,373,97,470,0,O-22-101-01-03-04
LIRA,ERUTE CTY SOUTH,ADEKOKWOK,ANYANGAPUC,CURA P.7 SCHOOL,597,8,16,12,413,5,454,12,466,0,O-22-101-01-03-05
LIRA,ERUTE CTY SOUTH,ADEKOKWOK,ANYOMOREM,NGETTA D . F . I    I,679,6,21,9,298,29,363,27,390,0,O-22-101-01-04-01
LIRA,ERUTE CTY SOUTH,ADEKOKWOK,ANYOMOREM,NGETTA D . F . I   II,585,1,13,7,346,24,391,8,399,0,O-22-101-01-04-02
LIRA,ERUTE CTY SOUTH,ADEKOKWOK,ANYOMOREM,ANYOMOREM P.7 SCHOOL I,596,3,12,4,420,5,444,21,465,0,O-22-101-01-04-03
LIRA,ERUTE CTY SOUTH,ADEKOKWOK,ANYOMOREM,ANYOMOREM P.7 SCHOOL II,524,6,14,6,399,10,435,3,438,0,O-22-101-01-04-04
LIRA,ERUTE CTY SOUTH,ADEKOKWOK,BOKE,ADIKDIDGWENO I,434,4,25,0,202,18,249,74,323,0,O-22-101-01-05-01
LIRA,ERUTE CTY SOUTH,ADEKOKWOK,BOKE,ADIKDIDGWENO II,385,4,31,2,186,19,242,37,279,0,O-22-101-01-05-02
LIRA,ERUTE CTY SOUTH,ADEKOKWOK,BOKE,OPWO-AKERE,302,6,20,2,186,7,221,35,256,0,O-22-101-01-05-03
LIRA,ERUTE CTY SOUTH,ADEKOKWOK,BOKE,OMAA,309,3,15,3,206,2,229,12,241,0,O-22-101-01-05-04
LIRA,ERUTE CTY SOUTH,ADEKOKWOK,BOKE,ANGWETANGWET A,350,2,26,0,225,13,266,6,272,0,O-22-101-01-05-05
LIRA,ERUTE CTY SOUTH,ADEKOKWOK,BOKE,ANGWETANGWET B,405,5,29,2,238,12,286,15,301,0,O-22-101-01-05-06
LIRA,ERUTE CTY SOUTH,ADEKOKWOK,BOROBORO,OWINYO CHURCH,427,9,34,5,264,12,324,14,338,0,O-22-101-01-06-01
LIRA,ERUTE CTY SOUTH,ADEKOKWOK,BOROBORO,ADWILA P 7 SCHOOL,430,5,33,1,207,9,255,68,323,0,O-22-101-01-06-02
LIRA,ERUTE CTY SOUTH,ADEKOKWOK,BOROBORO,CONON LAWRENCE DEM.,644,3,49,7,268,32,359,0,359,0,O-22-101-01-06-03
LIRA,ERUTE CTY SOUTH,ADEKOKWOK,BOROBORO,BAROPU,529,10,49,9,285,16,369,10,379,0,O-22-101-01-06-04
LIRA,ERUTE CTY SOUTH,ADEKOKWOK,BOROBORO,ANYAGATIR TRADING CENTRE,693,15,56,8,395,13,487,59,546,0,O-22-101-01-06-05
LIRA,ERUTE CTY SOUTH,ADEKOKWOK,BOROBORO,TE-OBIA,268,4,17,5,109,6,141,8,149,0,O-22-101-01-06-06
LIRA,ERUTE CTY SOUTH,ADEKOKWOK,ONGICA,IWAL P.7 SCHOOL,658,12,31,7,342,8,400,162,562,0,O-22-101-01-07-01
LIRA,ERUTE CTY SOUTH,ADEKOKWOK,ONGICA,ONGICA TRADING CENTRE,638,8,22,8,491,7,536,6,542,0,O-22-101-01-07-02
LIRA,ERUTE CTY SOUTH,ADEKOKWOK,ONGICA,OCOL MARKET,491,8,21,9,268,9,315,6,321,0,O-22-101-01-07-03
LIRA,ERUTE CTY SOUTH,ADEKOKWOK,ONGICA,MAKATIN MARKET,584,10,12,6,421,10,459,31,490,0,O-22-101-01-07-04
LIRA,ERUTE CTY SOUTH,AMACH,ABONGORWOT,ABONGORWOT P 7 SCHOOL,439,6,10,3,150,16,185,130,315,0,O-22-101-02-01-01
LIRA,ERUTE CTY SOUTH,AMACH,ABONGORWOT,ACUNG PI RWOT,682,14,45,6,413,14,492,85,577,0,O-22-101-02-01-02
LIRA,ERUTE CTY SOUTH,AMACH,ABWOCOLIL,WIODYEK,664,11,42,23,404,26,506,20,526,0,O-22-101-02-02-01
LIRA,ERUTE CTY SOUTH,AMACH,ABWOCOLIL,OLIL,668,6,36,10,374,43,469,79,548,0,O-22-101-02-02-02
LIRA,ERUTE CTY SOUTH,AMACH,ABWOCOLIL,AMOKOGE,332,4,16,1,180,19,220,70,290,0,O-22-101-02-02-03
LIRA,ERUTE CTY SOUTH,AMACH,ADYAKA,ADYAKA P 7 SCHOOL,790,15,55,8,461,22,561,22,583,0,O-22-101-02-03-01
LIRA,ERUTE CTY SOUTH,AMACH,ADYAKA,ODYEK OGAI,590,10,70,9,376,14,479,0,479,0,O-22-101-02-03-02
LIRA,ERUTE CTY SOUTH,AMACH,ADYAKA,CORNER ANGWEN,586,14,56,5,321,11,407,54,461,0,O-22-101-02-03-03
LIRA,ERUTE CTY SOUTH,AMACH,ALWORO,ALWORO P 7 SCHOOL,647,8,41,3,414,20,486,14,500,0,O-22-101-02-04-01
LIRA,ERUTE CTY SOUTH,AMACH,ALWORO,BAROWO SOCIETY,146,0,8,3,82,4,97,6,103,0,O-22-101-02-04-02
LIRA,ERUTE CTY SOUTH,AMACH,AYACH,ODWONGA,699,3,53,2,426,18,502,67,569,0,O-22-101-02-05-01
LIRA,ERUTE CTY SOUTH,AMACH,AYACH,AMACH GOMB.,393,4,31,5,236,32,308,4,312,0,O-22-101-02-05-02
LIRA,ERUTE CTY SOUTH,AMACH,BANYA,ODYEK CAMO AOR,575,12,70,3,343,15,443,11,454,0,O-22-101-02-06-01
LIRA,ERUTE CTY SOUTH,AMACH,BANYA,ATERI,677,10,29,5,315,15,374,127,501,0,O-22-101-02-06-02
LIRA,ERUTE CTY SOUTH,AMACH,BANYA,ALINGIRI,594,6,64,9,225,28,332,110,442,0,O-22-101-02-06-03
LIRA,ERUTE CTY SOUTH,AMACH,OCAMONYANG,ODIT,652,8,11,5,347,5,376,105,481,0,O-22-101-02-07-01
LIRA,ERUTE CTY SOUTH,AMACH,OCAMONYANG,ODYEBONGWEN,422,2,9,2,298,3,314,5,319,0,O-22-101-02-07-02
LIRA,ERUTE CTY SOUTH,AMACH,OCAMONYANG,OCAMONYANG P 7   SCHOOL,735,9,28,18,459,10,524,26,550,0,O-22-101-02-07-03
LIRA,ERUTE CTY SOUTH,AMACH,OCAMONYANG,BEJA,421,9,35,7,243,3,297,11,308,0,O-22-101-02-07-04
LIRA,ERUTE CTY SOUTH,AMACH,OKILE,ATIMIKOMA P 7 SCHOOL,403,3,71,2,116,11,203,81,284,0,O-22-101-02-08-01
LIRA,ERUTE CTY SOUTH,AMACH,OKILE,OKILE P 7 SCHOOL,424,9,23,3,242,5,282,73,355,0,O-22-101-02-08-02
LIRA,ERUTE CTY SOUTH,AMACH,OKILE,GOMI P.7 SCHOOL,399,0,53,0,185,13,251,59,310,0,O-22-101-02-08-03
LIRA,ERUTE CTY SOUTH,AMACH,ONYAKEDE,ODWONGA II,189,1,11,0,128,2,142,21,163,0,O-22-101-02-09-01
LIRA,ERUTE CTY SOUTH,AMACH,ONYAKEDE,AKULI,733,12,49,9,489,17,576,18,594,0,O-22-101-02-09-02
LIRA,ERUTE CTY SOUTH,AMACH,ONYAKEDE,ONYAKIDE P 7 SCHOOL,722,6,50,11,534,15,616,4,620,0,O-22-101-02-09-03
LIRA,ERUTE CTY SOUTH,AMACH,RAO,ABERI OCER P.7 SCHOOL,377,6,27,8,220,20,281,7,288,0,O-22-101-02-10-01
LIRA,ERUTE CTY SOUTH,AMACH,RAO,ABUTOADI P 7 SCHOOL   I,476,2,20,0,213,7,242,82,324,0,O-22-101-02-10-02
LIRA,ERUTE CTY SOUTH,AMACH,RAO,ABUTOADI P 7 SCHOOL   II,478,11,20,16,281,21,349,11,360,0,O-22-101-02-10-03
LIRA,ERUTE CTY SOUTH,BARR,ABUNGA,OREM,604,4,40,3,449,20,516,3,519,0,O-22-101-03-01-01
LIRA,ERUTE CTY SOUTH,BARR,ABUNGA,ABUNG PAG,641,8,54,16,362,29,469,20,489,0,O-22-101-03-01-02
LIRA,ERUTE CTY SOUTH,BARR,ABUNGA,ABUNGA P.7 SCHOOL,668,12,53,15,433,10,523,6,529,0,O-22-101-03-01-03
LIRA,ERUTE CTY SOUTH,BARR,ALEBERE,ABIKET PRIMARY SCHOOL,649,13,40,4,376,13,446,81,527,0,O-22-101-03-02-01
LIRA,ERUTE CTY SOUTH,BARR,ALEBERE,ALEBERE P 7 SCHOOL I,485,8,36,10,287,21,362,20,382,0,O-22-101-03-02-02
LIRA,ERUTE CTY SOUTH,BARR,ALEBERE,ALEBERE P.7 SCHOOL II,493,6,31,10,205,11,263,130,393,0,O-22-101-03-02-03
LIRA,ERUTE CTY SOUTH,BARR,AYAMO,ODANO,430,8,49,7,201,11,276,16,292,0,O-22-101-03-03-01
LIRA,ERUTE CTY SOUTH,BARR,AYAMO,MON-IRINGO,358,18,43,18,209,8,296,12,308,0,O-22-101-03-03-02
LIRA,ERUTE CTY SOUTH,BARR,AYIRA,BAR-SUB-COUNTY I,830,13,58,10,300,66,447,9,456,0,O-22-101-03-04-01
LIRA,ERUTE CTY SOUTH,BARR,AYIRA,BAR SUB-COUNTY II,759,21,78,22,374,32,527,7,534,0,O-22-101-03-04-02
LIRA,ERUTE CTY SOUTH,BARR,AYIRA,OBOT P.7 SCHOOL I,677,7,47,8,455,8,525,7,532,0,O-22-101-03-04-03
LIRA,ERUTE CTY SOUTH,BARR,AYIRA,OBOT P.7 SCHOOL II,569,9,67,19,310,7,412,10,422,0,O-22-101-03-04-04
LIRA,ERUTE CTY SOUTH,BARR,AYIRA,ATYENAOWE,302,1,29,3,116,8,157,77,234,0,O-22-101-03-04-05
LIRA,ERUTE CTY SOUTH,BARR,OBER,OBER P 7 SCHOOL I,481,5,21,6,233,20,285,96,381,0,O-22-101-03-05-01
LIRA,ERUTE CTY SOUTH,BARR,OBER,OBER P 7 SCHOOL II,597,8,36,12,361,22,439,38,477,0,O-22-101-03-05-02
LIRA,ERUTE CTY SOUTH,BARR,OBER,OBER P.7 SCHOOL III,710,16,44,15,440,20,535,34,569,0,O-22-101-03-05-03
LIRA,ERUTE CTY SOUTH,BARR,OLILO,AJWIA,557,6,19,7,324,10,366,86,452,0,O-22-101-03-06-01
LIRA,ERUTE CTY SOUTH,BARR,OLILO,OLILO PRIMARY SCHOOL,615,10,50,20,380,18,478,13,491,0,O-22-101-03-06-02
LIRA,ERUTE CTY SOUTH,BARR,OLILO,ABAA- APARI I,612,18,58,13,393,18,500,8,508,0,O-22-101-03-06-03
LIRA,ERUTE CTY SOUTH,BARR,OLILO,ABAA- APARI II,272,3,45,3,128,4,183,31,214,0,O-22-101-03-06-04
LIRA,ERUTE CTY SOUTH,BARR,ONYWAKO,ONYWAKO P.7 SCHOOL I,746,8,94,2,251,5,360,177,537,0,O-22-101-03-07-01
LIRA,ERUTE CTY SOUTH,BARR,ONYWAKO,ONYWAKO P.7 SCHOOL II,493,6,60,2,231,6,305,65,370,0,O-22-101-03-07-02
LIRA,ERUTE CTY SOUTH,BARR,ONYWAKO,ONYWAKO P.7 SCHOOL III,468,4,38,2,206,11,261,0,261,0,O-22-101-03-07-03
LIRA,ERUTE CTY SOUTH,BARR,ONYWAKO,ONYWAKO P.7 SCHOOL IV,319,8,23,6,148,6,191,50,241,0,O-22-101-03-07-04
LIRA,LIRA MUNICIPALITY,ADYEL,JUNIOR QUARTERS,JUNIOR QUARTERS A,1108,3,69,1,373,88,534,8,542,0,O-22-105-01-01-01
LIRA,LIRA MUNICIPALITY,ADYEL,JUNIOR QUARTERS,JUNIOR QUARTERS B,1047,5,94,2,389,98,588,1,589,0,O-22-105-01-01-02
LIRA,LIRA MUNICIPALITY,ADYEL,KIROMBE,KIROMBE EAST I,603,5,44,2,287,79,417,15,432,0,O-22-105-01-02-01
LIRA,LIRA MUNICIPALITY,ADYEL,KIROMBE,KIROMBE EAST II,292,0,15,0,144,25,184,7,191,0,O-22-105-01-02-02
LIRA,LIRA MUNICIPALITY,ADYEL,LANGO CENTRAL,TE-TUGU,539,4,30,2,253,58,347,0,347,0,O-22-105-01-03-01
LIRA,LIRA MUNICIPALITY,ADYEL,LANGO CENTRAL,CUK EBANGE,424,1,20,1,179,32,233,41,274,0,O-22-105-01-03-02
LIRA,LIRA MUNICIPALITY,ADYEL,OMITTO WARD,KIROMBE NORTH,1154,21,103,4,558,81,767,11,778,0,O-22-105-01-04-01
LIRA,LIRA MUNICIPALITY,ADYEL,OMITTO WARD,ANYWAIONINO,380,3,33,1,184,22,243,46,289,0,O-22-105-01-04-02
LIRA,LIRA MUNICIPALITY,ADYEL,OMITTO WARD,ADYEL P.7 SCHOOL I,606,3,39,0,257,49,348,52,400,0,O-22-105-01-04-03
LIRA,LIRA MUNICIPALITY,ADYEL,OMITTO WARD,ADYEL P.7 SCHOOL II,626,4,46,6,354,49,459,6,465,0,O-22-105-01-04-04
LIRA,LIRA MUNICIPALITY,ADYEL,OMITTO WARD,TE-TUGU CAMP,178,2,1,0,25,0,28,0,28,0,O-22-105-01-04-05
LIRA,LIRA MUNICIPALITY,ADYEL,STARCH FACTORY,STARCH FACTORY A (A-A),846,12,54,8,369,70,513,40,553,0,O-22-105-01-05-01
LIRA,LIRA MUNICIPALITY,ADYEL,STARCH FACTORY,STARCH FACTORY A (B-Z),607,4,44,0,296,34,378,30,408,0,O-22-105-01-05-02
LIRA,LIRA MUNICIPALITY,ADYEL,STARCH FACTORY,STARCH FACTORY I (A-AL),597,8,23,4,139,1,175,6,181,0,O-22-105-01-05-03
LIRA,LIRA MUNICIPALITY,ADYEL,STARCH FACTORY,STARCH FACTORY II,667,3,27,4,131,9,174,1,175,0,O-22-105-01-05-04
LIRA,LIRA MUNICIPALITY,ADYEL,STARCH FACTORY,STARCH FACTORY I (AM-Z),538,7,15,0,86,8,116,4,120,0,O-22-105-01-05-05
LIRA,LIRA MUNICIPALITY,ADYEL,TESO   A,LIRA MODERN I,596,10,34,3,276,47,370,15,385,0,O-22-105-01-06-01
LIRA,LIRA MUNICIPALITY,ADYEL,TESO   A,LIRA MODERN II,555,5,38,3,242,61,349,14,363,0,O-22-105-01-06-02
LIRA,LIRA MUNICIPALITY,ADYEL,TESO   C,AMBALAL,909,4,69,2,414,57,546,8,554,0,O-22-105-01-07-01
LIRA,LIRA MUNICIPALITY,ADYEL,TESO   C,AMBALA P.7 SCH,529,1,32,1,98,9,141,38,179,0,O-22-105-01-07-02
LIRA,LIRA MUNICIPALITY,LIRA CENTRAL,BAZAAR,V.H PUBLIC SCHOOL I,763,3,50,0,277,102,432,31,463,0,O-22-105-02-01-01
LIRA,LIRA MUNICIPALITY,LIRA CENTRAL,BAZAAR,V.H PUBLIC SCHOOL II,634,5,45,1,240,104,395,0,395,0,O-22-105-02-01-02
LIRA,LIRA MUNICIPALITY,LIRA CENTRAL,IREDA EAST,IREDA P.7 SCHOOL,665,5,62,1,230,46,344,44,388,0,O-22-105-02-02-01
LIRA,LIRA MUNICIPALITY,LIRA CENTRAL,IREDA EAST,NADIS PLACE,806,10,61,4,332,92,499,7,506,0,O-22-105-02-02-02
LIRA,LIRA MUNICIPALITY,LIRA CENTRAL,IREDA EAST,ADEKOKWOK S/COUNTY HQRS,886,9,59,13,346,103,530,23,553,0,O-22-105-02-02-03
LIRA,LIRA MUNICIPALITY,LIRA CENTRAL,IREDA EAST,ADEKOKWOK S/C HQTRS,429,7,12,1,47,1,68,19,87,0,O-22-105-02-02-04
LIRA,LIRA MUNICIPALITY,LIRA CENTRAL,IREDA WEST,OKELLO ONGWENS PLACE,441,7,30,0,203,41,281,9,290,0,O-22-105-02-03-01
LIRA,LIRA MUNICIPALITY,LIRA CENTRAL,IREDA WEST,CHURCH OF UGANDA,469,1,25,0,176,37,239,44,283,0,O-22-105-02-03-02
LIRA,LIRA MUNICIPALITY,LIRA CENTRAL,IREDA WEST,PAG CHURCH,796,15,67,1,344,78,505,14,519,0,O-22-105-02-03-03
LIRA,LIRA MUNICIPALITY,LIRA CENTRAL,SEN. QUARTERS,LIRA ARMY PRIMARY I (A-L),1326,10,140,8,264,153,575,22,597,0,O-22-105-02-04-01
LIRA,LIRA MUNICIPALITY,LIRA CENTRAL,SEN. QUARTERS,LIRA ARMY PRIMARY I (M-Z),496,2,52,0,145,86,285,0,285,0,O-22-105-02-04-02
LIRA,LIRA MUNICIPALITY,LIRA CENTRAL,SEN. QUARTERS,ARMY PC.OUTSIDE GUARD (A-L),971,2,19,1,104,250,376,81,457,0,O-22-105-02-04-03
LIRA,LIRA MUNICIPALITY,LIRA CENTRAL,SEN. QUARTERS,ARMY PC.OUTSIDE GUARD (M-Z),840,2,7,0,86,242,337,36,373,0,O-22-105-02-04-04
LIRA,LIRA MUNICIPALITY,LIRA CENTRAL,SEN. QUARTERS,LPC/PCU CHURCH,372,6,38,2,115,11,172,8,180,0,O-22-105-02-04-05
LIRA,LIRA MUNICIPALITY,LIRA CENTRAL,TE-OBIA,UGANDA TECH. COLLEGE I,926,6,48,1,364,60,479,4,483,0,O-22-105-02-05-01
LIRA,LIRA MUNICIPALITY,LIRA CENTRAL,TE-OBIA,NUMA GROUND,761,5,45,1,327,92,470,7,477,0,O-22-105-02-05-02
LIRA,LIRA MUNICIPALITY,OJWINA,ALITO CAMP,TE-CWAO,880,8,66,4,325,96,499,7,506,0,O-22-105-03-01-01
LIRA,LIRA MUNICIPALITY,OJWINA,BAR-OGOLE,WIGWENG I,730,8,34,1,267,61,371,8,379,0,O-22-105-03-02-01
LIRA,LIRA MUNICIPALITY,OJWINA,BAR-OGOLE,WIGWENG II,769,5,55,1,329,49,439,9,448,0,O-22-105-03-02-02
LIRA,LIRA MUNICIPALITY,OJWINA,BAR-OGOLE,BLUE CORNER,614,8,38,3,225,76,350,12,362,0,O-22-105-03-02-03
LIRA,LIRA MUNICIPALITY,OJWINA,BAR-OGOLE,TEDA,188,0,13,1,35,12,61,2,63,0,O-22-105-03-02-04
LIRA,LIRA MUNICIPALITY,OJWINA,IPITO-AWENO,JUBA ROAD I,641,2,27,0,191,119,339,5,344,0,O-22-105-03-03-01
LIRA,LIRA MUNICIPALITY,OJWINA,IPITO-AWENO,JUBA ROAD II,518,1,28,2,175,92,298,3,301,0,O-22-105-03-03-02
LIRA,LIRA MUNICIPALITY,OJWINA,IPITO-AWENO,TE-GARAGE,252,0,15,1,49,31,96,16,112,0,O-22-105-03-03-03
LIRA,LIRA MUNICIPALITY,OJWINA,IPITO-AWENO,TE-KULO-OJWINA I,325,0,14,1,102,28,145,0,145,0,O-22-105-03-03-04
LIRA,LIRA MUNICIPALITY,OJWINA,IPITO-AWENO,TE-KULO-OJWINA II,269,1,7,1,85,23,117,0,117,0,O-22-105-03-03-05
LIRA,LIRA MUNICIPALITY,OJWINA,KAKOGE,KAKOGE (A-AP),715,4,45,0,184,37,270,86,356,0,O-22-105-03-04-01
LIRA,LIRA MUNICIPALITY,OJWINA,KAKOGE,OBUTUWELO A,655,6,46,0,237,61,350,6,356,0,O-22-105-03-04-02
LIRA,LIRA MUNICIPALITY,OJWINA,KAKOGE,KAKOGE (AQ-N),737,2,45,1,234,84,366,14,380,0,O-22-105-03-04-03
LIRA,LIRA MUNICIPALITY,OJWINA,KAKOGE,OBUTOWELO B,219,1,15,2,70,14,102,0,102,0,O-22-105-03-04-04
LIRA,LIRA MUNICIPALITY,OJWINA,KAKOGE,KAKOGE (O-Z),570,4,58,1,191,45,299,40,339,0,O-22-105-03-04-05
LIRA,LIRA MUNICIPALITY,OJWINA,OBER,ENTEBBE,421,7,28,0,201,15,251,8,259,0,O-22-105-03-05-01
LIRA,LIRA MUNICIPALITY,OJWINA,OBER,JINJA CAMP (A-L),686,8,47,1,306,54,416,6,422,0,O-22-105-03-05-02
LIRA,LIRA MUNICIPALITY,OJWINA,OBER,KICHOPE,936,22,103,1,420,57,603,0,603,0,O-22-105-03-05-03
LIRA,LIRA MUNICIPALITY,OJWINA,OBER,KAMPALA,700,21,57,4,375,27,484,10,494,0,O-22-105-03-05-04
LIRA,LIRA MUNICIPALITY,OJWINA,OBER,JINJA CAMP (M-Z),544,4,42,0,238,23,307,46,353,0,O-22-105-03-05-05
LIRA,LIRA MUNICIPALITY,OJWINA,OBER,ONAPOYEYERE,172,1,7,0,70,26,104,28,132,0,O-22-105-03-05-06
LIRA,LIRA MUNICIPALITY,RAILWAYS,AYAGO,AYAGO P.7 SCHOOL,816,16,39,13,435,73,576,14,590,0,O-22-105-04-01-01
LIRA,LIRA MUNICIPALITY,RAILWAYS,AYAGO,AGALI,272,7,14,0,153,27,201,10,211,0,O-22-105-04-01-02
LIRA,LIRA MUNICIPALITY,RAILWAYS,BAR-ONGER,BAR-ONGER CENTRAL,895,5,34,0,274,90,403,102,505,0,O-22-105-04-02-01
LIRA,LIRA MUNICIPALITY,RAILWAYS,RAILWAY QUARTERS,RAILWAYS QUARTERS,970,14,54,3,290,106,467,110,577,0,O-22-105-04-03-01
LIRA,LIRA MUNICIPALITY,RAILWAYS,RAILWAY QUARTERS,GOLF COURSE,407,2,24,0,85,8,119,13,132,0,O-22-105-04-03-02
LIRA,LIRA MUNICIPALITY,RAILWAYS,TE-MOGO,MARKET SQUARE,886,13,39,9,345,143,549,13,562,0,O-22-105-04-04-01
MOROTO,MATHENIKO COUNTY,KATIKEKILA,KAKINGOL,NAKODET,344,1,3,8,7,232,251,2,253,0,O-28-147-01-01-01
MOROTO,MATHENIKO COUNTY,KATIKEKILA,KAKINGOL,NAROO,401,2,7,17,12,271,309,17,326,0,O-28-147-01-01-02
MOROTO,MATHENIKO COUNTY,KATIKEKILA,LIA,MUSASI,191,12,4,10,5,110,141,7,148,0,O-28-147-01-02-01
MOROTO,MATHENIKO COUNTY,KATIKEKILA,LIA,NABUIN,538,12,7,13,35,199,266,45,311,0,O-28-147-01-02-02
MOROTO,MATHENIKO COUNTY,KATIKEKILA,LOYARABOTH,LOKILES,483,14,22,17,32,90,175,19,194,0,O-28-147-01-03-01
MOROTO,MATHENIKO COUNTY,KATIKEKILA,LOYARABOTH,KOSIROI,301,7,7,5,14,20,53,1,54,0,O-28-147-01-03-02
MOROTO,MATHENIKO COUNTY,KATIKEKILA,NATUMUKALE,LOMELA,629,0,1,10,0,137,148,6,154,0,O-28-147-01-04-01
MOROTO,MATHENIKO COUNTY,KATIKEKILA,TAPACH,KODONYO,174,12,4,12,20,103,151,2,153,0,O-28-147-01-05-01
MOROTO,MATHENIKO COUNTY,KATIKEKILA,TAPACH,TAPACH,641,8,10,23,51,319,411,7,418,0,O-28-147-01-05-02
MOROTO,MATHENIKO COUNTY,KATIKEKILA,TAPACH,NAOI,272,6,6,8,33,166,219,9,228,0,O-28-147-01-05-03
MOROTO,MATHENIKO COUNTY,NADUNGET,ACHERER,THIMON,677,16,14,39,19,245,333,28,361,0,O-28-147-02-01-01
MOROTO,MATHENIKO COUNTY,NADUNGET,KOMARET,ARECHEK,657,5,5,26,12,248,296,38,334,0,O-28-147-02-02-01
MOROTO,MATHENIKO COUNTY,NADUNGET,KOMARET,LODOOI,204,7,5,12,8,88,120,26,146,0,O-28-147-02-02-02
MOROTO,MATHENIKO COUNTY,NADUNGET,KOMARET,LORIKOKWA,244,2,6,10,7,122,147,28,175,0,O-28-147-02-02-03
MOROTO,MATHENIKO COUNTY,NADUNGET,LOPUTUK,LOPUTUK A,619,11,14,36,47,240,348,17,365,0,O-28-147-02-03-01
MOROTO,MATHENIKO COUNTY,NADUNGET,LOPUTUK,LOPUTUK B,576,10,8,25,21,239,303,53,356,0,O-28-147-02-03-02
MOROTO,MATHENIKO COUNTY,NADUNGET,LOPUTUK,NADIKET SEMINARY,172,7,0,3,27,77,114,15,129,0,O-28-147-02-03-03
MOROTO,MATHENIKO COUNTY,NADUNGET,LOPUTUK,KERAMIRIMAN,301,3,5,18,3,150,179,26,205,0,O-28-147-02-03-04
MOROTO,MATHENIKO COUNTY,NADUNGET,LOPUTUK,LOPUTUK C,407,1,2,19,2,223,247,17,264,0,O-28-147-02-03-05
MOROTO,MATHENIKO COUNTY,NADUNGET,LOTIRIR,NAWONATAU PRIMARY SCHOOL,979,20,10,35,19,248,332,62,394,0,O-28-147-02-04-01
MOROTO,MATHENIKO COUNTY,NADUNGET,LOTIRIR,ACHEBER PARISH HQRS,220,2,4,11,2,115,134,33,167,0,O-28-147-02-04-02
MOROTO,MATHENIKO COUNTY,NADUNGET,LOTIRIR,LOPUR,268,4,3,16,41,117,181,18,199,0,O-28-147-02-04-03
MOROTO,MATHENIKO COUNTY,NADUNGET,NADUNGET,COUNTY HEADQUARTERS,637,15,10,27,35,308,395,48,443,0,O-28-147-02-05-01
MOROTO,MATHENIKO COUNTY,NADUNGET,NADUNGET,LOKERIAUT,179,1,0,0,0,105,106,5,111,0,O-28-147-02-05-02
MOROTO,MATHENIKO COUNTY,NADUNGET,NADUNGET,NAKAMISTAE,463,0,0,5,3,296,304,75,379,0,O-28-147-02-05-03
MOROTO,MATHENIKO COUNTY,NADUNGET,NADUNGET,KOTARUK,265,2,2,2,4,182,192,6,198,0,O-28-147-02-05-04
MOROTO,MATHENIKO COUNTY,NADUNGET,NAITAKWAE,KATANGA,666,5,12,4,75,330,426,9,435,0,O-28-147-02-06-01
MOROTO,MATHENIKO COUNTY,NADUNGET,NAITAKWAE,NABOKAT,794,13,9,25,12,345,404,79,483,0,O-28-147-02-06-02
MOROTO,MATHENIKO COUNTY,NADUNGET,NAITAKWAE,NANGORIT,594,4,9,19,10,322,364,50,414,0,O-28-147-02-06-03
MOROTO,MATHENIKO COUNTY,NADUNGET,NAITAKWAE,KANAKOMOL,262,15,3,9,8,150,185,16,201,0,O-28-147-02-06-04
MOROTO,MATHENIKO COUNTY,RUPA,LOBUNEIT,RUPA PRIMARY SCHOOL,640,20,22,34,29,219,324,34,358,0,O-28-147-03-01-01
MOROTO,MATHENIKO COUNTY,RUPA,LOBUNEIT,KIDEPO,213,7,5,8,3,102,125,26,151,0,O-28-147-03-01-02
MOROTO,MATHENIKO COUNTY,RUPA,LOKISILE,"KRAAL ""A""",160,0,0,1,0,18,19,1,20,0,O-28-147-03-02-01
MOROTO,MATHENIKO COUNTY,RUPA,LOO ARENGAK,KRAAL D,100,0,1,3,1,54,59,10,69,0,O-28-147-03-03-01
MOROTO,MATHENIKO COUNTY,RUPA,LOO ARENGAK,KRAAL E,44,2,1,2,2,20,27,8,35,0,O-28-147-03-03-02
MOROTO,MATHENIKO COUNTY,RUPA,LOO ARENGAK,KRAAL F,171,1,3,1,17,87,109,16,125,0,O-28-147-03-03-03
MOROTO,MATHENIKO COUNTY,RUPA,MOGOTH,LOKITUMO A,761,12,7,16,14,213,262,51,313,0,O-28-147-03-04-01
MOROTO,MATHENIKO COUNTY,RUPA,MOGOTH,LOKITUMO B,742,15,11,42,19,236,323,53,376,0,O-28-147-03-04-02
MOROTO,MATHENIKO COUNTY,RUPA,NAKADELI,KALOI,742,4,4,20,9,378,415,27,442,0,O-28-147-03-05-01
MOROTO,MATHENIKO COUNTY,RUPA,NAKADELI,NATUMKASIKOU,276,3,2,9,4,121,139,14,153,0,O-28-147-03-05-02
MOROTO,MATHENIKO COUNTY,RUPA,PUPU,NAOI,523,2,0,16,14,276,308,65,373,0,O-28-147-03-06-01
MOROTO,MATHENIKO COUNTY,RUPA,PUPU,PUPU,391,5,5,8,7,235,260,39,299,0,O-28-147-03-06-02
MOROTO,MATHENIKO COUNTY,RUPA,RUPA,ACHOLI INN,617,2,2,12,70,263,349,27,376,0,O-28-147-03-07-01
MOROTO,MATHENIKO COUNTY,RUPA,RUPA,LORUKUMO,756,14,4,30,18,326,392,26,418,0,O-28-147-03-07-02
MOROTO,MATHENIKO COUNTY,RUPA,RUPA,MUSUPO,275,6,2,10,3,172,193,15,208,0,O-28-147-03-07-03
MOROTO,MATHENIKO COUNTY,RUPA,RUPA,MESS OUTSIDE Q.GUARD A,615,3,3,1,66,171,244,6,250,0,O-28-147-03-07-04
MOROTO,MATHENIKO COUNTY,RUPA,RUPA,MESS OUTSIDE Q.GUARD B,339,0,0,0,24,84,108,3,111,0,O-28-147-03-07-05
MOROTO,MOROTO MUNICIPALITY,NORTH DIVISION,BOMA NORTH,R.T.C,1067,2,1,4,191,156,354,33,387,0,O-28-150-01-01-01
MOROTO,MOROTO MUNICIPALITY,NORTH DIVISION,BOMA NORTH,BAZAAR,524,10,6,7,69,174,266,42,308,0,O-28-150-01-01-02
MOROTO,MOROTO MUNICIPALITY,NORTH DIVISION,BOMA NORTH,BOMA GROUND,124,0,1,0,34,43,78,12,90,0,O-28-150-01-01-03
MOROTO,MOROTO MUNICIPALITY,NORTH DIVISION,BOMA SOUTH,UPPER BOMA SOUTH,650,11,1,3,151,136,302,10,312,0,O-28-150-01-02-01
MOROTO,MOROTO MUNICIPALITY,NORTH DIVISION,BOMA SOUTH,LOWER BOMA SOUTH,317,1,3,0,84,77,165,8,173,0,O-28-150-01-02-02
MOROTO,MOROTO MUNICIPALITY,SOUTH DIVISION,CAMPSWAHILI CHIN,LABOUR LINE,685,16,4,14,93,265,392,53,445,0,O-28-150-02-01-01
MOROTO,MOROTO MUNICIPALITY,SOUTH DIVISION,CAMPSWAHILI CHIN,OLD CAMP A,682,1,2,11,65,339,418,37,455,0,O-28-150-02-01-02
MOROTO,MOROTO MUNICIPALITY,SOUTH DIVISION,CAMPSWAHILI CHIN,OLD CAMP B,158,3,4,6,5,94,112,14,126,0,O-28-150-02-01-03
MOROTO,MOROTO MUNICIPALITY,SOUTH DIVISION,CAMPSWAHILI JUU,CAMPSWAHILLI JUU,764,6,1,2,184,205,398,27,425,0,O-28-150-02-02-01
MOROTO,MOROTO MUNICIPALITY,SOUTH DIVISION,CAMPSWAHILI JUU,NAKAPELIMEN,694,9,4,17,90,315,435,57,492,0,O-28-150-02-02-02
MOYO,WEST MOYO CTY,DUFILE,ARRA,ROBIJO,381,11,5,8,79,162,265,20,285,0,O-29-153-01-01-01
MOYO,WEST MOYO CTY,DUFILE,ARRA,ARRA PRIMARY SCHOOL,467,9,4,9,111,204,337,10,347,0,O-29-153-01-01-02
MOYO,WEST MOYO CTY,DUFILE,DUFELE (INDRIDRI),ITIALO,424,14,6,6,108,149,283,28,311,0,O-29-153-01-02-01
MOYO,WEST MOYO CTY,DUFILE,DUFELE (INDRIDRI),NZEREA MEETING GROUND,325,10,1,5,160,64,240,2,242,0,O-29-153-01-02-02
MOYO,WEST MOYO CTY,DUFILE,DUFELE (INDRIDRI),INDRIDRI MARKET,422,4,1,0,104,131,240,55,295,0,O-29-153-01-02-03
MOYO,WEST MOYO CTY,DUFILE,IDRIMARI,PAJARU VILLAGE CENTRE,603,24,2,9,185,226,446,14,460,0,O-29-153-01-03-01
MOYO,WEST MOYO CTY,DUFILE,IDRIMARI,EDRE,347,7,3,4,103,137,254,17,271,0,O-29-153-01-03-02
MOYO,WEST MOYO CTY,DUFILE,LAROPI,PAKOMA VILLAGE CENTRE,320,3,1,3,99,104,210,27,237,0,O-29-153-01-04-01
MOYO,WEST MOYO CTY,DUFILE,LAROPI,GBALALA P7 SCH.,397,14,2,7,154,124,301,14,315,0,O-29-153-01-04-02
MOYO,WEST MOYO CTY,DUFILE,LAROPI,KIDHI VILLAGE CENTRE,150,1,1,0,54,72,128,5,133,0,O-29-153-01-04-03
MOYO,WEST MOYO CTY,DUFILE,LAROPI,LAROPI PR 7 SCH,634,7,3,5,220,174,409,12,421,0,O-29-153-01-04-04
MOYO,WEST MOYO CTY,DUFILE,LAROPI,OBI SOUTH,375,5,5,4,128,137,279,21,300,0,O-29-153-01-04-05
MOYO,WEST MOYO CTY,DUFILE,LEBUBU,OPPI,347,4,2,2,82,143,233,26,259,0,O-29-153-01-05-01
MOYO,WEST MOYO CTY,DUFILE,LEBUBU,PAONYA CENTRE,434,6,3,4,159,173,345,23,368,0,O-29-153-01-05-02
MOYO,WEST MOYO CTY,DUFILE,PANYANGA,NYAFORO CENTRE,303,5,2,5,110,84,206,6,212,0,O-29-153-01-06-01
MOYO,WEST MOYO CTY,DUFILE,PANYANGA,PANYANGA COMMUNITY CENTRE,488,6,4,4,105,197,316,14,330,0,O-29-153-01-06-02
MOYO,WEST MOYO CTY,LEFORI,COLOA,MUNU MOSQUE,206,3,0,1,96,17,117,5,122,0,O-29-153-02-01-01
MOYO,WEST MOYO CTY,LEFORI,COLOA,COLOA CENTRE,486,5,2,2,213,93,315,17,332,0,O-29-153-02-01-02
MOYO,WEST MOYO CTY,LEFORI,EBWEA,LOJILI MARKET,380,3,1,1,58,208,271,22,293,0,O-29-153-02-02-01
MOYO,WEST MOYO CTY,LEFORI,EBWEA,LEFORI CENTRE,293,0,0,2,92,96,190,23,213,0,O-29-153-02-02-02
MOYO,WEST MOYO CTY,LEFORI,GWERE,GWERE PRIMARY SCHOOL,467,14,6,5,158,109,292,25,317,0,O-29-153-02-03-01
MOYO,WEST MOYO CTY,LEFORI,MASALOA,MASALOA PRIMARY SCHOOL,516,11,5,2,112,257,387,10,397,0,O-29-153-02-04-01
MOYO,WEST MOYO CTY,METU,AYIRO,RAMOGINDU MARKET,566,12,5,7,174,195,393,27,420,0,O-29-153-03-01-01
MOYO,WEST MOYO CTY,METU,AYIRO,GOOPI P.7 SCHOOL,368,13,6,3,147,118,287,15,302,0,O-29-153-03-01-02
MOYO,WEST MOYO CTY,METU,AYIRO,RAMOGINDU YOUTH CENTRE [A-G,359,2,0,2,99,117,220,3,223,0,O-29-153-03-01-03
MOYO,WEST MOYO CTY,METU,AYIRO,GOOPI HEALTH UNIT,315,5,13,2,178,39,237,17,254,0,O-29-153-03-01-04
MOYO,WEST MOYO CTY,METU,AYIRO,RAMOGINDU YOUTH CENTRE [H-Z,369,1,3,1,96,111,212,16,228,0,O-29-153-03-01-05
MOYO,WEST MOYO CTY,METU,EREMI,LECU PR 7 SCH C,209,11,1,4,96,46,158,21,179,0,O-29-153-03-02-01
MOYO,WEST MOYO CTY,METU,EREMI,EREMI PR 7 SCH,479,13,6,2,233,101,355,14,369,0,O-29-153-03-02-02
MOYO,WEST MOYO CTY,METU,EREMI,EREMI HEALTH UNIT,274,9,1,3,107,91,211,5,216,0,O-29-153-03-02-03
MOYO,WEST MOYO CTY,METU,PAJAKIRI,AYA PR 7 SCH A,315,5,3,1,74,145,228,1,229,0,O-29-153-03-03-01
MOYO,WEST MOYO CTY,METU,PAJAKIRI,AYA PR 7 SCH B,435,8,5,5,111,159,288,0,288,0,O-29-153-03-03-02
MOYO,WEST MOYO CTY,METU,PAJAKIRI,ABESO PR. SCH,358,14,6,5,68,168,261,15,276,0,O-29-153-03-03-03
MOYO,WEST MOYO CTY,METU,PAMERI,EREPI PRIMARY 7 / FS,493,10,4,4,165,138,321,12,333,0,O-29-153-03-04-01
MOYO,WEST MOYO CTY,METU,PAMERI,METU SSS,608,6,1,3,257,150,417,15,432,0,O-29-153-03-04-02
MOYO,WEST MOYO CTY,METU,PAMERI,JOAGO'S HQTRS (A),561,8,4,1,207,142,362,10,372,0,O-29-153-03-04-03
MOYO,WEST MOYO CTY,METU,PAMERI,JOAGO'S HQTRS (B),217,4,1,1,61,88,155,5,160,0,O-29-153-03-04-04
MOYO,WEST MOYO CTY,METU,PAMOYI,AMUA P/7 SCHOOL (A),329,1,2,3,69,188,263,12,275,0,O-29-153-03-05-01
MOYO,WEST MOYO CTY,METU,PAMOYI,ALIMO PRI. SCHOOL,493,12,2,7,109,231,361,24,385,0,O-29-153-03-05-02
MOYO,WEST MOYO CTY,METU,PAMOYI,AMUA P/7 SCHOOL (B),450,9,7,5,101,194,316,12,328,0,O-29-153-03-05-03
MOYO,WEST MOYO CTY,METU,PAMUJO,KWEYO P.7 SCHOOL (A),337,5,3,7,96,110,221,6,227,0,O-29-153-03-06-01
MOYO,WEST MOYO CTY,METU,PAMUJO,GBARI PRIMARY SCHOOL,336,0,1,5,27,182,215,17,232,0,O-29-153-03-06-02
MOYO,WEST MOYO CTY,METU,PAMUJO,KWEYO P.7 SCHOOL (B),344,9,4,4,97,123,237,14,251,0,O-29-153-03-06-03
MOYO,WEST MOYO CTY,MOYO,ALURU,TAANO'S SHADE,331,2,2,8,123,97,232,8,240,0,O-29-153-04-01-01
MOYO,WEST MOYO CTY,MOYO,ALURU,MANGO SHADE (A),537,6,9,2,206,140,363,15,378,0,O-29-153-04-01-02
MOYO,WEST MOYO CTY,MOYO,ALURU,MANGO SHADE (B),419,8,3,2,245,43,301,19,320,0,O-29-153-04-01-03
MOYO,WEST MOYO CTY,MOYO,ALURU,MOYO TECH. INSTITUTE,271,9,2,1,114,20,146,13,159,0,O-29-153-04-01-04
MOYO,WEST MOYO CTY,MOYO,ALURU,DISTRICT FARM INSITUTE,369,5,4,4,133,109,255,14,269,0,O-29-153-04-01-05
MOYO,WEST MOYO CTY,MOYO,EBIHWA,PAREGO NURSERY,594,5,2,1,209,195,412,36,448,0,O-29-153-04-02-01
MOYO,WEST MOYO CTY,MOYO,EBIHWA,SIMON'S SHADE,632,6,6,6,279,154,451,24,475,0,O-29-153-04-02-02
MOYO,WEST MOYO CTY,MOYO,ERIA,EREA DISPENSARY,379,8,1,4,87,148,248,16,264,0,O-29-153-04-03-01
MOYO,WEST MOYO CTY,MOYO,ERIA,CEFO MANGO SHADE,469,10,3,4,190,104,311,23,334,0,O-29-153-04-03-02
MOYO,WEST MOYO CTY,MOYO,LOGOBA,LOGOBA PR 7 SCH (A),379,8,6,2,94,121,231,17,248,0,O-29-153-04-04-01
MOYO,WEST MOYO CTY,MOYO,LOGOBA,LOGOBA P/7 SCHOOL B (A - G),556,6,7,6,196,155,370,21,391,0,O-29-153-04-04-02
MOYO,WEST MOYO CTY,MOYO,LOGOBA,LOGOBA P/7 SCHOOL B (I - Z),638,14,2,9,220,165,410,25,435,0,O-29-153-04-04-03
MOYO,WEST MOYO CTY,MOYO,VURA,MOYO JOAGO'S HQTRS A,528,2,5,4,201,102,314,24,338,0,O-29-153-04-05-01
MOYO,WEST MOYO CTY,MOYO,VURA,TOLORO PRI. SCHOOL (A),596,6,3,4,273,119,405,4,409,0,O-29-153-04-05-02
MOYO,WEST MOYO CTY,MOYO,VURA,MOYO SEC SCH,425,4,0,1,173,106,284,16,300,0,O-29-153-04-05-03
MOYO,WEST MOYO CTY,MOYO,VURA,TOLORO PRI. SCHOOL (B),288,4,5,0,126,69,204,7,211,0,O-29-153-04-05-04
MOYO,WEST MOYO CTY,MOYO,VURA,MOYO JOAGO'S HQTRS B,365,8,1,2,147,87,245,6,251,0,O-29-153-04-05-05
MOYO,WEST MOYO CTY,MOYO,VURA,MOYO ARMY P. SCH.A,366,0,0,0,10,21,31,3,34,0,O-29-153-04-05-06
MOYO,WEST MOYO CTY,MOYO,VURA,MOYO ARMY P.SCH. B,207,1,1,0,17,21,40,1,41,0,O-29-153-04-05-07
MOYO,WEST MOYO CTY,MOYO TOWN COUNCIL,BESIA,PERINI CENTRE (A),712,3,5,0,270,185,463,13,476,0,O-29-153-05-01-01
MOYO,WEST MOYO CTY,MOYO TOWN COUNCIL,BESIA,PERINI CENTRE (B),344,3,7,0,139,60,209,10,219,0,O-29-153-05-01-02
MOYO,WEST MOYO CTY,MOYO TOWN COUNCIL,CELECELEA,PARISH HALL (A),720,4,3,5,300,156,468,5,473,0,O-29-153-05-02-01
MOYO,WEST MOYO CTY,MOYO TOWN COUNCIL,CELECELEA,MANGO SHADE,448,7,4,2,171,123,307,10,317,0,O-29-153-05-02-02
MOYO,WEST MOYO CTY,MOYO TOWN COUNCIL,CELECELEA,PARISH HALL (B),330,4,2,0,130,94,230,5,235,0,O-29-153-05-02-03
MOYO,WEST MOYO CTY,MOYO TOWN COUNCIL,ELENDEREA,MTC PRI. SCHOOL (A),696,2,5,1,298,137,443,22,465,0,O-29-153-05-03-01
MOYO,WEST MOYO CTY,MOYO TOWN COUNCIL,ELENDEREA,MTC PRI. SCHOOL (B),363,3,1,3,142,112,261,9,270,0,O-29-153-05-03-02
MOYO,WEST MOYO CTY,MOYO TOWN COUNCIL,MOYO CENTRAL,MAYOR'S GARDEN (A),603,0,4,1,245,77,327,7,334,0,O-29-153-05-04-01
MOYO,WEST MOYO CTY,MOYO TOWN COUNCIL,MOYO CENTRAL,MAYOR'S GARDEN (B),531,0,0,1,228,92,321,8,329,0,O-29-153-05-04-02
NEBBI,PADYERE COUNTY,AKWORO,KASATU (ANGABA),ANGABA GROWERS SOCIETY,838,7,11,2,210,341,571,12,583,0,O-33-183-01-01-01
NEBBI,PADYERE COUNTY,AKWORO,KASATU (ANGABA),AKWORO HEALTH CENTRE,558,9,5,16,82,292,404,14,418,0,O-33-183-01-01-02
NEBBI,PADYERE COUNTY,AKWORO,KASATU (ANGABA),NYARUNDIER PRI. SCHOOL,520,11,6,15,75,245,352,45,397,0,O-33-183-01-01-03
NEBBI,PADYERE COUNTY,AKWORO,KITUNA,APIKO PRI. SCHOOL,522,7,4,8,214,165,398,14,412,0,O-33-183-01-02-01
NEBBI,PADYERE COUNTY,AKWORO,KITUNA,KITUNA HEALTH CENTRE,477,6,8,7,146,186,353,12,365,0,O-33-183-01-02-02
NEBBI,PADYERE COUNTY,AKWORO,KITUNA,ORIERE,363,2,2,4,116,159,283,6,289,0,O-33-183-01-02-03
NEBBI,PADYERE COUNTY,AKWORO,KITUNA,PAKOLO COTTON STORE,468,14,14,13,163,152,356,12,368,0,O-33-183-01-02-04
NEBBI,PADYERE COUNTY,AKWORO,MURUSI,MUNDURYEMA P/S,623,21,9,8,120,230,388,30,418,0,O-33-183-01-03-01
NEBBI,PADYERE COUNTY,AKWORO,MURUSI,MURUSI TRADING CENTRE,452,9,2,3,74,234,322,20,342,0,O-33-183-01-03-02
NEBBI,PADYERE COUNTY,AKWORO,RERU,MUNGUJAKISA P/SCH,408,6,4,4,66,176,256,25,281,0,O-33-183-01-04-01
NEBBI,PADYERE COUNTY,AKWORO,RERU,RERO PRI. SCHOOL,295,1,3,5,65,129,203,4,207,0,O-33-183-01-04-02
NEBBI,PADYERE COUNTY,AKWORO,RERU,AKURU PRI. SCHOOL,350,5,8,3,115,124,255,15,270,0,O-33-183-01-04-03
NEBBI,PADYERE COUNTY,ERUSSI,ABAR,AVESI STORE-ONDHEU,415,3,3,4,104,197,311,9,320,0,O-33-183-02-01-01
NEBBI,PADYERE COUNTY,ERUSSI,ABAR,OBIYA CENTRE,512,8,3,13,106,229,359,13,372,0,O-33-183-02-01-02
NEBBI,PADYERE COUNTY,ERUSSI,ABAR,OMOYO P/S,885,10,14,15,335,276,650,18,668,0,O-33-183-02-01-03
NEBBI,PADYERE COUNTY,ERUSSI,ABAR,OWILLO P/S,502,4,9,2,273,113,401,8,409,0,O-33-183-02-01-04
NEBBI,PADYERE COUNTY,ERUSSI,ABAR,JALAKECH PRI. SCHOOL,294,4,2,8,69,114,197,8,205,0,O-33-183-02-01-05
NEBBI,PADYERE COUNTY,ERUSSI,ABAR,OWILLO CHAPEL (C.O.U.),341,4,6,2,138,105,255,13,268,0,O-33-183-02-01-06
NEBBI,PADYERE COUNTY,ERUSSI,ABONGO,ABONGO P/S,604,7,6,14,96,322,445,34,479,0,O-33-183-02-02-01
NEBBI,PADYERE COUNTY,ERUSSI,ABONGO,JUPAMINYA GROUND,689,3,11,6,133,376,529,14,543,0,O-33-183-02-02-02
NEBBI,PADYERE COUNTY,ERUSSI,ABONGO,LARA CENTRE,231,3,6,2,27,137,175,12,187,0,O-33-183-02-02-03
NEBBI,PADYERE COUNTY,ERUSSI,OWEKO,ARYEGO,450,5,6,4,139,170,324,5,329,0,O-33-183-02-03-01
NEBBI,PADYERE COUNTY,ERUSSI,OWEKO,OWEKO PRI. SCHOOL,746,9,9,11,278,228,535,15,550,0,O-33-183-02-03-02
NEBBI,PADYERE COUNTY,ERUSSI,OWEKO,PARWATH,399,6,4,1,124,138,273,3,276,0,O-33-183-02-03-03
NEBBI,PADYERE COUNTY,ERUSSI,PACHAKA,JUPANZIRI COOP SOCIETY,501,7,2,4,201,155,369,5,374,0,O-33-183-02-04-01
NEBBI,PADYERE COUNTY,ERUSSI,PACHAKA,ORIWO P SCHOOL,478,6,2,1,186,160,355,24,379,0,O-33-183-02-04-02
NEBBI,PADYERE COUNTY,ERUSSI,PACHAKA,PACHAKA PRI. SCHOOL,522,4,10,5,264,95,378,11,389,0,O-33-183-02-04-03
NEBBI,PADYERE COUNTY,ERUSSI,PACHAKA,KUBI PRI. SCHOOL,387,6,7,1,198,87,299,2,301,0,O-33-183-02-04-04
NEBBI,PADYERE COUNTY,ERUSSI,PACHAKA,AVURU PRI. SCHOOL,297,3,3,5,172,49,232,0,232,0,O-33-183-02-04-05
NEBBI,PADYERE COUNTY,ERUSSI,PADOLO,ERUSSI POLICE STATION,829,16,10,12,287,201,526,13,539,0,O-33-183-02-05-01
NEBBI,PADYERE COUNTY,ERUSSI,PADOLO,ERUSSI SUB-COUNTY HQRS,730,11,14,7,272,191,495,10,505,0,O-33-183-02-05-02
NEBBI,PADYERE COUNTY,ERUSSI,PADOLO,ITALIA P.SCHOOL,714,13,4,16,275,215,523,0,523,0,O-33-183-02-05-03
NEBBI,PADYERE COUNTY,ERUSSI,PADOLO,OLENY CENTRE,648,4,3,3,226,167,403,7,410,0,O-33-183-02-05-04
NEBBI,PADYERE COUNTY,ERUSSI,PADOLO,ERUSSI PRI. SCHOOL,228,6,2,2,69,81,160,6,166,0,O-33-183-02-05-05
NEBBI,PADYERE COUNTY,ERUSSI,PAJUR,ATHELE P.SCHOOL,474,6,5,8,97,204,320,52,372,0,O-33-183-02-06-01
NEBBI,PADYERE COUNTY,ERUSSI,PAJUR,NGANG P.SCHOOL,546,15,6,10,156,190,377,15,392,0,O-33-183-02-06-02
NEBBI,PADYERE COUNTY,ERUSSI,PAJUR,PAJUR P.SCHOOL,666,14,11,14,235,192,466,15,481,0,O-33-183-02-06-03
NEBBI,PADYERE COUNTY,ERUSSI,PAYERA,ADEIRA P/SCHOOL,352,4,1,1,127,110,243,4,247,0,O-33-183-02-07-01
NEBBI,PADYERE COUNTY,ERUSSI,PAYERA,NYANGA,470,6,6,6,103,204,325,9,334,0,O-33-183-02-07-02
NEBBI,PADYERE COUNTY,ERUSSI,PAYERA,AKEU COPE CENTRE,528,5,3,3,164,186,361,16,377,0,O-33-183-02-07-03
NEBBI,PADYERE COUNTY,ERUSSI,PAYERA,OVURU-RUI COOP SOCIETY,512,7,3,4,154,189,357,13,370,0,O-33-183-02-07-04
NEBBI,PADYERE COUNTY,ERUSSI,PAYERA,THER-OYELU COOP SOCIETY,478,1,5,8,139,209,362,13,375,0,O-33-183-02-07-05
NEBBI,PADYERE COUNTY,ERUSSI,PAYERA,JUPUGETA PLAY GROUND,445,6,7,2,128,155,298,8,306,0,O-33-183-02-07-06
NEBBI,PADYERE COUNTY,KUCWINY,OLAGO,CWA-LAO,543,5,12,6,267,92,382,0,382,0,O-33-183-03-01-01
NEBBI,PADYERE COUNTY,KUCWINY,OLAGO,KOM-KECH COOP SOCIETY,485,3,10,5,171,153,342,12,354,0,O-33-183-03-01-02
NEBBI,PADYERE COUNTY,KUCWINY,OLAGO,PADYERE COUNTY HQRS-AGWOK,428,4,16,5,161,95,281,16,297,0,O-33-183-03-01-03
NEBBI,PADYERE COUNTY,KUCWINY,OLAGO,WOR-CWERI,454,5,4,2,185,118,314,23,337,0,O-33-183-03-01-04
NEBBI,PADYERE COUNTY,KUCWINY,OLAGO,PADANYO,453,10,6,12,135,152,315,7,322,0,O-33-183-03-01-05
NEBBI,PADYERE COUNTY,KUCWINY,OLAGO,ORANGO,384,8,6,1,129,137,281,4,285,0,O-33-183-03-01-06
NEBBI,PADYERE COUNTY,KUCWINY,RAMOGI,KUCWINY P SCHOOL,329,6,11,3,158,64,242,8,250,0,O-33-183-03-02-01
NEBBI,PADYERE COUNTY,KUCWINY,RAMOGI,KUCWINY TRADING CENTRE,450,8,3,5,173,124,313,7,320,0,O-33-183-03-02-02
NEBBI,PADYERE COUNTY,KUCWINY,RAMOGI,KUCWINY  SUB-COUNTY  HQTRS,285,5,4,2,65,132,208,7,215,0,O-33-183-03-02-03
NEBBI,PADYERE COUNTY,KUCWINY,RAMOGI,LEE PR SCHOOL,471,10,4,4,89,194,301,26,327,0,O-33-183-03-02-04
NEBBI,PADYERE COUNTY,KUCWINY,RAMOGI,PADWOT P SCHOOL,547,4,19,5,271,68,367,4,371,0,O-33-183-03-02-05
NEBBI,PADYERE COUNTY,KUCWINY,RAMOGI,CUNGALWOKI,411,4,3,8,140,133,288,10,298,0,O-33-183-03-02-06
NEBBI,PADYERE COUNTY,KUCWINY,RAMOGI,AWARADI,383,1,1,2,153,108,265,11,276,0,O-33-183-03-02-07
NEBBI,PADYERE COUNTY,KUCWINY,RAMOGI,OTHWOL PR SCH,439,14,3,1,192,100,310,12,322,0,O-33-183-03-02-08
NEBBI,PADYERE COUNTY,KUCWINY,RAMOGI,JUPALA PR SCH,427,3,5,8,218,75,309,15,324,0,O-33-183-03-02-09
NEBBI,PADYERE COUNTY,KUCWINY,VUR,AKABA PRIMARY SCHOOL,507,2,5,5,142,230,384,16,400,0,O-33-183-03-03-01
NEBBI,PADYERE COUNTY,KUCWINY,VUR,AKANYO PR SCHOOL,634,5,2,1,155,298,461,16,477,0,O-33-183-03-03-02
NEBBI,PADYERE COUNTY,KUCWINY,VUR,ARINGA PR SCHOOL,514,9,2,3,146,213,373,15,388,0,O-33-183-03-03-03
NEBBI,PADYERE COUNTY,KUCWINY,VUR,KUCWINY DISPENSARY,357,6,1,4,90,146,247,14,261,0,O-33-183-03-03-04
NEBBI,PADYERE COUNTY,KUCWINY,VUR,THECWA ALALA LOWER,409,3,13,6,156,154,332,5,337,0,O-33-183-03-03-05
NEBBI,PADYERE COUNTY,KUCWINY,VUR,NYARAKWACHA CHAPEL,142,3,3,1,19,87,113,9,122,0,O-33-183-03-03-06
NEBBI,PADYERE COUNTY,NEBBI,JUP-PAWONG,GOLI P.SCHOOL,855,7,10,5,388,153,563,18,581,0,O-33-183-04-01-01
NEBBI,PADYERE COUNTY,NEBBI,JUP-PAWONG,JUPANGIRA P.SCHOOL,733,3,7,3,385,127,525,17,542,0,O-33-183-04-01-02
NEBBI,PADYERE COUNTY,NEBBI,JUP-PAWONG,PATONGO DISPENSARY,741,17,11,6,315,146,495,21,516,0,O-33-183-04-01-03
NEBBI,PADYERE COUNTY,NEBBI,JUP-PAWONG,GOLI TRADING CENTRE,364,6,6,1,165,73,251,11,262,0,O-33-183-04-01-04
NEBBI,PADYERE COUNTY,NEBBI,JUP-PAWONG,URINGI SEC.SCHOOL,177,0,4,0,96,23,123,2,125,0,O-33-183-04-01-05
NEBBI,PADYERE COUNTY,NEBBI,JUP-PAWONG,PAWONG PRI. SCHOOL,212,3,4,5,90,32,134,7,141,0,O-33-183-04-01-06
NEBBI,PADYERE COUNTY,NEBBI,KALOWANG,ARYEK COOP.SOCIETY,690,8,10,8,237,179,442,44,486,0,O-33-183-04-02-01
NEBBI,PADYERE COUNTY,NEBBI,KALOWANG,AZINGU P.SCHOOL,724,21,9,10,232,194,466,17,483,0,O-33-183-04-02-02
NEBBI,PADYERE COUNTY,NEBBI,KALOWANG,OMYER P. SCHOOL (A - Z),413,5,1,1,66,195,268,9,277,0,O-33-183-04-02-03
NEBBI,PADYERE COUNTY,NEBBI,KALOWANG,OWINYOPIELO,267,2,0,0,53,101,156,8,164,0,O-33-183-04-02-04
NEBBI,PADYERE COUNTY,NEBBI,KALOWANG,OMYER P. SCHOOL (M - Z),337,3,3,1,62,178,247,8,255,0,O-33-183-04-02-05
NEBBI,PADYERE COUNTY,NEBBI,KOCH,ADHWONGO COOP SOCIETY,522,6,7,7,180,174,374,12,386,0,O-33-183-04-03-01
NEBBI,PADYERE COUNTY,NEBBI,KOCH,JAAGI COOP STORE,528,2,17,5,170,207,401,7,408,0,O-33-183-04-03-02
NEBBI,PADYERE COUNTY,NEBBI,KOCH,KOCH P SCHOOL,577,2,12,2,226,161,403,15,418,0,O-33-183-04-03-03
NEBBI,PADYERE COUNTY,NEBBI T.C,ABINDU WARD,ABINDU PRI. SCHOOL,694,12,33,9,208,231,493,19,512,0,O-33-183-05-01-01
NEBBI,PADYERE COUNTY,NEBBI T.C,CENTRAL ZONE,BOMA GROUND,855,4,9,1,380,87,481,2,483,0,O-33-183-05-02-01
NEBBI,PADYERE COUNTY,NEBBI T.C,CENTRAL ZONE,NEBBI PRI. SCHOOL,886,2,11,1,380,110,504,4,508,0,O-33-183-05-02-02
NEBBI,PADYERE COUNTY,NEBBI T.C,CENTRAL ZONE,ADMINISTRATION POLICE HQS,460,5,2,0,176,105,288,6,294,0,O-33-183-05-02-03
NEBBI,PADYERE COUNTY,NEBBI T.C,FOREST,AFERE PR SCHOOL,900,10,12,8,327,153,510,26,536,0,O-33-183-05-03-01
NEBBI,PADYERE COUNTY,NEBBI T.C,FOREST,ONJUKU,606,5,8,3,230,124,370,22,392,0,O-33-183-05-03-02
NEBBI,PADYERE COUNTY,NEBBI T.C,FOREST,NEBBI SEC. SCHOOL,327,4,2,1,152,83,242,5,247,0,O-33-183-05-03-03
NEBBI,PADYERE COUNTY,NEBBI T.C,JUKIYA HILL,AMULLA ORCHARD,644,8,12,9,285,138,452,13,465,0,O-33-183-05-04-01
NEBBI,PADYERE COUNTY,NEBBI T.C,JUKIYA HILL,JUKIA PRIMARY SCHOOL,533,5,11,5,163,142,326,30,356,0,O-33-183-05-04-02
NEBBI,PADYERE COUNTY,NEBBI T.C,NAMATHIN,PIDA,252,6,5,1,117,46,175,10,185,0,O-33-183-05-05-01
NEBBI,PADYERE COUNTY,NEBBI T.C,NAMATHIN,PUBIDHI PRI. SCHOOL,323,1,4,4,101,138,248,7,255,0,O-33-183-05-05-02
NEBBI,PADYERE COUNTY,NEBBI T.C,NAMRWODHO,NAMRWODHO P. SCHOOL,883,12,10,12,361,176,571,52,623,0,O-33-183-05-06-01
NEBBI,PADYERE COUNTY,NEBBI T.C,NEBBI HILL,ARUM-OKENG,604,5,15,1,210,164,395,19,414,0,O-33-183-05-07-01
NEBBI,PADYERE COUNTY,NEBBI T.C,NEBBI HILL,NDURO,595,1,12,4,196,141,354,14,368,0,O-33-183-05-07-02
NEBBI,PADYERE COUNTY,NEBBI T.C,NYACARA,KASUKU,553,6,18,3,244,78,349,4,353,0,O-33-183-05-08-01
NEBBI,PADYERE COUNTY,NEBBI T.C,NYACARA,MAKOR,536,1,9,5,180,111,306,0,306,0,O-33-183-05-08-02
NEBBI,PADYERE COUNTY,NEBBI T.C,NYACARA,NYACARA PRI. SCHOOL,910,2,8,6,369,104,489,18,507,0,O-33-183-05-08-03
NEBBI,PADYERE COUNTY,NEBBI T.C,THATHA,JUPANJAU,239,6,0,7,118,22,153,9,162,0,O-33-183-05-09-01
NEBBI,PADYERE COUNTY,NEBBI T.C,THATHA,THATHA CENTRE,666,3,7,2,179,103,294,146,440,0,O-33-183-05-09-02
NEBBI,PADYERE COUNTY,NYARAVUR,MBARO,AGENU,764,15,6,10,300,180,511,26,537,0,O-33-183-06-01-01
NEBBI,PADYERE COUNTY,NYARAVUR,MBARO,NYARAVUR TRADING CENTRE,756,5,8,2,244,194,453,19,472,0,O-33-183-06-01-02
NEBBI,PADYERE COUNTY,NYARAVUR,MBARO,ORYANG PR SCHOOL,708,6,5,1,191,259,462,15,477,0,O-33-183-06-01-03
NEBBI,PADYERE COUNTY,NYARAVUR,MBARO,NYARAVUR SUB COUNTY HQTRS,533,11,12,14,248,92,377,7,384,0,O-33-183-06-01-04
NEBBI,PADYERE COUNTY,NYARAVUR,MBARO,NYARAVUR COMMUNITY CENTRE,217,0,0,1,61,80,142,5,147,0,O-33-183-06-01-05
NEBBI,PADYERE COUNTY,NYARAVUR,OWARO,ATAR COTTON STORE,445,5,5,7,162,147,326,6,332,0,O-33-183-06-02-01
NEBBI,PADYERE COUNTY,NYARAVUR,OWARO,AYILA P SCHOOL,273,1,1,0,79,126,207,10,217,0,O-33-183-06-02-02
NEBBI,PADYERE COUNTY,NYARAVUR,OWARO,KWIRO COTTON STORE,480,2,6,4,173,153,338,7,345,0,O-33-183-06-02-03
NEBBI,PADYERE COUNTY,NYARAVUR,OWARO,OLYEKO THE-CWA,393,3,4,3,104,157,271,0,271,0,O-33-183-06-02-04
NEBBI,PADYERE COUNTY,NYARAVUR,PAMINYA,AKANGA STORE,626,4,10,5,166,210,395,13,408,0,O-33-183-06-03-01
NEBBI,PADYERE COUNTY,NYARAVUR,PAMINYA,PACERO P SCHOOL,585,8,3,9,179,215,414,17,431,0,O-33-183-06-03-02
NEBBI,PADYERE COUNTY,NYARAVUR,PAMINYA,PADYERE CENTRE,545,5,4,5,86,299,399,7,406,0,O-33-183-06-03-03
NEBBI,PADYERE COUNTY,NYARAVUR,PAMINYA,PAMINYA P SCHOOL,471,1,6,7,124,196,334,10,344,0,O-33-183-06-03-04
NEBBI,PADYERE COUNTY,NYARAVUR,PAMORA,ANGAL BOYS PR SCHOOL,825,8,5,8,300,188,509,9,518,0,O-33-183-06-04-01
NEBBI,PADYERE COUNTY,NYARAVUR,PAMORA,GIRA,636,8,9,4,237,184,442,8,450,0,O-33-183-06-04-02
NEBBI,PADYERE COUNTY,NYARAVUR,PAMORA,RINGE MEMORIAL PR SCHOOL,484,5,5,7,147,168,332,25,357,0,O-33-183-06-04-03
NEBBI,PADYERE COUNTY,NYARAVUR,PAMORA,ANGAL GIRLS,287,6,1,14,54,103,178,10,188,0,O-33-183-06-04-04
NEBBI,PADYERE COUNTY,NYARAVUR,PAMORA,OBOKO PRI. SCHOOL,192,1,4,3,65,55,128,11,139,0,O-33-183-06-04-05
NEBBI,PADYERE COUNTY,PAROMBO,OSSI,OSSI PR SCHOOL,650,5,7,4,222,258,496,28,524,0,O-33-183-07-01-01
NEBBI,PADYERE COUNTY,PAROMBO,OSSI,ALEGO PRI. SCHOOL,352,2,3,3,120,131,259,8,267,0,O-33-183-07-01-02
NEBBI,PADYERE COUNTY,PAROMBO,OSSI,PADEL PR SCHOOL,544,4,6,3,250,134,397,16,413,0,O-33-183-07-01-03
NEBBI,PADYERE COUNTY,PAROMBO,OSSI,ANYANG PRI. SCHOOL,262,3,0,2,78,103,186,10,196,0,O-33-183-07-01-04
NEBBI,PADYERE COUNTY,PAROMBO,PADEL,AYILA COTTON STORE,630,4,7,7,206,202,426,30,456,0,O-33-183-07-02-01
NEBBI,PADYERE COUNTY,PAROMBO,PADEL,PENJI-ORYANG PR SCH,261,1,1,2,119,73,196,11,207,0,O-33-183-07-02-02
NEBBI,PADYERE COUNTY,PAROMBO,PADEL,PAMITU CENTRE,526,5,10,3,234,133,385,19,404,0,O-33-183-07-02-03
NEBBI,PADYERE COUNTY,PAROMBO,PADEL,KULUKWAC,391,9,4,2,111,189,315,7,322,0,O-33-183-07-02-04
NEBBI,PADYERE COUNTY,PAROMBO,PAGWATA,KATANGA COTTON STORE,764,9,23,8,254,229,523,43,566,0,O-33-183-07-03-01
NEBBI,PADYERE COUNTY,PAROMBO,PAGWATA,PAGWATA PRI. SCHOOL,706,4,15,5,175,297,496,29,525,0,O-33-183-07-03-02
NEBBI,PADYERE COUNTY,PAROMBO,PAGWATA,ATIDO,125,3,0,1,46,37,87,7,94,0,O-33-183-07-03-03
NEBBI,PADYERE COUNTY,PAROMBO,PANGERE,PANGERE GWII COOP STORE,425,3,4,3,105,176,291,23,314,0,O-33-183-07-04-01
NEBBI,PADYERE COUNTY,PAROMBO,PANGERE,ALALA COPE CENTRE,407,4,8,1,127,162,302,12,314,0,O-33-183-07-04-02
NEBBI,PADYERE COUNTY,PAROMBO,PARWO,MARKET VILLAGE-ALENGO COOP,652,5,5,4,243,203,460,15,475,0,O-33-183-07-05-01
NEBBI,PADYERE COUNTY,PAROMBO,PARWO,NYAROGALO UPPER,609,4,7,3,258,135,407,15,422,0,O-33-183-07-05-02
NEBBI,PADYERE COUNTY,PAROMBO,PARWO,PAROMBO S/COUNTY HQRS,323,5,4,6,134,96,245,12,257,0,O-33-183-07-05-03
NEBBI,PADYERE COUNTY,PAROMBO,PARWO,PARWO CENTRE,678,3,5,5,287,184,484,9,493,0,O-33-183-07-05-04
NEBBI,PADYERE COUNTY,PAROMBO,PARWO,ALALA,429,7,3,3,139,159,311,11,322,0,O-33-183-07-05-05
NEBBI,PADYERE COUNTY,PAROMBO,PARWO,NYAROGALO LOWER,583,4,11,2,212,169,398,6,404,0,O-33-183-07-05-06
NEBBI,PADYERE COUNTY,PAROMBO,PARWO,JUPANGUMA,401,4,5,6,129,144,288,11,299,0,O-33-183-07-05-07
NEBBI,PADYERE COUNTY,PAROMBO,PULUM,ANJAT,602,9,10,11,170,241,441,5,446,0,O-33-183-07-06-01
NEBBI,PADYERE COUNTY,PAROMBO,PULUM,UDUK,768,10,20,5,291,237,563,6,569,0,O-33-183-07-06-02
ADJUMANI,EAST MOYO,ADJUMANI TOWN COUNCIL,BIYAYA,BIYAYA PRIMARY SCHOOL,804,4,1,8,279,203,495,29,524,0,O-40-151-01-01-01
ADJUMANI,EAST MOYO,ADJUMANI TOWN COUNCIL,BIYAYA,TOWN HALL,771,5,5,3,346,110,469,16,485,0,O-40-151-01-01-02
ADJUMANI,EAST MOYO,ADJUMANI TOWN COUNCIL,BIYAYA,ADJUMANI MOSQUE,272,1,0,0,47,113,161,10,171,0,O-40-151-01-01-03
ADJUMANI,EAST MOYO,ADJUMANI TOWN COUNCIL,BIYAYA,BOMA GROUND,571,5,4,1,275,71,356,13,369,0,O-40-151-01-01-04
ADJUMANI,EAST MOYO,ADJUMANI TOWN COUNCIL,CENTRAL,ADJUMANI COMMUNITY CENTRE,635,1,0,1,188,101,291,12,303,0,O-40-151-01-02-01
ADJUMANI,EAST MOYO,ADJUMANI TOWN COUNCIL,CENTRAL,ADJUMANI DIST. HQRS,869,8,3,7,425,109,552,21,573,0,O-40-151-01-02-02
ADJUMANI,EAST MOYO,ADJUMANI TOWN COUNCIL,CENTRAL,AULOGO,800,3,2,4,249,139,397,21,418,0,O-40-151-01-02-03
ADJUMANI,EAST MOYO,ADJUMANI TOWN COUNCIL,CENTRAL,CENTRAL PRIMARY SCHOOL A,549,4,1,1,210,97,313,9,322,0,O-40-151-01-02-04
ADJUMANI,EAST MOYO,ADJUMANI TOWN COUNCIL,CENTRAL,CENTRAL PRIMARY SCHOOL B,509,0,1,2,204,90,297,4,301,0,O-40-151-01-02-05
ADJUMANI,EAST MOYO,ADJUMANI TOWN COUNCIL,CESIA,ADJUMANI GIRLS PRI. SCHOOL,610,6,0,5,264,90,365,15,380,0,O-40-151-01-03-01
ADJUMANI,EAST MOYO,ADJUMANI TOWN COUNCIL,CESIA,OLIGO PRI. SCH.,821,13,2,12,346,165,538,30,568,0,O-40-151-01-03-02
ADJUMANI,EAST MOYO,ADJUMANI TOWN COUNCIL,CESIA,CESIA PRIMARY SCHOOL,774,5,1,3,354,117,480,21,501,0,O-40-151-01-03-03
ADJUMANI,EAST MOYO,ADJUMANI TOWN COUNCIL,CESIA,PARISH HALL,575,4,0,4,237,111,356,16,372,0,O-40-151-01-03-04
ADJUMANI,EAST MOYO,ADROPI,ALERE,AJUJO PRIMARY SCHOOL,561,10,1,12,132,244,399,33,432,0,O-40-151-02-01-01
ADJUMANI,EAST MOYO,ADROPI,ESIA,OBILOKONG PR SCH,744,23,0,20,217,260,520,29,549,0,O-40-151-02-02-01
ADJUMANI,EAST MOYO,ADROPI,ESIA,MOINYA PRI. SCH,520,9,3,14,116,241,383,40,423,0,O-40-151-02-02-02
ADJUMANI,EAST MOYO,ADROPI,JIHWA,PACARA PRIMARY SCHOOL,551,4,1,8,209,133,355,9,364,0,O-40-151-02-03-01
ADJUMANI,EAST MOYO,ADROPI,LAJOPI,ADROPI SUB-COUNTY HEADQUAR,723,8,3,9,340,107,467,13,480,0,O-40-151-02-04-01
ADJUMANI,EAST MOYO,ADROPI,MARINDI,UNNA PRIMARY SCHOOL,322,1,0,4,183,26,214,12,226,0,O-40-151-02-05-01
ADJUMANI,EAST MOYO,ADROPI,MARINDI,ELEUHWE PRIMARY SCHOOL,505,7,0,6,196,106,315,8,323,0,O-40-151-02-05-02
ADJUMANI,EAST MOYO,ADROPI,MARINDI,MARINDI CENTRE,627,7,3,3,242,178,433,22,455,0,O-40-151-02-05-03
ADJUMANI,EAST MOYO,ADROPI,OMI,ARRA TRADING CENTRE,699,6,1,9,251,225,492,22,514,0,O-40-151-02-06-01
ADJUMANI,EAST MOYO,ADROPI,OPENZINZI,OPENZINZI PRISON,200,0,0,1,64,44,109,2,111,0,O-40-151-02-07-01
ADJUMANI,EAST MOYO,ADROPI,OPENZINZI,OPENZINZI PR SCH B,647,5,9,8,312,116,450,12,462,0,O-40-151-02-07-02
ADJUMANI,EAST MOYO,ADROPI,PALEMO,KOZEIZA CENTRE,776,20,6,8,374,144,552,27,579,0,O-40-151-02-08-01
ADJUMANI,EAST MOYO,CIFORO,AYIRI,AYIRI PRI. SCH.,746,13,4,7,369,97,490,32,522,0,O-40-151-03-01-01
ADJUMANI,EAST MOYO,CIFORO,GULINYA,GULINYA PRI SCH,486,7,2,8,189,143,349,17,366,0,O-40-151-03-02-01
ADJUMANI,EAST MOYO,CIFORO,KIRABA,OKUSIJONI PR SCH A,563,12,2,17,126,247,404,21,425,0,O-40-151-03-03-01
ADJUMANI,EAST MOYO,CIFORO,KIRABA,OKUSIJONI PR SCH B,644,29,1,8,285,164,487,27,514,0,O-40-151-03-03-02
ADJUMANI,EAST MOYO,CIFORO,LOA,LIRI CENTRE,510,8,0,4,138,208,358,20,378,0,O-40-151-03-04-01
ADJUMANI,EAST MOYO,CIFORO,LOA,LOA PR SCH,841,14,0,12,198,350,574,30,604,0,O-40-151-03-04-02
ADJUMANI,EAST MOYO,CIFORO,MAAJI,MAAJI MARKET,891,21,1,17,300,169,508,43,551,0,O-40-151-03-05-01
ADJUMANI,EAST MOYO,CIFORO,MUGI,ONIGO CENTRE,666,6,1,5,231,260,503,34,537,0,O-40-151-03-06-01
ADJUMANI,EAST MOYO,CIFORO,MUGI,CIFORO MARKET,734,7,2,13,308,218,548,19,567,0,O-40-151-03-06-02
ADJUMANI,EAST MOYO,CIFORO,MUGI,AGOJO PRI SCH,198,2,1,3,52,77,135,16,151,0,O-40-151-03-06-03
ADJUMANI,EAST MOYO,CIFORO,OKANGALI,OGBORO CENTRE,358,3,0,12,65,135,215,14,229,0,O-40-151-03-07-01
ADJUMANI,EAST MOYO,CIFORO,OKANGALI,OKANGALI PR SCH,566,15,1,8,211,152,387,38,425,0,O-40-151-03-07-02
ADJUMANI,EAST MOYO,CIFORO,OKANGALI,ESIA PRIMARY SCHOOL,432,6,1,5,179,107,298,7,305,0,O-40-151-03-07-03
ADJUMANI,EAST MOYO,CIFORO,OPEJO,OPEJO WESTEAST,831,10,1,11,240,339,601,34,635,0,O-40-151-03-08-01
ADJUMANI,EAST MOYO,DZAIPI,AJUGOPI,AJUGOPI PRI. SCH.,694,8,1,4,245,247,505,22,527,0,O-40-151-04-01-01
ADJUMANI,EAST MOYO,DZAIPI,AJUGOPI,EGGE BOREHOLE CENTRE,248,2,0,3,119,52,176,11,187,0,O-40-151-04-01-02
ADJUMANI,EAST MOYO,DZAIPI,AJUGOPI,JURUMINI PRI. SCH.,589,7,0,6,286,110,409,17,426,0,O-40-151-04-01-03
ADJUMANI,EAST MOYO,DZAIPI,EELEGU,ORIANGWA PR SCH,711,31,5,24,262,155,477,48,525,0,O-40-151-04-02-01
ADJUMANI,EAST MOYO,DZAIPI,ITUJI,ARINYAPI DISPENSARY,615,15,5,20,265,120,425,15,440,0,O-40-151-04-03-01
ADJUMANI,EAST MOYO,DZAIPI,ITUJI,ARINYAPI DISP. OUTSIDE Q. GUA,141,2,0,1,37,31,71,12,83,0,O-40-151-04-03-02
ADJUMANI,EAST MOYO,DZAIPI,LIRI,ETIA PRIMARY SCHOOL,248,3,0,6,53,112,174,8,182,0,O-40-151-04-04-01
ADJUMANI,EAST MOYO,DZAIPI,LIRI,OGOLO PRIMARY SCH.,288,2,3,4,175,37,221,20,241,0,O-40-151-04-04-02
ADJUMANI,EAST MOYO,DZAIPI,LIRI,PAMAJUA LANDING BAY,182,6,0,6,53,67,132,17,149,0,O-40-151-04-04-03
ADJUMANI,EAST MOYO,DZAIPI,LOGOANGWA,BARI BOREHOLE,611,13,3,5,294,141,456,11,467,0,O-40-151-04-05-01
ADJUMANI,EAST MOYO,DZAIPI,LOGOANGWA,LOGOANGWA HILL,533,9,0,11,279,62,361,23,384,0,O-40-151-04-05-02
ADJUMANI,EAST MOYO,DZAIPI,MGWERE,DZAIPI SUB-CTY HQTRS,1015,18,2,14,399,219,652,15,667,0,O-40-151-04-06-01
ADJUMANI,EAST MOYO,DZAIPI,MGWERE,DZAIPI PRIMARY SCHOOL,348,4,0,5,114,101,224,5,229,0,O-40-151-04-06-02
ADJUMANI,EAST MOYO,DZAIPI,MGWERE,MARINDI BOREHOLE,663,12,0,11,330,120,473,20,493,0,O-40-151-04-06-03
ADJUMANI,EAST MOYO,DZAIPI,MGWERE,MAGARA PR SCH,292,7,0,5,127,62,201,20,221,0,O-40-151-04-06-04
ADJUMANI,EAST MOYO,DZAIPI,MINIKI,MINIKI MARKET,671,12,1,7,168,258,446,15,461,0,O-40-151-04-07-01
ADJUMANI,EAST MOYO,DZAIPI,MINIKI,ELEMA PR. SCH,558,13,7,10,190,142,362,42,404,0,O-40-151-04-07-02
ADJUMANI,EAST MOYO,DZAIPI,ZINYINI,GWERE PRI. SCH.,416,14,2,1,103,97,217,67,284,0,O-40-151-04-08-01
ADJUMANI,EAST MOYO,OFUA,BACERE,KUREKU PR SCH,734,9,5,12,373,152,551,30,581,0,O-40-151-05-01-01
ADJUMANI,EAST MOYO,OFUA,BACERE,OFUA SECONDARY SCHOOL,450,14,0,4,197,158,373,10,383,0,O-40-151-05-01-02
ADJUMANI,EAST MOYO,OFUA,ITIRIKWA,ITIRIKWA PR SCH,851,16,3,13,346,200,578,47,625,0,O-40-151-05-02-01
ADJUMANI,EAST MOYO,OFUA,ODU,ODU PR SCH A,780,24,4,5,427,87,547,68,615,0,O-40-151-05-03-01
ADJUMANI,EAST MOYO,OFUA,ODU,ODU PR SCH B,1023,28,6,10,397,155,596,61,657,0,O-40-151-05-03-02
ADJUMANI,EAST MOYO,OFUA,OFUA CENTRAL,OFUA MARKET,851,23,3,16,314,254,610,25,635,0,O-40-151-05-04-01
ADJUMANI,EAST MOYO,OFUA,OFUA CENTRAL,OFUA SUBCOUNTY HEADQUARTE,256,4,0,6,54,96,160,15,175,0,O-40-151-05-04-02
ADJUMANI,EAST MOYO,OFUA,SUBBE,SUBBE PR SCH,827,19,5,13,359,217,613,55,668,0,O-40-151-05-05-01
ADJUMANI,EAST MOYO,OFUA,TIANYU,MIRIEYI COTTON STORE,678,4,2,11,391,81,489,41,530,0,O-40-151-05-06-01
ADJUMANI,EAST MOYO,OFUA,TIANYU,TIANYU MANGO TREE,440,4,3,5,225,93,330,28,358,0,O-40-151-05-06-02
ADJUMANI,EAST MOYO,OFUA,ZOKA,ZOKA P SCH,453,8,3,11,130,137,289,15,304,0,O-40-151-05-07-01
ADJUMANI,EAST MOYO,PAKELLE,BOROLI,BOROLI TRADING CENTRE,755,8,5,8,324,176,521,27,548,0,O-40-151-06-01-01
ADJUMANI,EAST MOYO,PAKELLE,BOROLI,AMURU PR SCH,324,7,0,4,171,58,240,26,266,0,O-40-151-06-01-02
ADJUMANI,EAST MOYO,PAKELLE,CENTRAL,JOAGO'S HQTRS,814,7,3,3,328,153,494,25,519,0,O-40-151-06-02-01
ADJUMANI,EAST MOYO,PAKELLE,CENTRAL,MARKET SQUARE,1226,16,5,12,534,157,724,27,751,0,O-40-151-06-02-02
ADJUMANI,EAST MOYO,PAKELLE,CENTRAL,KERELU CENTRE,415,10,1,2,173,50,236,11,247,0,O-40-151-06-02-03
ADJUMANI,EAST MOYO,PAKELLE,CENTRAL,OUTSIDE Q.GUARD,327,2,0,0,45,56,103,4,107,0,O-40-151-06-02-04
ADJUMANI,EAST MOYO,PAKELLE,FUDA,FUDA PR SCH,855,5,4,14,343,226,592,66,658,0,O-40-151-06-03-01
ADJUMANI,EAST MOYO,PAKELLE,LEWA,LEWA PR SCH,486,11,2,15,229,34,291,31,322,0,O-40-151-06-04-01
ADJUMANI,EAST MOYO,PAKELLE,LEWA,INDRIANI PR SCH,362,14,2,8,180,39,243,25,268,0,O-40-151-06-04-02
ADJUMANI,EAST MOYO,PAKELLE,LEWA,GONYILAA MARKET AREA,374,11,1,7,150,68,237,22,259,0,O-40-151-06-04-03
ADJUMANI,EAST MOYO,PAKELLE,LEWA,LEWA OUTSIDE Q.GUARD,204,0,0,0,43,28,71,9,80,0,O-40-151-06-04-04
ADJUMANI,EAST MOYO,PAKELLE,MELIADERI,PALUGA CENTRE,798,14,3,9,423,106,555,33,588,0,O-40-151-06-05-01
ADJUMANI,EAST MOYO,PAKELLE,MELIADERI,OLIA PR SCH,480,5,4,6,240,74,329,13,342,0,O-40-151-06-05-02
ADJUMANI,EAST MOYO,PAKELLE,MELIJO,MELIJO PR SCH,227,9,1,6,123,29,168,8,176,0,O-40-151-06-06-01
ADJUMANI,EAST MOYO,PAKELLE,PERECI,PERECI PR SCH,811,5,1,11,405,132,554,35,589,0,O-40-151-06-07-01
ADJUMANI,EAST MOYO,PAKELLE,PERECI,AMELO BOREHOLE,591,7,5,6,364,62,444,37,481,0,O-40-151-06-07-02
ADJUMANI,EAST MOYO,PAKELLE,PERECI,PALANYUA BOREHOLE,331,5,1,5,181,60,252,10,262,0,O-40-151-06-07-03
PADER,ARUU COUNTY,ACHOLI-BUR,GEM-CENTRAL,ACHOLIBUR MARKET,945,7,6,17,457,48,535,12,547,0,O-50-90-01-01-01
PADER,ARUU COUNTY,ACHOLI-BUR,GEM-CENTRAL,ACHOLI BUR P.7,685,4,3,5,314,40,366,12,378,0,O-50-90-01-01-02
PADER,ARUU COUNTY,ACHOLI-BUR,GEM-CENTRAL,LUGEDE,141,1,0,3,68,10,82,7,89,0,O-50-90-01-01-03
PADER,ARUU COUNTY,ACHOLI-BUR,GEM-CENTRAL,LUKWOR NORTH,650,3,3,4,219,172,401,17,418,0,O-50-90-01-01-04
PADER,ARUU COUNTY,ACHOLI-BUR,GEM-CENTRAL,ARINGOMONE,180,2,1,1,116,0,120,4,124,0,O-50-90-01-01-05
PADER,ARUU COUNTY,ACHOLI-BUR,GEM-ONYOT,OKINGA P/S,576,11,3,3,206,17,240,6,246,0,O-50-90-01-02-01
PADER,ARUU COUNTY,ACHOLI-BUR,GEM-ONYOT,OKINGA MARKT,382,10,1,9,201,12,233,3,236,0,O-50-90-01-02-02
PADER,ARUU COUNTY,ACHOLI-BUR,GEM-ONYOT,OKINGA COP SOC,401,7,1,4,205,21,238,9,247,0,O-50-90-01-02-03
PADER,ARUU COUNTY,ACHOLI-BUR,GEM-ONYOT,PAWACHKANAJOBI,80,0,0,2,36,2,40,2,42,0,O-50-90-01-02-04
PADER,ARUU COUNTY,ACHOLI-BUR,GEM-ONYOT,ACUTOMER,445,5,3,7,258,21,294,0,294,0,O-50-90-01-02-05
PADER,ARUU COUNTY,ACHOLI-BUR,GEM-ONYOT,ARITATWONG,132,2,0,1,60,6,69,9,78,0,O-50-90-01-02-06
PADER,ARUU COUNTY,ACHOLI-BUR,LATIGI,LAMINYIM,499,4,4,4,291,45,348,8,356,0,O-50-90-01-03-01
PADER,ARUU COUNTY,ACHOLI-BUR,LATIGI,PURUNGU MARKET,726,11,4,10,344,30,399,21,420,0,O-50-90-01-03-02
PADER,ARUU COUNTY,ACHOLI-BUR,LATIGI,POROGALI P7 SCHOOL,437,4,1,2,148,29,184,10,194,0,O-50-90-01-03-03
PADER,ARUU COUNTY,ACHOLI-BUR,LATIGI,POROGALI T C,245,2,2,1,122,6,133,4,137,0,O-50-90-01-03-04
PADER,ARUU COUNTY,ACHOLI-BUR,NGEKIDI,DURE P/S,635,0,2,7,322,38,369,5,374,0,O-50-90-01-04-01
PADER,ARUU COUNTY,ACHOLI-BUR,NGEKIDI,ALIMA,423,5,1,6,235,14,261,12,273,0,O-50-90-01-04-02
PADER,ARUU COUNTY,ACHOLI-BUR,NGEKIDI,LATANYA MRKT (A-K),685,4,1,3,307,26,341,10,351,0,O-50-90-01-04-03
PADER,ARUU COUNTY,ACHOLI-BUR,NGEKIDI,DAGOIWAYO,170,5,1,1,84,10,101,2,103,0,O-50-90-01-04-04
PADER,ARUU COUNTY,ACHOLI-BUR,NGEKIDI,LATANYA MRKT (L-Z),662,8,0,3,305,28,344,4,348,0,O-50-90-01-04-05
PADER,ARUU COUNTY,ACHOLI-BUR,NGEKIDI,DURE TRADING CENTRE,144,1,3,2,83,3,92,2,94,0,O-50-90-01-04-06
PADER,ARUU COUNTY,ACHOLI-BUR,NGEKIDI,LAGWENUM OUTSIDE Q.GUARD,481,0,0,0,4,2,6,0,6,0,O-50-90-01-04-07
PADER,ARUU COUNTY,ATANGA,KAL,LABONGOGURU MARKET PLACE,547,8,6,5,218,25,262,12,274,0,O-50-90-02-01-01
PADER,ARUU COUNTY,ATANGA,KAL,PANYAKAWA - DISPENSARY,845,6,4,15,354,53,432,5,437,0,O-50-90-02-01-02
PADER,ARUU COUNTY,ATANGA,KAL,NAGWELA - OLD MARKET,496,9,6,6,280,24,325,18,343,0,O-50-90-02-01-03
PADER,ARUU COUNTY,ATANGA,KAL,RWOTAWICH,197,3,1,2,80,20,106,11,117,0,O-50-90-02-01-04
PADER,ARUU COUNTY,ATANGA,NGOTO,LAWIYEADUL-WANG TANGI,514,5,3,9,284,17,318,17,335,0,O-50-90-02-02-01
PADER,ARUU COUNTY,ATANGA,NGOTO,WIAKEDO P 7 SCHOOL,519,11,3,3,302,11,330,11,341,0,O-50-90-02-02-02
PADER,ARUU COUNTY,ATANGA,NGOTO,ATAL ACAMOGOMA,422,7,0,7,254,10,278,8,286,0,O-50-90-02-02-03
PADER,ARUU COUNTY,ATANGA,NGOTO,TEOLAM,168,1,2,3,76,11,93,7,100,0,O-50-90-02-02-04
PADER,ARUU COUNTY,ATANGA,PUCOTA,OGOM P. SCHOOL,588,8,4,8,281,26,327,23,350,0,O-50-90-02-03-01
PADER,ARUU COUNTY,ATANGA,PUCOTA,ABIL NINO (PARISH CENTRE),449,4,1,7,230,24,266,18,284,0,O-50-90-02-03-02
PADER,ARUU COUNTY,ATANGA,PUCOTA,LACOR P/S,352,3,2,3,216,15,239,13,252,0,O-50-90-02-03-03
PADER,ARUU COUNTY,ATANGA,PUCOTA,JUBA OUTSIDE BARRACKS,1447,7,6,4,119,425,561,0,561,0,O-50-90-02-03-04
PADER,ARUU COUNTY,ATANGA,PUNGOLE,BURLOBO MARKET,375,5,3,4,175,22,209,8,217,0,O-50-90-02-04-01
PADER,ARUU COUNTY,ATANGA,PUNGOLE,LACEDE SCH,478,10,2,11,279,20,322,9,331,0,O-50-90-02-04-02
PADER,ARUU COUNTY,ATANGA,PUNGOLE,LARABA MRKT,505,8,2,13,265,27,315,17,332,0,O-50-90-02-04-03
PADER,ARUU COUNTY,AWERE,ANGOLE,OBIC,296,5,2,2,162,13,184,4,188,0,O-50-90-03-01-01
PADER,ARUU COUNTY,AWERE,ANGOLE,ONGOLE MARKET,389,6,1,1,203,12,223,5,228,0,O-50-90-03-01-02
PADER,ARUU COUNTY,AWERE,ANGOLE,ATEDE,266,3,0,1,110,12,126,12,138,0,O-50-90-03-01-03
PADER,ARUU COUNTY,AWERE,BOLO,BOLO P. SCHOOL,503,11,1,3,304,10,329,8,337,0,O-50-90-03-02-01
PADER,ARUU COUNTY,AWERE,BOLO,DOLTYENI MARKET,574,7,3,8,330,49,397,12,409,0,O-50-90-03-02-02
PADER,ARUU COUNTY,AWERE,BOLO,AWERE DIV. HQRS,767,7,3,2,337,33,382,26,408,0,O-50-90-03-02-03
PADER,ARUU COUNTY,AWERE,BOLO,AYOM,374,4,1,2,187,43,237,10,247,0,O-50-90-03-02-04
PADER,ARUU COUNTY,AWERE,BOLO,BOLO OUTSIDE Q.GUARD,232,0,0,0,7,2,9,0,9,0,O-50-90-03-02-05
PADER,ARUU COUNTY,AWERE,LAGILE,LAGILE PUB MRKT,573,9,5,8,255,14,291,13,304,0,O-50-90-03-03-01
PADER,ARUU COUNTY,AWERE,LAGILE,LAGILE P/S,735,13,2,9,292,91,407,9,416,0,O-50-90-03-03-02
PADER,ARUU COUNTY,AWERE,LAGILE,LABOYE P/S,342,9,1,3,168,12,193,4,197,0,O-50-90-03-03-03
PADER,ARUU COUNTY,AWERE,LAGILE,OLOKOTUM,169,4,0,3,73,15,95,0,95,0,O-50-90-03-03-04
PADER,ARUU COUNTY,AWERE,RACHKOKO,LUNYIRI P/S,861,5,4,4,395,52,460,4,464,0,O-50-90-03-04-01
PADER,ARUU COUNTY,AWERE,RACHKOKO,RACHKOKO P.7,608,3,1,4,269,48,325,9,334,0,O-50-90-03-04-02
PADER,ARUU COUNTY,LAGUTI,LAPYEM,LAGUTI TRADING CENTRE (A-L),681,8,13,12,241,65,339,25,364,0,O-50-90-04-01-01
PADER,ARUU COUNTY,LAGUTI,LAPYEM,LAJENG MRKT,405,5,7,3,176,20,211,8,219,0,O-50-90-04-01-02
PADER,ARUU COUNTY,LAGUTI,LAPYEM,LAGUTI TRADING CENTRE (M-Z),424,4,3,5,169,53,234,8,242,0,O-50-90-04-01-03
PADER,ARUU COUNTY,LAGUTI,LAPYEM,TUMALYEC,224,2,1,2,108,2,115,0,115,0,O-50-90-04-01-04
PADER,ARUU COUNTY,LAGUTI,PAIBWOR,AMILOBO CENTRAL,443,16,2,7,240,12,277,30,307,0,O-50-90-04-02-01
PADER,ARUU COUNTY,LAGUTI,PAIBWOR,LOBUT,409,7,2,0,174,27,210,24,234,0,O-50-90-04-02-02
PADER,ARUU COUNTY,LAGUTI,PAIBWOR,ARINGOYON,274,9,2,6,144,8,169,11,180,0,O-50-90-04-02-03
PADER,ARUU COUNTY,LAGUTI,PAKEYO,WIKO,216,4,4,3,137,10,158,4,162,0,O-50-90-04-03-01
PADER,ARUU COUNTY,LAGUTI,PAKEYO,ATANGA P. SCHOOL,613,18,2,12,311,41,384,24,408,0,O-50-90-04-03-02
PADER,ARUU COUNTY,LAPUL,ATO,JAKA CENTRAL,592,10,5,7,344,74,440,5,445,0,O-50-90-05-01-01
PADER,ARUU COUNTY,LAPUL,ATO,LALOKE,418,12,6,8,246,20,292,14,306,0,O-50-90-05-01-02
PADER,ARUU COUNTY,LAPUL,ATO,OMOGI EAST,387,9,3,5,214,27,258,10,268,0,O-50-90-05-01-03
PADER,ARUU COUNTY,LAPUL,ATO,ORATWILA WEST,251,8,1,5,146,16,176,0,176,0,O-50-90-05-01-04
PADER,ARUU COUNTY,LAPUL,KOYO,KOYO LALOGI P/S,606,7,3,1,147,75,233,5,238,0,O-50-90-05-02-01
PADER,ARUU COUNTY,LAPUL,KOYO,BAR ODILO,547,6,0,7,168,95,276,6,282,0,O-50-90-05-02-02
PADER,ARUU COUNTY,LAPUL,KOYO,OJURU,107,1,0,1,68,5,75,2,77,0,O-50-90-05-02-03
PADER,ARUU COUNTY,LAPUL,KOYO,ABUNGA,202,6,1,1,119,9,136,6,142,0,O-50-90-05-02-04
PADER,ARUU COUNTY,LAPUL,LUKACI,LANYATIDO P/S,485,2,6,9,222,25,264,7,271,0,O-50-90-05-03-01
PADER,ARUU COUNTY,LAPUL,LUKACI,ALIM,263,7,6,5,126,22,166,4,170,0,O-50-90-05-03-02
PADER,ARUU COUNTY,LAPUL,LUKACI,APURIPII,309,7,2,4,175,24,212,13,225,0,O-50-90-05-03-03
PADER,ARUU COUNTY,LAPUL,OGOLE,LACANI A,574,4,6,9,267,61,347,6,353,0,O-50-90-05-04-01
PADER,ARUU COUNTY,LAPUL,OGOLE,OKWORO,354,5,4,4,202,25,240,16,256,0,O-50-90-05-04-02
PADER,ARUU COUNTY,LAPUL,OGOLE,LACANI B (A-L),427,3,1,3,154,54,215,6,221,0,O-50-90-05-04-03
PADER,ARUU COUNTY,LAPUL,OGOLE,GULALELA,190,6,2,8,125,11,152,2,154,0,O-50-90-05-04-04
PADER,ARUU COUNTY,LAPUL,OGOLE,LACANI B (M-Z),418,2,3,2,133,71,211,12,223,0,O-50-90-05-04-05
PADER,ARUU COUNTY,PADER,KILAK CORNER,KILAK T.C. A,671,2,3,9,270,129,413,6,419,0,O-50-90-06-01-01
PADER,ARUU COUNTY,PADER,KILAK CORNER,OGWIL EAST,445,10,7,10,229,49,305,9,314,0,O-50-90-06-01-02
PADER,ARUU COUNTY,PADER,KILAK CORNER,ONGAMY P.7 SCHOOL,639,17,6,8,330,53,414,14,428,0,O-50-90-06-01-03
PADER,ARUU COUNTY,PADER,KILAK CORNER,KILAK T.C. B,561,2,2,4,264,68,340,11,351,0,O-50-90-06-01-04
PADER,ARUU COUNTY,PADER,KILAK CORNER,ACHOLI PII OUTSISE Q. GUARD (A,462,0,2,3,27,145,177,3,180,0,O-50-90-06-01-05
PADER,ARUU COUNTY,PADER,KILAK CORNER,ACHOLI PII OUTSISE Q. GUARD (N,1105,0,2,2,81,396,481,3,484,0,O-50-90-06-01-06
PADER,ARUU COUNTY,PADER,OGOM,OGOM TELELA,607,9,2,4,332,67,414,29,443,0,O-50-90-06-02-01
PADER,ARUU COUNTY,PADER,OTONG,OPOLACEN P SCHOOL,241,6,0,4,143,17,170,2,172,0,O-50-90-06-03-01
PADER,ARUU COUNTY,PADER,OTONG,MATROM,818,15,10,23,410,85,543,20,563,0,O-50-90-06-03-02
PADER,ARUU COUNTY,PADER,OTONG,TYER,133,2,4,1,40,27,74,5,79,0,O-50-90-06-03-03
PADER,ARUU COUNTY,PADER,PUKOR,KINENI P/S,389,11,2,15,248,30,306,0,306,0,O-50-90-06-04-01
PADER,ARUU COUNTY,PADER,PUKOR,TE ADWOKI,590,9,5,9,303,82,408,25,433,0,O-50-90-06-04-02
PADER,ARUU COUNTY,PADER TOWN COUNCIL,ACORO,OLWORNGUU P/S,891,6,4,17,411,69,507,16,523,0,O-50-90-07-01-01
PADER,ARUU COUNTY,PADER TOWN COUNCIL,ACORO,OGENG SOUTH,230,2,2,1,114,16,135,3,138,0,O-50-90-07-01-02
PADER,ARUU COUNTY,PADER TOWN COUNCIL,KALALO,PAIPIR PRIMARY SCHOOL,555,6,1,6,278,54,345,8,353,0,O-50-90-07-02-01
PADER,ARUU COUNTY,PADER TOWN COUNCIL,KALALO,SMALL WORLD,240,3,3,4,118,49,177,6,183,0,O-50-90-07-02-02
PADER,ARUU COUNTY,PADER TOWN COUNCIL,LAGWAI,PADER KILAK P/S,461,1,1,0,239,21,262,56,318,0,O-50-90-07-03-01
PADER,ARUU COUNTY,PADER TOWN COUNCIL,LAGWAI,OUTSIDE Q.GUARD,1473,2,2,7,85,352,448,6,454,0,O-50-90-07-03-02
PADER,ARUU COUNTY,PAJULE,OGAGO,LANYATONO,247,4,0,4,111,30,149,15,164,0,O-50-90-08-01-01
PADER,ARUU COUNTY,PAJULE,OGAGO,AGAGO P.7 SCHOOL,484,5,3,4,231,60,303,15,318,0,O-50-90-08-01-02
PADER,ARUU COUNTY,PAJULE,ORYANG,AWAL,573,13,11,19,273,60,376,13,389,0,O-50-90-08-02-01
PADER,ARUU COUNTY,PAJULE,ORYANG,ORYANG WEST,263,4,2,2,140,29,177,9,186,0,O-50-90-08-02-02
PADER,ARUU COUNTY,PAJULE,OTOK,OGUTA P/S,561,3,1,2,326,64,396,11,407,0,O-50-90-08-03-01
PADER,ARUU COUNTY,PAJULE,PAIULA,PAIULA P 7   SCHOOL [A-K],434,18,3,11,196,32,260,13,273,0,O-50-90-08-04-01
PADER,ARUU COUNTY,PAJULE,PAIULA,OMINYIMAC   P 7   SCHOOL,389,18,7,10,167,37,239,22,261,0,O-50-90-08-04-02
PADER,ARUU COUNTY,PAJULE,PAIULA,BUSIA,126,1,0,2,42,10,55,2,57,0,O-50-90-08-04-03
PADER,ARUU COUNTY,PAJULE,PAIULA,PAIULA P 7   SCHOOL [L-Z],353,4,2,3,164,35,208,2,210,0,O-50-90-08-04-04
PADER,ARUU COUNTY,PAJULE,PALENGA,LAMOGI PALENGA,702,6,1,7,358,98,470,11,481,0,O-50-90-08-05-01
PADER,ARUU COUNTY,PAJULE,PALENGA,AMOKOLAGWAY,489,6,3,11,238,55,313,18,331,0,O-50-90-08-05-02
PADER,ARUU COUNTY,PAJULE,PALWO 'A',KALKWARO,747,3,6,6,215,82,312,104,416,0,O-50-90-08-06-01
PADER,ARUU COUNTY,PAJULE,PALWO 'A',BOMA GROUND A & B,296,3,0,1,48,32,84,9,93,0,O-50-90-08-06-02
PADER,ARUU COUNTY,PAJULE,PALWO 'A',OJILE EAST,411,10,5,7,203,50,275,23,298,0,O-50-90-08-06-03
PADER,ARUU COUNTY,PAJULE,PALWO 'A',WANGKWEYO,296,7,2,2,158,38,207,6,213,0,O-50-90-08-06-04
PADER,ARUU COUNTY,PURANGA,APWOR,OGONYO P SCHOOL,570,5,6,2,299,33,345,22,367,0,O-50-90-09-01-01
PADER,ARUU COUNTY,PURANGA,APWOR,AWERE LAKOKA P/S,324,6,6,4,199,7,222,9,231,0,O-50-90-09-01-02
PADER,ARUU COUNTY,PURANGA,APWOR,ABALOKODI P/S,346,5,3,3,211,12,234,13,247,0,O-50-90-09-01-03
PADER,ARUU COUNTY,PURANGA,APWOR,LAMINAJIKO P/S,210,1,1,1,126,16,145,9,154,0,O-50-90-09-01-04
PADER,ARUU COUNTY,PURANGA,ARINGA,ARINGA P/S,137,4,0,1,55,21,81,4,85,0,O-50-90-09-02-01
PADER,ARUU COUNTY,PURANGA,ARINGA,LOBAT P/S,341,2,3,1,189,28,223,16,239,0,O-50-90-09-02-02
PADER,ARUU COUNTY,PURANGA,ARINGA,LAKOGA P. SCHOOL,475,7,3,3,249,66,328,9,337,0,O-50-90-09-02-03
PADER,ARUU COUNTY,PURANGA,ORET,ODUM P 7 SCHOOL,489,5,19,1,188,9,222,3,225,0,O-50-90-09-03-01
PADER,ARUU COUNTY,PURANGA,ORET,KOMDEKLIT MARKET,272,2,1,0,58,3,64,4,68,0,O-50-90-09-03-02
PADER,ARUU COUNTY,PURANGA,ORET,LAMINO CWIDA,482,4,4,5,181,15,209,6,215,0,O-50-90-09-03-03
PADER,ARUU COUNTY,PURANGA,PARWECH,PURANGA MARKET (A-K),611,3,9,6,228,60,306,2,308,0,O-50-90-09-04-01
PADER,ARUU COUNTY,PURANGA,PARWECH,ADONG KENA,285,1,5,1,166,6,179,4,183,0,O-50-90-09-04-02
PADER,ARUU COUNTY,PURANGA,PARWECH,PURANGA MARKET (L-Z),322,0,3,2,119,42,166,19,185,0,O-50-90-09-04-03
PADER,ARUU COUNTY,PURANGA,PARWECH,TEKULU P/S,358,5,2,2,193,31,233,14,247,0,O-50-90-09-04-04
PADER,ARUU COUNTY,PURANGA,PARWECH,LODEL,315,3,1,5,175,37,221,9,230,0,O-50-90-09-04-05
YUMBE,ARINGA COUNTY,APO,ACHOLI,PAIJO A (A-C),536,5,1,5,131,142,284,5,289,0,O-53-6-01-01-01
YUMBE,ARINGA COUNTY,APO,ACHOLI,PAIJO A (D-Z),421,1,3,5,116,131,256,12,268,0,O-53-6-01-01-02
YUMBE,ARINGA COUNTY,APO,ACHOLI,PAIJO B (A-C),515,6,2,6,138,132,284,4,288,0,O-53-6-01-01-03
YUMBE,ARINGA COUNTY,APO,ACHOLI,PAIJO B(D-Z),400,1,2,3,95,120,221,23,244,0,O-53-6-01-01-04
YUMBE,ARINGA COUNTY,APO,ARIA,AUPI A (A-C),486,5,5,9,201,75,295,12,307,0,O-53-6-01-02-01
YUMBE,ARINGA COUNTY,APO,ARIA,AUPI A (D-Z),345,4,2,3,143,59,211,3,214,0,O-53-6-01-02-02
YUMBE,ARINGA COUNTY,APO,ARIA,KISIMUA,735,8,2,9,251,171,441,18,459,0,O-53-6-01-02-03
YUMBE,ARINGA COUNTY,APO,KERILA,KERILA A (A-C),777,15,6,12,223,151,407,9,416,0,O-53-6-01-03-01
YUMBE,ARINGA COUNTY,APO,KERILA,KERILA A (D-Z),404,9,1,3,136,112,261,3,264,0,O-53-6-01-03-02
YUMBE,ARINGA COUNTY,APO,KERILA,OLUGOFE,653,21,6,10,234,125,396,16,412,0,O-53-6-01-03-03
YUMBE,ARINGA COUNTY,APO,KERILA,BANIKA PRI. SCHOOL,501,5,7,12,168,108,300,7,307,0,O-53-6-01-03-04
YUMBE,ARINGA COUNTY,APO,ORINJI,GBORO,567,6,3,11,162,196,378,19,397,0,O-53-6-01-04-01
YUMBE,ARINGA COUNTY,APO,ORINJI,MIJALE-UPDF OUTSIDE Q.GUARD,429,1,1,0,12,26,40,3,43,0,O-53-6-01-04-02
YUMBE,ARINGA COUNTY,APO,PENA,FATA PRI. SCHOOL,409,6,2,5,157,66,236,11,247,0,O-53-6-01-05-01
YUMBE,ARINGA COUNTY,APO,PENA,OMBA,326,2,1,4,165,71,243,6,249,0,O-53-6-01-05-02
YUMBE,ARINGA COUNTY,APO,PENA,ANINIA,403,5,3,2,148,85,243,8,251,0,O-53-6-01-05-03
YUMBE,ARINGA COUNTY,DRAJINI/ARAJIM,AUPI,ALIVU (A-A),505,20,5,13,330,115,483,20,503,0,O-53-6-02-01-01
YUMBE,ARINGA COUNTY,DRAJINI/ARAJIM,AUPI,ALIVU (B-N),493,9,1,3,173,59,245,12,257,0,O-53-6-02-01-02
YUMBE,ARINGA COUNTY,DRAJINI/ARAJIM,AUPI,ALIVU (O-Z),268,0,3,5,99,44,151,1,152,0,O-53-6-02-01-03
YUMBE,ARINGA COUNTY,DRAJINI/ARAJIM,NYORI,YUMELE A (D-Z),731,9,3,9,298,101,420,11,431,0,O-53-6-02-02-01
YUMBE,ARINGA COUNTY,DRAJINI/ARAJIM,NYORI,YUMELE A (A-C),442,6,0,6,184,91,287,12,299,0,O-53-6-02-02-02
YUMBE,ARINGA COUNTY,DRAJINI/ARAJIM,NYORI,YUMELE B (A-C),396,10,4,6,176,73,269,5,274,0,O-53-6-02-02-03
YUMBE,ARINGA COUNTY,DRAJINI/ARAJIM,NYORI,YUMELE B (D-Z),457,2,1,3,194,65,265,13,278,0,O-53-6-02-02-04
YUMBE,ARINGA COUNTY,DRAJINI/ARAJIM,OLIVU,PALADRU,739,18,10,11,385,106,530,9,539,0,O-53-6-02-03-01
YUMBE,ARINGA COUNTY,DRAJINI/ARAJIM,OLIVU,YAA A (A-C),1011,23,15,22,480,169,709,12,721,0,O-53-6-02-03-02
YUMBE,ARINGA COUNTY,DRAJINI/ARAJIM,OLIVU,YAA B,352,4,6,3,257,27,297,3,300,0,O-53-6-02-03-03
YUMBE,ARINGA COUNTY,DRAJINI/ARAJIM,OLIVU,YAA A (D-Z),414,7,5,12,226,80,330,14,344,0,O-53-6-02-03-04
YUMBE,ARINGA COUNTY,DRAJINI/ARAJIM,OROGBO,OROGBO A (A-C),412,7,3,4,138,116,268,12,280,0,O-53-6-02-04-01
YUMBE,ARINGA COUNTY,DRAJINI/ARAJIM,OROGBO,OROGBO A (D-Z),430,0,2,1,148,112,263,9,272,0,O-53-6-02-04-02
YUMBE,ARINGA COUNTY,DRAJINI/ARAJIM,OROGBO,OROGBO B,391,3,2,3,138,107,253,9,262,0,O-53-6-02-04-03
YUMBE,ARINGA COUNTY,DRAJINI/ARAJIM,PAJAMA,Pajama,918,23,10,13,436,203,685,20,705,0,O-53-6-02-05-01
YUMBE,ARINGA COUNTY,DRAJINI/ARAJIM,PAJAMA,Pajama/Alivu,407,9,1,3,164,49,226,100,326,0,O-53-6-02-05-02
YUMBE,ARINGA COUNTY,DRAJINI/ARAJIM,YIBA,GALABA A,818,10,1,6,384,79,480,35,515,0,O-53-6-02-06-01
YUMBE,ARINGA COUNTY,DRAJINI/ARAJIM,YIBA,MIJALA A,829,6,4,6,397,122,535,30,565,0,O-53-6-02-06-02
YUMBE,ARINGA COUNTY,DRAJINI/ARAJIM,YIBA,LODONGA CENTER,693,6,5,7,291,141,450,6,456,0,O-53-6-02-06-03
YUMBE,ARINGA COUNTY,DRAJINI/ARAJIM,YIBA,GALABA B,839,2,1,2,345,70,420,13,433,0,O-53-6-02-06-04
YUMBE,ARINGA COUNTY,KEI,AWOBA,GOBU (A-C),568,10,6,9,183,124,332,11,343,0,O-53-6-03-01-01
YUMBE,ARINGA COUNTY,KEI,AWOBA,OMBA A (A-C),600,7,2,3,154,123,289,23,312,0,O-53-6-03-01-02
YUMBE,ARINGA COUNTY,KEI,AWOBA,OMBA B,247,3,0,3,118,60,184,4,188,0,O-53-6-03-01-03
YUMBE,ARINGA COUNTY,KEI,AWOBA,GOBU (D-Z),423,8,4,11,133,84,240,20,260,0,O-53-6-03-01-04
YUMBE,ARINGA COUNTY,KEI,AWOBA,OMBA A (D-Z),441,1,3,4,162,108,278,0,278,0,O-53-6-03-01-05
YUMBE,ARINGA COUNTY,KEI,GICHARA,KECHURU,688,6,3,2,219,111,341,30,371,0,O-53-6-03-02-01
YUMBE,ARINGA COUNTY,KEI,GICHARA,KOKA,842,9,2,9,361,229,610,10,620,0,O-53-6-03-02-02
YUMBE,ARINGA COUNTY,KEI,GICHARA,ORABA,415,9,4,12,216,66,307,6,313,0,O-53-6-03-02-03
YUMBE,ARINGA COUNTY,KEI,GIMERE,JOKE (A-C),428,10,6,5,169,71,261,5,266,0,O-53-6-03-03-01
YUMBE,ARINGA COUNTY,KEI,GIMERE,MAGU (A-C),384,0,5,3,181,57,246,5,251,0,O-53-6-03-03-02
YUMBE,ARINGA COUNTY,KEI,GIMERE,JOKE (D-Z),479,4,2,8,194,65,273,14,287,0,O-53-6-03-03-03
YUMBE,ARINGA COUNTY,KEI,GIMERE,MAGU (D-Z),427,10,1,5,205,69,290,10,300,0,O-53-6-03-03-04
YUMBE,ARINGA COUNTY,KEI,PALAJA,RODO (A-C),520,12,8,8,143,129,300,9,309,0,O-53-6-03-04-01
YUMBE,ARINGA COUNTY,KEI,PALAJA,AMBALA (A-C),480,6,1,7,112,165,291,4,295,0,O-53-6-03-04-02
YUMBE,ARINGA COUNTY,KEI,PALAJA,RODO (D-Z),615,15,5,8,166,153,347,22,369,0,O-53-6-03-04-03
YUMBE,ARINGA COUNTY,KEI,PALAJA,AMBALA (D-C),369,8,2,5,106,135,256,9,265,0,O-53-6-03-04-04
YUMBE,ARINGA COUNTY,KURU,ALIAPI,Onjinga,669,3,5,4,156,110,278,14,292,0,O-53-6-04-01-01
YUMBE,ARINGA COUNTY,KURU,ALIAPI,Onjiri,849,7,3,9,267,259,545,13,558,0,O-53-6-04-01-02
YUMBE,ARINGA COUNTY,KURU,ALIAPI,GILA,310,2,1,4,107,77,191,10,201,0,O-53-6-04-01-03
YUMBE,ARINGA COUNTY,KURU,GEYA,KURU/ALIBA A,589,5,3,4,176,140,328,18,346,0,O-53-6-04-02-01
YUMBE,ARINGA COUNTY,KURU,GEYA,MEROBA,678,11,5,10,216,159,401,18,419,0,O-53-6-04-02-02
YUMBE,ARINGA COUNTY,KURU,GEYA,ALIBA B,425,1,2,2,132,99,236,7,243,0,O-53-6-04-02-03
YUMBE,ARINGA COUNTY,KURU,GEYA,GEYA PRI SCHOOL,555,4,1,0,129,199,333,13,346,0,O-53-6-04-02-04
YUMBE,ARINGA COUNTY,KURU,GOJURU,IMVENGA,665,4,10,6,179,265,464,10,474,0,O-53-6-04-03-01
YUMBE,ARINGA COUNTY,KURU,GOJURU,GOJURU (A-C),392,0,3,7,82,296,388,4,392,0,O-53-6-04-03-02
YUMBE,ARINGA COUNTY,KURU,GOJURU,JABALA B,401,3,2,3,86,271,365,11,376,0,O-53-6-04-03-03
YUMBE,ARINGA COUNTY,KURU,GOJURU,GOJURU (D-Z),459,3,1,3,73,277,357,6,363,0,O-53-6-04-03-04
YUMBE,ARINGA COUNTY,KURU,LOMUNGA,BURA A (A-C),510,6,1,2,168,117,294,11,305,0,O-53-6-04-04-01
YUMBE,ARINGA COUNTY,KURU,LOMUNGA,BURA A (D-Z),557,7,1,3,138,184,333,6,339,0,O-53-6-04-04-02
YUMBE,ARINGA COUNTY,KURU,LOMUNGA,KULULU,582,7,5,5,177,132,326,4,330,0,O-53-6-04-04-03
YUMBE,ARINGA COUNTY,KURU,OMBA,OKULICACI PRI.SCHOOL,423,8,3,4,108,237,360,7,367,0,O-53-6-04-05-01
YUMBE,ARINGA COUNTY,KURU,OMBA,ALIBA,610,0,1,6,119,176,302,4,306,0,O-53-6-04-05-02
YUMBE,ARINGA COUNTY,KURU,OMBA,OMBA,857,5,1,6,222,224,458,8,466,0,O-53-6-04-05-03
YUMBE,ARINGA COUNTY,KURU,OMBA,ALINGA,789,4,1,7,144,233,389,9,398,0,O-53-6-04-05-04
YUMBE,ARINGA COUNTY,KURU,RENDA,YINGA (A-A),453,4,1,5,81,166,257,3,260,0,O-53-6-04-06-01
YUMBE,ARINGA COUNTY,KURU,RENDA,YINGA (B-K),505,2,3,5,100,162,272,19,291,0,O-53-6-04-06-02
YUMBE,ARINGA COUNTY,KURU,RENDA,YINGA (M-Z),411,2,1,1,99,182,285,7,292,0,O-53-6-04-06-03
YUMBE,ARINGA COUNTY,KURU,ROGALE,ROGALE A (A-D),566,4,1,6,129,154,294,12,306,0,O-53-6-04-07-01
YUMBE,ARINGA COUNTY,KURU,ROGALE,ROGALE A (E-Z),491,1,3,3,106,206,319,3,322,0,O-53-6-04-07-02
YUMBE,ARINGA COUNTY,KURU,ROGALE,INIA,547,6,0,5,117,138,266,4,270,0,O-53-6-04-07-03
YUMBE,ARINGA COUNTY,KURU,YOYO,YOYO/KOMGBE,1039,7,1,15,373,144,540,4,544,0,O-53-6-04-08-01
YUMBE,ARINGA COUNTY,MIDIGO,KERWA,MIJALE A (L-Z),516,14,8,4,22,205,253,8,261,0,O-53-6-05-01-01
YUMBE,ARINGA COUNTY,MIDIGO,KERWA,MIJALE A (A-K),815,23,16,29,79,647,794,21,815,0,O-53-6-05-01-02
YUMBE,ARINGA COUNTY,MIDIGO,KERWA,MIJALE B,638,17,6,10,24,325,382,25,407,0,O-53-6-05-01-03
YUMBE,ARINGA COUNTY,MIDIGO,KERWA,OLUGA OUTSIDE Q.GUARD,536,10,0,4,117,366,497,32,529,0,O-53-6-05-01-04
YUMBE,ARINGA COUNTY,MIDIGO,MIGO,MIGO (A-C),590,18,4,5,209,185,421,13,434,0,O-53-6-05-02-01
YUMBE,ARINGA COUNTY,MIDIGO,MIGO,MIGO/ODROPI (A-C),455,18,4,11,244,86,363,8,371,0,O-53-6-05-02-02
YUMBE,ARINGA COUNTY,MIDIGO,MIGO,MIGO (D-Z),423,13,2,2,141,206,364,20,384,0,O-53-6-05-02-03
YUMBE,ARINGA COUNTY,MIDIGO,MIGO,MIGO/ODROPI (D-Z),379,11,3,5,164,52,235,8,243,0,O-53-6-05-02-04
YUMBE,ARINGA COUNTY,MIDIGO,MOICHA,MULUMBE,460,12,4,5,222,197,440,12,452,0,O-53-6-05-03-01
YUMBE,ARINGA COUNTY,MIDIGO,MOICHA,WEST MIDIGO CENTER,659,10,3,10,302,227,552,12,564,0,O-53-6-05-03-02
YUMBE,ARINGA COUNTY,MIDIGO,MOICHA,OYAKWA TRADING CENTER,504,24,4,6,208,232,474,1,475,0,O-53-6-05-03-03
YUMBE,ARINGA COUNTY,MIDIGO,MOICHA,ODROPI A (D - Z),445,9,6,1,213,192,421,13,434,0,O-53-6-05-03-04
YUMBE,ARINGA COUNTY,MIDIGO,WANDI,WANDI A (D - L),557,2,4,3,41,95,145,5,150,0,O-53-6-05-04-01
YUMBE,ARINGA COUNTY,MIDIGO,WANDI,WANDI A (M - Z),589,38,14,24,92,384,552,27,579,0,O-53-6-05-04-02
YUMBE,ARINGA COUNTY,MIDIGO,WANDI,WANDI A (A - C),506,21,2,10,165,238,436,10,446,0,O-53-6-05-04-03
YUMBE,ARINGA COUNTY,ODRAVU,LUI,AMBELECU,777,10,6,1,273,103,393,109,502,0,O-53-6-06-01-01
YUMBE,ARINGA COUNTY,ODRAVU,LUI,GODRIA (A-C),654,7,2,4,279,133,425,9,434,0,O-53-6-06-01-02
YUMBE,ARINGA COUNTY,ODRAVU,LUI,ATIMINDA,538,8,6,7,148,100,269,71,340,0,O-53-6-06-01-03
YUMBE,ARINGA COUNTY,ODRAVU,LUI,GODRIA (D-Z),319,6,0,3,100,67,176,45,221,0,O-53-6-06-01-04
YUMBE,ARINGA COUNTY,ODRAVU,MOLI,LUDARA (A-C),395,1,3,2,102,92,200,53,253,0,O-53-6-06-02-01
YUMBE,ARINGA COUNTY,ODRAVU,MOLI,MOJU A (A-C),489,4,3,11,182,107,307,18,325,0,O-53-6-06-02-02
YUMBE,ARINGA COUNTY,ODRAVU,MOLI,IDACHE,557,12,4,8,216,74,314,13,327,0,O-53-6-06-02-03
YUMBE,ARINGA COUNTY,ODRAVU,MOLI,LUDARA (D-Z),448,3,0,2,125,122,252,11,263,0,O-53-6-06-02-04
YUMBE,ARINGA COUNTY,ODRAVU,MOLI,MOJU A (D-Z),433,2,2,6,168,76,254,4,258,0,O-53-6-06-02-05
YUMBE,ARINGA COUNTY,ODRAVU,NYOKO,PARACHA,679,8,4,20,182,245,459,18,477,0,O-53-6-06-03-01
YUMBE,ARINGA COUNTY,ODRAVU,NYOKO,AYURI,598,16,7,3,227,111,364,11,375,0,O-53-6-06-03-02
YUMBE,ARINGA COUNTY,ODRAVU,OKUYO,OKUYO (A-A),367,7,3,8,146,75,239,13,252,0,O-53-6-06-04-01
YUMBE,ARINGA COUNTY,ODRAVU,OKUYO,OKUYO (B-L),377,5,4,6,110,88,213,9,222,0,O-53-6-06-04-02
YUMBE,ARINGA COUNTY,ODRAVU,OKUYO,OKUYO (M-Z),321,4,1,3,84,54,146,41,187,0,O-53-6-06-04-03
YUMBE,ARINGA COUNTY,ODRAVU,OLUBA,AJI (A-D),603,11,5,5,252,136,409,7,416,0,O-53-6-06-05-01
YUMBE,ARINGA COUNTY,ODRAVU,OLUBA,AJI (E-Z),481,2,4,9,188,115,318,6,324,0,O-53-6-06-05-02
YUMBE,ARINGA COUNTY,ODRAVU,OLUBA,IGAMARA,399,14,5,8,143,117,287,7,294,0,O-53-6-06-05-03
YUMBE,ARINGA COUNTY,ODRAVU,RIGBONGA,ARIWA,698,12,3,19,228,111,373,22,395,0,O-53-6-06-06-01
YUMBE,ARINGA COUNTY,ODRAVU,RIGBONGA,AWINGA,436,4,0,5,149,65,223,19,242,0,O-53-6-06-06-02
YUMBE,ARINGA COUNTY,ODRAVU,WOLO,IBABIRI (A-A),416,4,5,5,109,120,243,14,257,0,O-53-6-06-07-01
YUMBE,ARINGA COUNTY,ODRAVU,WOLO,NYOKO (A-C),424,5,5,2,117,99,228,14,242,0,O-53-6-06-07-02
YUMBE,ARINGA COUNTY,ODRAVU,WOLO,NYOKO/IBABIRI (A-C),388,5,1,3,119,72,200,4,204,0,O-53-6-06-07-03
YUMBE,ARINGA COUNTY,ODRAVU,WOLO,IBABIRI (B-L),503,8,1,5,144,177,335,1,336,0,O-53-6-06-07-04
YUMBE,ARINGA COUNTY,ODRAVU,WOLO,IBABIRI (M-Z),417,4,3,3,114,109,233,15,248,0,O-53-6-06-07-05
YUMBE,ARINGA COUNTY,ODRAVU,WOLO,NYOKO (D-Z),457,4,0,0,121,103,228,12,240,0,O-53-6-06-07-06
YUMBE,ARINGA COUNTY,ODRAVU,WOLO,NYOKO/IBABIRI (D-Z),488,7,4,2,120,88,221,3,224,0,O-53-6-06-07-07
YUMBE,ARINGA COUNTY,ROMOGI,BARINGA,ONOKO,798,12,4,17,194,201,428,13,441,0,O-53-6-07-01-01
YUMBE,ARINGA COUNTY,ROMOGI,BARINGA,LEINGA A (A-C),539,4,2,14,156,130,306,5,311,0,O-53-6-07-01-02
YUMBE,ARINGA COUNTY,ROMOGI,BARINGA,SUINGA,540,12,1,8,134,95,250,8,258,0,O-53-6-07-01-03
YUMBE,ARINGA COUNTY,ROMOGI,BARINGA,LEINGA A (D-Z),625,6,6,3,151,169,335,4,339,0,O-53-6-07-01-04
YUMBE,ARINGA COUNTY,ROMOGI,KOCHI,KOCHI (A-C),537,4,1,8,149,124,286,13,299,0,O-53-6-07-02-01
YUMBE,ARINGA COUNTY,ROMOGI,KOCHI,LOKPE,655,6,5,9,262,84,366,17,383,0,O-53-6-07-02-02
YUMBE,ARINGA COUNTY,ROMOGI,KOCHI,LOMBE PRI. SCHOOL,166,0,0,1,44,40,85,2,87,0,O-53-6-07-02-03
YUMBE,ARINGA COUNTY,ROMOGI,KOCHI,KOCHI (D-Z),619,11,3,4,145,141,304,9,313,0,O-53-6-07-02-04
YUMBE,ARINGA COUNTY,ROMOGI,LIMIDIA,OKOI PRI.SCHOOL,639,11,2,10,229,135,387,21,408,0,O-53-6-07-03-01
YUMBE,ARINGA COUNTY,ROMOGI,LIMIDIA,LIMIDA,626,10,0,16,229,223,478,21,499,0,O-53-6-07-03-02
YUMBE,ARINGA COUNTY,ROMOGI,LOCOMBGO,LOCOMBGO,882,12,3,15,250,172,452,19,471,0,O-53-6-07-04-01
YUMBE,ARINGA COUNTY,ROMOGI,LOCOMBGO,LIMIKA,235,1,1,2,39,60,103,3,106,0,O-53-6-07-04-02
YUMBE,ARINGA COUNTY,ROMOGI,OMBACHI,ABENEKA,191,0,4,5,92,32,133,1,134,0,O-53-6-07-05-01
YUMBE,ARINGA COUNTY,ROMOGI,OMBACHI,LORI A,749,5,1,2,230,212,450,8,458,0,O-53-6-07-05-02
YUMBE,ARINGA COUNTY,ROMOGI,OMBACHI,ALABA CENTER,535,6,1,5,197,114,323,4,327,0,O-53-6-07-05-03
YUMBE,ARINGA COUNTY,YUMBE T. C.,ARUNGA WARD,DISTRICT ADMINISTRATION HQS.,130,0,1,0,31,35,67,3,70,0,O-53-6-08-01-01
YUMBE,ARINGA COUNTY,YUMBE T. C.,ARUNGA WARD,MIJALE (A - A),571,4,2,3,88,155,252,11,263,0,O-53-6-08-01-02
YUMBE,ARINGA COUNTY,YUMBE T. C.,ARUNGA WARD,MIJALE (B -L ),722,1,1,5,122,159,288,7,295,0,O-53-6-08-01-03
YUMBE,ARINGA COUNTY,YUMBE T. C.,ARUNGA WARD,EAST YUMBE,737,3,1,1,173,138,316,8,324,0,O-53-6-08-01-04
YUMBE,ARINGA COUNTY,YUMBE T. C.,ARUNGA WARD,PARIKILE,166,0,0,0,51,35,86,2,88,0,O-53-6-08-01-05
YUMBE,ARINGA COUNTY,YUMBE T. C.,ARUNGA WARD,MIJALE (M -Z ),408,3,1,1,62,97,164,10,174,0,O-53-6-08-01-06
YUMBE,ARINGA COUNTY,YUMBE T. C.,CHARANGA WARD,WEST YUMBE/ODROPI,204,2,0,1,58,60,121,0,121,0,O-53-6-08-02-01
YUMBE,ARINGA COUNTY,YUMBE T. C.,CHARANGA WARD,OWOLONGA,179,1,1,1,35,46,84,0,84,0,O-53-6-08-02-02
YUMBE,ARINGA COUNTY,YUMBE T. C.,CHARANGA WARD,MIJALE C (E-Z),547,0,2,4,134,173,313,15,328,0,O-53-6-08-02-03
YUMBE,ARINGA COUNTY,YUMBE T. C.,CHARANGA WARD,MIJALE C (A-D),634,7,2,9,142,173,333,14,347,0,O-53-6-08-02-04
YUMBE,ARINGA COUNTY,YUMBE T. C.,LUKUTUA WARD,MIJALE A (E-Z),1073,19,6,6,282,378,691,24,715,0,O-53-6-08-03-01
NAKAPIRIPIRIT,CHEKWII CTY (KADAM),KAKOMONGOLE,AKUYAM,ARECHAK,198,4,9,7,8,81,109,5,114,0,O-56-146-01-01-01
NAKAPIRIPIRIT,CHEKWII CTY (KADAM),KAKOMONGOLE,AKUYAM,NAKAALE,436,1,0,5,4,364,374,0,374,0,O-56-146-01-01-02
NAKAPIRIPIRIT,CHEKWII CTY (KADAM),KAKOMONGOLE,NABOLIS,LOKADWARAN,512,0,0,5,0,339,344,3,347,0,O-56-146-01-02-01
NAKAPIRIPIRIT,CHEKWII CTY (KADAM),KAKOMONGOLE,NAMOROTOT,TAKORA PR/SCHOOL,417,7,2,5,19,151,184,77,261,0,O-56-146-01-03-01
NAKAPIRIPIRIT,CHEKWII CTY (KADAM),KAKOMONGOLE,OKWAPON,LOKEERUMAN,216,7,4,7,2,75,95,45,140,0,O-56-146-01-04-01
NAKAPIRIPIRIT,CHEKWII CTY (KADAM),KAKOMONGOLE,OKWAPON,OKWAPON,512,20,5,11,20,230,286,25,311,0,O-56-146-01-04-02
NAKAPIRIPIRIT,CHEKWII CTY (KADAM),KAKOMONGOLE,TOKORA,NADING PR. SCH.,340,6,0,17,2,235,260,22,282,0,O-56-146-01-05-01
NAKAPIRIPIRIT,CHEKWII CTY (KADAM),KAKOMONGOLE,TOKORA,NADOKETARIGITOMEI,260,1,2,1,10,231,245,4,249,0,O-56-146-01-05-02
NAKAPIRIPIRIT,CHEKWII CTY (KADAM),KAKOMONGOLE,TOKORA,TOKORA T.C.,499,3,2,0,45,230,280,73,353,0,O-56-146-01-05-03
NAKAPIRIPIRIT,CHEKWII CTY (KADAM),MORUITA,KATABOK,DOO,751,1,1,0,17,409,428,3,431,0,O-56-146-02-01-01
NAKAPIRIPIRIT,CHEKWII CTY (KADAM),MORUITA,KATABOK,MUNYOKERE,220,0,0,0,0,105,105,0,105,0,O-56-146-02-01-02
NAKAPIRIPIRIT,CHEKWII CTY (KADAM),MORUITA,KATABOK,DOO P/S,228,0,0,0,12,104,116,0,116,0,O-56-146-02-01-03
NAKAPIRIPIRIT,CHEKWII CTY (KADAM),MORUITA,MORUITA,KAPEDURU,846,5,6,10,49,216,286,19,305,0,O-56-146-02-02-01
NAKAPIRIPIRIT,CHEKWII CTY (KADAM),NAKAPIRIPIRIT T.C.,KATANGA/TOWNSHIP,TOWNSHIP,690,7,8,7,90,251,363,17,380,0,O-56-146-03-01-01
NAKAPIRIPIRIT,CHEKWII CTY (KADAM),NAKAPIRIPIRIT T.C.,LOBULIO/LOMU,LUBULIO/LOMU,225,5,0,3,24,118,150,4,154,0,O-56-146-03-02-01
NAKAPIRIPIRIT,CHEKWII CTY (KADAM),NAKAPIRIPIRIT T.C.,LOBURIET/LOKOMA,LOKOONA/LOBUNEIT,148,2,1,1,13,60,77,30,107,0,O-56-146-03-03-01
NAKAPIRIPIRIT,CHEKWII CTY (KADAM),NAMALU,KAIKU,AROUNDABOUT,457,3,0,1,9,259,272,40,312,0,O-56-146-04-01-01
NAKAPIRIPIRIT,CHEKWII CTY (KADAM),NAMALU,KAIKU,NAABORE PR/SCH,434,4,8,8,22,224,266,0,266,0,O-56-146-04-01-02
NAKAPIRIPIRIT,CHEKWII CTY (KADAM),NAMALU,KOKUWUAM,APEDED,290,6,2,7,6,98,119,86,205,0,O-56-146-04-02-01
NAKAPIRIPIRIT,CHEKWII CTY (KADAM),NAMALU,KOKUWUAM,KAWUOLOBU,301,0,0,0,0,186,186,26,212,0,O-56-146-04-02-02
NAKAPIRIPIRIT,CHEKWII CTY (KADAM),NAMALU,KOKUWUAM,LOCHOANGIKALEI,356,0,0,2,2,246,250,14,264,0,O-56-146-04-02-03
NAKAPIRIPIRIT,CHEKWII CTY (KADAM),NAMALU,KOKUWUAM,LOKIBU,497,1,2,4,8,322,337,15,352,0,O-56-146-04-02-04
NAKAPIRIPIRIT,CHEKWII CTY (KADAM),NAMALU,KOKUWUAM,NAMALU PR/SCHOOL,669,7,6,3,92,238,346,31,377,0,O-56-146-04-02-05
NAKAPIRIPIRIT,CHEKWII CTY (KADAM),NAMALU,LOKATAPAN,LOBORIO,741,5,0,7,38,396,446,0,446,0,O-56-146-04-03-01
NAKAPIRIPIRIT,CHEKWII CTY (KADAM),NAMALU,LOKATAPAN,LOBULEPEDED,266,0,0,4,16,135,155,39,194,0,O-56-146-04-03-02
NAKAPIRIPIRIT,CHEKWII CTY (KADAM),NAMALU,LOKATAPAN,NABOKAT,616,1,1,9,40,353,404,5,409,0,O-56-146-04-03-03
NAKAPIRIPIRIT,CHEKWII CTY (KADAM),NAMALU,LOKATAPAN,NAMINIT,60,0,2,1,2,49,54,4,58,0,O-56-146-04-03-04
NAKAPIRIPIRIT,CHEKWII CTY (KADAM),NAMALU,LOPEROT,LOMORIMOR,572,0,0,1,13,345,359,7,366,0,O-56-146-04-04-01
NAKAPIRIPIRIT,CHEKWII CTY (KADAM),NAMALU,LOPEROT,LOPEDOT,512,4,2,7,10,192,215,50,265,0,O-56-146-04-04-02
NAKAPIRIPIRIT,CHEKWII CTY (KADAM),NAMALU,LOREGAE,AKWAKORI,588,0,0,5,1,345,351,8,359,0,O-56-146-04-05-01
NAKAPIRIPIRIT,CHEKWII CTY (KADAM),NAMALU,LOREGAE,LOMUCURUS A,445,0,1,2,3,323,329,9,338,0,O-56-146-04-05-02
NAKAPIRIPIRIT,CHEKWII CTY (KADAM),NAMALU,LOREGAE,LOMUCURUS B,315,1,3,3,27,234,268,4,272,0,O-56-146-04-05-03
NAKAPIRIPIRIT,CHEKWII CTY (KADAM),NAMALU,LOREGAE,LOREGAE PR/SCHOOL,598,0,1,4,1,371,377,20,397,0,O-56-146-04-05-04
NAKAPIRIPIRIT,CHEKWII CTY (KADAM),NAMALU,LOREGAE,LORENG,605,2,2,1,3,339,347,21,368,0,O-56-146-04-05-05
NAKAPIRIPIRIT,CHEKWII CTY (KADAM),NAMALU,LOREGAE,NABULENGER,359,4,4,2,19,262,291,14,305,0,O-56-146-04-05-06
NAKAPIRIPIRIT,CHEKWII CTY (KADAM),NAMALU,LOREGAE,NAKAUMEUMEI,329,2,0,1,6,214,223,6,229,0,O-56-146-04-05-07
NAKAPIRIPIRIT,CHEKWII CTY (KADAM),NAMALU,LOREGAE,NATHINYONOIT,332,0,0,2,5,213,220,4,224,0,O-56-146-04-05-08
NAKAPIRIPIRIT,CHEKWII CTY (KADAM),NAMALU,MORUAJORE,PRODUCTION,212,0,0,0,26,22,48,0,48,0,O-56-146-04-06-01
NAKAPIRIPIRIT,CHEKWII CTY (KADAM),NAMALU,NAPYANANYA,ALAMACHAR PR. SCH.,562,0,1,1,14,329,345,5,350,0,O-56-146-04-07-01
NAKAPIRIPIRIT,CHEKWII CTY (KADAM),NAMALU,NAPYANANYA,NAKAALE,479,2,1,5,16,284,308,20,328,0,O-56-146-04-07-02
NAKAPIRIPIRIT,CHEKWII CTY (KADAM),NAMALU,NAPYANANYA,NAPYANANYA PR/SCHOOL,546,2,0,2,7,369,380,0,380,0,O-56-146-04-07-03
AMOLATAR,KIOGA COUNTY,AMOLATAR T.C.,ABURKOT,ALEMERE BUNG,497,2,3,6,211,192,414,11,425,0,O-57-102-01-01-01
AMOLATAR,KIOGA COUNTY,AMOLATAR T.C.,APALE PE,APOKMITIMOGO,439,3,0,5,244,104,356,7,363,0,O-57-102-01-02-01
AMOLATAR,KIOGA COUNTY,AMOLATAR T.C.,APALE PE,AMOLATAR P.7 SCHOOL,278,0,3,2,123,78,206,8,214,0,O-57-102-01-02-02
AMOLATAR,KIOGA COUNTY,AMOLATAR T.C.,APALE PE,AMOLATAR HEADQUATERS,129,0,2,0,34,36,72,8,80,0,O-57-102-01-02-03
AMOLATAR,KIOGA COUNTY,AMOLATAR T.C.,EPYEL,EPYEL,420,2,2,2,120,177,303,4,307,0,O-57-102-01-03-01
AMOLATAR,KIOGA COUNTY,AMOLATAR T.C.,INOMO,CORNER APUTI,381,9,5,8,129,162,313,2,315,0,O-57-102-01-04-01
AMOLATAR,KIOGA COUNTY,APUTI,ABALODYANG,ALONGO-OBUTATARO,559,9,1,4,289,61,364,6,370,0,O-57-102-02-01-01
AMOLATAR,KIOGA COUNTY,APUTI,ADONYIMO,ADONYIMO P 7 SCHOOL I,509,5,15,18,253,110,401,15,416,0,O-57-102-02-02-01
AMOLATAR,KIOGA COUNTY,APUTI,ADONYIMO,ADONYIMO P 7 SCHOOL II,439,4,7,8,224,94,337,13,350,0,O-57-102-02-02-02
AMOLATAR,KIOGA COUNTY,APUTI,AGIKDAK,AGIKDAK P 7 SCHOOL I,603,3,4,6,424,71,508,7,515,0,O-57-102-02-03-01
AMOLATAR,KIOGA COUNTY,APUTI,AGIKDAK,AGIKDAK P.7 SCHOOL II,453,5,6,13,273,60,357,10,367,0,O-57-102-02-03-02
AMOLATAR,KIOGA COUNTY,APUTI,AGIKDAK,ALWIT LONGO,447,6,4,5,205,121,341,16,357,0,O-57-102-02-03-03
AMOLATAR,KIOGA COUNTY,APUTI,AKWON,AKWON P.7 SCHOOL I,673,5,11,10,383,55,464,11,475,0,O-57-102-02-04-01
AMOLATAR,KIOGA COUNTY,APUTI,AKWON,AKWON P.7 SCHOOL II,440,3,6,9,259,53,330,10,340,0,O-57-102-02-04-02
AMOLATAR,KIOGA COUNTY,APUTI,ANYWALI,APUTI SUB-COUNTY HEADQUATE,370,2,7,2,183,86,280,6,286,0,O-57-102-02-05-01
AMOLATAR,KIOGA COUNTY,APUTI,ANYWALI,APUTI SUB-COUNTY HQRS II,539,6,17,6,225,121,375,7,382,0,O-57-102-02-05-02
AMOLATAR,KIOGA COUNTY,APUTI,ANYWALI,APUTI SUB-COUNTY HQRS III,490,7,7,4,235,80,333,6,339,0,O-57-102-02-05-03
AMOLATAR,KIOGA COUNTY,APUTI,AWONANGIRO,ABARIKORI P 7 SCHOOL I,622,2,10,8,381,63,464,5,469,0,O-57-102-02-06-01
AMOLATAR,KIOGA COUNTY,APUTI,AWONANGIRO,ABARIKORI P.7 SCHOOL II,555,8,10,7,324,59,408,6,414,0,O-57-102-02-06-02
AMOLATAR,KIOGA COUNTY,APUTI,OTIRA,OTIRA P 7 SCHOOL I,734,6,11,13,418,122,570,11,581,0,O-57-102-02-07-01
AMOLATAR,KIOGA COUNTY,APUTI,OTIRA,OTIRA P.7 SCHOOL II,782,7,13,11,424,167,622,9,631,0,O-57-102-02-07-02
AMOLATAR,KIOGA COUNTY,AWELLO,ABEJA,ABEJA P.7 SCHOOL EAST I,352,7,7,3,200,48,265,21,286,0,O-57-102-03-01-01
AMOLATAR,KIOGA COUNTY,AWELLO,ABEJA,ABEJA P.7 SCHOOL EAST II,383,7,8,10,238,27,290,15,305,0,O-57-102-03-01-02
AMOLATAR,KIOGA COUNTY,AWELLO,ABWONG,ABWONG P. 7 SCHOOL,687,6,6,7,339,101,459,2,461,0,O-57-102-03-02-01
AMOLATAR,KIOGA COUNTY,AWELLO,ABWONG,ABURKIDI,578,8,7,9,347,180,551,1,552,0,O-57-102-03-02-02
AMOLATAR,KIOGA COUNTY,AWELLO,AKOL,AKOL P.7 SCHOOL WEST,629,4,10,5,403,60,482,16,498,0,O-57-102-03-03-01
AMOLATAR,KIOGA COUNTY,AWELLO,AKONGOMIT,ADWALA P 7 SCH,636,1,10,5,178,316,510,7,517,0,O-57-102-03-04-01
AMOLATAR,KIOGA COUNTY,AWELLO,AKONGOMIT,AWELLO P7 SCH,332,2,2,8,128,121,261,11,272,0,O-57-102-03-04-02
AMOLATAR,KIOGA COUNTY,AWELLO,AKONGOMIT,ODONG OYERE T.C,473,4,4,5,157,240,410,4,414,0,O-57-102-03-04-03
AMOLATAR,KIOGA COUNTY,AWELLO,ANAMIDO,ANAMIDO P 7 SCHOOL I,702,10,7,22,345,98,482,33,515,0,O-57-102-03-05-01
AMOLATAR,KIOGA COUNTY,AWELLO,ANAMIDO,ANAMIDO P.7 SCHOOL II,545,7,8,13,285,73,386,9,395,0,O-57-102-03-05-02
AMOLATAR,KIOGA COUNTY,AWELLO,ANAMWANY,AWELO SUB-COUNTY HQRS I,455,4,15,10,108,233,370,3,373,0,O-57-102-03-06-01
AMOLATAR,KIOGA COUNTY,AWELLO,ANAMWANY,AWELO SUB-COUNTY HQRS II,572,3,16,5,190,195,409,37,446,0,O-57-102-03-06-02
AMOLATAR,KIOGA COUNTY,AWELLO,ANAMWANY,AWELO SUB-COUNTY HQRS III,419,5,2,5,226,124,362,5,367,0,O-57-102-03-06-03
AMOLATAR,KIOGA COUNTY,AWELLO,ARWOTCEK,ARWOTCEK HEALTH CENTRE,417,3,4,10,272,64,353,14,367,0,O-57-102-03-07-01
AMOLATAR,KIOGA COUNTY,AWELLO,ARWOTCEK,OTANGOCING T.C,482,3,6,10,319,51,389,11,400,0,O-57-102-03-07-02
AMOLATAR,KIOGA COUNTY,AWELLO,ARWOTCEK,ARWOTCEK P7 SCHOOL,474,3,5,6,319,76,409,5,414,0,O-57-102-03-07-03
AMOLATAR,KIOGA COUNTY,AWELLO,CHAKWARA,CHAKWARA P.7 SCHOOL I,434,6,6,9,276,42,339,7,346,0,O-57-102-03-08-01
AMOLATAR,KIOGA COUNTY,AWELLO,CHAKWARA,CHAKWARA P.7 SCHOOL II,374,12,2,6,210,73,303,10,313,0,O-57-102-03-08-02
AMOLATAR,KIOGA COUNTY,AWELLO,ETAM,ETAM P.7 SCHOOL,600,4,7,3,365,79,458,28,486,0,O-57-102-03-09-01
AMOLATAR,KIOGA COUNTY,AWELLO,ETAM,OTIKE MEMORIAL PRIMARY,718,10,17,14,379,159,579,13,592,0,O-57-102-03-09-02
AMOLATAR,KIOGA COUNTY,MUNTU,ABARLER,ABARLER P.7 SCHOOL,505,3,2,2,275,82,364,17,381,0,O-57-102-04-01-01
AMOLATAR,KIOGA COUNTY,MUNTU,ALEMERE,AMIRIMIRI,416,4,7,6,141,156,314,15,329,0,O-57-102-04-02-01
AMOLATAR,KIOGA COUNTY,MUNTU,ALEMERE,ALARO,552,0,2,8,219,239,468,12,480,0,O-57-102-04-02-02
AMOLATAR,KIOGA COUNTY,MUNTU,ALYECMEDA,OBAGO,698,9,4,14,400,141,568,10,578,0,O-57-102-04-03-01
AMOLATAR,KIOGA COUNTY,MUNTU,ALYECMEDA,AKURI,435,5,2,7,200,122,336,20,356,0,O-57-102-04-03-02
AMOLATAR,KIOGA COUNTY,MUNTU,MUNTU,MUNTU P.7 SCHOOL I,478,4,8,10,234,83,339,10,349,0,O-57-102-04-04-01
AMOLATAR,KIOGA COUNTY,MUNTU,MUNTU,MUNTU P.7 SCHOOL II,482,3,6,7,247,98,361,11,372,0,O-57-102-04-04-02
AMOLATAR,KIOGA COUNTY,MUNTU,NAKATITI,ODYAK TRADING CENTRE I,541,2,5,1,332,48,388,14,402,0,O-57-102-04-05-01
AMOLATAR,KIOGA COUNTY,MUNTU,NAKATITI,ALELANGO P.7 SCHOOL,596,5,5,6,368,60,444,7,451,0,O-57-102-04-05-02
AMOLATAR,KIOGA COUNTY,MUNTU,NALUBWOYO,NALUBWOYO LANDING VILLAGE I,125,0,3,0,41,28,72,4,76,0,O-57-102-04-06-01
AMOLATAR,KIOGA COUNTY,MUNTU,NALUBWOYO,NALUBWOYO LANDING VILLAGE II,114,1,1,0,30,21,53,3,56,0,O-57-102-04-06-02
AMOLATAR,KIOGA COUNTY,MUNTU,NALUBWOYO,KAMPALA LANDING VILLAGE,305,2,4,2,175,34,217,8,225,0,O-57-102-04-06-03
AMOLATAR,KIOGA COUNTY,MUNTU,NALUBWOYO,OPIR P 7 SCHOOL,289,7,2,2,158,68,237,10,247,0,O-57-102-04-06-04
AMOLATAR,KIOGA COUNTY,MUNTU,NALUBWOYO,AGWENONYWAL P.7 SCHOOL,606,3,13,7,334,130,487,12,499,0,O-57-102-04-06-05
AMOLATAR,KIOGA COUNTY,NAMASALE,ACII,ACII P 7 SCHOOL I,223,0,1,0,77,45,123,3,126,0,O-57-102-05-01-01
AMOLATAR,KIOGA COUNTY,NAMASALE,ACII,ACII P.7 SCHOOL II,509,7,8,13,280,109,417,21,438,0,O-57-102-05-01-02
AMOLATAR,KIOGA COUNTY,NAMASALE,ACII,ACII P.7 SCHOOL III,500,0,7,2,288,104,401,13,414,0,O-57-102-05-01-03
AMOLATAR,KIOGA COUNTY,NAMASALE,BANGLADESH,BANGLADESH I,689,3,4,4,286,98,395,18,413,0,O-57-102-05-02-01
AMOLATAR,KIOGA COUNTY,NAMASALE,BANGLADESH,BANGLADESH II,301,0,1,5,116,35,157,12,169,0,O-57-102-05-02-02
AMOLATAR,KIOGA COUNTY,NAMASALE,IZIGWE,NAMASALE TRADING CENTRE I,479,4,10,6,138,100,258,3,261,0,O-57-102-05-03-01
AMOLATAR,KIOGA COUNTY,NAMASALE,IZIGWE,NAMASALE TRADING CENTRE II,445,6,5,2,189,100,302,6,308,0,O-57-102-05-03-02
AMOLATAR,KIOGA COUNTY,NAMASALE,IZIGWE,NAMASALE TRADING CENTRE III,339,7,5,8,148,97,265,7,272,0,O-57-102-05-03-03
AMOLATAR,KIOGA COUNTY,NAMASALE,IZIGWE,KAYAGO I,342,2,6,1,130,48,187,5,192,0,O-57-102-05-03-04
AMOLATAR,KIOGA COUNTY,NAMASALE,IZIGWE,KAYAGO II,199,2,1,2,54,46,105,3,108,0,O-57-102-05-03-05
AMOLATAR,KIOGA COUNTY,NAMASALE,IZIGWE,KAYAGO III,286,2,0,1,108,24,135,3,138,0,O-57-102-05-03-06
AMOLATAR,KIOGA COUNTY,NAMASALE,KIKONDO,KATANGIRA,515,7,13,14,251,97,382,11,393,0,O-57-102-05-04-01
AMOLATAR,KIOGA COUNTY,NAMASALE,NABWEYO,OLYAKA P.7 SCHOOL I,468,2,6,4,131,230,373,11,384,0,O-57-102-05-05-01
AMOLATAR,KIOGA COUNTY,NAMASALE,NABWEYO,OLYAKA P.7 SCHOOL II,253,3,4,2,143,50,202,6,208,0,O-57-102-05-05-02
AMOLATAR,KIOGA COUNTY,NAMASALE,NABWEYO,NABWEYO P 7 SCHOOL,286,1,4,2,168,60,235,9,244,0,O-57-102-05-05-03
AMOLATAR,KIOGA COUNTY,NAMASALE,WABINUA,WABINUA P.7 SCHOOL I,209,4,3,3,83,61,154,1,155,0,O-57-102-05-06-01
AMOLATAR,KIOGA COUNTY,NAMASALE,WABINUA,WABINUA P.7 SCHOOL II,214,3,5,7,73,66,154,0,154,0,O-57-102-05-06-02
KAABONG,DODOTH COUNTY,KAABONG COUNCIL,BIAFRA,BIAFRA,615,4,7,16,48,283,358,40,398,0,O-63-93-01-01-01
KAABONG,DODOTH COUNTY,KAABONG COUNCIL,CAMPSWAHILI,CAMPSWAHILI MARKET,605,1,0,12,39,305,357,30,387,0,O-63-93-01-02-01
KAABONG,DODOTH COUNTY,KAABONG COUNCIL,CENTRAL,COUNTY HEADQUARTERS,636,6,2,10,63,244,325,10,335,0,O-63-93-01-03-01
KAABONG,DODOTH COUNTY,KAABONG COUNCIL,KAPILANI BAR,COMMUNITY CENTRE,778,2,1,6,58,352,419,12,431,0,O-63-93-01-04-01
KAABONG,DODOTH COUNTY,KAABONG COUNCIL,KOMURIA,LOKWAKWA,456,1,0,4,25,288,318,8,326,0,O-63-93-01-05-01
KAABONG,DODOTH COUNTY,KAABONG COUNCIL,LOBONGIA,PAJAR PR SCH,1063,11,11,19,49,486,576,27,603,0,O-63-93-01-06-01
KAABONG,DODOTH COUNTY,KAABONG COUNCIL,LOBONGIA,LOMUSIAN,481,9,4,28,33,203,277,57,334,0,O-63-93-01-06-02
KAABONG,DODOTH COUNTY,KAABONG COUNCIL,LOKERUI,LOKERUI,422,1,1,4,5,61,72,159,231,0,O-63-93-01-07-01
KAABONG,DODOTH COUNTY,KAABONG COUNCIL,LOKERUI,LOMORUITAE,583,8,6,15,16,186,231,60,291,0,O-63-93-01-07-02
KAABONG,DODOTH COUNTY,KAABONG COUNCIL,LOKERUI,NANGOLE KURUK,483,5,9,28,11,198,251,57,308,0,O-63-93-01-07-03
KAABONG,DODOTH COUNTY,KAABONG COUNCIL,LOKOLIA,KALODEKE,583,4,2,4,2,87,99,29,128,0,O-63-93-01-08-01
KAABONG,DODOTH COUNTY,KAABONG COUNCIL,LOKOLIA,SIMALOK,515,5,13,34,18,176,246,52,298,0,O-63-93-01-08-02
KAABONG,DODOTH COUNTY,KAABONG COUNCIL,LOMERIS,KACHIKOL,567,1,1,18,4,308,332,51,383,0,O-63-93-01-09-01
KAABONG,DODOTH COUNTY,KAABONG COUNCIL,LOMERIS,KEPAK,505,0,2,4,2,345,353,48,401,0,O-63-93-01-09-02
KAABONG,DODOTH COUNTY,KAABONG COUNCIL,LOPAMA,LOKUT-TAYAL,172,0,0,2,3,148,153,14,167,0,O-63-93-01-10-01
KAABONG,DODOTH COUNTY,KAABONG COUNCIL,LOPUTUK,KOMUKUNY BOY'S P/SCH,351,3,1,6,14,172,196,24,220,0,O-63-93-01-11-01
KAABONG,DODOTH COUNTY,KAABONG COUNCIL,LOSOGOLO,KALONGOR PRIMARY SCHOOL,467,4,2,7,5,163,181,62,243,0,O-63-93-01-12-01
KAABONG,DODOTH COUNTY,KAABONG COUNCIL,LOSOGOLO,NAMERI,501,5,7,11,4,236,263,38,301,0,O-63-93-01-12-02
KAABONG,DODOTH COUNTY,KAABONG COUNCIL,LOSOGOLO,KALONGOR P/S,368,7,3,25,6,136,177,41,218,0,O-63-93-01-12-03
KAABONG,DODOTH COUNTY,KALAPATA,KALAPATA,KALAPATA,634,8,3,9,24,318,362,17,379,0,O-63-93-02-01-01
KAABONG,DODOTH COUNTY,KALAPATA,KALAPATA,LOCEGER,659,6,0,6,36,471,519,12,531,0,O-63-93-02-01-02
KAABONG,DODOTH COUNTY,KALAPATA,KALAPATA,LOKASENYA/KURAO-OUTSIDE GU,29,0,0,0,10,14,24,5,29,0,O-63-93-02-01-03
KAABONG,DODOTH COUNTY,KALAPATA,KAMION,KAMION,427,0,4,4,7,186,201,12,213,0,O-63-93-02-02-01
KAABONG,DODOTH COUNTY,KALAPATA,KAMION,LOKWAKORAMWAE,187,0,0,3,0,161,164,19,183,0,O-63-93-02-02-02
KAABONG,DODOTH COUNTY,KALAPATA,KAMION,TIMU,318,4,1,6,9,198,218,1,219,0,O-63-93-02-02-03
KAABONG,DODOTH COUNTY,KALAPATA,LOKWARAMOE,LOKWARAMOE,390,1,0,1,0,135,137,43,180,0,O-63-93-02-03-01
KAABONG,DODOTH COUNTY,KALAPATA,LOTIM,LOTIM,182,0,3,1,0,163,167,0,167,0,O-63-93-02-04-01
KAABONG,DODOTH COUNTY,KALAPATA,LOTIM,LOTIM PRIMARY SCHOOL,557,7,6,10,15,167,205,14,219,0,O-63-93-02-04-02
KAABONG,DODOTH COUNTY,KALAPATA,LOTIM,NAKWAKA CELL,261,0,1,4,4,124,133,16,149,0,O-63-93-02-04-03
KAABONG,DODOTH COUNTY,KALAPATA,MOROTO,MEUS,545,6,7,26,6,202,247,9,256,0,O-63-93-02-05-01
KAABONG,DODOTH COUNTY,KALAPATA,MOROTO,MOROTO EAST,492,9,7,13,4,126,159,56,215,0,O-63-93-02-05-02
KAABONG,DODOTH COUNTY,KALAPATA,MOROTO,NAKARACH,274,7,11,6,7,64,95,31,126,0,O-63-93-02-05-03
KAABONG,DODOTH COUNTY,KALAPATA,MORUKORI,KOSUSUI,215,1,1,3,0,90,95,33,128,0,O-63-93-02-06-01
KAABONG,DODOTH COUNTY,KALAPATA,MORUKORI,MORUKORI,656,11,14,19,9,134,187,65,252,0,O-63-93-02-06-02
KAABONG,DODOTH COUNTY,KALAPATA,MORUKORI,MORUKORI PRI. SCH.,380,8,6,14,4,119,151,45,196,0,O-63-93-02-06-03
KAABONG,DODOTH COUNTY,KALAPATA,MORUNYANG,MORUNYANG,162,0,2,1,3,90,96,11,107,0,O-63-93-02-07-01
KAABONG,DODOTH COUNTY,KALAPATA,NAPETAKORI,LOTWAL - LOKUT,101,2,2,4,1,57,66,2,68,0,O-63-93-02-08-01
KAABONG,DODOTH COUNTY,KATHILE,KAMACHARIKOL,KAMACHARIKOL,731,1,0,2,0,443,446,10,456,0,O-63-93-03-01-01
KAABONG,DODOTH COUNTY,KATHILE,KAMACHARIKOL,LOIS,299,1,4,9,7,145,166,21,187,0,O-63-93-03-01-02
KAABONG,DODOTH COUNTY,KATHILE,KATHILE,LOBATOU(A-LOL),496,3,1,7,4,297,312,19,331,0,O-63-93-03-02-01
KAABONG,DODOTH COUNTY,KATHILE,KATHILE,TEREGU PRIMARY SCHOOL,669,5,1,4,37,409,456,27,483,0,O-63-93-03-02-02
KAABONG,DODOTH COUNTY,KATHILE,KATHILE,LOBATOU(LOLE-Z),507,2,2,2,8,289,303,10,313,0,O-63-93-03-02-03
KAABONG,DODOTH COUNTY,KATHILE,LOKARENGAK,NGIRO NWAKAPICHA,112,2,4,5,5,75,91,4,95,0,O-63-93-03-03-01
KAABONG,DODOTH COUNTY,KATHILE,LOMALER,LOKILLI,25,1,0,0,2,21,24,1,25,0,O-63-93-03-04-01
KAABONG,DODOTH COUNTY,KATHILE,LOMILIMIL (NATINGO,LENGONYA KRAAL,103,1,1,0,0,55,57,6,63,0,O-63-93-03-05-01
KAABONG,DODOTH COUNTY,KATHILE,NARENGEPAK,NARENGEPAK,534,8,16,15,13,299,351,29,380,0,O-63-93-03-06-01
KAABONG,DODOTH COUNTY,KATHILE,NARENGEPAK,NARUBE P/S,434,3,18,7,21,220,269,14,283,0,O-63-93-03-06-02
KAABONG,DODOTH COUNTY,KATHILE,NARIAMDOI,NARYONOMORU,714,5,0,0,2,534,541,16,557,0,O-63-93-03-07-01
KAABONG,DODOTH COUNTY,KATHILE,NARIAMDOI,LOIS PRIMARY SCHOOL,288,2,0,5,19,258,284,1,285,0,O-63-93-03-07-02
KAABONG,DODOTH COUNTY,LOLELIA,KAIMESE,KAIMESE,739,3,7,17,6,308,341,35,376,0,O-63-93-04-01-01
KAABONG,DODOTH COUNTY,LOLELIA,KAIMESE,KAIWELE,262,2,1,5,1,120,129,6,135,0,O-63-93-04-01-02
KAABONG,DODOTH COUNTY,LOLELIA,LOLELIA,LOLELIA,357,2,6,12,11,157,188,5,193,0,O-63-93-04-02-01
KAABONG,DODOTH COUNTY,LOLELIA,LOTETELEIT,LOCHEREP,433,1,2,2,2,391,398,24,422,0,O-63-93-04-03-01
KAABONG,DODOTH COUNTY,LOLELIA,NAROGO,KAILOB,791,5,7,26,4,206,248,31,279,0,O-63-93-04-04-01
KAABONG,DODOTH COUNTY,LOYORO,LODIKO,KANGIOS,527,4,4,3,6,267,284,16,300,0,O-63-93-05-01-01
KAABONG,DODOTH COUNTY,LOYORO,LODIKO,KOTOME,551,0,0,1,0,288,289,33,322,0,O-63-93-05-01-02
KAABONG,DODOTH COUNTY,LOYORO,LODIKO,LOKIDO,393,2,7,6,7,167,189,57,246,0,O-63-93-05-01-03
KAABONG,DODOTH COUNTY,LOYORO,LOKANAYONA,KALAPATA,392,0,0,2,5,338,345,2,347,0,O-63-93-05-02-01
KAABONG,DODOTH COUNTY,LOYORO,LOMERIMA,LOMERIMA (not specified),173,2,5,3,0,156,166,1,167,0,O-63-93-05-03-01
KAABONG,DODOTH COUNTY,LOYORO,LOPEDO,LOPEDO/TEUSO,181,1,0,3,2,131,137,11,148,0,O-63-93-05-04-01
KAABONG,DODOTH COUNTY,LOYORO,TOROI,LOYORO MISSION,365,7,4,19,24,192,246,16,262,0,O-63-93-05-05-01
KAABONG,DODOTH COUNTY,LOYORO,TOROI,TOROI-OUTSIDE Q.GUARD,51,0,0,2,5,41,48,1,49,0,O-63-93-05-05-02
KAABONG,DODOTH COUNTY,SIDOK (KOPOTH),KAKAMAR,KITE-LORE,510,5,6,19,4,269,303,10,313,0,O-63-93-06-01-01
KAABONG,DODOTH COUNTY,SIDOK (KOPOTH),KAKAMAR,MORUNYANG,434,1,5,11,34,212,263,22,285,0,O-63-93-06-01-02
KAABONG,DODOTH COUNTY,SIDOK (KOPOTH),KAKAMAR,KAKAMAR,298,2,2,16,2,200,222,38,260,0,O-63-93-06-01-03
KAABONG,DODOTH COUNTY,SIDOK (KOPOTH),KAKAMAR,KOTIRAE,633,0,1,8,5,452,466,12,478,0,O-63-93-06-01-04
KAABONG,DODOTH COUNTY,SIDOK (KOPOTH),KASIMERI,LOCHOM,540,6,1,6,6,401,420,53,473,0,O-63-93-06-02-01
KAABONG,DODOTH COUNTY,SIDOK (KOPOTH),LONGARO,KOPOS,681,8,3,25,19,348,403,13,416,0,O-63-93-06-03-01
KOBOKO,KOBOKO COUNTY,KOBOKO TOWN COUNCIL,APA WARD,BUKUTU SUB WARD A,1057,6,3,6,267,229,511,15,526,0,O-66-8-01-01-01
KOBOKO,KOBOKO COUNTY,KOBOKO TOWN COUNCIL,APA WARD,BUKUTU SUB WARD B,724,2,0,3,207,170,382,16,398,0,O-66-8-01-01-02
KOBOKO,KOBOKO COUNTY,KOBOKO TOWN COUNCIL,MALENGA,ALENGA B,697,12,1,6,190,185,394,21,415,0,O-66-8-01-02-01
KOBOKO,KOBOKO COUNTY,KOBOKO TOWN COUNCIL,MALENGA,ALENGA A,762,6,3,7,194,213,423,27,450,0,O-66-8-01-02-02
KOBOKO,KOBOKO COUNTY,KOBOKO TOWN COUNCIL,MALENGA,ALENGA OUTSIDE Q.GUARD,1193,8,1,3,112,222,346,2,348,0,O-66-8-01-02-03
KOBOKO,KOBOKO COUNTY,KOBOKO TOWN COUNCIL,MENGO,OMA GROUND (A-A),682,7,2,4,164,157,334,7,341,0,O-66-8-01-03-01
KOBOKO,KOBOKO COUNTY,KOBOKO TOWN COUNCIL,MENGO,ENGO B (A-L),403,1,1,0,119,78,199,2,201,0,O-66-8-01-03-02
KOBOKO,KOBOKO COUNTY,KOBOKO TOWN COUNCIL,MENGO,BELE,465,5,1,1,140,93,240,64,304,0,O-66-8-01-03-03
KOBOKO,KOBOKO COUNTY,KOBOKO TOWN COUNCIL,MENGO,OMA GROUND (B-Z),464,2,1,1,133,98,235,2,237,0,O-66-8-01-03-04
KOBOKO,KOBOKO COUNTY,KOBOKO TOWN COUNCIL,MENGO,ENGO B (M-Z),608,3,0,1,182,129,315,13,328,0,O-66-8-01-03-05
KOBOKO,KOBOKO COUNTY,KOBOKO TOWN COUNCIL,TEREMUNG,EREMUNG SUB WARD B,688,2,1,1,186,162,352,29,381,0,O-66-8-01-04-01
KOBOKO,KOBOKO COUNTY,KOBOKO TOWN COUNCIL,TEREMUNG,EREMUNG SUB WARD A,736,1,0,2,186,210,399,12,411,0,O-66-8-01-04-02
KOBOKO,KOBOKO COUNTY,KULUBA,AYIPE,AYIPE (A-J),539,13,2,11,63,208,297,25,322,0,O-66-8-02-01-01
KOBOKO,KOBOKO COUNTY,KULUBA,AYIPE,WOLIMO,663,19,4,15,132,217,387,14,401,0,O-66-8-02-01-02
KOBOKO,KOBOKO COUNTY,KULUBA,AYIPE,AYIPE (K-Z),421,11,1,8,48,174,242,14,256,0,O-66-8-02-01-03
KOBOKO,KOBOKO COUNTY,KULUBA,KULUBA,PAKARIO A (A-F),443,7,2,7,74,130,220,19,239,0,O-66-8-02-02-01
KOBOKO,KOBOKO COUNTY,KULUBA,KULUBA,PAKARIO B (A-I),567,6,4,7,75,188,280,14,294,0,O-66-8-02-02-02
KOBOKO,KOBOKO COUNTY,KULUBA,KULUBA,MONODU (A-H),408,21,1,3,84,158,267,6,273,0,O-66-8-02-02-03
KOBOKO,KOBOKO COUNTY,KULUBA,KULUBA,PAKARIO A (G-Z),504,11,1,4,90,164,270,7,277,0,O-66-8-02-02-04
KOBOKO,KOBOKO COUNTY,KULUBA,KULUBA,PAKARIO B (J-Z),483,2,1,2,60,126,191,13,204,0,O-66-8-02-02-05
KOBOKO,KOBOKO COUNTY,KULUBA,KULUBA,MONODU (I-Z),359,15,2,6,61,140,224,8,232,0,O-66-8-02-02-06
KOBOKO,KOBOKO COUNTY,KULUBA,ORABA,JOBU A,638,23,3,11,146,220,403,26,429,0,O-66-8-02-03-01
KOBOKO,KOBOKO COUNTY,KULUBA,ORABA,JOBU B,431,10,0,9,124,123,266,19,285,0,O-66-8-02-03-02
KOBOKO,KOBOKO COUNTY,KULUBA,ORABA,NYOKE (A-E),399,13,1,10,91,119,234,14,248,0,O-66-8-02-03-03
KOBOKO,KOBOKO COUNTY,KULUBA,ORABA,NYOKE (F-Z),375,11,2,6,91,113,223,11,234,0,O-66-8-02-03-04
KOBOKO,KOBOKO COUNTY,KULUBA,PAMODO,KANDIO/ARAGALE,454,18,6,11,82,194,311,6,317,0,O-66-8-02-04-01
KOBOKO,KOBOKO COUNTY,KULUBA,PAMODO,ARAGALE,624,21,3,12,111,155,302,25,327,0,O-66-8-02-04-02
KOBOKO,KOBOKO COUNTY,LOBULE,ALIRIBU,WUDI (A-D),459,14,4,6,218,50,292,9,301,0,O-66-8-03-01-01
KOBOKO,KOBOKO COUNTY,LOBULE,ALIRIBU,OINYA (A-D),451,11,5,5,189,93,303,13,316,0,O-66-8-03-01-02
KOBOKO,KOBOKO COUNTY,LOBULE,ALIRIBU,WUDI (E-Z),426,6,1,3,235,43,288,9,297,0,O-66-8-03-01-03
KOBOKO,KOBOKO COUNTY,LOBULE,ALIRIBU,OINYA (E-Z),368,10,0,6,158,70,244,6,250,0,O-66-8-03-01-04
KOBOKO,KOBOKO COUNTY,LOBULE,GBOROKOLONGO,BOROKOLONGO,1181,28,8,13,533,119,701,11,712,0,O-66-8-03-02-01
KOBOKO,KOBOKO COUNTY,LOBULE,GBOROKOLONGO,NYOKUNGA,852,23,5,10,452,68,558,27,585,0,O-66-8-03-02-02
KOBOKO,KOBOKO COUNTY,LOBULE,LOBULE,IMU,901,20,2,11,306,229,568,84,652,0,O-66-8-03-03-01
KOBOKO,KOBOKO COUNTY,LOBULE,LOBULE,JIPALA,796,23,4,16,342,129,514,66,580,0,O-66-8-03-03-02
KOBOKO,KOBOKO COUNTY,LOBULE,LOBULE,TU - RIVER,385,19,4,10,162,50,245,11,256,0,O-66-8-03-03-03
KOBOKO,KOBOKO COUNTY,LOBULE,LURUJO,ONYONA A,602,17,6,20,273,123,439,9,448,0,O-66-8-03-04-01
KOBOKO,KOBOKO COUNTY,LOBULE,LURUJO,ATUWA,688,16,4,5,390,81,496,28,524,0,O-66-8-03-04-02
KOBOKO,KOBOKO COUNTY,LOBULE,LURUJO,ONYONA B,520,12,0,7,188,85,292,8,300,0,O-66-8-03-04-03
KOBOKO,KOBOKO COUNTY,LOBULE,NYAYI,ETINO (A-C),477,15,3,2,246,69,335,12,347,0,O-66-8-03-05-01
KOBOKO,KOBOKO COUNTY,LOBULE,NYAYI,YORI A,628,20,9,10,330,52,421,17,438,0,O-66-8-03-05-02
KOBOKO,KOBOKO COUNTY,LOBULE,NYAYI,YORI B,520,12,2,6,261,34,315,4,319,0,O-66-8-03-05-03
KOBOKO,KOBOKO COUNTY,LOBULE,NYAYI,ETINO (D-Z),504,22,3,9,273,64,371,11,382,0,O-66-8-03-05-04
KOBOKO,KOBOKO COUNTY,LOBULE,PONYURA,OBURI A,706,11,0,6,169,281,467,14,481,0,O-66-8-03-06-01
KOBOKO,KOBOKO COUNTY,LOBULE,PONYURA,OBURI B,753,8,1,9,319,218,555,17,572,0,O-66-8-03-06-02
KOBOKO,KOBOKO COUNTY,LOBULE,PONYURA,ADROMBU (A-E),564,20,1,22,186,133,362,17,379,0,O-66-8-03-06-03
KOBOKO,KOBOKO COUNTY,LOBULE,PONYURA,ADROMBU (F-Z),467,7,1,4,187,122,321,7,328,0,O-66-8-03-06-04
KOBOKO,KOBOKO COUNTY,LUDARA,GUREPI,WOBA/GIMERE A,680,17,3,13,246,60,339,25,364,0,O-66-8-04-01-01
KOBOKO,KOBOKO COUNTY,LUDARA,GUREPI,ETTA/NYAI,371,11,1,11,203,35,261,18,279,0,O-66-8-04-01-02
KOBOKO,KOBOKO COUNTY,LUDARA,GUREPI,WOBA/GIMERE B,698,15,2,10,242,65,334,36,370,0,O-66-8-04-01-03
KOBOKO,KOBOKO COUNTY,LUDARA,GUREPI,UREPI/MITIKA,337,4,0,2,209,26,241,19,260,0,O-66-8-04-01-04
KOBOKO,KOBOKO COUNTY,LUDARA,GUREPI,ORODU/ADROPI,704,20,2,11,346,54,433,20,453,0,O-66-8-04-01-05
KOBOKO,KOBOKO COUNTY,LUDARA,LONGIRA,IDORU (A-G),624,20,1,13,287,55,376,26,402,0,O-66-8-04-02-01
KOBOKO,KOBOKO COUNTY,LUDARA,LONGIRA,PODO A,401,10,4,10,177,40,241,27,268,0,O-66-8-04-02-02
KOBOKO,KOBOKO COUNTY,LUDARA,LONGIRA,PODO B (A-C),227,8,0,3,98,25,134,1,135,0,O-66-8-04-02-03
KOBOKO,KOBOKO COUNTY,LUDARA,LONGIRA,MIDORU (H-Z),555,9,2,7,257,53,328,8,336,0,O-66-8-04-02-04
KOBOKO,KOBOKO COUNTY,LUDARA,LONGIRA,PODO A (D-Z),809,19,4,8,318,72,421,35,456,0,O-66-8-04-02-05
KOBOKO,KOBOKO COUNTY,LUDARA,LUDARA,CHAKULI A,730,21,3,22,220,121,387,22,409,0,O-66-8-04-03-01
KOBOKO,KOBOKO COUNTY,LUDARA,LUDARA,INDIGA A (A-D),559,16,5,4,214,127,366,18,384,0,O-66-8-04-03-02
KOBOKO,KOBOKO COUNTY,LUDARA,LUDARA,INDIGA B,358,10,2,3,116,118,249,25,274,0,O-66-8-04-03-03
KOBOKO,KOBOKO COUNTY,LUDARA,LUDARA,CHAKULI B,591,23,1,9,218,106,357,31,388,0,O-66-8-04-03-04
KOBOKO,KOBOKO COUNTY,LUDARA,LUDARA,INDIGA A (E-Z),484,14,0,6,187,86,293,12,305,0,O-66-8-04-03-05
KOBOKO,KOBOKO COUNTY,MIDIA,ALA,MITIKA,778,10,6,15,298,149,478,32,510,0,O-66-8-05-01-01
KOBOKO,KOBOKO COUNTY,MIDIA,ASUNGA,ASUNGA/MENIKA,626,7,3,8,231,175,424,14,438,0,O-66-8-05-02-01
KOBOKO,KOBOKO COUNTY,MIDIA,AUNGA,DRANYA (A-D),476,9,5,5,211,53,283,30,313,0,O-66-8-05-03-01
KOBOKO,KOBOKO COUNTY,MIDIA,AUNGA,DRANYA (E-Z),435,21,1,3,190,57,272,14,286,0,O-66-8-05-03-02
KOBOKO,KOBOKO COUNTY,MIDIA,DEGIBA,DEGIBA,781,17,2,16,201,273,509,28,537,0,O-66-8-05-04-01
KOBOKO,KOBOKO COUNTY,MIDIA,DRICILE,MENIKA (A-H),412,10,4,9,225,58,306,18,324,0,O-66-8-05-05-01
KOBOKO,KOBOKO COUNTY,MIDIA,DRICILE,MENIKA (I-Z),389,13,2,1,215,35,266,13,279,0,O-66-8-05-05-02
KOBOKO,KOBOKO COUNTY,MIDIA,GINYAKO,RUGBUJA CLUB (A-F),500,14,3,15,213,95,340,18,358,0,O-66-8-05-06-01
KOBOKO,KOBOKO COUNTY,MIDIA,GINYAKO,RUGBUJA CLUB (G-Z),387,11,4,6,175,85,281,8,289,0,O-66-8-05-06-02
KOBOKO,KOBOKO COUNTY,MIDIA,GODIA,DRIMU/TURUPA (A-C),415,7,1,7,128,41,184,16,200,0,O-66-8-05-07-01
KOBOKO,KOBOKO COUNTY,MIDIA,GODIA,DRIMU A,622,7,4,6,202,102,321,17,338,0,O-66-8-05-07-02
KOBOKO,KOBOKO COUNTY,MIDIA,GODIA,DRIMU B,695,11,1,2,232,111,357,25,382,0,O-66-8-05-07-03
KOBOKO,KOBOKO COUNTY,MIDIA,GODIA,DRIMU/TURUPA (D-Z),534,3,0,9,200,68,280,18,298,0,O-66-8-05-07-04
KOBOKO,KOBOKO COUNTY,MIDIA,KINGABA,KINGABA P/S (A-H),548,14,1,13,178,148,354,27,381,0,O-66-8-05-08-01
KOBOKO,KOBOKO COUNTY,MIDIA,KINGABA,KINGABA P/S (I-Z),398,6,0,2,134,115,257,15,272,0,O-66-8-05-08-02
KOBOKO,KOBOKO COUNTY,MIDIA,LEIKO,OPOO A,467,17,1,8,242,86,354,12,366,0,O-66-8-05-09-01
KOBOKO,KOBOKO COUNTY,MIDIA,LEIKO,OPOO B,578,15,5,13,263,115,411,9,420,0,O-66-8-05-09-02
KOBOKO,KOBOKO COUNTY,MIDIA,LURUNO,RANJU,530,10,2,14,159,190,375,15,390,0,O-66-8-05-10-01
KOBOKO,KOBOKO COUNTY,MIDIA,LURUNO,GBOROKOLONGO,371,7,0,6,94,142,249,14,263,0,O-66-8-05-10-02
KOBOKO,KOBOKO COUNTY,MIDIA,MIDIA,PAKAYO (A-C),542,10,1,3,133,141,288,15,303,0,O-66-8-05-11-01
KOBOKO,KOBOKO COUNTY,MIDIA,MIDIA,PAKAYO (D-Z),680,8,1,7,167,184,367,15,382,0,O-66-8-05-11-02
KOBOKO,KOBOKO COUNTY,MIDIA,NYAGAZIA,NYAGAZIA,701,13,3,9,259,136,420,20,440,0,O-66-8-05-12-01
KOBOKO,KOBOKO COUNTY,MIDIA,NYANGILIA,RODO CHURCH,320,2,0,7,126,82,217,4,221,0,O-66-8-05-13-01
KOBOKO,KOBOKO COUNTY,MIDIA,NYANGILIA,NYANGILIA,625,12,2,10,215,171,410,16,426,0,O-66-8-05-13-02
KOTIDO,LABWOR COUNTY,ABIM,ATUNGA+ABIM T.C.,ORYEOTENE APELKERE,195,2,2,3,11,121,139,5,144,0,O-70-95-01-01-01
KOTIDO,LABWOR COUNTY,ABIM,ATUNGA+ABIM T.C.,OTALABAR,394,3,2,7,14,246,272,5,277,0,O-70-95-01-01-02
KOTIDO,LABWOR COUNTY,ABIM,ATUNGA+ABIM T.C.,ARINGOWELLO - ATUGO,274,1,0,1,20,164,186,8,194,0,O-70-95-01-01-03
KOTIDO,LABWOR COUNTY,ABIM,ATUNGA+ABIM T.C.,ORYEOTENE - APELEKER (A),352,0,0,1,14,190,205,3,208,0,O-70-95-01-01-04
KOTIDO,LABWOR COUNTY,ABIM,ATUNGA+ABIM T.C.,ABIM EAST,363,0,0,3,25,47,75,0,75,0,O-70-95-01-01-05
KOTIDO,LABWOR COUNTY,ADEA,ANGOLEBWAL,ADEA PRIMARY SCHOOL,353,2,0,0,9,209,220,15,235,0,O-70-95-02-01-01
KOTIDO,LABWOR COUNTY,ADEA,AREMO,MORULEM BOYS I,814,3,6,8,92,385,494,24,518,0,O-70-95-02-02-01
KOTIDO,LABWOR COUNTY,ADEA,AREMO,OKONYOKECH,133,1,0,0,28,38,67,16,83,0,O-70-95-02-02-02
KOTIDO,LABWOR COUNTY,ADEA,AREMO,REFORMATORY P/S,509,3,4,10,33,305,355,24,379,0,O-70-95-02-02-03
KOTIDO,LABWOR COUNTY,ADEA,KATABOK,KATABOK AKANGAGWEL,287,2,0,0,14,185,201,24,225,0,O-70-95-02-03-01
KOTIDO,LABWOR COUNTY,ADEA,KATABOK,KATABOK RACHKOKO P/SCH,693,4,4,14,34,380,436,30,466,0,O-70-95-02-03-02
KOTIDO,LABWOR COUNTY,ADEA,KATABOK,KATABOK T/C,662,10,3,7,63,310,393,20,413,0,O-70-95-02-03-03
KOTIDO,LABWOR COUNTY,ADEA,KATABOK,KATABOK P/S,343,4,1,3,20,229,257,19,276,0,O-70-95-02-03-04
KOTIDO,LABWOR COUNTY,ALEREK,LOYOROIT,ALEREK PRIMARY SCHOOL I,477,1,2,13,13,148,177,11,188,0,O-70-95-03-01-01
KOTIDO,LABWOR COUNTY,ALEREK,LOYOROIT,LOYOROIT P/S,225,1,1,0,16,89,107,28,135,0,O-70-95-03-01-02
KOTIDO,LABWOR COUNTY,ALEREK,LOYOROIT,TYEN OLAM,280,5,4,9,17,172,207,14,221,0,O-70-95-03-01-03
KOTIDO,LABWOR COUNTY,ALEREK,WILELA,WILELA PRIMARY SCHOOL,662,1,0,8,35,408,452,22,474,0,O-70-95-03-02-01
KOTIDO,LABWOR COUNTY,KANU,ATUNGA+ABIM T.C.,ANINATA EAST PRIMARY SCHOOL,250,2,0,3,8,197,210,3,213,0,O-70-95-04-01-01
KOTIDO,LABWOR COUNTY,KANU,ATUNGA+ABIM T.C.,ANINATA WEST,542,2,0,5,4,497,508,27,535,0,O-70-95-04-01-02
KOTIDO,LABWOR COUNTY,KANU,ATUNGA+ABIM T.C.,AREMBWOLA P/S,339,2,0,5,9,296,312,9,321,0,O-70-95-04-01-03
KOTIDO,LABWOR COUNTY,KIRU,ATUNGA+ABIM T.C.,OYARO,295,3,0,2,19,205,229,13,242,0,O-70-95-05-01-04
KOTIDO,LABWOR COUNTY,KIRU,ATUNGA+ABIM T.C.,KIRU PRIMARY SCHOOL II,826,3,3,5,49,461,521,7,528,0,O-70-95-05-01-05
KOTIDO,LABWOR COUNTY,KIRU,KALAKALA,KIRU PRIMARY SCHOOL I,602,3,0,13,59,343,418,11,429,0,O-70-95-05-02-01
KOTIDO,LABWOR COUNTY,KIRU,WIAWER,ABIM EAST - DAGARONYA,448,5,2,3,48,224,282,12,294,0,O-70-95-05-03-01
KOTIDO,LABWOR COUNTY,KIRU,WIAWER,ABIM HOSPITAL - ATWILO,712,0,2,2,67,320,391,9,400,0,O-70-95-05-03-02
KOTIDO,LABWOR COUNTY,KIRU,WIAWER,YENGLEMI EAST,670,7,4,3,61,324,399,22,421,0,O-70-95-05-03-03
KOTIDO,LABWOR COUNTY,KOYA,OTUMPILI,OTUMPILI,317,2,0,2,13,167,184,6,190,0,O-70-95-06-01-01
KOTIDO,LABWOR COUNTY,KOYA,OTUMPILI,ALEREK PRIMARY SCHOOL II,764,1,0,1,44,348,394,58,452,0,O-70-95-06-01-02
KOTIDO,LABWOR COUNTY,KOYA,WILELA,GULOTWORO,680,2,3,4,23,415,447,19,466,0,O-70-95-06-02-01
KOTIDO,LABWOR COUNTY,KOYA,WILELA,KOYA PRIMARY SCHOOL II,327,0,0,4,11,178,193,22,215,0,O-70-95-06-02-02
KOTIDO,LABWOR COUNTY,LOTUKEI,ACHANGALI,ORWAMUGE PRIMARY SCHOOL,765,2,2,4,68,457,533,14,547,0,O-70-95-07-01-01
KOTIDO,LABWOR COUNTY,LOTUKEI,AWACH,AWACH PRIMARY SCHOOL I,625,6,1,6,52,272,337,27,364,0,O-70-95-07-02-01
KOTIDO,LABWOR COUNTY,LOTUKEI,AWACH,GOTAPWO P/S,260,1,0,1,7,192,201,8,209,0,O-70-95-07-02-02
KOTIDO,LABWOR COUNTY,LOTUKEI,OPOROTH,AWACH PRIMARY SCHOOL II,800,11,2,12,116,353,494,19,513,0,O-70-95-07-03-01
KOTIDO,LABWOR COUNTY,LOTUKEI,ORWAMUGE,BARATANGA PRIMARY SCHOOL,1029,5,2,0,62,454,523,13,536,0,O-70-95-07-04-01
KOTIDO,LABWOR COUNTY,LOTUKEI,ORWAMUGE,LOTUKEI P/S,448,2,0,3,24,283,312,17,329,0,O-70-95-07-04-02
KOTIDO,LABWOR COUNTY,MORULEM,ANGOLEBWAL,ANGOLEBWAL CENTRE II - ARING,495,10,5,11,33,248,307,47,354,0,O-70-95-08-01-01
KOTIDO,LABWOR COUNTY,MORULEM,ANGOLEBWAL,OBANGANGEO,240,0,1,1,8,150,160,12,172,0,O-70-95-08-01-02
KOTIDO,LABWOR COUNTY,NYAKWAE,OPOPONGO,NUTHU PRIMARY SCHOOL,237,4,2,3,3,119,131,16,147,0,O-70-95-09-01-01
KOTIDO,LABWOR COUNTY,NYAKWAE,OPOPONGO,OPOPONGO PRIMARY SCHOOL,412,2,0,0,14,324,340,11,351,0,O-70-95-09-01-02
KOTIDO,LABWOR COUNTY,NYAKWAE,ORETHA,ORETA PRIMARY SCHOOL I,591,1,2,1,18,308,330,3,333,0,O-70-95-09-02-01
KOTIDO,LABWOR COUNTY,NYAKWAE,ORETHA,TYEN ALERA,278,0,2,2,7,213,224,2,226,0,O-70-95-09-02-02
KOTIDO,LABWOR COUNTY,NYAKWAE,PUPUKAMUYA,ATHEDER,434,0,1,3,25,263,292,15,307,0,O-70-95-09-03-01
KOTIDO,LABWOR COUNTY,NYAKWAE,ROGOM,SUB-COUNTY HQRS,593,7,4,6,25,327,369,49,418,0,O-70-95-09-04-01
GULU,KILAK COUNTY,AMURU,ACWERA,OBERABIC PRIMARY SCHOOL,489,11,2,6,206,52,277,0,277,0,O-71-24-01-01-01
GULU,KILAK COUNTY,AMURU,ACWERA,OBER -TEDDI,753,10,3,16,322,47,398,33,431,0,O-71-24-01-01-02
GULU,KILAK COUNTY,ATIAK,BIBIA,BIBIA P 7 SCHOOL A,259,5,2,3,101,28,139,23,162,0,O-71-24-02-01-01
GULU,KILAK COUNTY,ATIAK,BIBIA,BIBIA P 7 SCHOOL B,851,11,3,4,181,192,391,64,455,0,O-71-24-02-01-02
GULU,KILAK COUNTY,ATIAK,BIBIA,BIBIA P 7 SCHOOL C,657,14,5,3,130,180,332,53,385,0,O-71-24-02-01-03
GULU,KILAK COUNTY,ATIAK,BIBIA,BIBIA P 7 SCHOOL D,329,4,3,2,155,40,204,14,218,0,O-71-24-02-01-04
GULU,KILAK COUNTY,ATIAK,BIBIA,BIBIA OUTSIDE GUARD(A-J),185,1,1,1,14,23,40,3,43,0,O-71-24-02-01-05
GULU,KILAK COUNTY,ATIAK,BIBIA,BIBIA OUTSIDE GUARD (K-M),162,0,0,0,5,11,16,6,22,0,O-71-24-02-01-06
GULU,KILAK COUNTY,ATIAK,BIBIA,BIBIA OUTSIDE GUARD (N-Z),227,2,0,1,17,19,39,4,43,0,O-71-24-02-01-07
GULU,KILAK COUNTY,ATIAK,KAL(ATIAK),OLYA P 7 SCHOOL I,632,8,4,3,235,78,328,34,362,0,O-71-24-02-02-01
GULU,KILAK COUNTY,ATIAK,KAL(ATIAK),OLYA P.7 SCHOOL II,475,7,5,9,263,41,325,32,357,0,O-71-24-02-02-02
GULU,KILAK COUNTY,ATIAK,KAL(ATIAK),OLYA P 7 SCHOOL III,580,4,6,7,212,138,367,17,384,0,O-71-24-02-02-03
GULU,KILAK COUNTY,ATIAK,OKIDI,OKIDI P.7 SCHOOL I,560,10,5,7,315,36,373,37,410,0,O-71-24-02-03-01
GULU,KILAK COUNTY,ATIAK,OKIDI,OKIDI P.7 SCH. II,257,1,0,1,93,30,125,55,180,0,O-71-24-02-03-02
GULU,KILAK COUNTY,ATIAK,PACILO,JUBA ROAD P 7 SCHOOL,732,15,7,4,395,66,487,24,511,0,O-71-24-02-04-01
GULU,KILAK COUNTY,ATIAK,PACILO,MURULI P 7 SCHOOL,433,13,3,4,270,40,330,18,348,0,O-71-24-02-04-02
GULU,KILAK COUNTY,ATIAK,PALUKERE,PALUKERE P.7 SCH. A,517,6,2,4,219,55,286,36,322,0,O-71-24-02-05-01
GULU,KILAK COUNTY,ATIAK,PALUKERE,PALUKERE P 7 SCHOOL   B,326,8,1,5,158,36,208,16,224,0,O-71-24-02-05-02
GULU,KILAK COUNTY,ATIAK,PARWACA,PONGDWONGO PR. SCH. I,638,13,8,5,342,74,442,49,491,0,O-71-24-02-06-01
GULU,KILAK COUNTY,ATIAK,PARWACA,PONGDWONGO PR. SCH. II,357,11,1,3,164,46,225,31,256,0,O-71-24-02-06-02
GULU,KILAK COUNTY,ATIAK,PAWEL,LANGETA P.7 SCH.,610,6,4,9,304,39,362,30,392,0,O-71-24-02-07-01
GULU,KILAK COUNTY,ATIAK,PAWEL,TEKOO MARKET,458,15,4,5,295,29,348,11,359,0,O-71-24-02-07-02
GULU,KILAK COUNTY,ATIAK,PAWEL,LALEM P 7 SCHOOL,435,19,2,3,256,31,311,13,324,0,O-71-24-02-07-03
GULU,KILAK COUNTY,ATIAK,PAWEL,LANGETA P.7 SCH. B,283,0,1,2,185,19,207,17,224,0,O-71-24-02-07-04
GULU,KILAK COUNTY,ATIAK,PUPWONYA,PUPWONYA P.7 SCH. A,521,6,6,5,287,51,355,23,378,0,O-71-24-02-08-01
GULU,KILAK COUNTY,ATIAK,PUPWONYA,PUPWONYA P.7 SCH. B,498,12,6,11,262,46,337,25,362,0,O-71-24-02-08-02
GULU,KILAK COUNTY,ATIAK,PUPWONYA,PUPWONYA P 7 SCHOOL C,138,2,2,2,76,5,87,9,96,0,O-71-24-02-08-03
GULU,KILAK COUNTY,LAMOGI,AGWARYUGI,AGWAYUGI P.7 SCH I,635,7,7,10,342,57,423,25,448,0,O-71-24-03-01-01
GULU,KILAK COUNTY,LAMOGI,AGWARYUGI,AGWAYUGI P 7 SCHOOL II,788,2,4,7,456,62,531,16,547,0,O-71-24-03-01-02
GULU,KILAK COUNTY,LAMOGI,AGWARYUGI,AGWAYUGI P 7 SCHOOL III,622,6,6,4,293,45,354,38,392,0,O-71-24-03-01-03
GULU,KILAK COUNTY,LAMOGI,AGWARYUGI,PARABONGO  T C,365,8,4,5,201,14,232,42,274,0,O-71-24-03-01-04
GULU,KILAK COUNTY,LAMOGI,COKE,PARABONGO T C,835,14,7,10,438,77,546,18,564,0,O-71-24-03-02-01
GULU,KILAK COUNTY,LAMOGI,COKE,PARABONGO P.7 SCH.,788,13,8,18,452,65,556,46,602,0,O-71-24-03-02-02
GULU,KILAK COUNTY,LAMOGI,GIRAGIRA,GIRAGIRA PRIMARY SCHOOL,507,13,13,5,230,79,340,8,348,0,O-71-24-03-03-01
GULU,KILAK COUNTY,LAMOGI,GIRAGIRA,OLWAL MUCAJA PR. SCH. A (A-K),450,6,3,4,264,33,310,6,316,0,O-71-24-03-03-02
GULU,KILAK COUNTY,LAMOGI,GIRAGIRA,OLWAL COMMUNITY HALL,590,7,3,5,330,52,397,12,409,0,O-71-24-03-03-03
GULU,KILAK COUNTY,LAMOGI,GIRAGIRA,OLWAL MUCAJA PR. SCH. B (L-Z),369,1,0,2,242,31,276,6,282,0,O-71-24-03-03-04
GULU,KILAK COUNTY,LAMOGI,GURUGURU,GURUGURU PRIMARY SCHOOL,651,15,5,5,329,76,430,19,449,0,O-71-24-03-04-01
GULU,KILAK COUNTY,LAMOGI,LACOR,LACOR P.7 SCHOOL A,605,4,1,3,374,25,407,24,431,0,O-71-24-03-05-01
GULU,KILAK COUNTY,LAMOGI,LACOR,LACOR P.7 SCHOOL B,729,7,10,4,421,44,486,26,512,0,O-71-24-03-05-02
GULU,KILAK COUNTY,LAMOGI,LACOR,LACOR P.7 SCH. C,526,4,4,3,316,31,358,19,377,0,O-71-24-03-05-03
GULU,KILAK COUNTY,LAMOGI,LACOR,LACOR P.7 SCHOOL D,646,7,13,8,418,30,476,9,485,0,O-71-24-03-05-04
GULU,KILAK COUNTY,LAMOGI,OBBO,PAGAK P.7 SCH. A,148,3,0,2,86,14,105,8,113,0,O-71-24-03-06-01
GULU,KILAK COUNTY,LAMOGI,OBBO,OGORO- PII GROWERS SOCIETY,237,0,0,2,128,23,153,7,160,0,O-71-24-03-06-02
GULU,KILAK COUNTY,LAMOGI,OBBO,PAGAK P.7 SCH. B (A-G),467,12,5,7,230,62,316,23,339,0,O-71-24-03-06-03
GULU,KILAK COUNTY,LAMOGI,OBBO,OGORO- PII GROWERS SOCIETY,705,13,4,10,372,82,481,20,501,0,O-71-24-03-06-04
GULU,KILAK COUNTY,LAMOGI,OBBO,PAGAK P.7 SCH. B(K-Z),440,5,1,3,263,65,337,9,346,0,O-71-24-03-06-05
GULU,KILAK COUNTY,LAMOGI,PAGORO,OLWAL TRADING CENTRE I (A-K),504,9,11,5,286,30,341,5,346,0,O-71-24-03-07-01
GULU,KILAK COUNTY,LAMOGI,PAGORO,KALADIMA P 7 SCHOOL,262,5,4,3,143,23,178,18,196,0,O-71-24-03-07-02
GULU,KILAK COUNTY,LAMOGI,PAGORO,LAMOGI DIVISION HQRS,760,18,6,12,483,62,581,0,581,0,O-71-24-03-07-03
GULU,KILAK COUNTY,LAMOGI,PAGORO,OLWAL TRADING CENTRE II (L-Z),397,4,3,5,265,21,298,3,301,0,O-71-24-03-07-04
GULU,KILAK COUNTY,LAMOGI,PALEMA,AWER COUNTY HQTRS I,616,4,5,2,310,91,412,29,441,0,O-71-24-03-08-01
GULU,KILAK COUNTY,LAMOGI,PALEMA,AWER COUNTY HQRS II,558,5,3,4,287,78,377,8,385,0,O-71-24-03-08-02
GULU,KILAK COUNTY,LAMOGI,PALEMA,KEYO PRIMARY SCHOOL I,643,10,5,6,374,25,420,13,433,0,O-71-24-03-08-03
GULU,KILAK COUNTY,LAMOGI,PALEMA,KEYO PRIMARY SCHOOL II,870,11,5,16,519,42,593,15,608,0,O-71-24-03-08-04
GULU,KILAK COUNTY,OKUNGGED,ACWERA,OKUNGGEDI PR. SCH.,455,7,3,5,233,36,284,4,288,0,O-71-24-04-01-01
GULU,KILAK COUNTY,OKUNGGED,ACWERA,OKUNGGEDI ACODO,567,11,7,10,302,40,370,23,393,0,O-71-24-04-01-02
GULU,KILAK COUNTY,OKUNGGED,ACWERA,OKUNGGEDI MARKET,536,9,6,17,256,29,317,18,335,0,O-71-24-04-01-03
GULU,KILAK COUNTY,PABBO,GAYA,OTONG P.7 SCH. I,612,15,6,15,318,72,426,18,444,0,O-71-24-05-01-01
GULU,KILAK COUNTY,PABBO,GAYA,OTONG P7 SCH. II (A-J),399,17,3,6,219,27,272,17,289,0,O-71-24-05-01-02
GULU,KILAK COUNTY,PABBO,GAYA,OTONG P.7 SCH. III,504,6,3,4,278,23,314,19,333,0,O-71-24-05-01-03
GULU,KILAK COUNTY,PABBO,GAYA,OTONG P7 SCH. II (K-Z),387,8,3,3,235,42,291,9,300,0,O-71-24-05-01-04
GULU,KILAK COUNTY,PABBO,GAYA,BAUBI,411,10,4,6,201,38,259,33,292,0,O-71-24-05-01-05
GULU,KILAK COUNTY,PABBO,KAL,PABBO TC 1,652,12,7,10,316,68,413,32,445,0,O-71-24-05-02-01
GULU,KILAK COUNTY,PABBO,KAL,PABBO TC 2,555,13,7,1,236,37,294,104,398,0,O-71-24-05-02-02
GULU,KILAK COUNTY,PABBO,KAL,PABBO TC 3,583,21,4,11,345,49,430,21,451,0,O-71-24-05-02-03
GULU,KILAK COUNTY,PABBO,KAL,PABBO TC 4,119,4,1,1,55,20,81,3,84,0,O-71-24-05-02-04
GULU,KILAK COUNTY,PABBO,KAL,PABBO TC 5,320,14,2,7,184,26,233,12,245,0,O-71-24-05-02-05
GULU,KILAK COUNTY,PABBO,KAL,KAL OUTSIDE Q GUARD (A-L),607,2,0,1,103,128,234,27,261,0,O-71-24-05-02-06
GULU,KILAK COUNTY,PABBO,KAL,KAL OUTSIDE Q GUARD (M-Z),727,5,1,2,160,159,327,2,329,0,O-71-24-05-02-07
GULU,KILAK COUNTY,PABBO,LABALA,OKALOCWAN MARKET,701,17,1,6,403,48,475,20,495,0,O-71-24-05-03-01
GULU,KILAK COUNTY,PABBO,LABALA,ODONG VALENTINO'S HOME,424,9,4,6,237,37,293,0,293,0,O-71-24-05-03-02
GULU,KILAK COUNTY,PABBO,LABALA,OMONA CHARLES' HOME,779,37,12,13,466,24,552,2,554,0,O-71-24-05-03-03
GULU,KILAK COUNTY,PABBO,LABALA,OLINGA OUTSIDE Q.GURAD,12,0,0,0,0,0,0,0,0,1,O-71-24-05-03-04
GULU,KILAK COUNTY,PABBO,PALWONG,PALWONG P 6 SCHOOL,621,10,5,10,349,40,414,50,464,0,O-71-24-05-04-01
GULU,KILAK COUNTY,PABBO,PALWONG,KONY PACO MARKET,601,9,2,2,262,60,335,98,433,0,O-71-24-05-04-02
GULU,KILAK COUNTY,PABBO,PALWONG,PAMIN LALWAK P.5 SCH.,499,24,3,17,274,33,351,8,359,0,O-71-24-05-04-03
GULU,KILAK COUNTY,PABBO,PALWONG,ODOK NYERO MARKET,555,17,6,7,304,58,392,15,407,0,O-71-24-05-04-04
GULU,KILAK COUNTY,PABBO,PARUBANGA,ABERA MARKET I,601,37,4,19,290,98,448,21,469,0,O-71-24-05-05-01
GULU,KILAK COUNTY,PABBO,PARUBANGA,ABERA MARKET II,644,31,3,14,374,87,509,9,518,0,O-71-24-05-05-02
GULU,KILAK COUNTY,PABBO,PARUBANGA,ABERA MARKET III,601,28,8,8,295,85,424,15,439,0,O-71-24-05-05-03
GULU,KILAK COUNTY,PABBO,PARUBANGA,ABERA P.6 SCHOOL,558,32,3,11,303,61,410,24,434,0,O-71-24-05-05-04
GULU,KILAK COUNTY,PABBO,POGO,OLAMNYUNGU 1,323,16,3,6,164,22,211,15,226,0,O-71-24-05-06-01
GULU,KILAK COUNTY,PABBO,POGO,OLAMNYUNGU 2,510,16,3,3,264,37,323,10,333,0,O-71-24-05-06-02
GULU,KILAK COUNTY,PABBO,POGO,OLYAMNYUNGU,182,5,3,0,78,8,94,7,101,0,O-71-24-05-06-03
GULU,KILAK COUNTY,PAGAK,ACWERA,AMURU DIVISION HQRS I,608,11,8,15,270,70,374,8,382,0,O-71-24-06-01-01
GULU,KILAK COUNTY,PAGAK,ACWERA,AMURU P.7 SCH.,694,10,4,9,368,62,453,33,486,0,O-71-24-06-01-02
GULU,KILAK COUNTY,PAGAK,ACWERA,OTWE TRADING CENTRE,712,11,10,7,375,72,475,30,505,0,O-71-24-06-01-03
GULU,KILAK COUNTY,PAGAK,ACWERA,AMURU DIVISION HQRS II,476,2,0,0,247,69,318,0,318,0,O-71-24-06-01-04
GULU,KILAK COUNTY,PAILYEC,ACWERA,MUTEMA P.7 SCH. A (A-K),413,5,0,5,208,37,255,0,255,0,O-71-24-07-01-05
GULU,KILAK COUNTY,PAILYEC,ACWERA,MUTEMA P.7 SCH. B,372,4,4,7,208,29,252,19,271,0,O-71-24-07-01-06
GULU,KILAK COUNTY,PAILYEC,ACWERA,MUTEMA P.7 SCH. C,311,5,1,4,182,31,223,14,237,0,O-71-24-07-01-07
GULU,KILAK COUNTY,PAILYEC,ACWERA,MUTEMA P.7 SCH. D,356,12,3,7,137,20,179,7,186,0,O-71-24-07-01-08
GULU,KILAK COUNTY,PAILYEC,ACWERA,MUTEMA P.7 SCH. A (L-Z),399,2,0,0,135,22,159,31,190,0,O-71-24-07-01-09
GULU,KILAK COUNTY,PAMUCA,ACWERA,LABONGOGALI P 7   SCH A,739,12,6,18,334,57,427,10,437,0,O-71-24-08-01-10
GULU,KILAK COUNTY,PAMUCA,ACWERA,LACORO P 7 SCHOOL,461,7,6,2,251,30,296,27,323,0,O-71-24-08-01-11
GULU,KILAK COUNTY,PAMUCA,ACWERA,LABONGOGALI P 7   SCH B,730,4,2,3,339,61,409,20,429,0,O-71-24-08-01-12
GULU,KILAK COUNTY,TORO,ACWERA,AYWEECO COOPERATIVES SOCI,492,7,8,5,261,41,322,20,342,0,O-71-24-09-01-13
GULU,KILAK COUNTY,TORO,ACWERA,AYWEE CO-OPERATIVE SOCIETY,481,8,8,7,258,46,327,20,347,0,O-71-24-09-01-14
GULU,KILAK COUNTY,TORO,ACWERA,AMURU T.C I,659,10,7,7,320,71,415,39,454,0,O-71-24-09-01-15
GULU,KILAK COUNTY,TORO,ACWERA,AMURU T C  II,499,9,2,6,243,66,326,24,350,0,O-71-24-09-01-16
LIRA,DOKOLO COUNTY,AGWATTA,ADOK,ODEO P.7 SCHOOL,593,12,67,22,262,50,413,48,461,0,O-74-99-01-01-01
LIRA,DOKOLO COUNTY,AGWATTA,ADOK,ADOK P 7 SCHOOL,488,14,19,12,305,27,377,30,407,0,O-74-99-01-01-02
LIRA,DOKOLO COUNTY,AGWATTA,ADOK,AMONOLOCO P 7 SCHOOL,483,4,26,6,264,24,324,15,339,0,O-74-99-01-01-03
LIRA,DOKOLO COUNTY,AGWATTA,ADOK,APYE P 7 SCHOOL,517,14,31,14,287,33,379,24,403,0,O-74-99-01-01-04
LIRA,DOKOLO COUNTY,AGWATTA,ADWOKI,ADWOKI P 7 SCHOOL I,374,4,17,4,207,24,256,14,270,0,O-74-99-01-02-01
LIRA,DOKOLO COUNTY,AGWATTA,ADWOKI,ADWOKI P 7 SCHOOL II,456,8,45,14,239,41,347,25,372,0,O-74-99-01-02-02
LIRA,DOKOLO COUNTY,AGWATTA,AGWICIRI,AWEROWOT P.7 SCHOOL,400,5,19,4,284,22,334,3,337,0,O-74-99-01-03-01
LIRA,DOKOLO COUNTY,AGWATTA,AGWICIRI,ALYEC JUK P.7 SCHOOL,712,17,42,29,350,82,520,0,520,0,O-74-99-01-03-02
LIRA,DOKOLO COUNTY,AGWATTA,AMUDA,TETUGU P.7 SCHOOL,584,15,49,12,318,32,426,17,443,0,O-74-99-01-04-01
LIRA,DOKOLO COUNTY,AGWATTA,AMUDA,AMUDA P.7 SCHOOL,560,11,16,4,216,44,291,118,409,0,O-74-99-01-04-02
LIRA,DOKOLO COUNTY,AGWATTA,AMUDA,AGWATTA P.7 SCHOOL,626,5,22,2,239,24,292,119,411,0,O-74-99-01-04-03
LIRA,DOKOLO COUNTY,AGWATTA,BARRDYANG,AMUNAMUN P.7 SCHOOL,725,30,97,28,326,25,506,22,528,0,O-74-99-01-05-01
LIRA,DOKOLO COUNTY,AGWATTA,BARRDYANG,BARDYANG P.7 SCHOOL,453,8,91,18,152,47,316,26,342,0,O-74-99-01-05-02
LIRA,DOKOLO COUNTY,AGWATTA,BARRDYANG,HASSA MEMORIAL P 7,649,14,73,29,305,62,483,25,508,0,O-74-99-01-05-03
LIRA,DOKOLO COUNTY,AGWATTA,KACUNG,KACHUNG P 7 SCHOOL A,491,5,18,7,189,65,284,100,384,0,O-74-99-01-06-01
LIRA,DOKOLO COUNTY,AGWATTA,KACUNG,KACUNG P 7 SCHOOL B,435,11,16,10,198,70,305,23,328,0,O-74-99-01-06-02
LIRA,DOKOLO COUNTY,AGWATTA,KACUNG,ACOTO P.7 SCHOOL,537,7,25,15,277,41,365,18,383,0,O-74-99-01-06-03
LIRA,DOKOLO COUNTY,BATTA,ABALANG,OKWALONGWEN P 7 SCHOOL,675,8,17,5,299,22,351,104,455,0,O-74-99-02-01-01
LIRA,DOKOLO COUNTY,BATTA,ABALANG,ABAKULI P 7 SCHOOL,417,10,18,15,226,8,277,13,290,0,O-74-99-02-01-02
LIRA,DOKOLO COUNTY,BATTA,ABYENEK,BARLELA MARKET,688,19,23,20,427,34,523,13,536,0,O-74-99-02-02-01
LIRA,DOKOLO COUNTY,BATTA,ABYENEK,BARLELA P 7 SCHOOL,480,11,18,4,233,22,288,78,366,0,O-74-99-02-02-02
LIRA,DOKOLO COUNTY,BATTA,ADEROLONGO,ADEROLONGO P 7 SCHOOL,509,10,23,13,242,46,334,17,351,0,O-74-99-02-03-01
LIRA,DOKOLO COUNTY,BATTA,ADEROLONGO,ORYENY CHAPEL,343,4,13,10,128,46,201,20,221,0,O-74-99-02-03-02
LIRA,DOKOLO COUNTY,BATTA,ADEROLONGO,AWIE ALEM P 7 SCHOOL,460,10,9,14,218,25,276,19,295,0,O-74-99-02-03-03
LIRA,DOKOLO COUNTY,BATTA,AKWANGA,OGURA,770,16,10,8,274,26,334,168,502,0,O-74-99-02-04-01
LIRA,DOKOLO COUNTY,BATTA,AKWANGA,ADAGNYEKO,529,11,10,19,282,21,343,14,357,0,O-74-99-02-04-02
LIRA,DOKOLO COUNTY,BATTA,ALAPATA,ALAPATA P 7 SCHOOL I A,586,18,30,7,205,34,294,125,419,0,O-74-99-02-05-01
LIRA,DOKOLO COUNTY,BATTA,ALAPATA,ALAPATA P 7 SCHOOL II B,479,13,15,3,171,43,245,130,375,0,O-74-99-02-05-02
LIRA,DOKOLO COUNTY,BATTA,ATABU,ATABU P 7 SCHOOL I,713,32,18,16,387,50,503,27,530,0,O-74-99-02-06-01
LIRA,DOKOLO COUNTY,BATTA,ATABU,BARDEGE MARKET,666,19,29,23,373,49,493,5,498,0,O-74-99-02-06-02
LIRA,DOKOLO COUNTY,BATTA,TE-YAO,BAR OPILA,314,12,17,10,145,14,198,18,216,0,O-74-99-02-07-01
LIRA,DOKOLO COUNTY,BATTA,TE-YAO,BATA DISPENSARY,595,22,32,19,274,38,385,32,417,0,O-74-99-02-07-02
LIRA,DOKOLO COUNTY,DOKOLO,ADAGMON,IGAR P 7 SCHOOL I,397,4,12,8,253,15,292,12,304,0,O-74-99-03-01-01
LIRA,DOKOLO COUNTY,DOKOLO,ADAGMON,ACENLWORO P.7 SCHOOL,508,16,19,10,235,67,347,0,347,0,O-74-99-03-01-02
LIRA,DOKOLO COUNTY,DOKOLO,ADAGMON,ANANGO-OGWEC CHAPEL,436,5,13,10,182,15,225,99,324,0,O-74-99-03-01-03
LIRA,DOKOLO COUNTY,DOKOLO,ALENGA,ALENGA P 7 SCHOOL,476,13,7,2,270,29,321,61,382,0,O-74-99-03-02-01
LIRA,DOKOLO COUNTY,DOKOLO,ALENGA,ALENGA CHAPEL,521,5,12,6,230,27,280,119,399,0,O-74-99-03-02-02
LIRA,DOKOLO COUNTY,DOKOLO,ALWITMAC,ALWITMAC,498,12,21,17,262,60,372,16,388,0,O-74-99-03-03-01
LIRA,DOKOLO COUNTY,DOKOLO,ALWITMAC,ABUR CHURCH,477,12,15,6,239,14,286,69,355,0,O-74-99-03-03-02
LIRA,DOKOLO COUNTY,DOKOLO,ALWITMAC,ST JOHN BOSCO S.S,426,10,9,9,165,108,301,8,309,0,O-74-99-03-03-03
LIRA,DOKOLO COUNTY,DOKOLO,AMWOMA,AMWOMA P 7 SCHOOL I,519,5,12,4,259,17,297,77,374,0,O-74-99-03-04-01
LIRA,DOKOLO COUNTY,DOKOLO,AMWOMA,AMWOMA P 7 SCHOOL II,264,8,3,3,133,20,167,47,214,0,O-74-99-03-04-02
LIRA,DOKOLO COUNTY,DOKOLO,AMWOMA,ABURCERO P.7 SCHOOL,322,6,3,0,191,10,210,42,252,0,O-74-99-03-04-03
LIRA,DOKOLO COUNTY,DOKOLO,ANGWECIBANGE,ANGWECIBANGE P 7 SCHOOL,575,8,10,11,301,50,380,9,389,0,O-74-99-03-05-01
LIRA,DOKOLO COUNTY,DOKOLO,ANGWECIBANGE,ALAO OKWANYO C.O.U,767,2,10,0,261,25,298,55,353,0,O-74-99-03-05-02
LIRA,DOKOLO COUNTY,DOKOLO,ANGWECIBANGE,DOKOLO P.7 SCHOOL,305,6,5,8,161,11,191,17,208,0,O-74-99-03-05-03
LIRA,DOKOLO COUNTY,DOKOLO,ATUR,ATUR P.7 SCHOOL,488,18,10,10,303,16,357,6,363,0,O-74-99-03-06-01
LIRA,DOKOLO COUNTY,DOKOLO,ATUR,ATUR CHURCH OF UGANDA,379,13,12,6,154,26,211,52,263,0,O-74-99-03-06-02
LIRA,DOKOLO COUNTY,DOKOLO,ATUR,ATUR TRADING CENTRE,621,10,12,2,318,69,411,52,463,0,O-74-99-03-06-03
LIRA,DOKOLO COUNTY,DOKOLO,AWIRI,ABENY P 7 SCHOOL,605,5,16,5,407,27,460,28,488,0,O-74-99-03-07-01
LIRA,DOKOLO COUNTY,DOKOLO,AWIRI,AWIRI P 7 SCHOOL,625,18,13,5,360,50,446,45,491,0,O-74-99-03-07-02
LIRA,DOKOLO COUNTY,DOKOLO,IGULI,AKOLODONG P.7 SCHOOL,639,17,27,17,361,22,444,20,464,0,O-74-99-03-08-01
LIRA,DOKOLO COUNTY,DOKOLO,IGULI,ADAK P.7 SCHOOL,602,9,21,13,227,29,299,122,421,0,O-74-99-03-08-02
LIRA,DOKOLO COUNTY,DOKOLO,IGULI,IGULI P 7 SCHOOL,502,2,21,2,229,35,289,57,346,0,O-74-99-03-08-03
LIRA,DOKOLO COUNTY,KANGAI,ADEKNINO,BATA EBWOL,475,5,5,3,237,31,281,73,354,0,O-74-99-04-01-01
LIRA,DOKOLO COUNTY,KANGAI,ADEKNINO,AJIBA CHAPEL,524,4,11,2,308,29,354,42,396,0,O-74-99-04-01-02
LIRA,DOKOLO COUNTY,KANGAI,ADEKNINO,ADEKNINO P 7 SCHOOL,502,8,12,3,302,26,351,52,403,0,O-74-99-04-01-03
LIRA,DOKOLO COUNTY,KANGAI,ADEKNINO,ONGEI TRADING CENTRE,434,3,38,6,264,10,321,51,372,0,O-74-99-04-01-04
LIRA,DOKOLO COUNTY,KANGAI,ADWILA,AMATIBURU,725,10,37,6,304,45,402,120,522,0,O-74-99-04-02-01
LIRA,DOKOLO COUNTY,KANGAI,ADWILA,ACANCILLING,409,5,21,9,262,29,326,8,334,0,O-74-99-04-02-02
LIRA,DOKOLO COUNTY,KANGAI,AKUROLANGO,KANGAI SUB-COUNTY I,647,13,11,6,404,18,452,58,510,0,O-74-99-04-03-01
LIRA,DOKOLO COUNTY,KANGAI,AKUROLANGO,KANGAI SUB-COUNTY II,644,3,23,4,321,22,373,61,434,0,O-74-99-04-03-02
LIRA,DOKOLO COUNTY,KANGAI,AKUROLANGO,KANGAI SUB-COUNTY III,464,2,5,3,291,16,317,44,361,0,O-74-99-04-03-03
LIRA,DOKOLO COUNTY,KANGAI,ANGWENYA,KANGAI S.S,711,16,19,8,327,58,428,11,439,0,O-74-99-04-04-01
LIRA,DOKOLO COUNTY,KANGAI,ANGWENYA,OYIROGOLE P 7 SCHOOL,484,6,15,0,248,40,309,84,393,0,O-74-99-04-04-02
LIRA,DOKOLO COUNTY,KANGAI,ANGWENYA,ALIWOK P 7 SCHOOL,467,11,22,7,289,27,356,5,361,0,O-74-99-04-04-03
LIRA,DOKOLO COUNTY,KANGAI,AWELO,AWELLO TRADING CENTRE,707,8,11,6,445,50,520,47,567,0,O-74-99-04-05-01
LIRA,DOKOLO COUNTY,KANGAI,AWELO,ADOGMONMINGO T.C,550,7,3,4,359,9,382,47,429,0,O-74-99-04-05-02
LIRA,DOKOLO COUNTY,KANGAI,AWELO,ELWANGE C.O.U,612,5,9,5,436,37,492,20,512,0,O-74-99-04-05-03
LIRA,DOKOLO COUNTY,KWERA,AGENI,AGENI P.7 SCHOOL,639,7,14,15,343,134,513,0,513,0,O-74-99-05-01-01
LIRA,DOKOLO COUNTY,KWERA,AGENI,OTORO,486,5,13,14,267,95,394,2,396,0,O-74-99-05-01-02
LIRA,DOKOLO COUNTY,KWERA,ANERALIBI,AJAA,710,9,33,4,441,59,546,29,575,0,O-74-99-05-02-01
LIRA,DOKOLO COUNTY,KWERA,ANERALIBI,OKWONGODUL,607,8,10,5,340,41,404,53,457,0,O-74-99-05-02-02
LIRA,DOKOLO COUNTY,KWERA,ANERALIBI,ANERALIBI,516,13,31,7,204,85,340,59,399,0,O-74-99-05-02-03
LIRA,DOKOLO COUNTY,KWERA,ANWANGI,ANWANGI P 7 SCHOOL I,697,18,20,22,278,115,453,23,476,0,O-74-99-05-03-01
LIRA,DOKOLO COUNTY,KWERA,ANWANGI,ANWANGI P 7 SCHOOL II,621,12,16,5,369,63,465,12,477,0,O-74-99-05-03-02
LIRA,DOKOLO COUNTY,KWERA,APENYANG,KWERA P 7 SCHOOL,643,14,29,18,330,70,461,25,486,0,O-74-99-05-04-01
LIRA,DOKOLO COUNTY,KWERA,APENYANG,AOYENNYANG P.7 SCHOOL,592,16,25,5,244,116,406,88,494,0,O-74-99-05-04-02
LIRA,DOKOLO COUNTY,KWERA,APENYANG,ADWILA,571,11,23,6,293,47,380,87,467,0,O-74-99-05-04-03
LIRA,DOKOLO COUNTY,KWERA,APENYOWEO,APENYOWEO,830,19,45,15,468,73,620,0,620,0,O-74-99-05-05-01
LIRA,DOKOLO COUNTY,KWERA,APENYOWEO,ANYACOTO,479,7,28,5,274,50,364,46,410,0,O-74-99-05-05-02
APAC,OYAM COUNTY NORTH,ACHABA,ABANYA,BAROBIA,399,9,6,9,255,19,298,5,303,0,O-76-4-01-01-01
APAC,OYAM COUNTY NORTH,ACHABA,ABANYA,MOMOTATWERO,544,6,14,3,298,65,386,8,394,0,O-76-4-01-01-02
APAC,OYAM COUNTY NORTH,ACHABA,ABANYA,AKWAC,710,10,19,8,403,60,500,18,518,0,O-76-4-01-01-03
APAC,OYAM COUNTY NORTH,ACHABA,ANYEKE,OYAM HQS,452,5,7,13,247,51,323,14,337,0,O-76-4-01-02-01
APAC,OYAM COUNTY NORTH,ACHABA,ANYEKE,ADYANG,238,4,5,5,139,33,186,8,194,0,O-76-4-01-02-02
APAC,OYAM COUNTY NORTH,ACHABA,ANYEKE,ATONGLELA,341,6,6,12,231,27,282,6,288,0,O-76-4-01-02-03
APAC,OYAM COUNTY NORTH,ACHABA,ANYEKE,ACET,701,6,20,16,410,85,537,8,545,0,O-76-4-01-02-04
APAC,OYAM COUNTY NORTH,ACHABA,ANYEKE,LELAOLOK,209,8,9,6,123,21,167,8,175,0,O-76-4-01-02-05
APAC,OYAM COUNTY NORTH,ACHABA,ATEKOBER,ACABA P7 SCHOOL,717,8,34,10,484,34,570,8,578,0,O-76-4-01-03-01
APAC,OYAM COUNTY NORTH,ACHABA,ATEKOBER,AKURILUBA,231,1,6,1,153,22,183,7,190,0,O-76-4-01-03-02
APAC,OYAM COUNTY NORTH,ACHABA,ATEKOBER,PUKICA TRADING CENTRE,660,16,20,11,374,63,484,0,484,0,O-76-4-01-03-03
APAC,OYAM COUNTY NORTH,ACHABA,ATEKOBER,TE GACIA TRADING CENTRE,458,9,16,9,277,67,378,10,388,0,O-76-4-01-03-04
APAC,OYAM COUNTY NORTH,ACHABA,DOGAPIO,ATIPE,533,6,20,11,343,36,416,13,429,0,O-76-4-01-04-01
APAC,OYAM COUNTY NORTH,ACHABA,DOGAPIO,DOGAPIO I,507,6,13,6,329,45,399,1,400,0,O-76-4-01-04-02
APAC,OYAM COUNTY NORTH,ACHABA,DOGAPIO,DOGAPIO II,559,12,11,14,324,78,439,11,450,0,O-76-4-01-04-03
APAC,OYAM COUNTY NORTH,ACHABA,DOGAPIO,OGWANGAPUR,511,12,29,10,289,38,378,5,383,0,O-76-4-01-04-04
APAC,OYAM COUNTY NORTH,ACHABA,OBANGANGEO,DEKARAWAI,306,10,5,9,126,82,232,10,242,0,O-76-4-01-05-01
APAC,OYAM COUNTY NORTH,ACHABA,OBANGANGEO,AWELOBUTORYO,384,7,16,8,209,56,296,7,303,0,O-76-4-01-05-02
APAC,OYAM COUNTY NORTH,ACHABA,OBANGANGEO,ALAO,242,8,5,15,150,18,196,7,203,0,O-76-4-01-05-03
APAC,OYAM COUNTY NORTH,ACHABA,OBANGANGEO,OBANGANGEO,504,12,31,8,248,88,387,13,400,0,O-76-4-01-05-04
APAC,OYAM COUNTY NORTH,ACHABA,OBANGANGEO,MALABA,350,8,7,5,173,95,288,3,291,0,O-76-4-01-05-05
APAC,OYAM COUNTY NORTH,ICHEME,ALONI,ALONI P 7 SCHOOL,722,15,20,9,291,115,450,21,471,0,O-76-4-02-01-01
APAC,OYAM COUNTY NORTH,ICHEME,ALONI,ANGOM P.7 SCHOOL,448,6,15,9,178,102,310,8,318,0,O-76-4-02-01-02
APAC,OYAM COUNTY NORTH,ICHEME,ALONI,TECWAO,665,10,24,14,280,119,447,19,466,0,O-76-4-02-01-03
APAC,OYAM COUNTY NORTH,ICHEME,ALONI,ALWERWANG PAG CHURCH,312,12,7,6,152,36,213,17,230,0,O-76-4-02-01-04
APAC,OYAM COUNTY NORTH,ICHEME,AUNGU,AUNGU P7 SCHOOL SOCIETY,337,9,10,7,176,40,242,12,254,0,O-76-4-02-02-01
APAC,OYAM COUNTY NORTH,ICHEME,AUNGU,ICEME SUBCOUNTY,1011,31,33,16,422,100,602,0,602,0,O-76-4-02-02-02
APAC,OYAM COUNTY NORTH,ICHEME,AUNGU,ARINGODYANG P 7   SCHOOL,490,6,12,10,304,23,355,4,359,0,O-76-4-02-02-03
APAC,OYAM COUNTY NORTH,ICHEME,AUNGU,DELE P 7 SCHOOL,539,7,21,9,31,50,118,17,135,0,O-76-4-02-02-04
APAC,OYAM COUNTY NORTH,ICHEME,AUNGU,ADILI P 7   SCHOOL,589,11,12,9,335,31,398,17,415,0,O-76-4-02-02-05
APAC,OYAM COUNTY NORTH,ICHEME,AUNGU,ARINGOLWORO,449,7,14,14,218,46,299,10,309,0,O-76-4-02-02-06
APAC,OYAM COUNTY NORTH,ICHEME,AWIO,BARLONYO SOCIETY,631,9,8,13,394,61,485,7,492,0,O-76-4-02-03-01
APAC,OYAM COUNTY NORTH,ICHEME,AWIO,AKUNYI MARKET,470,9,10,10,267,42,338,8,346,0,O-76-4-02-03-02
APAC,OYAM COUNTY NORTH,ICHEME,AWIO,AWIO P.7 SCHOOL,602,9,30,6,320,61,426,11,437,0,O-76-4-02-03-03
APAC,OYAM COUNTY NORTH,ICHEME,AWIO,BAR-JOBI -JAI,470,5,32,3,245,31,316,11,327,0,O-76-4-02-03-04
APAC,OYAM COUNTY NORTH,ICHEME,OMOLO,ICHEME GIRLS,707,13,20,6,371,49,459,21,480,0,O-76-4-02-04-01
APAC,OYAM COUNTY NORTH,ICHEME,OMOLO,TE APENA P.7 SCHOOL,625,17,22,16,307,31,393,30,423,0,O-76-4-02-04-02
APAC,OYAM COUNTY NORTH,ICHEME,OMOLO,APANYALONGO,249,5,13,5,99,24,146,0,146,0,O-76-4-02-04-03
APAC,OYAM COUNTY NORTH,ICHEME,ORUPO,ODOK MARKET,616,18,11,14,336,53,432,16,448,0,O-76-4-02-05-01
APAC,OYAM COUNTY NORTH,ICHEME,ORUPO,AGOBA  P 7 SCHOOL,774,24,19,18,434,70,565,13,578,0,O-76-4-02-05-02
APAC,OYAM COUNTY NORTH,ICHEME,ORUPO,AKWANGI P 7   SCHOOL,708,34,23,17,335,126,535,23,558,0,O-76-4-02-05-03
APAC,OYAM COUNTY NORTH,ICHEME,ORUPO,ANGWETA P.7 SCHOOL,535,13,8,13,257,42,333,41,374,0,O-76-4-02-05-04
APAC,OYAM COUNTY NORTH,ICHEME,ORUPO,WII-DAM AKUNGATAR,558,15,5,10,340,62,432,2,434,0,O-76-4-02-05-05
APAC,OYAM COUNTY NORTH,NGAI,ACUT,AKUK,576,14,10,8,236,49,317,10,327,0,O-76-4-03-01-01
APAC,OYAM COUNTY NORTH,NGAI,ACUT,ITUBARA P.7 SCHOOL,587,15,5,6,280,81,387,0,387,0,O-76-4-03-01-02
APAC,OYAM COUNTY NORTH,NGAI,ACUT,ARIEK P.7 SCHOOL,837,14,26,7,349,86,482,7,489,0,O-76-4-03-01-03
APAC,OYAM COUNTY NORTH,NGAI,AJERIJERI,BAR RIO P.7 SCHOOL,750,17,37,5,341,72,472,44,516,0,O-76-4-03-02-01
APAC,OYAM COUNTY NORTH,NGAI,AJERIJERI,AKWON,524,6,20,8,216,39,289,64,353,0,O-76-4-03-02-02
APAC,OYAM COUNTY NORTH,NGAI,AJERIJERI,OTOTONG P.7 SCHOOL,472,3,16,4,240,30,293,50,343,0,O-76-4-03-02-03
APAC,OYAM COUNTY NORTH,NGAI,AJERIJERI,ADYENY TRADING CENTER,459,13,21,6,244,63,347,26,373,0,O-76-4-03-02-04
APAC,OYAM COUNTY NORTH,NGAI,AKUCA,NGAI S.S,559,4,12,3,192,58,269,29,298,0,O-76-4-03-03-01
APAC,OYAM COUNTY NORTH,NGAI,AKUCA,SUBCOUNTY HQRS,863,11,18,5,258,310,602,6,608,0,O-76-4-03-03-02
APAC,OYAM COUNTY NORTH,NGAI,AKUCA,AKUCA P.7 SCHOOL,825,18,8,13,295,200,534,0,534,0,O-76-4-03-03-03
APAC,OYAM COUNTY NORTH,NGAI,AKUCA,AJAKA MARKET,446,4,7,1,130,42,184,47,231,0,O-76-4-03-03-04
APAC,OYAM COUNTY NORTH,NGAI,AKUCA,APAPIMOM,350,2,12,0,123,56,193,40,233,0,O-76-4-03-03-05
APAC,OYAM COUNTY NORTH,NGAI,ARAMITA,ONEKGWOK P.7 SCHOOL,533,4,7,5,296,34,346,35,381,0,O-76-4-03-04-01
APAC,OYAM COUNTY NORTH,NGAI,ARAMITA,ARAMITA P.7 SCHOOL,551,4,13,6,210,68,301,48,349,0,O-76-4-03-04-02
APAC,OYAM COUNTY NORTH,NGAI,ARAMITA,ONEKEGWOK TRADING CENTER,396,3,3,0,183,25,214,45,259,0,O-76-4-03-04-03
APAC,OYAM COUNTY NORTH,NGAI,ARAMITA,ABERE TRADING CENTRE,575,7,8,5,300,52,372,22,394,0,O-76-4-03-04-04
APAC,OYAM COUNTY NORTH,NGAI,BAR,ABOK TRADING CENTRE,827,6,12,5,336,124,483,73,556,0,O-76-4-03-05-01
APAC,OYAM COUNTY NORTH,NGAI,BAR,ABOK P.7 SCHOOL,664,4,14,0,321,58,397,45,442,0,O-76-4-03-05-02
APAC,OYAM COUNTY NORTH,NGAI,BAR,ARIBA P.7 SCHOOL,689,8,40,3,271,89,411,56,467,0,O-76-4-03-05-03
APAC,OYAM COUNTY NORTH,NGAI,OMACH,ABAKIRAO TRADING CENTRE,446,5,11,2,212,39,269,30,299,0,O-76-4-03-06-01
APAC,OYAM COUNTY NORTH,NGAI,OMACH,KULAKULA P 7   SCHOOL,717,6,28,9,397,47,487,16,503,0,O-76-4-03-06-02
APAC,OYAM COUNTY NORTH,NGAI,OMACH,OKURE P 7 SCHOOL,503,2,8,9,291,36,346,14,360,0,O-76-4-03-06-03
APAC,OYAM COUNTY NORTH,NGAI,OMACH,OMACH P.7 SCHOOL,677,6,8,9,351,48,422,9,431,0,O-76-4-03-06-04
APAC,OYAM COUNTY NORTH,OTWAL,ABELA,ABELA P.7 SCHOOL,648,14,7,7,397,46,471,12,483,0,O-76-4-04-01-01
APAC,OYAM COUNTY NORTH,OTWAL,ABELA,ALEKA P.7 SCHOOL,771,20,24,12,413,76,545,17,562,0,O-76-4-04-01-02
APAC,OYAM COUNTY NORTH,OTWAL,ABELA,ANWGET P.7 SCHOOL,746,16,8,11,353,16,404,2,406,0,O-76-4-04-01-03
APAC,OYAM COUNTY NORTH,OTWAL,ACOKARA,NYERIKEDE,623,4,15,2,334,23,378,11,389,0,O-76-4-04-02-01
APAC,OYAM COUNTY NORTH,OTWAL,ACOKARA,AWEILUT,571,9,13,11,283,40,356,11,367,0,O-76-4-04-02-02
APAC,OYAM COUNTY NORTH,OTWAL,ACOKARA,ACOKARA P 7 SCHOOL,840,14,17,13,409,47,500,17,517,0,O-76-4-04-02-03
APAC,OYAM COUNTY NORTH,OTWAL,AJUL,AGWAR,479,4,15,5,342,15,381,15,396,0,O-76-4-04-03-01
APAC,OYAM COUNTY NORTH,OTWAL,AJUL,RAILWAY STATION,675,11,33,7,342,51,444,27,471,0,O-76-4-04-03-02
APAC,OYAM COUNTY NORTH,OTWAL,AJUL,ABOLO NENO,684,7,10,10,424,33,484,12,496,0,O-76-4-04-03-03
APAC,OYAM COUNTY NORTH,OTWAL,AJUL,BAROMO P.7 SCHOOL,684,8,29,26,409,33,505,18,523,0,O-76-4-04-03-04
APAC,OYAM COUNTY NORTH,OTWAL,AJUL,ACUKE MARKET,391,4,14,12,226,26,282,6,288,0,O-76-4-04-03-05
APAC,OYAM COUNTY NORTH,OTWAL,ALIBI,ALIBI PRIMARY SCHOOL,664,10,21,12,387,21,451,5,456,0,O-76-4-04-04-01
APAC,OYAM COUNTY NORTH,OTWAL,ALIBI,BARTOKE,194,0,4,3,139,4,150,4,154,0,O-76-4-04-04-02
APAC,OYAM COUNTY NORTH,OTWAL,ALIBI,OGARO PRIMARY SCHOL,545,7,19,16,321,15,378,30,408,0,O-76-4-04-04-03
APAC,OYAM COUNTY NORTH,OTWAL,ALIBI,LELA-APALA P.7 SCHOOL,589,9,11,13,354,39,426,15,441,0,O-76-4-04-04-04
APAC,OYAM COUNTY NORTH,OTWAL,AMUKOGUNG,BEIWE TRADING CENTRE,618,8,9,15,350,38,420,11,431,0,O-76-4-04-05-01
APAC,OYAM COUNTY NORTH,OTWAL,AMUKOGUNG,ADER P.7 SCHOOL,642,6,18,6,398,25,453,19,472,0,O-76-4-04-05-02
APAC,OYAM COUNTY NORTH,OTWAL,AMUKOGUNG,BAR OMELE P.7 SCHOOL,567,4,13,12,303,14,346,10,356,0,O-76-4-04-05-03
APAC,OYAM COUNTY NORTH,OTWAL,OKII,OTWAL P 7   SCHOOL,600,2,22,8,295,41,368,7,375,0,O-76-4-04-06-01
APAC,OYAM COUNTY NORTH,OTWAL,OKII,OGWANG OKEWW,720,10,27,13,493,31,574,12,586,0,O-76-4-04-06-02
APAC,OYAM COUNTY NORTH,OTWAL,OKII,TE-OLAM,686,18,14,23,359,50,464,23,487,0,O-76-4-04-06-03
APAC,OYAM COUNTY NORTH,OTWAL,OKII,BAR LWALA SUB-GRADE SCHOOL,541,4,16,8,381,10,419,3,422,0,O-76-4-04-06-04
APAC,OYAM COUNTY NORTH,OTWAL,OKII,ANYOMO LYEC P.7 SCHOOL,578,8,11,7,330,28,384,6,390,0,O-76-4-04-06-05
APAC,OYAM COUNTY SOUTH,ABER,ADYEGI,APALA P 7   SCHOOL,473,12,28,16,217,63,336,28,364,0,O-76-5-01-01-01
APAC,OYAM COUNTY SOUTH,ABER,ADYEGI,ADYEGI P 7   SCHOOL,494,7,22,8,161,121,319,37,356,0,O-76-5-01-01-02
APAC,OYAM COUNTY SOUTH,ABER,ADYEGI,ADYEGI HEALTH CENTER,339,4,9,7,127,107,254,14,268,0,O-76-5-01-01-03
APAC,OYAM COUNTY SOUTH,ABER,AKAKA,ALYEC,591,17,18,7,248,108,398,11,409,0,O-76-5-01-02-01
APAC,OYAM COUNTY SOUTH,ABER,AKAKA,AWELOMAKWERI,553,13,17,5,233,104,372,17,389,0,O-76-5-01-02-02
APAC,OYAM COUNTY SOUTH,ABER,AKAKA,OBAPO,758,14,27,20,331,110,502,34,536,0,O-76-5-01-02-03
APAC,OYAM COUNTY SOUTH,ABER,AKAKA,OKAROWOK,612,7,23,6,267,92,395,22,417,0,O-76-5-01-02-04
APAC,OYAM COUNTY SOUTH,ABER,ATURA,OCAMPAR,773,13,19,4,396,98,530,34,564,0,O-76-5-01-03-01
APAC,OYAM COUNTY SOUTH,ABER,ATURA,ODYEBO,613,10,10,7,281,101,409,21,430,0,O-76-5-01-03-02
APAC,OYAM COUNTY SOUTH,ABER,ATURA,STATION,718,7,14,5,272,228,526,13,539,0,O-76-5-01-03-03
APAC,OYAM COUNTY SOUTH,ABER,KAMDINI,ABANYA/OGEKBUGA,546,4,14,6,266,78,368,8,376,0,O-76-5-01-04-01
APAC,OYAM COUNTY SOUTH,ABER,KAMDINI,TETOCI/TENAN,709,8,11,9,403,64,495,9,504,0,O-76-5-01-04-02
APAC,OYAM COUNTY SOUTH,ABER,KAMDINI,BOMBAY MARKET,375,10,4,9,219,19,261,10,271,0,O-76-5-01-04-03
APAC,OYAM COUNTY SOUTH,ABER,KAMDINI,ONEA 'B'/APALA 'A'/TIT,659,8,9,8,361,8,394,24,418,0,O-76-5-01-04-04
APAC,OYAM COUNTY SOUTH,ABER,KAMDINI,KAMDINI TOWNSHIP A,900,15,17,5,404,91,532,6,538,0,O-76-5-01-04-05
APAC,OYAM COUNTY SOUTH,ABER,KAMDINI,DICUNYI/AMATI A,459,7,20,5,238,15,285,29,314,0,O-76-5-01-04-06
APAC,OYAM COUNTY SOUTH,ABER,KAMDINI,NORA,524,4,6,2,263,13,288,0,288,0,O-76-5-01-04-07
APAC,OYAM COUNTY SOUTH,ABER,KAMDINI,DICUNYI/AMATI B,394,2,15,2,245,17,281,15,296,0,O-76-5-01-04-08
APAC,OYAM COUNTY SOUTH,ABER,OCINI,ATAPARA P 7   SCHOOL,674,8,12,1,326,87,434,15,449,0,O-76-5-01-05-01
APAC,OYAM COUNTY SOUTH,ABER,OCINI,ACUTAWENA/AMWABUNG/WOBAL,390,8,7,9,240,34,298,15,313,0,O-76-5-01-05-02
APAC,OYAM COUNTY SOUTH,ABER,OCINI,ATAPARA S.S.S,553,15,9,8,283,69,384,14,398,0,O-76-5-01-05-03
APAC,OYAM COUNTY SOUTH,ABER,OCINI,WANG DWE,767,9,29,6,437,30,511,15,526,0,O-76-5-01-05-04
APAC,OYAM COUNTY SOUTH,ABER,PUKICA,KAMDINI P 7 SCHOOL,445,3,7,8,185,34,237,24,261,0,O-76-5-01-06-01
APAC,OYAM COUNTY SOUTH,ABER,PUKICA,ALENY P 7 SCHOOL,503,10,2,5,288,43,348,16,364,0,O-76-5-01-06-02
APAC,OYAM COUNTY SOUTH,ABER,PUKICA,ANIKOLONG,613,5,5,6,363,47,426,17,443,0,O-76-5-01-06-03
APAC,OYAM COUNTY SOUTH,ABER,PUKICA,ZAMBIA MARKET,507,5,4,4,251,15,279,8,287,0,O-76-5-01-06-04
APAC,OYAM COUNTY SOUTH,ABER,PUKICA,ZAMBIA  P 7 SCHOOL,561,6,7,11,293,42,359,4,363,0,O-76-5-01-06-05
APAC,OYAM COUNTY SOUTH,ABER,PUKICA,OPTOYERE,618,4,6,6,352,20,388,14,402,0,O-76-5-01-06-06
APAC,OYAM COUNTY SOUTH,ABER,WIRAO,AYOMAPWONO P. 7 SCHOOL,536,15,19,14,223,56,327,12,339,0,O-76-5-01-07-01
APAC,OYAM COUNTY SOUTH,ABER,WIRAO,WIRAO,494,8,12,8,239,35,302,12,314,0,O-76-5-01-07-02
APAC,OYAM COUNTY SOUTH,ABER,WIRAO,BARLONYO MARKET,717,11,16,9,409,71,516,16,532,0,O-76-5-01-07-03
APAC,OYAM COUNTY SOUTH,ABER,WIRAO,BARCAL,474,4,19,8,232,38,301,0,301,0,O-76-5-01-07-04
APAC,OYAM COUNTY SOUTH,ABER,WIRAO,OYOE,301,5,22,4,141,20,192,11,203,0,O-76-5-01-07-05
APAC,OYAM COUNTY SOUTH,LORO,ACINPII,IYANYI,704,14,17,22,346,65,464,22,486,0,O-76-5-02-01-01
APAC,OYAM COUNTY SOUTH,LORO,ACINPII,ACAN PII P.7 SCHOOL,818,26,15,31,411,73,556,50,606,0,O-76-5-02-01-02
APAC,OYAM COUNTY SOUTH,LORO,ACINPII,BARLYEC CENTER,145,4,11,2,72,18,107,1,108,0,O-76-5-02-01-03
APAC,OYAM COUNTY SOUTH,LORO,ADIGO,KOKCAN IKWERI,644,6,13,15,288,128,450,18,468,0,O-76-5-02-02-01
APAC,OYAM COUNTY SOUTH,LORO,ADIGO,APEDI II,591,3,11,7,289,77,387,28,415,0,O-76-5-02-02-02
APAC,OYAM COUNTY SOUTH,LORO,ADIGO,IWARI,521,8,29,10,150,88,285,20,305,0,O-76-5-02-02-03
APAC,OYAM COUNTY SOUTH,LORO,ADIGO,ICEKELEYE,563,8,5,9,150,101,273,7,280,0,O-76-5-02-02-04
APAC,OYAM COUNTY SOUTH,LORO,ADYEDA,LORO P 7   SCHOOL,685,6,13,6,210,76,311,11,322,0,O-76-5-02-03-01
APAC,OYAM COUNTY SOUTH,LORO,ADYEDA,GOMBOLA HQTRS,729,8,10,6,340,78,442,24,466,0,O-76-5-02-03-02
APAC,OYAM COUNTY SOUTH,LORO,ADYEDA,ACANKOME,511,9,7,5,312,41,374,10,384,0,O-76-5-02-03-03
APAC,OYAM COUNTY SOUTH,LORO,ADYEDA,OGUGU  P.7,377,7,26,5,172,29,239,20,259,0,O-76-5-02-03-04
APAC,OYAM COUNTY SOUTH,LORO,ADYEDA,AGWOKNENO ACWARI,716,6,15,10,330,81,442,29,471,0,O-76-5-02-03-05
APAC,OYAM COUNTY SOUTH,LORO,ADYEDA,ADYEDA OUTSIDE Q.GUARD,168,0,0,0,5,23,28,0,28,0,O-76-5-02-03-06
APAC,OYAM COUNTY SOUTH,LORO,AGULURUDE,AGULURUDE P.7 SCHOOL,678,19,26,23,368,60,496,29,525,0,O-76-5-02-04-01
APAC,OYAM COUNTY SOUTH,LORO,AGULURUDE,GWOKWIKEO CENTER,128,2,3,3,73,22,103,7,110,0,O-76-5-02-04-02
APAC,OYAM COUNTY SOUTH,LORO,AGULURUDE,ANAMOCAMOBAGO,707,18,20,21,120,70,249,28,277,0,O-76-5-02-04-03
APAC,OYAM COUNTY SOUTH,LORO,ALIDI,ALIDI P.7 SCHOOL,426,9,9,9,224,42,293,15,308,0,O-76-5-02-05-01
APAC,OYAM COUNTY SOUTH,LORO,ALIDI,AMIDO P.7 SCHOOL,553,20,17,20,224,98,379,15,394,0,O-76-5-02-05-02
APAC,OYAM COUNTY SOUTH,LORO,ALIDI,WIDAM,609,6,12,7,302,66,393,19,412,0,O-76-5-02-05-03
APAC,OYAM COUNTY SOUTH,LORO,ALUTKOT,ODIKE AWE IKWO,558,8,18,9,262,51,348,16,364,0,O-76-5-02-06-01
APAC,OYAM COUNTY SOUTH,LORO,ALUTKOT,AGENGO,706,9,9,9,365,68,460,30,490,0,O-76-5-02-06-02
APAC,OYAM COUNTY SOUTH,LORO,ALUTKOT,ABONGODERO,747,10,17,12,417,85,541,25,566,0,O-76-5-02-06-03
APAC,OYAM COUNTY SOUTH,LORO,ALUTKOT,AWEIKWO,741,7,26,10,297,90,430,44,474,0,O-76-5-02-06-04
APAC,OYAM COUNTY SOUTH,MINAKULU,ACENO,ADEL HQTRS,537,5,4,5,225,79,318,9,327,0,O-76-5-03-01-01
APAC,OYAM COUNTY SOUTH,MINAKULU,ACENO,TANGI ODIRO,610,13,6,3,340,45,407,15,422,0,O-76-5-03-01-02
APAC,OYAM COUNTY SOUTH,MINAKULU,ACENO,AWE BETTY,643,7,5,5,398,44,459,13,472,0,O-76-5-03-01-03
APAC,OYAM COUNTY SOUTH,MINAKULU,ACENO,MINAKULU TECHINICAL INSTITUT,870,21,30,7,459,69,586,15,601,0,O-76-5-03-01-04
APAC,OYAM COUNTY SOUTH,MINAKULU,ACENO,OWINYKUU,166,4,13,2,67,16,102,4,106,0,O-76-5-03-01-05
APAC,OYAM COUNTY SOUTH,MINAKULU,ADEL,OBAPO OCTION,632,2,12,4,265,123,406,6,412,0,O-76-5-03-02-01
APAC,OYAM COUNTY SOUTH,MINAKULU,ADEL,AMWA TEDUKA TUNGA OBOTE,471,7,10,14,260,47,338,15,353,0,O-76-5-03-02-02
APAC,OYAM COUNTY SOUTH,MINAKULU,ADEL,OKULE P 7 SCHOOL,394,4,5,4,226,45,284,22,306,0,O-76-5-03-02-03
APAC,OYAM COUNTY SOUTH,MINAKULU,ADEL,TE-OKULLO TUGOLOK,275,3,3,3,185,28,222,8,230,0,O-76-5-03-02-04
APAC,OYAM COUNTY SOUTH,MINAKULU,ADEL,MWAKULU OUTSIDE GUARD,137,0,0,0,5,2,7,0,7,0,O-76-5-03-02-05
APAC,OYAM COUNTY SOUTH,MINAKULU,AMWA,ZAMBIA,785,7,7,7,449,30,500,22,522,0,O-76-5-03-03-01
APAC,OYAM COUNTY SOUTH,MINAKULU,AMWA,AMWA T.T.C,655,7,9,5,357,66,444,16,460,0,O-76-5-03-03-02
APAC,OYAM COUNTY SOUTH,MINAKULU,AMWA,OGALI P 7 SCHOOL,451,6,5,7,243,46,307,11,318,0,O-76-5-03-03-03
APAC,OYAM COUNTY SOUTH,MINAKULU,AMWA,TE-ANANGA,421,12,5,14,217,61,309,17,326,0,O-76-5-03-03-04
APAC,OYAM COUNTY SOUTH,MINAKULU,AMWA,AMWA HQTRS,429,5,4,7,266,28,310,23,333,0,O-76-5-03-03-05
APAC,OYAM COUNTY SOUTH,MINAKULU,AMWA,AMWA COMPREHENSIVE,223,6,4,3,134,27,174,9,183,0,O-76-5-03-03-06
APAC,OYAM COUNTY SOUTH,MINAKULU,ATEK,ARAK EAST/WEST,753,8,10,2,538,38,596,17,613,0,O-76-5-03-04-01
APAC,OYAM COUNTY SOUTH,MINAKULU,ATEK,LANGO BOBI,487,8,5,4,308,53,378,20,398,0,O-76-5-03-04-02
APAC,OYAM COUNTY SOUTH,MINAKULU,ATEK,OPATI A&B,578,10,6,14,325,76,431,28,459,0,O-76-5-03-04-03
APAC,OYAM COUNTY SOUTH,MINAKULU,ATEK,LONCANOMIA MING/MOSHI,284,4,7,3,149,29,192,16,208,0,O-76-5-03-04-04
APAC,OYAM COUNTY SOUTH,MINAKULU,ATEK,BARAKWIJI TANGI,304,6,4,6,204,32,252,15,267,0,O-76-5-03-04-05
APAC,OYAM COUNTY SOUTH,MINAKULU,KULUABURA,OLWIO,615,5,10,7,338,49,409,5,414,0,O-76-5-03-05-01
APAC,OYAM COUNTY SOUTH,MINAKULU,KULUABURA,WIRAO AJAGA,334,6,6,4,157,30,203,10,213,0,O-76-5-03-05-02
APAC,OYAM COUNTY SOUTH,MINAKULU,KULUABURA,AJAGA,463,5,5,7,269,28,314,5,319,0,O-76-5-03-05-03
APAC,OYAM COUNTY SOUTH,MINAKULU,KULUABURA,AJAGA OUTSIDE Q.GUARD,334,2,1,3,40,25,71,2,73,0,O-76-5-03-05-04
APAC,OYAM COUNTY SOUTH,MINAKULU,OYORO,ABULO P 7 SCHOOL (ABULULYE,674,6,5,9,374,78,472,15,487,0,O-76-5-03-06-01
APAC,OYAM COUNTY SOUTH,MINAKULU,OYORO,BARDYEL MARKET,490,11,11,11,297,60,390,9,399,0,O-76-5-03-06-02
APAC,OYAM COUNTY SOUTH,MINAKULU,OYORO,TELELA MARKET,518,5,4,4,305,38,356,9,365,0,O-76-5-03-06-03
APAC,OYAM COUNTY SOUTH,MINAKULU,OYORO,OPUK,313,10,5,9,178,25,227,12,239,0,O-76-5-03-06-04
APAC,OYAM COUNTY SOUTH,MINAKULU,OYORO,ACIMI P.7 SCHOOL,657,11,10,13,385,60,479,8,487,0,O-76-5-03-06-05
ARUA,MARACHA COUNTY,KIJOMORO,ALIVU,ALIVU A,609,11,5,16,281,109,422,19,441,0,O-77-10-01-01-01
ARUA,MARACHA COUNTY,KIJOMORO,ALIVU,ALIVU B,878,23,7,18,325,144,517,53,570,0,O-77-10-01-01-02
ARUA,MARACHA COUNTY,KIJOMORO,AMBIDRO,KAKWA,535,20,4,15,245,131,415,38,453,0,O-77-10-01-02-01
ARUA,MARACHA COUNTY,KIJOMORO,AMBIDRO,OMBAVU,729,16,9,19,322,155,521,10,531,0,O-77-10-01-02-02
ARUA,MARACHA COUNTY,KIJOMORO,AMBIDRO,KAKWA/OMBAVU,445,16,4,8,226,95,349,16,365,0,O-77-10-01-02-03
ARUA,MARACHA COUNTY,KIJOMORO,DRAHZIPI,DRANZIPI A,945,9,5,17,208,276,515,25,540,0,O-77-10-01-03-01
ARUA,MARACHA COUNTY,KIJOMORO,DRAHZIPI,DRANZIPI B,803,15,6,4,190,249,464,51,515,0,O-77-10-01-03-02
ARUA,MARACHA COUNTY,KIJOMORO,LAMILA,NYOO A,650,7,7,7,268,146,435,23,458,0,O-77-10-01-04-01
ARUA,MARACHA COUNTY,KIJOMORO,LAMILA,NYOO B,836,10,4,9,266,192,481,43,524,0,O-77-10-01-04-02
ARUA,MARACHA COUNTY,KIJOMORO,LAMILA,POO A (A-C),722,3,5,4,115,321,448,21,469,0,O-77-10-01-04-03
ARUA,MARACHA COUNTY,KIJOMORO,LAMILA,POO A (D-Z),495,4,3,10,90,254,361,17,378,0,O-77-10-01-04-04
ARUA,MARACHA COUNTY,KIJOMORO,OLUVU,ANZUPI A,816,10,3,11,312,128,464,40,504,0,O-77-10-01-05-01
ARUA,MARACHA COUNTY,KIJOMORO,OLUVU,ANZUPI B,604,10,7,10,255,94,376,19,395,0,O-77-10-01-05-02
ARUA,MARACHA COUNTY,KIJOMORO,ROBU,ROBU A,674,9,6,7,346,93,461,20,481,0,O-77-10-01-06-01
ARUA,MARACHA COUNTY,KIJOMORO,ROBU,ROBU B,638,9,0,5,318,86,418,12,430,0,O-77-10-01-06-02
ARUA,MARACHA COUNTY,NYADRI,BARIA,NYORO (A-C),380,4,1,3,178,51,237,36,273,0,O-77-10-02-01-01
ARUA,MARACHA COUNTY,NYADRI,BARIA,AYIVU A (A-C),478,13,2,4,165,136,320,37,357,0,O-77-10-02-01-02
ARUA,MARACHA COUNTY,NYADRI,BARIA,NYORO (D-Z),337,9,2,7,158,50,226,15,241,0,O-77-10-02-01-03
ARUA,MARACHA COUNTY,NYADRI,BARIA,AYIVU A (D-Z),527,14,7,14,216,132,383,25,408,0,O-77-10-02-01-04
ARUA,MARACHA COUNTY,NYADRI,BURA,AYIVU A,648,12,0,8,331,84,435,21,456,0,O-77-10-02-02-01
ARUA,MARACHA COUNTY,NYADRI,BURA,AYIVU B,659,11,5,11,294,99,420,34,454,0,O-77-10-02-02-02
ARUA,MARACHA COUNTY,NYADRI,BURA,LIBOA A,431,11,1,8,240,51,311,14,325,0,O-77-10-02-02-03
ARUA,MARACHA COUNTY,NYADRI,BURA,LIBOA B,356,4,1,5,202,49,261,12,273,0,O-77-10-02-02-04
ARUA,MARACHA COUNTY,NYADRI,PABURA,KIMIRU A,701,20,8,14,256,156,454,38,492,0,O-77-10-02-03-01
ARUA,MARACHA COUNTY,NYADRI,PABURA,KIMIRU B,623,16,6,9,241,109,381,34,415,0,O-77-10-02-03-02
ARUA,MARACHA COUNTY,NYADRI,PABURA,RANDRA A,765,17,3,13,316,116,465,14,479,0,O-77-10-02-03-03
ARUA,MARACHA COUNTY,NYADRI,PABURA,RANDRA B,551,11,3,5,233,102,354,15,369,0,O-77-10-02-03-04
ARUA,MARACHA COUNTY,NYADRI,ROBU,MIDRIA A,592,25,8,14,224,112,383,16,399,0,O-77-10-02-04-01
ARUA,MARACHA COUNTY,NYADRI,ROBU,MIDRIA B,427,12,3,7,163,88,273,10,283,0,O-77-10-02-04-02
ARUA,MARACHA COUNTY,NYADRI,ROBU,OLEVU A,584,13,3,11,198,147,372,33,405,0,O-77-10-02-04-03
ARUA,MARACHA COUNTY,NYADRI,ROBU,OLEVU B,515,18,12,8,162,132,332,31,363,0,O-77-10-02-04-04
ARUA,MARACHA COUNTY,OLEBA,BANGO,BANGO A,675,13,2,8,239,163,425,19,444,0,O-77-10-03-01-01
ARUA,MARACHA COUNTY,OLEBA,BANGO,BANGO B,614,16,10,12,258,138,434,15,449,0,O-77-10-03-01-02
ARUA,MARACHA COUNTY,OLEBA,BANGO,BANGO C,507,6,3,6,199,125,339,12,351,0,O-77-10-03-01-03
ARUA,MARACHA COUNTY,OLEBA,BURAMALI,GBEREMU,901,28,7,28,179,411,653,16,669,0,O-77-10-03-02-01
ARUA,MARACHA COUNTY,OLEBA,BURAMALI,PIAGO,793,25,6,25,335,156,547,36,583,0,O-77-10-03-02-02
ARUA,MARACHA COUNTY,OLEBA,ETOKO,ETOKO (A-C),587,8,5,11,176,182,382,9,391,0,O-77-10-03-03-01
ARUA,MARACHA COUNTY,OLEBA,ETOKO,ETOKO (D-Z),430,6,6,14,121,175,322,14,336,0,O-77-10-03-03-02
ARUA,MARACHA COUNTY,OLEBA,PARANGA,PARANGA A,683,19,8,9,259,176,471,10,481,0,O-77-10-03-04-01
ARUA,MARACHA COUNTY,OLEBA,PARANGA,PARANGA B (A-D),464,12,5,4,165,107,293,14,307,0,O-77-10-03-04-02
ARUA,MARACHA COUNTY,OLEBA,PARANGA,PARANGA C (A-D),427,12,3,7,170,82,274,14,288,0,O-77-10-03-04-03
ARUA,MARACHA COUNTY,OLEBA,PARANGA,PARANGA B (E-Z),438,12,3,11,156,86,268,19,287,0,O-77-10-03-04-04
ARUA,MARACHA COUNTY,OLEBA,PARANGA,PARANGA C (E-Z),379,12,5,5,145,66,233,29,262,0,O-77-10-03-04-05
ARUA,MARACHA COUNTY,OLEBA,ROBU,ROBUA (E-Z),508,6,4,12,193,127,342,16,358,0,O-77-10-03-05-01
ARUA,MARACHA COUNTY,OLEBA,ROBU,ROBU A (A-D),618,18,3,4,221,146,392,26,418,0,O-77-10-03-05-02
ARUA,MARACHA COUNTY,OLEBA,ROBU,ROBU B,696,17,5,18,244,171,455,17,472,0,O-77-10-03-05-03
ARUA,MARACHA COUNTY,OLEBA,WOROGBO,ONIBA,643,15,9,12,350,72,458,25,483,0,O-77-10-03-06-01
ARUA,MARACHA COUNTY,OLEBA,WOROGBO,RUE A,613,24,7,10,224,144,409,10,419,0,O-77-10-03-06-02
ARUA,MARACHA COUNTY,OLEBA,WOROGBO,RUE B,423,7,1,3,193,59,263,7,270,0,O-77-10-03-06-03
ARUA,MARACHA COUNTY,OLUFE,KAMAKA,BURA (A-E),567,9,2,7,119,199,336,27,363,0,O-77-10-04-01-01
ARUA,MARACHA COUNTY,OLUFE,KAMAKA,MUNYE,527,7,1,13,82,232,335,23,358,0,O-77-10-04-01-02
ARUA,MARACHA COUNTY,OLUFE,KAMAKA,BURA/MUNYE,540,9,1,10,77,252,349,31,380,0,O-77-10-04-01-03
ARUA,MARACHA COUNTY,OLUFE,KAMAKA,BURA (E-Z),368,6,5,9,91,151,262,27,289,0,O-77-10-04-01-04
ARUA,MARACHA COUNTY,OLUFE,KIMIRU,RONDRIA/RWE (A-D),489,13,8,10,169,154,354,9,363,0,O-77-10-04-02-01
ARUA,MARACHA COUNTY,OLUFE,KIMIRU,RWE,730,13,4,10,189,307,523,49,572,0,O-77-10-04-02-02
ARUA,MARACHA COUNTY,OLUFE,KIMIRU,RONDRIA/RWE (E-Z),428,10,1,11,155,141,318,24,342,0,O-77-10-04-02-03
ARUA,MARACHA COUNTY,OLUFE,MUNDRU,OMBADRI A,744,15,9,10,287,133,454,13,467,0,O-77-10-04-03-01
ARUA,MARACHA COUNTY,OLUFE,MUNDRU,OMBADRI B,527,7,4,4,212,95,322,23,345,0,O-77-10-04-03-02
ARUA,MARACHA COUNTY,OLUFE,MUNDRU,RWE,446,15,6,10,187,82,300,25,325,0,O-77-10-04-03-03
ARUA,MARACHA COUNTY,OLUFE,OTRAVU,AYIVU A,410,6,6,6,124,154,296,17,313,0,O-77-10-04-04-01
ARUA,MARACHA COUNTY,OLUFE,OTRAVU,ROBU A,675,9,5,13,170,213,410,22,432,0,O-77-10-04-04-02
ARUA,MARACHA COUNTY,OLUFE,OTRAVU,ROBU B,442,9,4,15,144,128,300,20,320,0,O-77-10-04-04-03
ARUA,MARACHA COUNTY,OLUFE,OTRAVU,AYIVU B,419,5,4,7,123,146,285,30,315,0,O-77-10-04-04-04
ARUA,MARACHA COUNTY,OLUVU,AYIKO,AYIKO A,825,24,6,29,268,138,465,33,498,0,O-77-10-05-01-01
ARUA,MARACHA COUNTY,OLUVU,AYIKO,AYIKO B,688,12,2,14,291,106,425,11,436,0,O-77-10-05-01-02
ARUA,MARACHA COUNTY,OLUVU,DRAJU,DRAJU A,645,18,6,26,267,113,430,17,447,0,O-77-10-05-02-01
ARUA,MARACHA COUNTY,OLUVU,DRAJU,DRAJU B,546,18,2,10,209,143,382,15,397,0,O-77-10-05-02-02
ARUA,MARACHA COUNTY,OLUVU,MICHU,ROGALE A,650,21,4,25,107,309,466,31,497,0,O-77-10-05-03-01
ARUA,MARACHA COUNTY,OLUVU,MICHU,WOROGBO (A-D),450,11,2,10,162,123,308,20,328,0,O-77-10-05-03-02
ARUA,MARACHA COUNTY,OLUVU,MICHU,ROGALE B,422,13,2,11,139,153,318,22,340,0,O-77-10-05-03-03
ARUA,MARACHA COUNTY,OLUVU,MICHU,WOROGBO (E-Z),558,5,3,10,211,161,390,12,402,0,O-77-10-05-03-04
ARUA,MARACHA COUNTY,OLUVU,NYOGO,NYOGO,882,22,8,27,242,232,531,45,576,0,O-77-10-05-04-01
ARUA,MARACHA COUNTY,OLUVU,OMBACHI,GODRIA A,764,12,4,10,378,64,468,58,526,0,O-77-10-05-05-01
ARUA,MARACHA COUNTY,OLUVU,OMBACHI,GODRIA B,543,15,2,9,225,151,402,16,418,0,O-77-10-05-05-02
ARUA,MARACHA COUNTY,OLUVU,OMBACHI,MOTINO A,802,18,10,13,321,222,584,24,608,0,O-77-10-05-05-03
ARUA,MARACHA COUNTY,OLUVU,OMBACHI,MOTINO B,247,13,3,4,84,65,169,14,183,0,O-77-10-05-05-04
ARUA,MARACHA COUNTY,OLUVU,RIKABU,RIKABU A,840,24,8,17,218,300,567,20,587,0,O-77-10-05-06-01
ARUA,MARACHA COUNTY,OLUVU,RIKABU,RIKABU B,662,24,2,19,260,105,410,15,425,0,O-77-10-05-06-02
ARUA,MARACHA COUNTY,OLUVU,RIKABU,RIKABU C,334,8,6,9,131,74,228,6,234,0,O-77-10-05-06-03
ARUA,MARACHA COUNTY,TARA,ANYIVU,ANIVU A,750,31,16,21,314,176,558,13,571,0,O-77-10-06-01-01
ARUA,MARACHA COUNTY,TARA,ANYIVU,ANIVU B,719,27,14,19,331,142,533,27,560,0,O-77-10-06-01-02
ARUA,MARACHA COUNTY,TARA,OJAPI,OJAPIL,641,24,6,10,238,115,393,60,453,0,O-77-10-06-02-01
ARUA,MARACHA COUNTY,TARA,OJAPI,OJAPIL (D-Z),586,25,10,6,256,97,394,31,425,0,O-77-10-06-02-02
ARUA,MARACHA COUNTY,TARA,OMBAVU,KARONOGO,174,11,3,5,91,39,149,8,157,0,O-77-10-06-03-01
ARUA,MARACHA COUNTY,TARA,OMBAVU,ABIRIJO,910,26,16,23,350,289,704,16,720,0,O-77-10-06-03-02
ARUA,MARACHA COUNTY,TARA,PAJAMA,PAJAMA,982,20,6,22,352,251,651,44,695,0,O-77-10-06-04-01
ARUA,MARACHA COUNTY,TARA,VURA,VURA A (D-Z),484,10,2,7,237,88,344,23,367,0,O-77-10-06-05-01
ARUA,MARACHA COUNTY,TARA,VURA,VURA A (A-C),597,15,3,7,273,104,402,31,433,0,O-77-10-06-05-02
ARUA,MARACHA COUNTY,TARA,VURA,VURA B,445,20,4,13,239,83,359,12,371,0,O-77-10-06-05-03
ARUA,MARACHA COUNTY,YIVU,ALARAPI,ANYANZIPI,780,18,10,22,398,123,571,39,610,0,O-77-10-07-01-01
ARUA,MARACHA COUNTY,YIVU,AMANIPI,AMANIPI/WOROGBO,802,19,8,17,259,241,544,22,566,0,O-77-10-07-02-01
ARUA,MARACHA COUNTY,YIVU,AROI,AROI (A-C),444,10,5,6,153,89,263,28,291,0,O-77-10-07-03-01
ARUA,MARACHA COUNTY,YIVU,AROI,AROI (D-Z),378,9,6,10,137,104,266,8,274,0,O-77-10-07-03-02
ARUA,MARACHA COUNTY,YIVU,AROI,AROI/EGAMARA,649,6,4,11,219,106,346,15,361,0,O-77-10-07-03-03
ARUA,MARACHA COUNTY,YIVU,EGAMARA,EGAMARA P/S (A-C),505,11,4,9,230,91,345,10,355,0,O-77-10-07-04-01
ARUA,MARACHA COUNTY,YIVU,EGAMARA,EGAMARA P/S (D-Z),517,10,8,6,209,101,334,22,356,0,O-77-10-07-04-02
ARUA,MARACHA COUNTY,YIVU,LOINYA,WOROGBO A,232,7,3,3,116,36,165,9,174,0,O-77-10-07-05-01
ARUA,MARACHA COUNTY,YIVU,LOINYA,WOROGBO B,627,25,6,18,303,96,448,27,475,0,O-77-10-07-05-02
ARUA,MARACHA COUNTY,YIVU,OKUVU,AMBALA A,686,19,9,11,309,135,483,28,511,0,O-77-10-07-06-01
ARUA,MARACHA COUNTY,YIVU,OKUVU,AMBALA B,786,41,7,20,371,111,550,27,577,0,O-77-10-07-06-02
ARUA,MARACHA COUNTY,YIVU,OMBIA,OMBA,454,21,1,8,196,97,323,15,338,0,O-77-10-07-07-01
ARUA,MARACHA COUNTY,YIVU,OMBIA,OMBA/LECU A,446,5,2,6,221,93,327,6,333,0,O-77-10-07-07-02
ARUA,MARACHA COUNTY,YIVU,OMBIA,OMBA/LECU B,447,15,6,10,194,65,290,27,317,0,O-77-10-07-07-03
ARUA,MARACHA COUNTY,YIVU,PAKAYO,PAKAYO,799,16,6,12,410,132,576,58,634,0,O-77-10-07-08-01
NAKAPIRIPIRIT,UPE COUNTY,AMUDAT,AMUDAT,ALAKAS,1247,0,1,3,30,770,804,7,811,0,O-81-149-01-01-01
NAKAPIRIPIRIT,UPE COUNTY,AMUDAT,AMUDAT,AMUDAT (A-J),1126,2,1,4,27,472,506,5,511,0,O-81-149-01-01-02
NAKAPIRIPIRIT,UPE COUNTY,AMUDAT,AMUDAT,LOBURIWI,163,2,2,2,15,35,56,4,60,0,O-81-149-01-01-03
NAKAPIRIPIRIT,UPE COUNTY,AMUDAT,AMUDAT,AMUDAT (K-Z),1394,2,1,6,69,489,567,19,586,0,O-81-149-01-01-04
NAKAPIRIPIRIT,UPE COUNTY,AMUDAT,AMUDAT,LOBURUWII OUTSIDE Q.GUARD,485,3,0,1,29,223,256,2,258,0,O-81-149-01-01-05
NAKAPIRIPIRIT,UPE COUNTY,AMUDAT,KATABOK,DINGIDINGA,930,0,0,0,0,435,435,0,435,0,O-81-149-01-02-01
NAKAPIRIPIRIT,UPE COUNTY,AMUDAT,KATABOK,KATOBOK,256,0,0,0,0,129,129,1,130,0,O-81-149-01-02-02
NAKAPIRIPIRIT,UPE COUNTY,AMUDAT,LOBURIN,LOBURIN,637,1,3,5,26,277,312,13,325,0,O-81-149-01-03-01
NAKAPIRIPIRIT,UPE COUNTY,AMUDAT,LOBURIN,NAREMIT,491,1,0,6,34,253,294,24,318,0,O-81-149-01-03-02
NAKAPIRIPIRIT,UPE COUNTY,KARITA,KARITA,KARITA,759,1,0,0,6,189,196,4,200,0,O-81-149-02-01-01
NAKAPIRIPIRIT,UPE COUNTY,KARITA,KARITA,KALOWANI,494,0,0,0,1,91,92,5,97,0,O-81-149-02-01-02
NAKAPIRIPIRIT,UPE COUNTY,KARITA,KARITA,KARITA OUTSIDE Q.GUARD,294,4,0,1,39,47,91,3,94,0,O-81-149-02-01-03
NAKAPIRIPIRIT,UPE COUNTY,KARITA,LOKALES,CHEPKAKARAT,179,0,0,0,1,70,71,2,73,0,O-81-149-02-02-01
NAKAPIRIPIRIT,UPE COUNTY,KARITA,LOKALES,LOKALES/KARITA,671,2,1,0,4,170,177,11,188,0,O-81-149-02-02-02
NAKAPIRIPIRIT,UPE COUNTY,KARITA,LOSIDOK,CHEPTAPOYO,543,0,0,1,7,506,514,4,518,0,O-81-149-02-03-01
NAKAPIRIPIRIT,UPE COUNTY,KARITA,LOSIDOK,LOLEPON,527,3,7,3,24,211,248,1,249,0,O-81-149-02-03-02
NAKAPIRIPIRIT,UPE COUNTY,KARITA,LOSIDOK,KALEKETYO,404,0,0,0,2,120,122,2,124,0,O-81-149-02-03-03
NAKAPIRIPIRIT,UPE COUNTY,LOROO,ABILIYEP,KOSIKE,553,0,0,0,2,265,267,7,274,0,O-81-149-03-01-01
NAKAPIRIPIRIT,UPE COUNTY,LOROO,ABILIYEP,MOKONGWO,549,12,8,24,22,255,321,9,330,0,O-81-149-03-01-02
NAKAPIRIPIRIT,UPE COUNTY,LOROO,ACHORICHOR,ACHORICHOR I,527,0,0,1,0,228,229,1,230,0,O-81-149-03-02-01
NAKAPIRIPIRIT,UPE COUNTY,LOROO,ACHORICHOR,ACHORICHOR II,276,0,3,4,8,123,138,4,142,0,O-81-149-03-02-02
NAKAPIRIPIRIT,UPE COUNTY,LOROO,ACHORICHOR,KOSIKE,394,0,1,2,8,87,98,4,102,0,O-81-149-03-02-03
NAKAPIRIPIRIT,UPE COUNTY,LOROO,LOROO,LOROO,372,1,0,1,9,149,160,5,165,0,O-81-149-03-03-01
NAKAPIRIPIRIT,UPE COUNTY,LOROO,LOROO,LOROO RETURNE,397,3,1,4,11,143,162,5,167,0,O-81-149-03-03-02
NAKAPIRIPIRIT,UPE COUNTY,LOROO,LOROO,ANGURUMA,449,0,0,0,23,201,224,8,232,0,O-81-149-03-03-03
NAKAPIRIPIRIT,UPE COUNTY,LOROO,LOROO,OUTSIDE QURTER GUARD,459,2,2,1,15,73,93,7,100,0,O-81-149-03-03-04
KITGUM,LAMWO COUNTY,AGORO,LOPURINGI,POLUCIRE,615,8,3,7,188,251,457,6,463,0,O-85-92-01-01-01
KITGUM,LAMWO COUNTY,AGORO,LOPURINGI,AGULAODICIRI,422,23,7,6,104,88,228,26,254,0,O-85-92-01-01-02
KITGUM,LAMWO COUNTY,AGORO,NGACINO,OBERE,521,14,14,13,257,61,359,13,372,0,O-85-92-01-02-01
KITGUM,LAMWO COUNTY,AGORO,PAWACH,PALACAM PRIMARY SCHOOL,515,5,8,13,115,199,340,14,354,0,O-85-92-01-03-01
KITGUM,LAMWO COUNTY,AGORO,PAWACH,PAWACH PRIMARY SCHOOL,714,15,6,8,285,124,438,31,469,0,O-85-92-01-03-02
KITGUM,LAMWO COUNTY,AGORO,POBAR,AGORO P.7 SCHOOL,449,10,3,6,251,36,306,10,316,0,O-85-92-01-04-01
KITGUM,LAMWO COUNTY,AGORO,POBAR,LOROMO IBENGE,493,10,8,3,321,18,360,17,377,0,O-85-92-01-04-02
KITGUM,LAMWO COUNTY,AGORO,POBAR,GOLORO KITUBA TREE,322,11,4,10,192,29,246,17,263,0,O-85-92-01-04-03
KITGUM,LAMWO COUNTY,AGORO,POTIKA,POTIKA TRADING CENTRE,698,19,12,10,208,142,391,19,410,0,O-85-92-01-05-01
KITGUM,LAMWO COUNTY,AGORO,POTIKA,LOBULE OKEJO TREE,334,9,5,6,99,55,174,15,189,0,O-85-92-01-05-02
KITGUM,LAMWO COUNTY,AGORO,POTIKA,POTIKA KITUBA TREE,432,10,5,5,153,91,264,6,270,0,O-85-92-01-05-03
KITGUM,LAMWO COUNTY,AGORO,POTIKA,PATIKA OUTSIDE Q.GUARD (A-L),470,0,0,0,3,18,21,1,22,0,O-85-92-01-05-04
KITGUM,LAMWO COUNTY,AGORO,POTIKA,PATIKA OUTSIDE Q.GUARD (M-L),552,0,0,0,12,17,29,3,32,0,O-85-92-01-05-05
KITGUM,LAMWO COUNTY,AGORO,RUDI,PAKINYI,600,17,23,12,356,86,494,19,513,0,O-85-92-01-06-01
KITGUM,LAMWO COUNTY,AGORO,RUDI,LOGEDE,169,4,5,3,67,36,115,7,122,0,O-85-92-01-06-02
KITGUM,LAMWO COUNTY,LOKUNG,DIPOLYEC,BERLOBO MARKET PLACE,387,3,2,2,22,31,60,6,66,0,O-85-92-02-01-01
KITGUM,LAMWO COUNTY,LOKUNG,DIPOLYEC,LOGWAK SUB-DISPENSARY,394,7,7,6,97,86,203,14,217,0,O-85-92-02-01-02
KITGUM,LAMWO COUNTY,LOKUNG,DIPOLYEC,AWENO - OLUI MARKET,328,3,2,6,35,69,115,0,115,0,O-85-92-02-01-03
KITGUM,LAMWO COUNTY,LOKUNG,LELA PWOT,TEDOPE MRKT,428,11,16,11,157,136,331,16,347,0,O-85-92-02-02-01
KITGUM,LAMWO COUNTY,LOKUNG,LICWA,LICWA TRADING CENTRE,555,14,4,10,191,177,396,26,422,0,O-85-92-02-03-01
KITGUM,LAMWO COUNTY,LOKUNG,LICWA,NGOMOROMO,265,9,4,1,103,42,159,17,176,0,O-85-92-02-03-02
KITGUM,LAMWO COUNTY,LOKUNG,OLEBI,AYAGO P.7 SCHOOL,209,3,0,2,105,49,159,11,170,0,O-85-92-02-04-01
KITGUM,LAMWO COUNTY,LOKUNG,OLEBI,NGOMLAC P.7 SCHOOL,665,14,11,15,291,105,436,26,462,0,O-85-92-02-04-02
KITGUM,LAMWO COUNTY,LOKUNG,PAKALABULE,OCULA-OBE TREE,635,6,7,8,357,129,507,23,530,0,O-85-92-02-05-01
KITGUM,LAMWO COUNTY,LOKUNG,PANGIRA,AKELIKONGO PANGIRA CENTRE,400,15,5,8,143,114,285,15,300,0,O-85-92-02-06-01
KITGUM,LAMWO COUNTY,LOKUNG,PANGIRA,OKORA KAMANDING,509,9,2,15,205,124,355,25,380,0,O-85-92-02-06-02
KITGUM,LAMWO COUNTY,LOKUNG,PANGIRA,AKELIKONGO OUTSIDE BARRACK,563,0,0,0,0,7,7,0,7,0,O-85-92-02-06-03
KITGUM,LAMWO COUNTY,LOKUNG,PARAPONO,LALAK SCHOOL LONAI,754,8,10,7,255,238,518,49,567,0,O-85-92-02-07-01
KITGUM,LAMWO COUNTY,LOKUNG,PARAPONO,NGOMOROMO (A-F),419,1,0,1,9,127,138,4,142,0,O-85-92-02-07-02
KITGUM,LAMWO COUNTY,LOKUNG,PARAPONO,NGOMOROMO (N-Z),617,1,2,3,24,182,212,3,215,0,O-85-92-02-07-03
KITGUM,LAMWO COUNTY,LOKUNG,PARAPONO,NGOMOROMO (G-M),479,0,0,0,5,119,124,3,127,0,O-85-92-02-07-04
KITGUM,LAMWO COUNTY,LOKUNG,PAWOR,POWACH P.7 SCHOOL,198,5,2,6,75,50,138,10,148,0,O-85-92-02-08-01
KITGUM,LAMWO COUNTY,LOKUNG,PAWOR,LATIDA CENTRE,534,7,9,10,211,110,347,22,369,0,O-85-92-02-08-02
KITGUM,LAMWO COUNTY,LOKUNG,POBEL,POBEL TRADING CENTRE,598,6,5,4,313,114,442,18,460,0,O-85-92-02-09-01
KITGUM,LAMWO COUNTY,MADI-OPEI,KAL,KAL TRADING CENTRE HQRS,578,8,6,3,277,80,374,1,375,0,O-85-92-03-01-01
KITGUM,LAMWO COUNTY,MADI-OPEI,KAL,MALEC ABONDIO'S HOME,536,17,4,6,266,84,377,10,387,0,O-85-92-03-01-02
KITGUM,LAMWO COUNTY,MADI-OPEI,KAL,MALIM ABONDIA HOME,480,4,0,0,31,21,56,2,58,0,O-85-92-03-01-03
KITGUM,LAMWO COUNTY,MADI-OPEI,LAWIYE-ODUNY,DOKTANGI,622,24,10,9,326,70,439,24,463,0,O-85-92-03-02-01
KITGUM,LAMWO COUNTY,MADI-OPEI,OKOL,KAPETA,523,13,9,11,311,21,365,26,391,0,O-85-92-03-03-01
KITGUM,LAMWO COUNTY,MADI-OPEI,OKOL,KIROMBE,504,21,8,9,305,39,382,15,397,0,O-85-92-03-03-02
KITGUM,LAMWO COUNTY,MADI-OPEI,PABURA,WIGWENG LUBIRI,675,14,16,8,361,75,474,17,491,0,O-85-92-03-04-01
KITGUM,LAMWO COUNTY,MADI-OPEI,PABURA,GUDA PALWO TEE-CWAA,316,1,0,2,175,51,229,6,235,0,O-85-92-03-04-02
KITGUM,LAMWO COUNTY,OGILI,APYETA,AKANYO P.7 SCHOOL,358,9,4,6,183,26,228,14,242,0,O-85-92-04-01-01
KITGUM,LAMWO COUNTY,OGILI,APYETA,TE MUYEME,389,5,1,4,205,23,238,22,260,0,O-85-92-04-01-02
KITGUM,LAMWO COUNTY,OGILI,LUGWAR,AKWORO PICKET,713,9,5,4,284,209,511,6,517,0,O-85-92-04-02-01
KITGUM,LAMWO COUNTY,OGILI,LUGWAR,LUGWAR P/S,340,4,1,3,161,42,211,15,226,0,O-85-92-04-02-02
KITGUM,LAMWO COUNTY,OGILI,PADWAT,PADWAT P/S,519,3,4,4,173,140,324,9,333,0,O-85-92-04-03-01
KITGUM,LAMWO COUNTY,OGILI,PADWAT,PADWAT T.C,633,12,3,4,338,43,400,12,412,0,O-85-92-04-03-02
KITGUM,LAMWO COUNTY,OGILI,PADWAT,PADWAT WEST T-YAA,265,10,1,2,120,21,154,4,158,0,O-85-92-04-03-03
KITGUM,LAMWO COUNTY,OGILI,PARACELLE,PARACELLE P/S,470,10,6,15,207,57,295,24,319,0,O-85-92-04-04-01
KITGUM,LAMWO COUNTY,PADIBE EAST,KATUM,KATUM OLOK'S HOME,571,13,4,8,306,38,369,15,384,0,O-85-92-05-01-01
KITGUM,LAMWO COUNTY,PADIBE EAST,KATUM,DEC ALPEO OKAC'S HOME,576,17,0,6,281,136,440,14,454,0,O-85-92-05-01-02
KITGUM,LAMWO COUNTY,PADIBE EAST,KATUM,LOTIBOL OUTSIDE Q.GUARD,342,7,0,5,74,75,161,7,168,0,O-85-92-05-01-03
KITGUM,LAMWO COUNTY,PADIBE EAST,KATUM,KATUM OUTSIDE Q. GUARD,564,0,0,5,114,396,515,4,519,0,O-85-92-05-01-04
KITGUM,LAMWO COUNTY,PADIBE EAST,KULUYEE,LOTIBOR HQRS,465,6,3,8,237,52,306,11,317,0,O-85-92-05-02-01
KITGUM,LAMWO COUNTY,PADIBE EAST,KULUYEE,PADIBE BOYS PRIMARY SCHOOL,745,12,3,8,375,135,533,25,558,0,O-85-92-05-02-02
KITGUM,LAMWO COUNTY,PADIBE EAST,PANYINGA ALAA,LOYI-AGOLO (A-K),551,12,3,4,312,52,383,11,394,0,O-85-92-05-03-01
KITGUM,LAMWO COUNTY,PADIBE EAST,PANYINGA ALAA,LOYI-AGOLO (L-Z),455,4,4,2,288,40,338,12,350,0,O-85-92-05-03-02
KITGUM,LAMWO COUNTY,PADIBE EAST,WANGTIT,GUCI,301,5,3,1,156,60,225,7,232,0,O-85-92-05-04-01
KITGUM,LAMWO COUNTY,PADIBE EAST,WANGTIT,TADI WILSON OKWON'S HOME,417,12,2,8,229,56,307,11,318,0,O-85-92-05-04-02
KITGUM,LAMWO COUNTY,PADIBE EAST,WANGTIT,OGAKO LACAN P.7 SCHOOL,603,7,4,3,382,55,451,16,467,0,O-85-92-05-04-03
KITGUM,LAMWO COUNTY,PADIBE WEST,BOBO-ABAKADYAK,STORE BOR (A-L),523,10,4,10,175,183,382,20,402,0,O-85-92-06-01-01
KITGUM,LAMWO COUNTY,PADIBE WEST,BOBO-ABAKADYAK,AYOM,761,7,5,16,302,255,585,43,628,0,O-85-92-06-01-02
KITGUM,LAMWO COUNTY,PADIBE WEST,BOBO-ABAKADYAK,STORE BOR (M-Z),268,1,0,0,132,85,218,8,226,0,O-85-92-06-01-03
KITGUM,LAMWO COUNTY,PADIBE WEST,LAGWEL,ATWOL T/C,452,2,3,6,237,84,332,12,344,0,O-85-92-06-02-01
KITGUM,LAMWO COUNTY,PADIBE WEST,LAGWEL,TOLPOLO,609,7,5,10,323,142,487,22,509,0,O-85-92-06-02-02
KITGUM,LAMWO COUNTY,PADIBE WEST,MADI-KILOCH,ALUU MRKT,490,7,6,7,121,235,376,16,392,0,O-85-92-06-03-01
KITGUM,LAMWO COUNTY,PADIBE WEST,MADI-KILOCH,BASE CAMP,612,5,3,11,121,328,468,20,488,0,O-85-92-06-03-02
KITGUM,LAMWO COUNTY,PADIBE WEST,MADI-KILOCH,ALUU MARKET OUTSIDE Q. GUAR,169,0,1,0,12,84,97,6,103,0,O-85-92-06-03-03
KITGUM,LAMWO COUNTY,PADIBE WEST,YWAYA,OGWANG CAN P.7 SCHOOL,646,4,4,7,304,153,472,52,524,0,O-85-92-06-04-01
KITGUM,LAMWO COUNTY,PADIBE WEST,YWAYA,OLWORNGUU MARKET,614,10,8,10,295,150,473,30,503,0,O-85-92-06-04-02
KITGUM,LAMWO COUNTY,PADIBE WEST,YWAYA,LAGARA P.7 SCHOOL,142,0,0,3,55,51,109,12,121,0,O-85-92-06-04-03
KITGUM,LAMWO COUNTY,PALABEK-GEM,ANAKA,BEYOGOYA P.7 SCHOOL,465,11,2,7,169,49,238,48,286,0,O-85-92-07-01-01
KITGUM,LAMWO COUNTY,PALABEK-GEM,ANAKA,ANAKA P.7 SCHOOL,230,7,2,6,111,26,152,5,157,0,O-85-92-07-01-02
KITGUM,LAMWO COUNTY,PALABEK-GEM,CUBU,ABAM PARENTS SCHOOL,603,6,5,2,194,81,288,18,306,0,O-85-92-07-02-01
KITGUM,LAMWO COUNTY,PALABEK-GEM,CUBU,LAYAMO AGWATA P.7 SCHOOL,365,6,3,5,206,29,249,2,251,0,O-85-92-07-02-02
KITGUM,LAMWO COUNTY,PALABEK-GEM,CUBU,ABERA OUTSIDE Q. GUARD,248,0,0,0,33,162,195,1,196,0,O-85-92-07-02-03
KITGUM,LAMWO COUNTY,PALABEK-GEM,GEM,GEM MEDE P.7 SCHOOL,315,3,2,4,132,49,190,7,197,0,O-85-92-07-03-01
KITGUM,LAMWO COUNTY,PALABEK-GEM,GEM,GEM-MEDE P.7 SCHOOL B,375,15,4,11,162,62,254,8,262,0,O-85-92-07-03-02
KITGUM,LAMWO COUNTY,PALABEK-GEM,MOROTO,GEM P7 SCHOOL,792,16,8,18,349,81,472,29,501,0,O-85-92-07-04-01
KITGUM,LAMWO COUNTY,PALABEK-GEM,MOROTO,LAPONO MARKET,556,6,9,16,253,86,370,23,393,0,O-85-92-07-04-02
KITGUM,LAMWO COUNTY,PALABEK-GEM,MOROTO,HEALTH UNIT,525,7,1,6,223,79,316,13,329,0,O-85-92-07-04-03
KITGUM,LAMWO COUNTY,PALABEK-GEM,MOROTO,SUB-COUNTY HQRS,274,7,2,10,129,26,174,13,187,0,O-85-92-07-04-04
KITGUM,LAMWO COUNTY,PALABEK-GEM,PATANGA,LIGILIGI P.6 SCHOOL,524,13,4,6,256,57,336,15,351,0,O-85-92-07-05-01
KITGUM,LAMWO COUNTY,PALABEK-GEM,PATANGA,OUTSIDE Q.GUARD (A-K),421,0,0,0,0,0,0,0,0,1,O-85-92-07-05-02
KITGUM,LAMWO COUNTY,PALABEK-GEM,PATANGA,OUTSIDE Q.GUARD (L-Z),331,0,0,0,0,0,0,0,0,1,O-85-92-07-05-03
KITGUM,LAMWO COUNTY,PALABEK-KAL,AYU ALALI,BAYA-A-MARKET,744,16,9,9,355,108,497,12,509,0,O-85-92-08-01-01
KITGUM,LAMWO COUNTY,PALABEK-KAL,KAL,KAL TRADING CENTRE (A-L),568,18,6,10,197,84,315,8,323,0,O-85-92-08-02-01
KITGUM,LAMWO COUNTY,PALABEK-KAL,KAL,PAUMA,431,11,1,13,209,66,300,9,309,0,O-85-92-08-02-02
KITGUM,LAMWO COUNTY,PALABEK-KAL,KAL,PALABEK KAL P.7 SCHOOL,610,11,5,6,302,84,408,14,422,0,O-85-92-08-02-03
KITGUM,LAMWO COUNTY,PALABEK-KAL,KAL,KAL TRADING CENTRE (M-Z),412,2,0,2,165,64,233,6,239,0,O-85-92-08-02-04
KITGUM,LAMWO COUNTY,PALABEK-KAL,LABIGIRYANG,LAGWEDOLA MRKT,475,9,2,10,264,67,352,9,361,0,O-85-92-08-03-01
KITGUM,LAMWO COUNTY,PALABEK-KAL,LABIGIRYANG,ALIMOTIKO,578,16,1,14,310,97,438,17,455,0,O-85-92-08-03-02
KITGUM,LAMWO COUNTY,PALABEK-KAL,LAMWO,KAPETTA P.7 SCHOOL,582,11,3,6,327,47,394,19,413,0,O-85-92-08-04-01
KITGUM,LAMWO COUNTY,PALABEK-KAL,LAMWO,WALIGO OUTSIDE QUARTER GUA,419,0,0,0,0,0,0,0,0,1,O-85-92-08-04-02
KITGUM,LAMWO COUNTY,PALABEK-KAL,LAMWO,MICIRI,539,19,3,4,265,57,348,11,359,0,O-85-92-08-04-03
KITGUM,LAMWO COUNTY,PALUGA,BUNGU,LOYORO PALUGA P1-P3 SCHOOL,557,7,8,2,328,48,393,21,414,0,O-85-92-09-01-01
KITGUM,LAMWO COUNTY,PALUGA,BUNGU,JAMULA P.4 SCHOOL,162,1,1,0,95,0,97,0,97,0,O-85-92-09-01-02
KITGUM,LAMWO COUNTY,PALUGA,BUNGU,ORII P7 SCHOOL,324,0,0,6,133,3,142,4,146,0,O-85-92-09-01-03
KITGUM,LAMWO COUNTY,PALUGA,BUNGU,PALUGA OUTSIDE Q. GUARD,87,0,0,0,6,22,28,1,29,0,O-85-92-09-01-04
KITGUM,LAMWO COUNTY,PALUGA,PALUGA,PALUGA TRADING CENTRE,674,11,5,3,365,54,438,4,442,0,O-85-92-09-02-01
KITGUM,LAMWO COUNTY,PALUGA,PALUGA,LAPIDI YENYI MARKET,569,3,12,4,295,41,355,12,367,0,O-85-92-09-02-02
KITGUM,LAMWO COUNTY,PALUGA,PAWAJA,KANGOLE P.7 SCHOOL,320,4,4,2,159,40,209,18,227,0,O-85-92-09-03-01
KITGUM,LAMWO COUNTY,PALUGA,PAWAJA,MARAKAC,647,21,11,12,312,66,422,27,449,0,O-85-92-09-03-02
LIRA,OTUKE COUNTY,ADWARI,ALANGO,AYEKI A,629,4,19,9,291,13,336,19,355,0,O-86-104-01-01-01
LIRA,OTUKE COUNTY,ADWARI,ALANGO,AYEKI B,382,8,17,6,162,4,197,4,201,0,O-86-104-01-01-02
LIRA,OTUKE COUNTY,ADWARI,OKEE,AMINAWILI,320,4,5,2,89,6,106,4,110,0,O-86-104-01-02-01
LIRA,OTUKE COUNTY,ADWARI,OKEE,ADYERAKONYA,266,4,13,2,119,6,144,9,153,0,O-86-104-01-02-02
LIRA,OTUKE COUNTY,ADWARI,OLAROKWON,OKWONGO I,753,6,17,7,355,21,406,6,412,0,O-86-104-01-03-01
LIRA,OTUKE COUNTY,ADWARI,OLAROKWON,OKWONGO II,272,4,8,6,150,6,174,11,185,0,O-86-104-01-03-02
LIRA,OTUKE COUNTY,ADWARI,OLAROKWON,OKET PUR I,182,3,3,2,84,3,95,0,95,0,O-86-104-01-03-03
LIRA,OTUKE COUNTY,ADWARI,OLAROKWON,OKET PUR II,180,1,9,1,70,12,93,3,96,0,O-86-104-01-03-04
LIRA,OTUKE COUNTY,ADWARI,OMITO,ABUABURA,249,3,3,2,129,9,146,3,149,0,O-86-104-01-04-01
LIRA,OTUKE COUNTY,ADWARI,OMITO,ALIWANG,649,6,15,9,242,28,300,26,326,0,O-86-104-01-04-02
LIRA,OTUKE COUNTY,ADWARI,OMITO,AKWERA,652,7,20,3,367,24,421,4,425,0,O-86-104-01-04-03
LIRA,OTUKE COUNTY,ADWARI,OMITO,AGWENG,822,6,21,4,434,24,489,5,494,0,O-86-104-01-04-04
LIRA,OTUKE COUNTY,OKWANG,AMOYAI,BAR-ILEC A,574,6,28,2,131,2,169,28,197,0,O-86-104-02-01-01
LIRA,OTUKE COUNTY,OKWANG,AMOYAI,BAR-ILEC B,538,9,28,2,177,2,218,57,275,0,O-86-104-02-01-02
LIRA,OTUKE COUNTY,OKWANG,ARWOTNGO,BARALEGI,471,6,27,3,145,33,214,8,222,0,O-86-104-02-02-01
LIRA,OTUKE COUNTY,OKWANG,ARWOTNGO,BARAWOBE,517,2,26,2,114,6,150,6,156,0,O-86-104-02-02-02
LIRA,OTUKE COUNTY,OKWANG,ARWOTNGO,BARALEGI OUTSIDE QUARTER GU,84,0,0,0,1,83,84,0,84,0,O-86-104-02-02-03
LIRA,OTUKE COUNTY,OKWANG,BAROCOK,BAR-OCOK,528,6,24,4,252,4,290,6,296,0,O-86-104-02-03-01
LIRA,OTUKE COUNTY,OKWANG,OLWORNGU,AMELLE,302,5,28,3,86,12,134,4,138,0,O-86-104-02-04-01
LIRA,OTUKE COUNTY,OKWANG,OLWORNGU,BARABOLO,386,3,42,4,106,25,180,11,191,0,O-86-104-02-04-02
LIRA,OTUKE COUNTY,OKWANG,OLWORNGU,OKWANG T.C (A-M),381,6,18,3,74,36,137,11,148,0,O-86-104-02-04-03
LIRA,OTUKE COUNTY,OKWANG,OLWORNGU,OKWANG T.C (N-Z),517,7,21,2,178,42,250,12,262,0,O-86-104-02-04-04
LIRA,OTUKE COUNTY,OKWANG,OPEJAL,OGORO,465,1,14,0,61,3,79,0,79,0,O-86-104-02-05-01
LIRA,OTUKE COUNTY,OKWANG,OPEJAL,OLAROLOBO,531,1,19,4,175,11,210,5,215,0,O-86-104-02-05-02
LIRA,OTUKE COUNTY,OLILIM,AMUNGA,OKERA,617,12,19,14,190,63,298,10,308,0,O-86-104-03-01-01
LIRA,OTUKE COUNTY,OLILIM,ANEPKIDE,AMEDO,205,0,2,0,58,3,63,18,81,0,O-86-104-03-02-01
LIRA,OTUKE COUNTY,OLILIM,ANEPKIDE,TEGWENG,261,4,2,1,86,2,95,0,95,0,O-86-104-03-02-02
LIRA,OTUKE COUNTY,OLILIM,ANGETTA,OLILIM TRADING CENTRE,484,5,7,4,157,39,212,3,215,0,O-86-104-03-03-01
LIRA,OTUKE COUNTY,OLILIM,ANGETTA,OLILIM P.7 SCHOOL,632,8,9,9,205,25,256,6,262,0,O-86-104-03-03-02
LIRA,OTUKE COUNTY,OLILIM,ANGETTA,OLILIM HEALTH CENTER,386,9,18,9,136,31,203,0,203,0,O-86-104-03-03-03
LIRA,OTUKE COUNTY,OLILIM,ATIRA,OLILIM CHAPEL,334,7,5,4,67,95,178,5,183,0,O-86-104-03-04-01
LIRA,OTUKE COUNTY,OLILIM,GOTOJWANG,ALUGA,544,7,6,2,157,6,178,3,181,0,O-86-104-03-05-01
LIRA,OTUKE COUNTY,OLILIM,OGWETE,OKOKOKEA,521,5,7,4,86,138,240,7,247,0,O-86-104-03-06-01
LIRA,OTUKE COUNTY,ORUM,ALANGI,ORUM HEALTH CENTRE,788,3,12,6,216,152,389,119,508,0,O-86-104-04-01-01
LIRA,OTUKE COUNTY,ORUM,ALANGI,ALANGI P.7 SCHOOL,528,11,37,16,182,68,314,3,317,0,O-86-104-04-01-02
LIRA,OTUKE COUNTY,ORUM,ALANGI,AKAIDEBE OUTSIDE Q. GUARD,288,0,0,0,3,6,9,0,9,0,O-86-104-04-01-03
LIRA,OTUKE COUNTY,ORUM,ANEPMOROTO,ALAI,631,15,13,10,290,37,365,20,385,0,O-86-104-04-02-01
LIRA,OTUKE COUNTY,ORUM,ANEPMOROTO,OYUO A,507,8,17,8,234,26,293,6,299,0,O-86-104-04-02-02
LIRA,OTUKE COUNTY,ORUM,ANEPMOROTO,OYUO B,305,13,10,2,169,5,199,2,201,0,O-86-104-04-02-03
LIRA,OTUKE COUNTY,ORUM,ANYLIMA,OCIRO,645,9,10,7,165,26,217,12,229,0,O-86-104-04-03-01
LIRA,OTUKE COUNTY,ORUM,ATANGWATA,OGWENO,525,10,10,9,136,31,196,8,204,0,O-86-104-04-04-01
LIRA,OTUKE COUNTY,ORUM,ATANGWATA,AWITO OUTSIDE Q.GUARD,100,0,0,0,8,3,11,0,11,0,O-86-104-04-04-02
LIRA,OTUKE COUNTY,ORUM,ATING,ATING- OBANGAANGEO,563,15,20,9,194,53,291,7,298,0,O-86-104-04-05-01
LIRA,OTUKE COUNTY,ORUM,ATING,ATING- ODITE- DIP,674,9,14,8,246,53,330,11,341,0,O-86-104-04-05-02
LIRA,OTUKE COUNTY,ORUM,OLURO,OLURO P.7 SCHOOL,454,8,6,7,221,23,265,5,270,0,O-86-104-04-06-01
LIRA,OTUKE COUNTY,ORUM,OLURO,AROM P.7 SCHOOL,600,4,5,6,193,14,222,16,238,0,O-86-104-04-06-02
LIRA,OTUKE COUNTY,ORUM,OLURO,ODEROKECH P.7 SCHOOL,455,8,1,6,189,17,221,7,228,0,O-86-104-04-06-03
LIRA,OTUKE COUNTY,ORUM,OLURO,OMWONYOLE OUTSIDE Q. GUARD,440,0,0,0,0,430,430,10,440,0,O-86-104-04-06-04
NEBBI,OKORO COUNTY,ATYAK,ANGOL,ATYAK HEALTH CENTRE,330,18,3,13,41,148,223,20,243,0,O-87-182-01-01-01
NEBBI,OKORO COUNTY,ATYAK,ANGOL,GONY OBENDU,300,10,4,4,58,96,172,20,192,0,O-87-182-01-01-02
NEBBI,OKORO COUNTY,ATYAK,ANGOL,ADIADWOL PRIMARY SCHOOL,324,4,11,11,53,169,248,12,260,0,O-87-182-01-01-03
NEBBI,OKORO COUNTY,ATYAK,ANYOLA,ANYOLA - YOUTH COOP SOCIETY,499,17,15,9,186,135,362,1,363,0,O-87-182-01-02-01
NEBBI,OKORO COUNTY,ATYAK,ANYOLA,ARINGU-ANYOLA CENTRE,399,9,14,2,144,130,299,8,307,0,O-87-182-01-02-02
NEBBI,OKORO COUNTY,ATYAK,ANYOLA,URUU COOP. SOCIETY,310,5,5,6,64,90,170,10,180,0,O-87-182-01-02-03
NEBBI,OKORO COUNTY,ATYAK,ANYOLA,THER-URUU HEALTH CENTRE,258,7,4,1,93,55,160,5,165,0,O-87-182-01-02-04
NEBBI,OKORO COUNTY,ATYAK,JULOKA,JULOKA P SCHOOL,477,18,13,17,147,128,323,13,336,0,O-87-182-01-03-01
NEBBI,OKORO COUNTY,ATYAK,JULOKA,LWALA P SCHOOL,478,10,20,9,120,180,339,24,363,0,O-87-182-01-03-02
NEBBI,OKORO COUNTY,ATYAK,JULOKA,WARR MOSLEM P. SCHOOL,511,9,11,3,203,114,340,6,346,0,O-87-182-01-03-03
NEBBI,OKORO COUNTY,ATYAK,JULOKA,WARR COMMUNITY CENTRE,235,0,33,2,59,77,171,6,177,0,O-87-182-01-03-04
NEBBI,OKORO COUNTY,ATYAK,OGUSI,ATYAK COOP SOCIETY,577,5,10,12,67,305,399,27,426,0,O-87-182-01-04-01
NEBBI,OKORO COUNTY,ATYAK,OGUSI,ATYAK SUB-COUNTY HQRS,584,10,10,11,174,203,408,11,419,0,O-87-182-01-04-02
NEBBI,OKORO COUNTY,ATYAK,OGUSI,WARR COFFEE COOP SOCIETY,513,8,39,5,97,223,372,3,375,0,O-87-182-01-04-03
NEBBI,OKORO COUNTY,ATYAK,PAKIA,GOT-CAM P. SCH,267,6,6,4,46,118,180,11,191,0,O-87-182-01-05-01
NEBBI,OKORO COUNTY,ATYAK,PAKIA,PAKIA COOP. SOCIETY,279,6,5,5,110,82,208,7,215,0,O-87-182-01-05-02
NEBBI,OKORO COUNTY,ATYAK,PAKIA,PEI COOP. SOCIETY,540,11,11,10,177,137,346,8,354,0,O-87-182-01-05-03
NEBBI,OKORO COUNTY,ATYAK,PAKIA,AGIERMACH MALITABU CLUB,412,4,4,4,132,102,246,28,274,0,O-87-182-01-05-04
NEBBI,OKORO COUNTY,ATYAK,PAKIA,NYAMOLA MARKET,141,2,0,1,28,44,75,38,113,0,O-87-182-01-05-05
NEBBI,OKORO COUNTY,ATYAK,PAMACH,BITON MARKET,388,3,7,4,35,241,290,14,304,0,O-87-182-01-06-01
NEBBI,OKORO COUNTY,ATYAK,PAMACH,BITON CLUB,328,9,7,5,41,197,259,7,266,0,O-87-182-01-06-02
NEBBI,OKORO COUNTY,JANGOKORO,ABAJI,ARIKPA P/SCHOOL,692,6,6,16,188,246,462,23,485,0,O-87-182-02-01-01
NEBBI,OKORO COUNTY,JANGOKORO,ABAJI,LUMA CENTRE,512,8,7,10,158,149,332,24,356,0,O-87-182-02-01-02
NEBBI,OKORO COUNTY,JANGOKORO,ABAJI,ODUK CENTRE,650,14,11,12,126,280,443,19,462,0,O-87-182-02-01-03
NEBBI,OKORO COUNTY,JANGOKORO,ABAJI,ARAGU P SCHOOL/VIRRA,567,4,9,12,171,181,377,24,401,0,O-87-182-02-01-04
NEBBI,OKORO COUNTY,JANGOKORO,JUPADINDO,AJIGO,599,15,8,9,44,265,341,25,366,0,O-87-182-02-02-01
NEBBI,OKORO COUNTY,JANGOKORO,JUPADINDO,AWASI,439,15,8,12,75,178,288,34,322,0,O-87-182-02-02-02
NEBBI,OKORO COUNTY,JANGOKORO,JUPADINDO,KELLE,553,14,6,11,63,244,338,11,349,0,O-87-182-02-02-03
NEBBI,OKORO COUNTY,JANGOKORO,JUPADINDO,LELO,481,11,6,4,68,229,318,39,357,0,O-87-182-02-02-04
NEBBI,OKORO COUNTY,JANGOKORO,JUPADINDO,ACHU,728,26,10,7,123,292,458,23,481,0,O-87-182-02-02-05
NEBBI,OKORO COUNTY,JANGOKORO,PATEK,AKOTH CLUB,300,7,9,5,79,144,244,7,251,0,O-87-182-02-03-01
NEBBI,OKORO COUNTY,JANGOKORO,PATEK,KONGA MARKET,484,5,7,14,52,253,331,25,356,0,O-87-182-02-03-02
NEBBI,OKORO COUNTY,JANGOKORO,PATEK,NGMBANGMBA,807,21,12,22,110,316,481,24,505,0,O-87-182-02-03-03
NEBBI,OKORO COUNTY,JANGOKORO,PATEK,OJIGU PENTECOSTAL CHURCH,562,13,9,8,117,217,364,31,395,0,O-87-182-02-03-04
NEBBI,OKORO COUNTY,JANGOKORO,PATEK,JANGOKOKO HEALTH UNIT,482,19,13,17,88,211,348,22,370,0,O-87-182-02-03-05
NEBBI,OKORO COUNTY,KANGO,ANGAR,ANGAR PR SCH,397,21,12,14,121,126,294,23,317,0,O-87-182-03-01-01
NEBBI,OKORO COUNTY,KANGO,ANGAR,MBASI-(BAALIA VILL.),690,16,40,21,131,314,522,11,533,0,O-87-182-03-01-02
NEBBI,OKORO COUNTY,KANGO,ANGAR,LYANGA PR SCH,320,14,5,7,77,134,237,13,250,0,O-87-182-03-01-03
NEBBI,OKORO COUNTY,KANGO,GAMBA,AWUSONZI P/SCHOOL,519,23,20,12,127,201,383,14,397,0,O-87-182-03-02-01
NEBBI,OKORO COUNTY,KANGO,GAMBA,AVO CHAPEL,469,14,18,10,80,227,349,0,349,0,O-87-182-03-02-02
NEBBI,OKORO COUNTY,KANGO,GAMBA,ELEZE P. SCHOOL,452,12,21,22,93,166,314,7,321,0,O-87-182-03-02-03
NEBBI,OKORO COUNTY,KANGO,GAMBA,NGELE P/SCHOOL,671,8,17,21,71,318,435,15,450,0,O-87-182-03-02-04
NEBBI,OKORO COUNTY,KANGO,OLIRI,EZOO P SCHOOL,728,25,14,18,205,160,422,14,436,0,O-87-182-03-03-01
NEBBI,OKORO COUNTY,KANGO,OLIRI,KANGO SUB-COUNTY HQRS,437,11,7,13,142,136,309,9,318,0,O-87-182-03-03-02
NEBBI,OKORO COUNTY,KANGO,OMUA I,OMUA LOWER PRIMARY SCHOOL,549,14,8,12,124,280,438,6,444,0,O-87-182-03-04-01
NEBBI,OKORO COUNTY,KANGO,OMUA I,OMUA PRIMARY SCHOOL,365,17,13,16,116,129,291,6,297,0,O-87-182-03-04-02
NEBBI,OKORO COUNTY,KANGO,OMUA I,ONWAGNGASE CENTRE,378,14,6,8,138,134,300,8,308,0,O-87-182-03-04-03
NEBBI,OKORO COUNTY,KANGO,PADUBA,KANGO P/SCHOOL,823,12,3,12,312,150,489,13,502,0,O-87-182-03-05-01
NEBBI,OKORO COUNTY,KANGO,PADUBA,NYANGO PR SCH,393,12,9,10,133,89,253,30,283,0,O-87-182-03-05-02
NEBBI,OKORO COUNTY,KANGO,PADUBA,ZAMBA VILL/ALUBE PRI/SCHOOL,546,12,7,10,106,233,368,16,384,0,O-87-182-03-05-03
NEBBI,OKORO COUNTY,KANGO,PASAI,GAMBA P/SCHOOL,523,8,10,12,85,223,338,21,359,0,O-87-182-03-06-01
NEBBI,OKORO COUNTY,KANGO,PASAI,PASAI P. SCHOOL (A - M),404,11,3,6,55,135,210,11,221,0,O-87-182-03-06-02
NEBBI,OKORO COUNTY,KANGO,PASAI,NVURANYI PRIMARY SCHOOL,280,8,17,5,63,90,183,14,197,0,O-87-182-03-06-03
NEBBI,OKORO COUNTY,KANGO,PASAI,AGRIERMACH MISSION,205,3,2,1,32,90,128,3,131,0,O-87-182-03-06-04
NEBBI,OKORO COUNTY,KANGO,PASAI,PASAI P. SCHOOL (N - Z),315,8,1,10,49,124,192,14,206,0,O-87-182-03-06-05
NEBBI,OKORO COUNTY,NYAPEA,ABEJU,PATEK MARKET,384,8,6,8,90,137,249,9,258,0,O-87-182-04-01-01
NEBBI,OKORO COUNTY,NYAPEA,ABEJU,GUNA,543,8,12,13,133,180,346,11,357,0,O-87-182-04-01-02
NEBBI,OKORO COUNTY,NYAPEA,ABEJU,ABEJU COOP. SOCIETY,659,4,6,8,121,297,436,12,448,0,O-87-182-04-01-03
NEBBI,OKORO COUNTY,NYAPEA,ABIRA,ATYENDA EAST,351,5,8,7,140,83,243,16,259,0,O-87-182-04-02-01
NEBBI,OKORO COUNTY,NYAPEA,ABIRA,PATEK-PADUK MARKET,702,12,9,8,179,181,389,29,418,0,O-87-182-04-02-02
NEBBI,OKORO COUNTY,NYAPEA,ABIRA,ZUMBU UPPER PRI. SCHOOL,721,8,16,9,229,216,478,9,487,0,O-87-182-04-02-03
NEBBI,OKORO COUNTY,NYAPEA,ABIRA,CONGU-UMWOCHI CLUB,283,6,4,3,59,64,136,5,141,0,O-87-182-04-02-04
NEBBI,OKORO COUNTY,NYAPEA,ABIRA,KANISA AREJU (COU),262,3,7,3,110,69,192,4,196,0,O-87-182-04-02-05
NEBBI,OKORO COUNTY,NYAPEA,OYEYO,NUMBER TANO,593,6,8,6,204,187,411,14,425,0,O-87-182-04-03-01
NEBBI,OKORO COUNTY,NYAPEA,OYEYO,NYAPEA BOYS P. SCHOOL,620,15,8,12,236,162,433,16,449,0,O-87-182-04-03-02
NEBBI,OKORO COUNTY,NYAPEA,OYEYO,TUNG DYIANG,580,7,5,8,156,217,393,19,412,0,O-87-182-04-03-03
NEBBI,OKORO COUNTY,NYAPEA,PALEY,AJEI P SCHOOL,667,9,2,6,181,236,434,16,450,0,O-87-182-04-04-01
NEBBI,OKORO COUNTY,NYAPEA,PALEY,TENGO MARKET,339,2,4,2,114,119,241,30,271,0,O-87-182-04-04-02
NEBBI,OKORO COUNTY,NYAPEA,PALEY,YUGU P. SCHOOL,472,5,5,6,76,252,344,10,354,0,O-87-182-04-04-03
NEBBI,OKORO COUNTY,NYAPEA,PALEY,ZUMBU LOWER P. SCHOOL,660,8,9,7,247,182,453,6,459,0,O-87-182-04-04-04
NEBBI,OKORO COUNTY,NYAPEA,PALEY,PAPOGA CHAPEL,252,4,9,4,57,79,153,19,172,0,O-87-182-04-04-05
NEBBI,OKORO COUNTY,PAIDHA SUB-COUNTY,CHANA,JUPUMWOCO PRI. SCHOOL,860,13,16,14,270,232,545,13,558,0,O-87-182-05-01-01
NEBBI,OKORO COUNTY,PAIDHA SUB-COUNTY,CHANA,ONDWONG,653,5,17,13,233,180,448,17,465,0,O-87-182-05-01-02
NEBBI,OKORO COUNTY,PAIDHA SUB-COUNTY,KAYA,KAYA P/SCHOOL,487,11,5,7,184,150,357,11,368,0,O-87-182-05-02-01
NEBBI,OKORO COUNTY,PAIDHA SUB-COUNTY,KAYA,PAKOLO,605,7,12,8,193,227,447,12,459,0,O-87-182-05-02-02
NEBBI,OKORO COUNTY,PAIDHA SUB-COUNTY,OTHEKO,AVONO CENTRAL (A - N),517,8,2,12,88,160,270,18,288,0,O-87-182-05-03-01
NEBBI,OKORO COUNTY,PAIDHA SUB-COUNTY,OTHEKO,OTHEKO P/SCHOOL (A - N),468,5,11,9,116,114,255,15,270,0,O-87-182-05-03-02
NEBBI,OKORO COUNTY,PAIDHA SUB-COUNTY,OTHEKO,AVONO CENTRAL (O - Z),357,11,10,7,91,134,253,10,263,0,O-87-182-05-03-03
NEBBI,OKORO COUNTY,PAIDHA SUB-COUNTY,OTHEKO,URUKU P/SCHOOL,219,6,2,5,30,95,138,11,149,0,O-87-182-05-03-04
NEBBI,OKORO COUNTY,PAIDHA SUB-COUNTY,OTHEKO,KULIGAMBA CHURCH,105,3,4,1,50,22,80,3,83,0,O-87-182-05-03-05
NEBBI,OKORO COUNTY,PAIDHA SUB-COUNTY,OTHEKO,OTHEKO P/SCHOOL (O - Z),335,7,4,8,123,102,244,4,248,0,O-87-182-05-03-06
NEBBI,OKORO COUNTY,PAIDHA SUB-COUNTY,PAKADHA,JUPUJURU GROUND,655,13,8,19,68,356,464,12,476,0,O-87-182-05-04-01
NEBBI,OKORO COUNTY,PAIDHA SUB-COUNTY,PAKADHA,MUZII,660,12,10,14,77,329,442,22,464,0,O-87-182-05-04-02
NEBBI,OKORO COUNTY,PAIDHA SUB-COUNTY,PAKADHA,PAKADHA P/SCHOOL,890,23,15,14,140,351,543,34,577,0,O-87-182-05-04-03
NEBBI,OKORO COUNTY,PAIDHA SUB-COUNTY,PAKADHA,KANISA ABEJU (C.O.U.),253,4,2,8,53,123,190,12,202,0,O-87-182-05-04-04
NEBBI,OKORO COUNTY,PAIDHA SUB-COUNTY,PAMITU,AMWONYO,806,27,7,18,108,329,489,31,520,0,O-87-182-05-05-01
NEBBI,OKORO COUNTY,PAIDHA SUB-COUNTY,PAMITU,ANDHI,553,10,9,14,69,296,398,24,422,0,O-87-182-05-05-02
NEBBI,OKORO COUNTY,PAIDHA SUB-COUNTY,PAMITU,ASINA P/SCHOOL,448,4,3,9,74,227,317,21,338,0,O-87-182-05-05-03
NEBBI,OKORO COUNTY,PAIDHA SUB-COUNTY,PAMITU,PAMITU COOP. SOCIETY,286,5,3,6,43,130,187,17,204,0,O-87-182-05-05-04
NEBBI,OKORO COUNTY,PAIDHA SUB-COUNTY,THANGA,AYUDA COOP SOCIETY,723,19,11,12,162,262,466,32,498,0,O-87-182-05-06-01
NEBBI,OKORO COUNTY,PAIDHA SUB-COUNTY,THANGA,THANGA TRADING CENTRE,514,6,5,5,111,272,399,11,410,0,O-87-182-05-06-02
NEBBI,OKORO COUNTY,PAIDHA TOWN COUNCIL,CENTRAL,BAR-OKORO,500,5,3,1,216,72,297,12,309,0,O-87-182-06-01-01
NEBBI,OKORO COUNTY,PAIDHA TOWN COUNCIL,CENTRAL,BUS PARK,544,4,1,0,171,112,288,1,289,0,O-87-182-06-01-02
NEBBI,OKORO COUNTY,PAIDHA TOWN COUNCIL,CENTRAL,PAIDHA POLICE STATION,1041,9,7,6,388,139,549,8,557,0,O-87-182-06-01-03
NEBBI,OKORO COUNTY,PAIDHA TOWN COUNCIL,CENTRAL,BAR-OKORO [KOLOLOAWINJIRI],519,4,3,3,172,73,255,9,264,0,O-87-182-06-01-04
NEBBI,OKORO COUNTY,PAIDHA TOWN COUNCIL,CENTRAL,ANDIKA,1035,10,4,3,358,172,547,10,557,0,O-87-182-06-01-05
NEBBI,OKORO COUNTY,PAIDHA TOWN COUNCIL,DWONGA,PAIDHA P.T.C.,654,5,7,6,207,198,423,29,452,0,O-87-182-06-02-01
NEBBI,OKORO COUNTY,PAIDHA TOWN COUNCIL,DWONGA,MADARASA PAIDHA MOSLEM,798,7,6,8,261,236,518,22,540,0,O-87-182-06-02-02
NEBBI,OKORO COUNTY,PAIDHA TOWN COUNCIL,OMUA II,CANA PRIMARY SCHOOL,650,12,4,3,154,131,304,108,412,0,O-87-182-06-03-01
NEBBI,OKORO COUNTY,PAIDHA TOWN COUNCIL,OMUA II,NGUTHE P/SCHOOL,469,12,6,3,159,132,312,7,319,0,O-87-182-06-03-02
NEBBI,OKORO COUNTY,PAIDHA TOWN COUNCIL,OMUA II,ZINGILI KALAFURU,768,8,9,8,260,154,439,11,450,0,O-87-182-06-03-03
NEBBI,OKORO COUNTY,PAIDHA TOWN COUNCIL,OMUA II,MAWA,871,6,8,6,351,155,526,25,551,0,O-87-182-06-03-04
NEBBI,OKORO COUNTY,PAIDHA TOWN COUNCIL,OTURGANG,BAR-JUPATHOMBO,554,12,6,8,138,246,410,23,433,0,O-87-182-06-04-01
NEBBI,OKORO COUNTY,PAIDHA TOWN COUNCIL,OTURGANG,PAIDHA SEC.SCHOOL,698,4,3,6,231,156,400,18,418,0,O-87-182-06-04-02
NEBBI,OKORO COUNTY,PAIDHA TOWN COUNCIL,OTURGANG,KAKIRA PRISON,639,9,2,8,229,168,416,10,426,0,O-87-182-06-04-03
NEBBI,OKORO COUNTY,ZEU,ABANGA,ABANGA FARM PR SCH,283,6,5,4,72,62,149,4,153,0,O-87-182-07-01-01
NEBBI,OKORO COUNTY,ZEU,ABANGA,ARII PR SCHOOL,455,13,3,10,144,128,298,12,310,0,O-87-182-07-01-02
NEBBI,OKORO COUNTY,ZEU,AYAKA,ARAA P SCHOOL,207,4,4,10,93,40,151,3,154,0,O-87-182-07-02-01
NEBBI,OKORO COUNTY,ZEU,AYAKA,AYAKA P SCHOOL,418,12,4,8,147,93,264,24,288,0,O-87-182-07-02-02
NEBBI,OKORO COUNTY,ZEU,AYAKA,ATHEJU CLUB,291,6,2,9,102,84,203,4,207,0,O-87-182-07-02-03
NEBBI,OKORO COUNTY,ZEU,JUPAMATHO,ADUSI PR SCH,427,10,9,12,162,88,281,13,294,0,O-87-182-07-03-01
NEBBI,OKORO COUNTY,ZEU,JUPAMATHO,ADHINGI PR SCHOOL,421,12,7,11,100,182,312,22,334,0,O-87-182-07-03-02
NEBBI,OKORO COUNTY,ZEU,JUPAMATHO,ARINGO CHAPEL,326,12,9,12,95,118,246,18,264,0,O-87-182-07-03-03
NEBBI,OKORO COUNTY,ZEU,JUPAMATHO,JUPAMATHO CHAPEL,178,6,2,1,99,23,131,6,137,0,O-87-182-07-03-04
NEBBI,OKORO COUNTY,ZEU,LENDU,OGALO CENTRE,247,8,2,2,88,80,180,8,188,0,O-87-182-07-04-01
NEBBI,OKORO COUNTY,ZEU,LENDU,LENDU FOREST STATION,326,5,12,13,117,75,222,13,235,0,O-87-182-07-04-02
NEBBI,OKORO COUNTY,ZEU,LENDU,AKEYO CLUB,346,12,3,13,93,133,254,14,268,0,O-87-182-07-04-03
NEBBI,OKORO COUNTY,ZEU,LENDU,PALWO PR SCHOOL,358,10,12,6,110,101,239,15,254,0,O-87-182-07-04-04
NEBBI,OKORO COUNTY,ZEU,OMOYO,NGUME P/SCHOOL,346,11,4,7,112,100,234,12,246,0,O-87-182-07-05-01
NEBBI,OKORO COUNTY,ZEU,OMOYO,SONGOLI CHAPEL,339,12,5,9,94,137,257,20,277,0,O-87-182-07-05-02
NEBBI,OKORO COUNTY,ZEU,OMOYO,ZEU HEALTH CENTRE,687,8,3,6,266,167,450,8,458,0,O-87-182-07-05-03
NEBBI,OKORO COUNTY,ZEU,PAGEI,ANGIA CLUB,460,22,6,17,174,102,321,11,332,0,O-87-182-07-06-01
NEBBI,OKORO COUNTY,ZEU,PAGEI,NDRINYI PRI. SCHOOL,356,14,7,12,81,121,235,26,261,0,O-87-182-07-06-02
NEBBI,OKORO COUNTY,ZEU,PAGEI,PAGEI PRI. SCHOOL,545,16,6,8,158,151,339,23,362,0,O-87-182-07-06-03
NEBBI,OKORO COUNTY,ZEU,PAPOGA,PAPOGA P. SCHOOL,564,6,4,7,158,189,364,21,385,0,O-87-182-07-07-01
NEBBI,OKORO COUNTY,ZEU,PAPOGA,ZALE TRADING CENTRE,682,11,10,13,248,185,467,29,496,0,O-87-182-07-07-02
NEBBI,OKORO COUNTY,ZEU,PAPOGA,ZEU P/SCHOOL,601,8,4,10,209,154,385,10,395,0,O-87-182-07-07-03
LIRA,MOROTO COUNTY,ABAKO,ACEDE,ARWOT P.7 SCHOOL,856,10,18,13,474,5,520,27,547,0,O-88-103-01-01-01
LIRA,MOROTO COUNTY,ABAKO,ACEDE,OGOGORO P.7 SCHOOL,613,7,7,0,411,11,436,1,437,0,O-88-103-01-01-02
LIRA,MOROTO COUNTY,ABAKO,ACEDE,AWEI TRADING CENTRE,607,8,11,19,357,9,404,11,415,0,O-88-103-01-01-03
LIRA,MOROTO COUNTY,ABAKO,ALANYI,ABAKO SUB-COUNTY HQRS,366,1,13,20,234,7,275,9,284,0,O-88-103-01-02-01
LIRA,MOROTO COUNTY,ABAKO,ALANYI,P.W.D ALANYI,668,6,18,10,446,11,491,13,504,0,O-88-103-01-02-02
LIRA,MOROTO COUNTY,ABAKO,ALANYI,ABAKO P.7 SCHOOL,731,3,17,10,382,8,420,23,443,0,O-88-103-01-02-03
LIRA,MOROTO COUNTY,ABAKO,ALANYI,ALANYI P.7 SCHOOL,710,4,17,11,434,15,481,22,503,0,O-88-103-01-02-04
LIRA,MOROTO COUNTY,ABAKO,ALANYI,TE-IKWIA,150,2,4,7,75,2,90,0,90,0,O-88-103-01-02-05
LIRA,MOROTO COUNTY,ABAKO,AMONONENO,AMONONENO P.7 SCHOOL,693,15,17,27,424,7,490,8,498,0,O-88-103-01-03-01
LIRA,MOROTO COUNTY,ABAKO,AMONONENO,AKAYI,653,9,8,17,348,9,391,9,400,0,O-88-103-01-03-02
LIRA,MOROTO COUNTY,ABAKO,AMONONENO,OGWANG OKORI,782,3,8,14,392,9,426,6,432,0,O-88-103-01-03-03
LIRA,MOROTO COUNTY,ABAKO,AMONONENO,NEK BED PE,565,6,7,8,321,2,344,11,355,0,O-88-103-01-03-04
LIRA,MOROTO COUNTY,ABAKO,AWAPINY,OKUT SCHOOL,579,15,9,20,352,4,400,10,410,0,O-88-103-01-04-01
LIRA,MOROTO COUNTY,ABAKO,AWAPINY,APAMI SCHOOL,621,6,16,9,324,3,358,26,384,0,O-88-103-01-04-02
LIRA,MOROTO COUNTY,ABAKO,AWAPINY,AGWENG BAR,535,1,7,2,279,0,289,5,294,0,O-88-103-01-04-03
LIRA,MOROTO COUNTY,ABAKO,AWAPINY,ARWOM BAR,526,3,2,4,302,5,316,4,320,0,O-88-103-01-04-04
LIRA,MOROTO COUNTY,ABAKO,OJUL,OJUL,644,10,28,17,372,7,434,9,443,0,O-88-103-01-05-01
LIRA,MOROTO COUNTY,ABAKO,OJUL,TE-YAO,439,3,3,2,314,3,325,5,330,0,O-88-103-01-05-02
LIRA,MOROTO COUNTY,ABAKO,OJUL,OBANGA PEWANY,523,4,14,9,316,5,348,6,354,0,O-88-103-01-05-03
LIRA,MOROTO COUNTY,ABAKO,OLYET,OYENGOLWEDO P.7 SCHOOL,649,8,25,11,379,7,430,13,443,0,O-88-103-01-06-01
LIRA,MOROTO COUNTY,ABAKO,OLYET,ANEKAPIRIT MARKET,390,5,8,12,235,2,262,27,289,0,O-88-103-01-06-02
LIRA,MOROTO COUNTY,ABAKO,OWALO,TE-ONGORA I,750,11,9,5,603,11,639,17,656,0,O-88-103-01-07-01
LIRA,MOROTO COUNTY,ABAKO,OWALO,TE-ONGORA II,578,10,8,6,502,2,528,13,541,0,O-88-103-01-07-02
LIRA,MOROTO COUNTY,ABAKO,OWALO,OWALO P.7 SCHOOL,551,5,38,1,375,15,434,6,440,0,O-88-103-01-07-03
LIRA,MOROTO COUNTY,ALOI,AKURA,ALIRA P7 SCHOOL,534,2,23,3,250,4,282,2,284,0,O-88-103-02-01-01
LIRA,MOROTO COUNTY,ALOI,AKURA,TANGCI OMELLE,550,3,27,10,321,7,368,7,375,0,O-88-103-02-01-02
LIRA,MOROTO COUNTY,ALOI,AKURA,AKURA SUB-DISPENSARY,682,4,25,18,306,7,360,10,370,0,O-88-103-02-01-03
LIRA,MOROTO COUNTY,ALOI,AKURA,AGORO P.7 SCHOOL,729,5,8,2,374,1,390,4,394,0,O-88-103-02-01-04
LIRA,MOROTO COUNTY,ALOI,AKURA,OKELLO - OGWEL,229,2,5,6,141,9,163,0,163,0,O-88-103-02-01-05
LIRA,MOROTO COUNTY,ALOI,AKWANGKEL,KAKIRA P.7 SCHOOL A,477,3,20,16,327,80,446,10,456,0,O-88-103-02-02-01
LIRA,MOROTO COUNTY,ALOI,AKWANGKEL,KAKIRA P.7 SCHOOL B,516,3,12,9,358,7,389,10,399,0,O-88-103-02-02-02
LIRA,MOROTO COUNTY,ALOI,AKWANGKEL,OLOO MARKET,594,0,8,6,420,0,434,8,442,0,O-88-103-02-02-03
LIRA,MOROTO COUNTY,ALOI,AKWANGKEL,AMURIA CHURCH,263,6,5,6,168,3,188,2,190,0,O-88-103-02-02-04
LIRA,MOROTO COUNTY,ALOI,AKWANGKEL,AWINY P.7 SCHOOL,506,6,21,6,342,10,385,3,388,0,O-88-103-02-02-05
LIRA,MOROTO COUNTY,ALOI,ALAL,ALOI S S I,211,0,6,2,122,6,136,4,140,0,O-88-103-02-03-01
LIRA,MOROTO COUNTY,ALOI,ALAL,ALOI S.S III,926,7,14,12,524,37,594,12,606,0,O-88-103-02-03-02
LIRA,MOROTO COUNTY,ALOI,ALAL,OGENGO P 7 SCHOOL,566,4,7,5,326,11,353,10,363,0,O-88-103-02-03-03
LIRA,MOROTO COUNTY,ALOI,ALAL,ANAM OTURA MARKET,498,3,13,8,292,11,327,7,334,0,O-88-103-02-03-04
LIRA,MOROTO COUNTY,ALOI,ALAL,LAKCANI,371,2,6,3,214,1,226,6,232,0,O-88-103-02-03-05
LIRA,MOROTO COUNTY,ALOI,ALAL,OMIO CHAPEL,287,3,9,8,185,3,208,3,211,0,O-88-103-02-03-06
LIRA,MOROTO COUNTY,ALOI,ALEBTONG,ALEBTONG HQTRS A,534,6,10,7,343,6,372,10,382,0,O-88-103-02-04-01
LIRA,MOROTO COUNTY,ALOI,ALEBTONG,ALEBTONG HEADQUARTERS B,635,5,17,11,363,9,405,0,405,0,O-88-103-02-04-02
LIRA,MOROTO COUNTY,ALOI,ALEBTONG,APADO,651,3,11,8,473,6,501,0,501,0,O-88-103-02-04-03
LIRA,MOROTO COUNTY,ALOI,ALEBTONG,EYAMA P.7 SCHOOL,613,4,11,8,349,7,379,3,382,0,O-88-103-02-04-04
LIRA,MOROTO COUNTY,ALOI,ANARA,ANARA A,456,6,11,10,240,5,272,4,276,0,O-88-103-02-05-01
LIRA,MOROTO COUNTY,ALOI,ANARA,ANARA B,387,6,4,3,221,2,236,8,244,0,O-88-103-02-05-02
LIRA,MOROTO COUNTY,ALOI,ANARA,ANARA C,526,4,2,3,278,13,300,7,307,0,O-88-103-02-05-03
LIRA,MOROTO COUNTY,ALOI,ANYANGA,OCHABO P.7 SCHOOL I,521,5,20,13,352,9,399,7,406,0,O-88-103-02-06-01
LIRA,MOROTO COUNTY,ALOI,ANYANGA,OCHABO P.7 SCHOOL II,700,4,39,13,418,10,484,15,499,0,O-88-103-02-06-02
LIRA,MOROTO COUNTY,ALOI,ANYANGA,OCHABO P.7 SCHOOL III,306,4,10,8,214,2,238,3,241,0,O-88-103-02-06-03
LIRA,MOROTO COUNTY,ALOI,ANYANGA,OCHABO P.7 SCHOOL IV,651,5,17,6,374,6,408,12,420,0,O-88-103-02-06-04
LIRA,MOROTO COUNTY,ALOI,AWIEPEK,OCIN CHANNELS,664,15,28,19,391,6,459,20,479,0,O-88-103-02-07-01
LIRA,MOROTO COUNTY,ALOI,AWIEPEK,OMARA C.P,534,7,19,12,304,6,348,9,357,0,O-88-103-02-07-02
LIRA,MOROTO COUNTY,ALOI,OTWEOTOKE,IBELE,406,2,17,14,242,1,276,14,290,0,O-88-103-02-08-01
LIRA,MOROTO COUNTY,ALOI,OTWEOTOKE,FATIMA DEM SCHOOL,581,6,25,9,363,22,425,0,425,0,O-88-103-02-08-02
LIRA,MOROTO COUNTY,ALOI,OTWEOTOKE,OMARA ERIASAZI,571,6,34,4,379,7,430,20,450,0,O-88-103-02-08-03
LIRA,MOROTO COUNTY,AMUGU,ABONGOATIN,EBULE P 7 SCHOOL I,495,5,9,3,241,10,268,1,269,0,O-88-103-03-01-01
LIRA,MOROTO COUNTY,AMUGU,ABONGOATIN,AKAMDINI,493,3,5,7,236,6,257,6,263,0,O-88-103-03-01-02
LIRA,MOROTO COUNTY,AMUGU,ABONGOATIN,EBULE P.7 SCHOOL III,575,3,9,2,296,11,321,7,328,0,O-88-103-03-01-03
LIRA,MOROTO COUNTY,AMUGU,ABONGOATIN,OBANGANGEO,263,2,5,1,147,3,158,3,161,0,O-88-103-03-01-04
LIRA,MOROTO COUNTY,AMUGU,ABUNGA,BARORYO,360,2,12,4,211,5,234,3,237,0,O-88-103-03-02-01
LIRA,MOROTO COUNTY,AMUGU,ABUNGA,OCOM,753,7,17,12,477,3,516,3,519,0,O-88-103-03-02-02
LIRA,MOROTO COUNTY,AMUGU,ABUNGA,AKADDAYUBO,552,3,15,7,362,17,404,3,407,0,O-88-103-03-02-03
LIRA,MOROTO COUNTY,AMUGU,ABUNGA,BAROYO,398,1,11,14,258,5,289,5,294,0,O-88-103-03-02-04
LIRA,MOROTO COUNTY,AMUGU,AJONYI,AMUGO P.7 SCHOOL,618,8,15,8,436,18,485,6,491,0,O-88-103-03-03-01
LIRA,MOROTO COUNTY,AMUGU,AJONYI,AJONYI P 7 SCHOOL,831,6,15,10,570,16,617,24,641,0,O-88-103-03-03-02
LIRA,MOROTO COUNTY,AMUGU,OMEE,OTENO MARKET,479,6,8,13,277,10,314,17,331,0,O-88-103-03-04-01
LIRA,MOROTO COUNTY,AMUGU,OMEE,ABOLOLIL SCHOOL,501,6,15,12,305,5,343,6,349,0,O-88-103-03-04-02
LIRA,MOROTO COUNTY,AMUGU,OMEE,CAMP,437,4,3,0,225,3,235,3,238,0,O-88-103-03-04-03
LIRA,MOROTO COUNTY,AMUGU,OMEE,AORI SOCIETY,263,2,12,3,119,3,139,0,139,0,O-88-103-03-04-04
LIRA,MOROTO COUNTY,AMUGU,OMEE,OKAONYAC,359,2,17,3,166,8,196,4,200,0,O-88-103-03-04-05
LIRA,MOROTO COUNTY,AMUGU,OMEE,APUT,313,2,5,4,130,1,142,11,153,0,O-88-103-03-04-06
LIRA,MOROTO COUNTY,APALA,ABIA,ABIA P.7 SCHOOL,714,6,25,17,419,19,486,21,507,0,O-88-103-04-01-01
LIRA,MOROTO COUNTY,APALA,ABIA,ABEIDWOGO,720,0,22,6,422,7,457,3,460,0,O-88-103-04-01-02
LIRA,MOROTO COUNTY,APALA,ABIA,TE OBIA,431,4,9,9,252,1,275,1,276,0,O-88-103-04-01-03
LIRA,MOROTO COUNTY,APALA,ABIA,ABIA OUTSIDE Q. GUARD,54,0,0,0,0,0,0,0,0,1,O-88-103-04-01-04
LIRA,MOROTO COUNTY,APALA,ABIITING,ABALODYANG P.7 SCH,489,7,17,12,285,11,332,8,340,0,O-88-103-04-02-01
LIRA,MOROTO COUNTY,APALA,ABIITING,ALUTI,666,12,28,10,393,16,459,3,462,0,O-88-103-04-02-02
LIRA,MOROTO COUNTY,APALA,ABIITING,TELELA P.7 SCH,774,8,17,16,422,8,471,8,479,0,O-88-103-04-02-03
LIRA,MOROTO COUNTY,APALA,ABIITING,OLAOILONG,229,2,3,1,149,3,158,9,167,0,O-88-103-04-02-04
LIRA,MOROTO COUNTY,APALA,ATINKOK,AWALI,596,9,13,6,425,18,471,11,482,0,O-88-103-04-03-01
LIRA,MOROTO COUNTY,APALA,ATINKOK,AGUREDENGE I,551,2,13,3,343,9,370,3,373,0,O-88-103-04-03-02
LIRA,MOROTO COUNTY,APALA,ATINKOK,AGUREDENGE II,358,3,8,2,215,3,231,3,234,0,O-88-103-04-03-03
LIRA,MOROTO COUNTY,APALA,ATINKOK,AWINY-ORU,519,4,7,1,313,7,332,3,335,0,O-88-103-04-03-04
LIRA,MOROTO COUNTY,APALA,OBIM,SUNDAY CLUB I,622,12,23,8,415,16,474,28,502,0,O-88-103-04-04-01
LIRA,MOROTO COUNTY,APALA,OBIM,SUNDAY CLUB II,383,1,22,4,232,21,280,6,286,0,O-88-103-04-04-02
LIRA,MOROTO COUNTY,APALA,OBIM,BEIWE,608,9,35,7,472,7,530,3,533,0,O-88-103-04-04-03
LIRA,MOROTO COUNTY,APALA,OKWANGOLE,APALA SUB-COUNTY HEADQUATE,195,0,3,1,131,1,136,0,136,0,O-88-103-04-05-01
LIRA,MOROTO COUNTY,APALA,OKWANGOLE,APALLA T.C (A-M),557,5,13,8,373,10,409,10,419,0,O-88-103-04-05-02
LIRA,MOROTO COUNTY,APALA,OKWANGOLE,APALLA T.C (N-Z),432,0,12,1,289,4,306,0,306,0,O-88-103-04-05-03
LIRA,MOROTO COUNTY,APALA,OKWANGOLE,OLORO P.7 SCH,570,4,12,5,335,25,381,3,384,0,O-88-103-04-05-04
LIRA,MOROTO COUNTY,APALA,OKWANGOLE,ADOMA P.7 SCH,299,1,7,2,231,3,244,2,246,0,O-88-103-04-05-05
LIRA,MOROTO COUNTY,APALA,OKWANGOLE,OKALOAPANY,322,1,7,4,232,0,244,11,255,0,O-88-103-04-05-06
LIRA,MOROTO COUNTY,APALA,OTENO,TE-YAO I,718,2,38,9,432,4,485,9,494,0,O-88-103-04-06-01
LIRA,MOROTO COUNTY,APALA,OTENO,TE-YAO II,554,0,10,4,337,1,352,2,354,0,O-88-103-04-06-02
LIRA,MOROTO COUNTY,APALA,OTENO,TE-YAO III,681,3,10,3,420,3,439,2,441,0,O-88-103-04-06-03
LIRA,MOROTO COUNTY,OMORO,ABUKAMOLA,OMORO SSS,824,4,14,19,295,40,372,7,379,0,O-88-103-05-01-01
LIRA,MOROTO COUNTY,OMORO,ABUKAMOLA,OKOKOLAKO (A-C),452,10,9,15,213,6,253,22,275,0,O-88-103-05-01-02
LIRA,MOROTO COUNTY,OMORO,ABUKAMOLA,BAROPIRO,657,2,9,9,335,2,357,7,364,0,O-88-103-05-01-03
LIRA,MOROTO COUNTY,OMORO,ABUKAMOLA,OKOKOLAKO (D-Z),353,4,5,5,208,5,227,4,231,0,O-88-103-05-01-04
LIRA,MOROTO COUNTY,OMORO,ALOLOLOLO,ALOLOLO P.7 SCHHOOL (A-C),376,5,3,6,71,1,86,3,89,0,O-88-103-05-02-01
LIRA,MOROTO COUNTY,OMORO,ALOLOLOLO,OKURO P.7 SCHOOL,472,4,2,2,116,2,126,38,164,0,O-88-103-05-02-02
LIRA,MOROTO COUNTY,OMORO,ALOLOLOLO,ALOLOLO P.7 SCHHOOL (D-Z),296,1,1,2,81,2,87,0,87,0,O-88-103-05-02-03
LIRA,MOROTO COUNTY,OMORO,ANGETTA,ANGETTA P.7 SCHOOL (A-A),570,3,9,9,193,3,217,2,219,0,O-88-103-05-03-01
LIRA,MOROTO COUNTY,OMORO,ANGETTA,TELELA P 6 SCHOOL,577,5,6,6,294,10,321,0,321,0,O-88-103-05-03-02
LIRA,MOROTO COUNTY,OMORO,ANGETTA,OKURANGO P.7 SCHOOL,562,5,6,14,306,16,347,0,347,0,O-88-103-05-03-03
LIRA,MOROTO COUNTY,OMORO,ANGETTA,OBUO P.7 SCHOOL,590,4,1,9,224,8,246,12,258,0,O-88-103-05-03-04
LIRA,MOROTO COUNTY,OMORO,ANGETTA,ANGETTA P.7 SCHOOL (B-Z),454,3,6,1,199,7,216,6,222,0,O-88-103-05-03-05
LIRA,MOROTO COUNTY,OMORO,ANGETTA,TE-OLAM,403,6,3,2,167,1,179,9,188,0,O-88-103-05-03-06
LIRA,MOROTO COUNTY,OMORO,OCOKOBER,ADWIRI P.7 SCHOOL,565,2,5,6,242,10,265,17,282,0,O-88-103-05-04-01
LIRA,MOROTO COUNTY,OMORO,OCOKOBER,ADWIRI P.6 SCHOOL,587,5,3,9,224,12,253,11,264,0,O-88-103-05-04-02
LIRA,MOROTO COUNTY,OMORO,OCULOKORI,ALEBELEBE P.7 SCHOOL,566,3,7,10,264,4,288,4,292,0,O-88-103-05-05-01
LIRA,MOROTO COUNTY,OMORO,OCULOKORI,OMORO NORTH P7 SCHOOL,556,7,14,17,214,28,280,2,282,0,O-88-103-05-05-02
LIRA,MOROTO COUNTY,OMORO,OMARARI,OMARARI P.7 SCHOOL,673,10,13,6,247,16,292,5,297,0,O-88-103-05-06-01
LIRA,MOROTO COUNTY,OMORO,OMARARI,OBILE P.7 SCHOOL,620,5,9,8,264,0,286,6,292,0,O-88-103-05-06-02
LIRA,MOROTO COUNTY,OMORO,OMARARI,AKWANI LUM P.7 SCHOOL,738,22,137,0,103,0,262,1,263,0,O-88-103-05-06-03
APAC,KOLE COUNTY,ABOKE,AKWIRIDIDI,IMATO P 7   SCHOOL A,363,8,10,8,203,5,234,10,244,0,O-103-1-01-01-01
APAC,KOLE COUNTY,ABOKE,AKWIRIDIDI,IMATO P.7 SCHOOL B,618,12,31,20,276,17,356,20,376,0,O-103-1-01-01-02
APAC,KOLE COUNTY,ABOKE,AKWIRIDIDI,GWOKNENO ACWARI  MARKET,440,13,14,20,235,26,308,10,318,0,O-103-1-01-01-03
APAC,KOLE COUNTY,ABOKE,AKWIRIDIDI,ABOKE SUB COUNTY HEADQUAT,595,5,34,2,294,13,348,9,357,0,O-103-1-01-01-04
APAC,KOLE COUNTY,ABOKE,AKWIRIDIDI,ABOKE SUB COUNTY HQTRS B,523,8,20,4,284,15,331,11,342,0,O-103-1-01-01-05
APAC,KOLE COUNTY,ABOKE,AKWIRIDIDI,WIPIP P.7 SCHOOL,576,15,58,15,315,19,422,12,434,0,O-103-1-01-01-06
APAC,KOLE COUNTY,ABOKE,APACH,TE-ITEK,641,8,25,7,449,20,509,9,518,0,O-103-1-01-02-01
APAC,KOLE COUNTY,ABOKE,APACH,APEDI   P 7 SCHOOL,709,11,32,11,493,18,565,3,568,0,O-103-1-01-02-02
APAC,KOLE COUNTY,ABOKE,APACH,AGWET   P 7   SCHOOL,633,0,15,4,435,34,488,6,494,0,O-103-1-01-02-03
APAC,KOLE COUNTY,ABOKE,APACH,TELELA,410,7,14,4,271,35,331,8,339,0,O-103-1-01-02-04
APAC,KOLE COUNTY,ABOKE,APACH,PE-GERE,130,0,1,1,114,2,118,1,119,0,O-103-1-01-02-05
APAC,KOLE COUNTY,ABOKE,APURU,OGWANGADAR P 7   SCHOOL,520,20,18,3,308,35,384,15,399,0,O-103-1-01-03-01
APAC,KOLE COUNTY,ABOKE,APURU,AKUTI MARKET,504,8,19,15,292,34,368,19,387,0,O-103-1-01-03-02
APAC,KOLE COUNTY,ABOKE,APURU,ABONGODERO BOYS,959,13,55,11,437,47,563,18,581,0,O-103-1-01-03-03
APAC,KOLE COUNTY,ABOKE,APURU,OBANGA ATWERO,235,6,10,129,6,16,167,13,180,0,O-103-1-01-03-04
APAC,KOLE COUNTY,ABOKE,OGWANGACUMA,ALYAT P 7 SCHOOL,492,0,25,1,254,23,303,42,345,0,O-103-1-01-04-01
APAC,KOLE COUNTY,ABOKE,OGWANGACUMA,ABOKE HEALTH CENTRE,547,13,19,8,278,34,352,10,362,0,O-103-1-01-04-02
APAC,KOLE COUNTY,ABOKE,OGWANGACUMA,ACULABANYA S S S,610,6,28,10,279,88,411,13,424,0,O-103-1-01-04-03
APAC,KOLE COUNTY,ABOKE,OGWANGACUMA,ACULBANYA P 7   SCHOOL,619,5,29,11,288,46,379,19,398,0,O-103-1-01-04-04
APAC,KOLE COUNTY,ABOKE,OGWANGACUMA,AWEINGWEC P/S,183,6,13,4,91,11,125,17,142,0,O-103-1-01-04-05
APAC,KOLE COUNTY,ABOKE,OPETA,ONORO P.7 SCHOOL,608,4,28,6,413,19,470,6,476,0,O-103-1-01-05-01
APAC,KOLE COUNTY,ABOKE,OPETA,OPETA P 7   SCHOOL,884,14,24,23,558,32,651,0,651,0,O-103-1-01-05-02
APAC,KOLE COUNTY,ABOKE,OPETA,ABOKE GINNERY T CENTRE,636,5,35,6,402,25,473,17,490,0,O-103-1-01-05-03
APAC,KOLE COUNTY,ABOKE,OPETA,ABAKO,403,5,11,1,256,14,287,15,302,0,O-103-1-01-05-04
APAC,KOLE COUNTY,AKALO,ABELI,LORO CHAPEL,527,8,26,11,311,23,379,14,393,0,O-103-1-02-01-01
APAC,KOLE COUNTY,AKALO,ABELI,ATIN ATIN MARKET,493,11,34,16,269,12,342,5,347,0,O-103-1-02-01-02
APAC,KOLE COUNTY,AKALO,ABELI,LUKA MEMORIAL P 7 SCHOOL,598,12,28,14,301,23,378,45,423,0,O-103-1-02-01-03
APAC,KOLE COUNTY,AKALO,ADYANG,WITIM,535,16,40,20,268,20,364,18,382,0,O-103-1-02-02-01
APAC,KOLE COUNTY,AKALO,ADYANG,ATILEM T. CENTRE,530,10,29,3,236,34,312,87,399,0,O-103-1-02-02-02
APAC,KOLE COUNTY,AKALO,ADYANG,ADYANG P 7 SCHOOL,559,7,45,9,312,31,404,35,439,0,O-103-1-02-02-03
APAC,KOLE COUNTY,AKALO,ADYEDA,OWALO MARKET,567,6,42,12,352,47,459,7,466,0,O-103-1-02-03-01
APAC,KOLE COUNTY,AKALO,ADYEDA,ADYEDA P 7   SCHOOL,453,5,35,1,171,39,251,55,306,0,O-103-1-02-03-02
APAC,KOLE COUNTY,AKALO,ADYEDA,SUB COUNTY HQTRS,424,4,22,1,181,25,233,64,297,0,O-103-1-02-03-03
APAC,KOLE COUNTY,AKALO,ADYEDA,TIKOLING P.7 SCHOOL,403,3,28,8,205,20,264,0,264,0,O-103-1-02-03-04
APAC,KOLE COUNTY,AKALO,BAR-AKALO,AGERINONO,571,3,36,17,318,16,390,18,408,0,O-103-1-02-04-01
APAC,KOLE COUNTY,AKALO,BAR-AKALO,ST   PAUL P 7 SCHOOL,547,6,41,12,337,35,431,6,437,0,O-103-1-02-04-02
APAC,KOLE COUNTY,AKALO,BAR-AKALO,WANG-PEDING,381,0,20,2,273,11,306,6,312,0,O-103-1-02-04-03
APAC,KOLE COUNTY,AKALO,BAR-AKALO,ADUR-BE-IWE,344,4,13,6,203,22,248,13,261,0,O-103-1-02-04-04
APAC,KOLE COUNTY,ALITO,ADEL-LOGO,ALANG P 7   SCHOOL,512,5,28,8,344,16,401,5,406,0,O-103-1-03-01-01
APAC,KOLE COUNTY,ALITO,ADEL-LOGO,TIK GIN OKELI,571,11,15,7,341,13,387,8,395,0,O-103-1-03-01-02
APAC,KOLE COUNTY,ALITO,ADEL-LOGO,ATIM UMA,374,9,12,8,237,6,272,7,279,0,O-103-1-03-01-03
APAC,KOLE COUNTY,ALITO,ADEL-LOGO,ADELLOGO P 7   SCHOOL,649,6,14,5,428,17,470,15,485,0,O-103-1-03-01-04
APAC,KOLE COUNTY,ALITO,ADEL-LOGO,TUK IULA,518,5,17,6,330,10,368,67,435,0,O-103-1-03-01-05
APAC,KOLE COUNTY,ALITO,AKWERODOT,OKWERODOT P.7 SCHOOL,467,14,38,14,291,19,376,4,380,0,O-103-1-03-02-01
APAC,KOLE COUNTY,ALITO,AKWERODOT,ALAKE P. SCHOOL,430,3,21,6,288,21,339,16,355,0,O-103-1-03-02-02
APAC,KOLE COUNTY,ALITO,AKWERODOT,LWALA,596,13,13,8,427,34,495,16,511,0,O-103-1-03-02-03
APAC,KOLE COUNTY,ALITO,AKWERODOT,ALYEC CHAPLE,382,5,22,3,287,19,336,8,344,0,O-103-1-03-02-04
APAC,KOLE COUNTY,ALITO,ALITO,AGOMA,660,11,5,6,471,2,495,10,505,0,O-103-1-03-03-01
APAC,KOLE COUNTY,ALITO,ALITO,ANENOBER,361,3,6,4,227,3,243,23,266,0,O-103-1-03-03-02
APAC,KOLE COUNTY,ALITO,ALITO,ALITO SUB-COUNTY,476,7,13,4,312,10,346,17,363,0,O-103-1-03-03-03
APAC,KOLE COUNTY,ALITO,ALITO,ATAN P7 SCHOOL,587,4,15,5,338,37,399,11,410,0,O-103-1-03-03-04
APAC,KOLE COUNTY,ALITO,ALITO,ALYATO,647,9,12,7,393,11,432,28,460,0,O-103-1-03-03-05
APAC,KOLE COUNTY,ALITO,APALA,BAR PII SCHOOL,548,8,40,7,415,5,475,3,478,0,O-103-1-03-04-01
APAC,KOLE COUNTY,ALITO,APALA,BAR OWO P 7 SCHOOL,527,9,30,8,375,25,447,4,451,0,O-103-1-03-04-02
APAC,KOLE COUNTY,ALITO,APALA,ACANKADO P 7 SCHOOL,653,18,32,11,416,24,501,2,503,0,O-103-1-03-04-03
APAC,KOLE COUNTY,ALITO,APALA,OBUTO P 7   SCHOOL,624,24,32,7,424,6,493,12,505,0,O-103-1-03-04-04
APAC,KOLE COUNTY,ALITO,AYALA,TEKEO CHURCH,550,4,14,12,327,57,414,14,428,0,O-103-1-03-05-01
APAC,KOLE COUNTY,ALITO,AYALA,ORUNI COOP SOCIETY,696,8,26,7,468,17,526,19,545,0,O-103-1-03-05-02
APAC,KOLE COUNTY,ALITO,AYALA,AYARA P 7 SCHOOL,498,4,19,5,283,32,343,12,355,0,O-103-1-03-05-03
APAC,KOLE COUNTY,ALITO,AYALA,AJUKI CHURCH,362,4,21,4,263,4,296,8,304,0,O-103-1-03-05-04
APAC,KOLE COUNTY,ALITO,AYALA,BARODWONG C.O.U,230,3,7,2,160,16,188,7,195,0,O-103-1-03-05-05
APAC,KOLE COUNTY,ALITO,AYARA,ANEKAPIRI MARKET,256,7,14,3,141,16,181,5,186,0,O-103-1-03-06-01
APAC,KOLE COUNTY,ALITO,AYARA,ONYUT P.7 SCHOOL,711,7,16,1,530,15,569,7,576,0,O-103-1-03-06-02
APAC,KOLE COUNTY,ALITO,AYARA,ABIM P.7 SCHOOL,693,14,31,15,475,12,547,11,558,0,O-103-1-03-06-03
APAC,KOLE COUNTY,ALITO,AYARA,ALOGONONO MARKET,632,10,10,3,499,8,530,13,543,0,O-103-1-03-06-04
APAC,KOLE COUNTY,ALITO,AYARA,ORUPO VILLAGE,287,8,10,1,194,3,216,33,249,0,O-103-1-03-06-05
APAC,KOLE COUNTY,ALITO,AYARA,APENA - ONY,333,13,24,6,211,12,266,10,276,0,O-103-1-03-06-06
APAC,KOLE COUNTY,ALITO,OTKWACH,ALITO LEPER,456,2,14,9,247,14,286,8,294,0,O-103-1-03-07-01
APAC,KOLE COUNTY,ALITO,OTKWACH,OLIPA P 7 SCHOOL,455,3,15,5,301,2,326,9,335,0,O-103-1-03-07-02
APAC,KOLE COUNTY,ALITO,OTKWACH,OTKWACH AMALO,466,7,17,8,288,20,340,18,358,0,O-103-1-03-07-03
APAC,KOLE COUNTY,ALITO,OTKWACH,APIOGURU P.7 SCHOOL,439,2,12,0,247,7,268,12,280,0,O-103-1-03-07-04
APAC,KOLE COUNTY,ALITO,OTKWACH,AWAKADUNY,286,4,9,1,181,0,195,17,212,0,O-103-1-03-07-05
APAC,KOLE COUNTY,AYER,ABUR,ABUR P 7 SCHOOL,331,11,10,6,168,22,217,10,227,0,O-103-1-04-01-01
APAC,KOLE COUNTY,AYER,ABUR,LWALA MARKET,670,2,14,4,341,36,397,92,489,0,O-103-1-04-01-02
APAC,KOLE COUNTY,AYER,ABUR,ALEE MARKET,500,7,25,4,297,33,366,15,381,0,O-103-1-04-01-03
APAC,KOLE COUNTY,AYER,ABUR,AGWEA T.C,350,4,23,7,151,34,219,16,235,0,O-103-1-04-01-04
APAC,KOLE COUNTY,AYER,ALEMI,ATIMINGO MARKET,368,17,15,16,200,34,282,1,283,0,O-103-1-04-02-01
APAC,KOLE COUNTY,AYER,ALEMI,ABILONINO,429,6,17,5,210,29,267,6,273,0,O-103-1-04-02-02
APAC,KOLE COUNTY,AYER,ALEMI,AYEE  S S,696,15,33,17,399,37,501,15,516,0,O-103-1-04-02-03
APAC,KOLE COUNTY,AYER,ALEMI,ABELI,602,13,29,6,369,22,439,13,452,0,O-103-1-04-02-04
APAC,KOLE COUNTY,AYER,ALEMI,ABAKO MARKET,339,4,18,6,170,38,236,8,244,0,O-103-1-04-02-05
APAC,KOLE COUNTY,AYER,AYER,KOLE COUNTY HQRS,586,5,25,4,163,124,321,105,426,0,O-103-1-04-03-01
APAC,KOLE COUNTY,AYER,AYER,AYER P.7 SCHOOL,534,4,23,3,309,64,403,15,418,0,O-103-1-04-03-02
APAC,KOLE COUNTY,AYER,ILERA,APALA,668,11,28,11,398,47,495,16,511,0,O-103-1-04-04-01
APAC,KOLE COUNTY,AYER,ILERA,APII P 7 SCHOOL,534,6,20,4,292,41,363,48,411,0,O-103-1-04-04-02
APAC,KOLE COUNTY,AYER,ILERA,BUNG,568,12,46,10,313,40,421,18,439,0,O-103-1-04-04-03
APAC,KOLE COUNTY,AYER,OKWOR,BE-IWE MARKET,594,16,9,18,334,77,454,9,463,0,O-103-1-04-05-01
APAC,KOLE COUNTY,AYER,OKWOR,OKWOR P 7   SCHOOL,449,8,12,9,273,40,342,12,354,0,O-103-1-04-05-02
APAC,KOLE COUNTY,AYER,OKWOR,ATEK B,448,6,28,8,260,34,336,7,343,0,O-103-1-04-05-03
APAC,KOLE COUNTY,AYER,TELELA,BARAMINDYANG P.7,618,8,29,11,358,50,456,12,468,0,O-103-1-04-06-01
APAC,KOLE COUNTY,AYER,TELELA,MONDAY MARKET,558,4,21,8,287,31,351,85,436,0,O-103-1-04-06-02
APAC,KOLE COUNTY,AYER,TELELA,BE-IWE PIDA N.2,684,24,38,17,363,54,496,19,515,0,O-103-1-04-06-03
APAC,KOLE COUNTY,AYER,TELELA,WEDNESDAY MARKET,318,6,11,0,191,24,232,31,263,0,O-103-1-04-06-04
APAC,KOLE COUNTY,BALLA,AGEGE,ABERDYANGOTO P 7 SCHOOL,250,2,8,1,120,19,150,32,182,0,O-103-1-05-01-01
APAC,KOLE COUNTY,BALLA,AGEGE,ALEMI P.7 SCHOOL,413,3,26,1,203,11,244,76,320,0,O-103-1-05-01-02
APAC,KOLE COUNTY,BALLA,AGEGE,APELO T. CENTRE,602,5,38,4,398,28,473,3,476,0,O-103-1-05-01-03
APAC,KOLE COUNTY,BALLA,AGEGE,DAM ALIDI MARKET,237,4,12,3,131,4,154,11,165,0,O-103-1-05-01-04
APAC,KOLE COUNTY,BALLA,AGEGE,TE-SOCIETY,283,1,28,1,157,11,198,29,227,0,O-103-1-05-01-05
APAC,KOLE COUNTY,BALLA,AGEGE,PAMAMUNU,129,2,7,0,65,13,87,22,109,0,O-103-1-05-01-06
APAC,KOLE COUNTY,BALLA,AUMI,ABONGO NGWEN,535,6,55,6,285,29,381,36,417,0,O-103-1-05-02-01
APAC,KOLE COUNTY,BALLA,AUMI,OLAI,407,8,39,6,191,29,273,4,277,0,O-103-1-05-02-02
APAC,KOLE COUNTY,BALLA,AUMI,AUMI P.7 SCHOOL,505,1,29,1,295,33,359,20,379,0,O-103-1-05-02-03
APAC,KOLE COUNTY,BALLA,AUMI,ABANGOLAM TRADING CENTER,216,0,56,1,78,16,151,10,161,0,O-103-1-05-02-04
APAC,KOLE COUNTY,BALLA,AUMI,TE IBULE,223,2,18,1,108,16,145,9,154,0,O-103-1-05-02-05
APAC,KOLE COUNTY,BALLA,BALA,ANYONGOPIDA,656,18,60,16,381,47,522,13,535,0,O-103-1-05-03-01
APAC,KOLE COUNTY,BALLA,BALA,ADWONG OTINGO CORNER,504,6,16,6,212,33,273,106,379,0,O-103-1-05-03-02
APAC,KOLE COUNTY,BALLA,BALA,TE-ORYANG B,384,5,12,2,225,21,265,10,275,0,O-103-1-05-03-03
APAC,KOLE COUNTY,BALLA,BALA,ANGIC P.7 SCHOOL,352,4,12,1,157,21,195,73,268,0,O-103-1-05-03-04
APAC,KOLE COUNTY,BALLA,OMOLADYANG,OMATOLONGO,311,5,31,2,90,22,150,67,217,0,O-103-1-05-04-01
APAC,KOLE COUNTY,BALLA,OMOLADYANG,ABALOKARA,390,9,23,4,223,16,275,15,290,0,O-103-1-05-04-02
APAC,KOLE COUNTY,BALLA,OMOLADYANG,DAMATIRA P.7 SCHOOL,400,4,39,12,198,49,302,7,309,0,O-103-1-05-04-03
APAC,KOLE COUNTY,BALLA,OMOLADYANG,APARANGO,351,4,19,3,140,17,183,62,245,0,O-103-1-05-04-04
APAC,KOLE COUNTY,BALLA,OMOLADYANG,OKELLO KIZZA,209,3,8,1,75,53,140,6,146,0,O-103-1-05-04-05
APAC,KOLE COUNTY,BALLA,OMUGE,TE-OBIA P 7   SCHOOL,289,3,9,6,134,7,159,0,159,0,O-103-1-05-05-01
APAC,KOLE COUNTY,BALLA,OMUGE,OMUGE TANGCI,584,23,54,14,296,27,414,17,431,0,O-103-1-05-05-02
APAC,KOLE COUNTY,BALLA,OMUGE,OMUGE P 7   SCHOOL,500,4,30,3,210,50,297,53,350,0,O-103-1-05-05-03
APAC,KOLE COUNTY,BALLA,OMUGE,TE-TEK,295,8,22,14,168,25,237,4,241,0,O-103-1-05-05-04
APAC,KOLE COUNTY,BALLA,OMWARA,ABONGO DIC P.7 SCHOOL,685,14,48,9,257,24,352,79,431,0,O-103-1-05-06-01
APAC,KOLE COUNTY,BALLA,OMWARA,LANGO COOP UNION STORE,408,9,57,9,151,60,286,12,298,0,O-103-1-05-06-02
MOROTO,BOKORA COUNTY,IRIIRI,IRIIRI,CHOLICHOL,494,0,0,6,5,156,167,34,201,0,O-107-145-01-01-01
MOROTO,BOKORA COUNTY,IRIIRI,IRIIRI,IRIIRI T.C A,688,7,2,14,33,301,357,21,378,0,O-107-145-01-01-02
MOROTO,BOKORA COUNTY,IRIIRI,IRIIRI,LOMAROTOIT,175,0,2,0,1,103,106,0,106,0,O-107-145-01-01-03
MOROTO,BOKORA COUNTY,IRIIRI,IRIIRI,IRIIRI T.C B,660,6,0,8,37,281,332,7,339,0,O-107-145-01-01-04
MOROTO,BOKORA COUNTY,IRIIRI,IRIIRI,ALEKILEK,325,8,7,15,5,152,187,9,196,0,O-107-145-01-01-05
MOROTO,BOKORA COUNTY,IRIIRI,IRIIRI,KAURIKIAKINE,352,5,3,9,11,112,140,31,171,0,O-107-145-01-01-06
MOROTO,BOKORA COUNTY,IRIIRI,IRIIRI,NAMENDERA,97,3,2,3,3,31,42,8,50,0,O-107-145-01-01-07
MOROTO,BOKORA COUNTY,IRIIRI,LORENGECHORA,KOBULIN,576,4,6,18,3,280,311,28,339,0,O-107-145-01-02-01
MOROTO,BOKORA COUNTY,IRIIRI,LORENGECHORA,LOBOK,599,5,4,7,28,226,270,24,294,0,O-107-145-01-02-02
MOROTO,BOKORA COUNTY,IRIIRI,LORENGECHORA,LORENGECHORA A,627,3,5,12,22,157,199,64,263,0,O-107-145-01-02-03
MOROTO,BOKORA COUNTY,IRIIRI,LORENGECHORA,LORENGECHORA B,527,5,2,2,6,253,268,6,274,0,O-107-145-01-02-04
MOROTO,BOKORA COUNTY,IRIIRI,NABWAL,AMEDEK PRIMARY SCHOOL A,767,3,1,4,7,101,116,10,126,0,O-107-145-01-03-01
MOROTO,BOKORA COUNTY,IRIIRI,NABWAL,DUOL,112,1,0,2,4,27,34,3,37,0,O-107-145-01-03-02
MOROTO,BOKORA COUNTY,IRIIRI,NABWAL,AMEDEK PRIMARY SCHOOL B,571,7,1,0,3,107,118,7,125,0,O-107-145-01-03-03
MOROTO,BOKORA COUNTY,IRIIRI,NABWAL,NATAPAR APALEM,178,0,1,1,39,29,70,3,73,0,O-107-145-01-03-04
MOROTO,BOKORA COUNTY,IRIIRI,NABWAL,NABWAL,88,2,0,2,4,39,47,5,52,0,O-107-145-01-03-05
MOROTO,BOKORA COUNTY,IRIIRI,NABWAL,MICHOKO,242,5,2,12,5,113,137,9,146,0,O-107-145-01-03-06
MOROTO,BOKORA COUNTY,IRIIRI,TEPETH,KADACAR,222,2,1,5,3,122,133,14,147,0,O-107-145-01-04-01
MOROTO,BOKORA COUNTY,IRIIRI,TEPETH,LOSIKIAT,641,7,6,15,5,240,273,23,296,0,O-107-145-01-04-02
MOROTO,BOKORA COUNTY,IRIIRI,TEPETH,NAKISILET,29,0,0,0,0,6,6,6,12,0,O-107-145-01-04-03
MOROTO,BOKORA COUNTY,IRIIRI,TEPETH,NAMINIT,612,14,9,19,11,208,261,78,339,0,O-107-145-01-04-04
MOROTO,BOKORA COUNTY,IRIIRI,TEPETH,NATURUMURUMU,595,11,7,25,19,274,336,32,368,0,O-107-145-01-04-05
MOROTO,BOKORA COUNTY,LOKOPO,AKALAE,AKALALE,241,1,0,5,3,186,195,9,204,0,O-107-145-02-01-01
MOROTO,BOKORA COUNTY,LOKOPO,AKALAE,NAKAPELIMEN,319,3,5,1,4,246,259,5,264,0,O-107-145-02-01-02
MOROTO,BOKORA COUNTY,LOKOPO,AKALAE,ADIPALA,189,2,1,5,0,113,121,2,123,0,O-107-145-02-01-03
MOROTO,BOKORA COUNTY,LOKOPO,APEITOLIM,APEITOLIM CENTRE,107,0,2,0,3,97,102,5,107,0,O-107-145-02-02-01
MOROTO,BOKORA COUNTY,LOKOPO,APEITOLIM,NAKWAMORU,383,4,7,10,7,330,358,25,383,0,O-107-145-02-02-02
MOROTO,BOKORA COUNTY,LOKOPO,APEITOLIM,KANANGAR,224,1,1,5,1,125,133,12,145,0,O-107-145-02-02-03
MOROTO,BOKORA COUNTY,LOKOPO,APEITOLIM,NAMUGIT,536,1,0,11,1,260,273,32,305,0,O-107-145-02-02-04
MOROTO,BOKORA COUNTY,LOKOPO,KAYEPAS,NAPEILET,496,1,5,12,4,362,384,2,386,0,O-107-145-02-03-01
MOROTO,BOKORA COUNTY,LOKOPO,KAYEPAS,KACHODO,394,1,4,8,7,191,211,18,229,0,O-107-145-02-03-02
MOROTO,BOKORA COUNTY,LOKOPO,LONGALOM,KOKORIO,190,2,0,2,2,86,92,29,121,0,O-107-145-02-04-01
MOROTO,BOKORA COUNTY,LOKOPO,LONGALOM,LONGALOM PRIMARY SCHOOL,579,6,5,11,12,337,371,31,402,0,O-107-145-02-04-02
MOROTO,BOKORA COUNTY,LOKOPO,LONGALOM,LOKARUJAK,420,2,6,4,3,374,389,12,401,0,O-107-145-02-04-03
MOROTO,BOKORA COUNTY,LOKOPO,LORIKITAI,LOLITA,216,0,0,4,0,152,156,23,179,0,O-107-145-02-05-01
MOROTO,BOKORA COUNTY,LOKOPO,LORIKITAI,LOPEDURU,529,2,6,2,14,289,313,18,331,0,O-107-145-02-05-02
MOROTO,BOKORA COUNTY,LOKOPO,LORIKITAI,LOTHEET,518,1,0,6,4,403,414,12,426,0,O-107-145-02-05-03
MOROTO,BOKORA COUNTY,LOPEI,LOKODUMO,KALESA,389,0,0,1,0,216,217,2,219,0,O-107-145-03-01-01
MOROTO,BOKORA COUNTY,LOPEI,LOKODUMO,LOTUTUA,389,9,7,14,10,105,145,32,177,0,O-107-145-03-01-02
MOROTO,BOKORA COUNTY,LOPEI,LOKODUMO,LOTOP,227,4,3,6,7,146,166,4,170,0,O-107-145-03-01-03
MOROTO,BOKORA COUNTY,LOPEI,LOPEI,LOKARUKOI,639,4,2,11,6,166,189,62,251,0,O-107-145-03-02-01
MOROTO,BOKORA COUNTY,LOPEI,LOPEI,ARENGEPUWA,354,15,16,11,27,207,276,16,292,0,O-107-145-03-02-02
MOROTO,BOKORA COUNTY,LOPEI,LOPEI,NARIAMAREGAE,102,1,0,2,0,61,64,6,70,0,O-107-145-03-02-03
MOROTO,BOKORA COUNTY,LOPEI,NAKWAMORU,LOMURIA,667,0,0,0,0,337,337,7,344,0,O-107-145-03-03-01
MOROTO,BOKORA COUNTY,LOPEI,NAKWAMORU,LOPARIPARI,331,0,0,1,1,173,175,16,191,0,O-107-145-03-03-02
MOROTO,BOKORA COUNTY,LOPEI,NAKWAMORU,LORUNGET,512,1,0,5,0,484,490,14,504,0,O-107-145-03-03-03
MOROTO,BOKORA COUNTY,LOPEI,NAKWAMORU,NAOI,261,1,0,6,1,186,194,0,194,0,O-107-145-03-03-04
MOROTO,BOKORA COUNTY,LOPEI,NAKWAMORU,KAILIKONG,360,5,4,5,3,259,276,21,297,0,O-107-145-03-03-05
MOROTO,BOKORA COUNTY,LOTOME,KALOKENGEL EAST,NAACHUKA,590,2,2,12,17,406,439,9,448,0,O-107-145-04-01-01
MOROTO,BOKORA COUNTY,LOTOME,KALOKENGEL WEST,LOBEEI,339,1,2,6,6,208,223,5,228,0,O-107-145-04-02-01
MOROTO,BOKORA COUNTY,LOTOME,KALOKENGEL WEST,NAREGAE,453,0,2,11,2,276,291,26,317,0,O-107-145-04-02-02
MOROTO,BOKORA COUNTY,LOTOME,KALOKENGEL WEST,LOROO,500,1,5,6,14,332,358,16,374,0,O-107-145-04-02-03
MOROTO,BOKORA COUNTY,LOTOME,LOMUNO,LOMUNO PRIMARY SCHOOL,492,6,3,17,5,207,238,14,252,0,O-107-145-04-03-01
MOROTO,BOKORA COUNTY,LOTOME,LOMUNO,NATAPAR APALEM,297,3,2,2,4,168,179,5,184,0,O-107-145-04-03-02
MOROTO,BOKORA COUNTY,LOTOME,LOMUNO,NAOYAMINIT,366,4,1,5,9,158,177,8,185,0,O-107-145-04-03-03
MOROTO,BOKORA COUNTY,LOTOME,MORUONGOR,LOTOME T/C,596,2,1,9,33,248,293,24,317,0,O-107-145-04-04-01
MOROTO,BOKORA COUNTY,LOTOME,MORUONGOR,LOINGOT,340,4,3,2,4,120,133,41,174,0,O-107-145-04-04-02
MOROTO,BOKORA COUNTY,LOTOME,MORUONGOR,NAOI,193,7,4,14,6,109,140,16,156,0,O-107-145-04-04-03
MOROTO,BOKORA COUNTY,LOTOME,NARIAMEREGAE,LOLET,240,2,0,2,1,117,122,25,147,0,O-107-145-04-05-01
MOROTO,BOKORA COUNTY,LOTOME,NARIAMEREGAE,NAKAALE,426,3,4,12,6,245,270,10,280,0,O-107-145-04-05-02
MOROTO,BOKORA COUNTY,MATANY,LOKALI,LORUPAYO,285,1,1,3,6,125,136,13,149,0,O-107-145-05-01-01
MOROTO,BOKORA COUNTY,MATANY,LOKALI,MORUALOYETE,651,8,9,21,7,228,273,57,330,0,O-107-145-05-01-02
MOROTO,BOKORA COUNTY,MATANY,LOKALI,LOKALI P/S,109,3,2,3,6,55,69,9,78,0,O-107-145-05-01-03
MOROTO,BOKORA COUNTY,MATANY,LOKUPOI,LOKUPOI,403,1,2,3,8,218,232,14,246,0,O-107-145-05-02-01
MOROTO,BOKORA COUNTY,MATANY,LOKUPOI,LOMARIAMONG,441,2,4,4,9,218,237,17,254,0,O-107-145-05-02-02
MOROTO,BOKORA COUNTY,MATANY,LOKUPOI,LORENGEKUNGIN,525,10,3,24,9,181,227,37,264,0,O-107-145-05-02-03
MOROTO,BOKORA COUNTY,MATANY,LOKUPOI,KOKORIO P/S,394,8,1,6,3,186,204,29,233,0,O-107-145-05-02-04
MOROTO,BOKORA COUNTY,MATANY,LOKUWAS,HOSPITAL GATE,596,7,5,14,93,200,319,45,364,0,O-107-145-05-03-01
MOROTO,BOKORA COUNTY,MATANY,LOKUWAS,LOODOI,614,22,9,24,12,157,224,79,303,0,O-107-145-05-03-02
MOROTO,BOKORA COUNTY,MATANY,LOKUWAS,MATANY T.C.,776,8,7,18,51,336,420,34,454,0,O-107-145-05-03-03
MOROTO,BOKORA COUNTY,MATANY,LOKUWAS,NAKAPILAK,643,9,12,22,31,221,295,40,335,0,O-107-145-05-03-04
MOROTO,BOKORA COUNTY,MATANY,MORULINGA,NARO,390,2,4,12,8,181,207,16,223,0,O-107-145-05-04-01
MOROTO,BOKORA COUNTY,MATANY,MORULINGA,NASILOIT,438,6,0,20,5,163,194,7,201,0,O-107-145-05-04-02
MOROTO,BOKORA COUNTY,MATANY,MORULINGA,NYATHINYONOIT A,288,1,0,4,3,209,217,1,218,0,O-107-145-05-04-03
MOROTO,BOKORA COUNTY,MATANY,MORULINGA,NYATHINYONOIT B,163,1,0,4,2,74,81,10,91,0,O-107-145-05-04-04
MOROTO,BOKORA COUNTY,MATANY,NAKICUMET,NAKICUMET PARISH HQRS,762,4,1,5,20,382,412,14,426,0,O-107-145-05-05-01
MOROTO,BOKORA COUNTY,MATANY,NAKICUMET,LOOI,66,1,2,3,35,21,62,2,64,0,O-107-145-05-05-02
MOROTO,BOKORA COUNTY,NGOLERIET,KAUTAKOU,LOTIKOKEN,285,11,7,14,12,96,140,58,198,0,O-107-145-06-01-01
MOROTO,BOKORA COUNTY,NGOLERIET,KAUTAKOU,OUTSIDE Q.GUARD,28,0,0,0,0,0,0,0,0,1,O-107-145-06-01-02
MOROTO,BOKORA COUNTY,NGOLERIET,LOKORETO,LOPIIDA,683,3,2,9,49,300,363,37,400,0,O-107-145-06-02-01
MOROTO,BOKORA COUNTY,NGOLERIET,LOKORETO,NASIKE,617,3,7,31,21,336,398,39,437,0,O-107-145-06-02-02
MOROTO,BOKORA COUNTY,NGOLERIET,LOKORETO,NAWOKOTELEI,316,2,2,5,31,163,203,13,216,0,O-107-145-06-02-03
MOROTO,BOKORA COUNTY,NGOLERIET,NAGULE-ANGOLOL,LOPEDURU COURT HALL BOREH,391,1,3,8,21,218,251,23,274,0,O-107-145-06-03-01
MOROTO,BOKORA COUNTY,NGOLERIET,NAGULE-ANGOLOL,NAKIPOMIA,298,6,3,10,12,176,207,24,231,0,O-107-145-06-03-02
MOROTO,BOKORA COUNTY,NGOLERIET,NAITAKWAE,KARUKO,440,3,1,1,1,189,195,0,195,0,O-107-145-06-04-01
MOROTO,BOKORA COUNTY,NGOLERIET,NAITAKWAE,LOKODOKODOI,397,5,4,10,5,159,183,30,213,0,O-107-145-06-04-02
MOROTO,BOKORA COUNTY,NGOLERIET,NAITAKWAE,KAKUTALEM,306,18,5,11,19,198,251,1,252,0,O-107-145-06-04-03
MOROTO,BOKORA COUNTY,NGOLERIET,NARENGEMORU,KORIMOKORI,305,3,1,13,4,129,150,24,174,0,O-107-145-06-05-01
MOROTO,BOKORA COUNTY,NGOLERIET,NAWAIKOROT,LOMERIMONG,576,4,5,5,6,319,339,7,346,0,O-107-145-06-06-01
MOROTO,BOKORA COUNTY,NGOLERIET,NAWAIKOROT,NAWAIKOROT(BOREHOLE),725,5,4,2,6,335,352,27,379,0,O-107-145-06-06-02
MOROTO,BOKORA COUNTY,NGOLERIET,NAWAIKOROT,KALOSOONY BOREHOLE,415,5,4,3,5,211,228,5,233,0,O-107-145-06-06-03
GULU,NWOYA COUNTY,ALERO,BWOBONAM,ST PETER'S PR. SCH. BWOBO-NA,585,8,3,11,305,32,359,8,367,0,O-110-25-01-01-01
GULU,NWOYA COUNTY,ALERO,BWOBONAM,NAME_MISSING,443,8,2,12,223,43,288,18,306,0,O-110-25-01-01-02
GULU,NWOYA COUNTY,ALERO,KAL,ALERO DIVISION HQTRS I,427,7,3,16,194,25,245,29,274,0,O-110-25-01-02-01
GULU,NWOYA COUNTY,ALERO,KAL,ALERO DIVISION HQTRS II,550,7,8,9,266,31,321,6,327,0,O-110-25-01-02-02
GULU,NWOYA COUNTY,ALERO,KAL,ALERO P.7 SCH. I,684,10,1,5,369,23,408,18,426,0,O-110-25-01-02-03
GULU,NWOYA COUNTY,ALERO,KAL,ALERO P.7 SCH. II,490,2,4,4,250,24,284,19,303,0,O-110-25-01-02-04
GULU,NWOYA COUNTY,ALERO,KAL,KAL OUTSIDE Q.GUARD I,198,1,0,0,17,17,35,2,37,0,O-110-25-01-02-05
GULU,NWOYA COUNTY,ALERO,KAL,KAL OUTSIDE Q.GUARD II,334,0,1,2,61,90,154,13,167,0,O-110-25-01-02-06
GULU,NWOYA COUNTY,ALERO,KAL,LANGOL OUTSIDE Q.GUARD,379,1,0,0,25,156,182,4,186,0,O-110-25-01-02-07
GULU,NWOYA COUNTY,ALERO,PAIBWOR,NWOYA P 7 SCHOOL I,539,7,6,9,292,21,335,8,343,0,O-110-25-01-03-01
GULU,NWOYA COUNTY,ALERO,PAIBWOR,NWOYA P 7 SCHOOL II,327,3,1,5,160,18,187,12,199,0,O-110-25-01-03-02
GULU,NWOYA COUNTY,ALERO,PAIBWOR,NWOYA P 7 SCHOOL III,314,5,1,7,156,36,205,14,219,0,O-110-25-01-03-03
GULU,NWOYA COUNTY,ALERO,PANGUR,PAMINYAI P 7 SCHOOL A,356,3,4,7,204,14,232,11,243,0,O-110-25-01-04-01
GULU,NWOYA COUNTY,ALERO,PANGUR,PAMINYAI P.7 SCH. B,579,3,9,7,363,18,400,16,416,0,O-110-25-01-04-02
GULU,NWOYA COUNTY,ALERO,PANGUR,PAMINYAI P 7 SCHOOL   C,233,2,2,2,136,4,146,6,152,0,O-110-25-01-04-03
GULU,NWOYA COUNTY,ALERO,PANOKRAC,LEBNGEC P.7 SCH(A-K),488,10,2,13,258,7,290,10,300,0,O-110-25-01-05-01
GULU,NWOYA COUNTY,ALERO,PANOKRAC,LUNGULU TRADING CENTRE,304,1,4,8,157,11,181,8,189,0,O-110-25-01-05-02
GULU,NWOYA COUNTY,ALERO,PANOKRAC,LEBNGEC P.7 SCH(L-Z),422,3,3,6,267,27,306,4,310,0,O-110-25-01-05-03
GULU,NWOYA COUNTY,ALERO,PANYABONO,LALAR P 7 SCHOOL   A,310,5,4,9,145,26,189,7,196,0,O-110-25-01-06-01
GULU,NWOYA COUNTY,ALERO,PANYABONO,LALAR P 7 SCHOOL   B,314,2,3,3,129,6,143,3,146,0,O-110-25-01-06-02
GULU,NWOYA COUNTY,ANAKA (PAYIRA),KULU-AMUKA,PATIRA P.7 SCH. A,529,6,4,10,284,39,343,15,358,0,O-110-25-02-01-01
GULU,NWOYA COUNTY,ANAKA (PAYIRA),KULU-AMUKA,PATIRA P.7 SCH. B,566,8,4,12,286,42,352,11,363,0,O-110-25-02-01-02
GULU,NWOYA COUNTY,ANAKA (PAYIRA),PABALI,ANAKA P 7 SCHOOL,663,5,4,5,306,98,418,32,450,0,O-110-25-02-02-01
GULU,NWOYA COUNTY,ANAKA (PAYIRA),PADUNY,ANAKA COURT HALL,809,5,5,2,366,70,448,24,472,0,O-110-25-02-03-01
GULU,NWOYA COUNTY,ANAKA (PAYIRA),PADUNY,ANAKA HOSPITAL,643,4,5,7,365,68,449,12,461,0,O-110-25-02-03-02
GULU,NWOYA COUNTY,ANAKA (PAYIRA),PADUNY,ANAKA OUTSIDE Q. GUARD,790,4,2,2,75,287,370,2,372,0,O-110-25-02-03-03
GULU,NWOYA COUNTY,ANAKA (PAYIRA),PANGORA,ANAKA CENTRAL P 7 SCHOOL A,745,13,2,5,412,53,485,18,503,0,O-110-25-02-04-01
GULU,NWOYA COUNTY,ANAKA (PAYIRA),PANGORA,ANAKA CENTRAL P 7 SCHOOL B,172,2,1,2,112,11,128,5,133,0,O-110-25-02-04-02
GULU,NWOYA COUNTY,ANAKA (PAYIRA),TODORA,POPE PAUL VI S.S.S,410,6,2,3,206,15,232,23,255,0,O-110-25-02-05-01
GULU,NWOYA COUNTY,ANAKA (PAYIRA),TODORA,ST LUKE P 3 SCHOOL,403,11,2,4,200,25,242,27,269,0,O-110-25-02-05-02
GULU,NWOYA COUNTY,ANAKA (PAYIRA),TODORA,AGUNG,590,15,6,10,288,47,366,12,378,0,O-110-25-02-05-03
GULU,NWOYA COUNTY,ANAKA (PAYIRA),YWAYA,PATIRA SUB STATION,633,11,8,6,332,39,396,26,422,0,O-110-25-02-06-01
GULU,NWOYA COUNTY,ANAKA (PAYIRA),YWAYA,LAMOKI  P 7 SCHOOL,509,4,6,7,235,45,297,13,310,0,O-110-25-02-06-02
GULU,NWOYA COUNTY,KOCH-GOMA,AGONGA,AMAR TRADING CENTRE I,580,8,6,6,337,37,394,17,411,0,O-110-25-03-01-01
GULU,NWOYA COUNTY,KOCH-GOMA,AGONGA,AMAR TRADING CENTRE II,150,0,2,0,82,6,90,7,97,0,O-110-25-03-01-02
GULU,NWOYA COUNTY,KOCH-GOMA,AMAR,KOCH-AMAR P 7 SCHOOL,449,7,3,7,245,28,290,21,311,0,O-110-25-03-02-01
GULU,NWOYA COUNTY,KOCH-GOMA,AMAR,AMAR TRADING CENTRE III,255,3,2,6,142,9,162,11,173,0,O-110-25-03-02-02
GULU,NWOYA COUNTY,KOCH-GOMA,CO-OROM,KOCH COOROM P 7 SCHOOL A,454,10,2,4,268,15,299,14,313,0,O-110-25-03-03-01
GULU,NWOYA COUNTY,KOCH-GOMA,CO-OROM,KOCH COOROM P 7 SCHOOL   B,471,4,3,8,222,26,263,21,284,0,O-110-25-03-03-02
GULU,NWOYA COUNTY,KOCH-GOMA,KAL,KOCH-GOMA CENTRAL P7 SCH. A,460,5,1,10,268,37,321,1,322,0,O-110-25-03-04-01
GULU,NWOYA COUNTY,KOCH-GOMA,KAL,KOCH-GOMA CENTRAL P7 SCH. B,112,2,1,1,61,16,81,1,82,0,O-110-25-03-04-02
GULU,NWOYA COUNTY,KOCH-GOMA,KAL,KOCH-GOMA CENTRAL P7 SCH. C,351,0,2,5,174,35,216,12,228,0,O-110-25-03-04-03
GULU,NWOYA COUNTY,KOCH-GOMA,LII,KOCH-GOMA P 7 SCHOOL,128,0,2,0,69,11,82,6,88,0,O-110-25-03-05-01
GULU,NWOYA COUNTY,KOCH-GOMA,LII,BUNGU,113,3,3,3,64,2,75,4,79,0,O-110-25-03-05-02
GULU,NWOYA COUNTY,KOCH-GOMA,ORUM,KOCH GOMA P 7 SCHOOL   I,410,3,5,0,221,20,249,19,268,0,O-110-25-03-06-01
GULU,NWOYA COUNTY,KOCH-GOMA,ORUM,KOCH GOMA P.7 SCHOOL II,472,6,3,5,252,21,287,30,317,0,O-110-25-03-06-02
GULU,NWOYA COUNTY,PURONGO,LATORO,WII - ANAKA P 5 SCHOOL,538,4,4,9,204,79,300,13,313,0,O-110-25-04-01-01
GULU,NWOYA COUNTY,PURONGO,PABIT,PURONGO TRADING CENTRE I,448,9,4,8,231,45,297,9,306,0,O-110-25-04-02-01
GULU,NWOYA COUNTY,PURONGO,PABIT,PURONGO TRADING CENTRE II,631,4,6,7,377,31,425,14,439,0,O-110-25-04-02-02
GULU,NWOYA COUNTY,PURONGO,PABIT,PARAA LODGE,278,2,0,0,77,20,99,1,100,0,O-110-25-04-02-03
GULU,NWOYA COUNTY,PURONGO,PABIT,PURONGO OUTSIDE Q.GUARD,816,5,0,2,63,196,266,13,279,0,O-110-25-04-02-04
GULU,NWOYA COUNTY,PURONGO,PAROMO,OLWIYO P 7 SCHOOL,579,4,0,4,326,46,380,14,394,0,O-110-25-04-03-01
GULU,NWOYA COUNTY,PURONGO,PATIRA,OLWIYO TRADING CENTRE,481,4,2,5,265,40,316,9,325,0,O-110-25-04-04-01
GULU,NWOYA COUNTY,PURONGO,PAWATOMERO,PURONGO  P 7 SCHOOL,450,9,4,8,261,29,311,18,329,0,O-110-25-04-05-01
GULU,NWOYA COUNTY,PURONGO,PAWATOMERO,PURONGO HILL P.7 SCHOOL A,581,5,3,3,289,55,355,9,364,0,O-110-25-04-05-02
GULU,NWOYA COUNTY,PURONGO,PAWATOMERO,PURONGO HILL P.7 SCHOOL B,164,5,0,2,95,10,112,3,115,0,O-110-25-04-05-03
GULU,NWOYA COUNTY,PURONGO,PAWATOMERO,PAJOK OUTSIDE Q.GUARD,784,2,0,1,46,219,268,3,271,0,O-110-25-04-05-04
PADER,AGAGO COUNTY,ADILANG,KULAKA,NAMABILI P7 SCHOOL,588,8,4,10,279,65,366,45,411,0,O-111-89-01-01-01
PADER,AGAGO COUNTY,ADILANG,KULAKA,TEOBILOKECH,308,3,1,5,144,54,207,5,212,0,O-111-89-01-01-02
PADER,AGAGO COUNTY,ADILANG,LABWA,LACEKOTO PIDA,320,3,1,3,142,18,167,45,212,0,O-111-89-01-02-01
PADER,AGAGO COUNTY,ADILANG,LABWA,MUGILA TEE GACIA,470,10,0,6,262,62,340,6,346,0,O-111-89-01-02-02
PADER,AGAGO COUNTY,ADILANG,LALAL,ADILANG DIV. HQRS,715,6,4,10,268,92,380,12,392,0,O-111-89-01-03-01
PADER,AGAGO COUNTY,ADILANG,LALAL,ANYAMI TE CHWA,507,6,0,7,274,75,362,11,373,0,O-111-89-01-03-02
PADER,AGAGO COUNTY,ADILANG,LALAL,ODOM PIDA,285,5,0,6,156,26,193,9,202,0,O-111-89-01-03-03
PADER,AGAGO COUNTY,ADILANG,LALAL,TEE-O WII-PARK,320,6,3,3,113,58,183,6,189,0,O-111-89-01-03-04
PADER,AGAGO COUNTY,ADILANG,NGEKIDI,CIGACIGA P7 SCHOOL,604,3,1,6,325,68,403,10,413,0,O-111-89-01-04-01
PADER,AGAGO COUNTY,ADILANG,NGEKIDI,KILOKOITIO P. SCHOOL,540,5,2,7,305,46,365,4,369,0,O-111-89-01-04-02
PADER,AGAGO COUNTY,ADILANG,NGEKIDI,DOGDAGO,374,6,1,5,203,21,236,19,255,0,O-111-89-01-04-03
PADER,AGAGO COUNTY,ADILANG,ORINA,KANYIPA P.7 SCHOOL,522,10,6,8,284,65,373,16,389,0,O-111-89-01-05-01
PADER,AGAGO COUNTY,ADILANG,ORINA,ORINA P.7 SCHOOL,276,1,1,5,148,19,174,9,183,0,O-111-89-01-05-02
PADER,AGAGO COUNTY,ADILANG,ORINA,ARWAA TEKWOROL,143,1,0,1,99,3,104,1,105,0,O-111-89-01-05-03
PADER,AGAGO COUNTY,LAPONO,AMYEL,AMYEL T/CENTRE,740,6,8,12,318,122,466,26,492,0,O-111-89-02-01-01
PADER,AGAGO COUNTY,LAPONO,AMYEL,KIZEE,383,7,0,8,250,34,299,7,306,0,O-111-89-02-01-02
PADER,AGAGO COUNTY,LAPONO,LAPONO-MUK,ORIYA COTTON STORE,531,9,3,5,221,37,275,10,285,0,O-111-89-02-02-01
PADER,AGAGO COUNTY,LAPONO,LIRA-KAKET,KAKET P7 SCHOOL,597,17,5,4,316,57,399,6,405,0,O-111-89-02-03-01
PADER,AGAGO COUNTY,LAPONO,LIRA-KAKET,ONGALO CHAPEL,392,6,2,7,207,22,244,27,271,0,O-111-89-02-03-02
PADER,AGAGO COUNTY,LAPONO,LIRA-KAKET,LAPERE,299,3,1,1,145,12,162,17,179,0,O-111-89-02-03-03
PADER,AGAGO COUNTY,LAPONO,LIRA-KATO,LIRA KATO P.7 SCHOOL,597,8,4,9,269,64,354,30,384,0,O-111-89-02-04-01
PADER,AGAGO COUNTY,LAPONO,LIRA-KATO,OGUL,668,10,6,3,273,61,353,17,370,0,O-111-89-02-04-02
PADER,AGAGO COUNTY,LAPONO,LIRA-KATO,BIWANG,326,2,6,5,115,51,179,31,210,0,O-111-89-02-04-03
PADER,AGAGO COUNTY,LAPONO,LIRA-KATO,AWELO,564,6,2,7,274,49,338,11,349,0,O-111-89-02-04-04
PADER,AGAGO COUNTY,LAPONO,OGOLE,OGWANG KAMOLO P/SCHOOL,368,13,1,7,184,47,252,21,273,0,O-111-89-02-05-01
PADER,AGAGO COUNTY,LAPONO,OGOLE,AYWEE PALARO P/SCHOOL,528,23,7,6,288,42,366,23,389,0,O-111-89-02-05-02
PADER,AGAGO COUNTY,LIRA-PALWO,ADEMI,ADEMI,594,4,1,9,297,40,351,18,369,0,O-111-89-03-01-01
PADER,AGAGO COUNTY,LIRA-PALWO,ADEMI,ALWEE,223,6,1,1,119,22,149,8,157,0,O-111-89-03-01-02
PADER,AGAGO COUNTY,LIRA-PALWO,AGENGO,DOGDAGO,272,2,0,4,133,33,172,2,174,0,O-111-89-03-02-01
PADER,AGAGO COUNTY,LIRA-PALWO,AGENGO,OBOLOKOME,749,2,1,4,334,107,448,34,482,0,O-111-89-03-02-02
PADER,AGAGO COUNTY,LIRA-PALWO,LANYIRINYIRI,TIMAKICA,436,9,1,3,227,56,296,10,306,0,O-111-89-03-03-01
PADER,AGAGO COUNTY,LIRA-PALWO,LANYIRINYIRI,YABWANGI P.7 SCHOOL,294,4,3,6,171,24,208,6,214,0,O-111-89-03-03-02
PADER,AGAGO COUNTY,LIRA-PALWO,LANYIRINYIRI,WIMUNUPECEK,426,7,1,9,229,63,309,1,310,0,O-111-89-03-03-03
PADER,AGAGO COUNTY,LIRA-PALWO,LOTOME,TORI,453,6,1,3,247,54,311,9,320,0,O-111-89-03-04-01
PADER,AGAGO COUNTY,LIRA-PALWO,LOTOME,AMENYI,522,8,2,4,235,32,281,34,315,0,O-111-89-03-04-02
PADER,AGAGO COUNTY,LIRA-PALWO,OJUR,DOG OTAKA,235,0,0,3,72,30,105,2,107,0,O-111-89-03-05-01
PADER,AGAGO COUNTY,LIRA-PALWO,OJUR,ARAMBEE,443,2,0,4,204,39,249,9,258,0,O-111-89-03-05-02
PADER,AGAGO COUNTY,LIRA-PALWO,OMONGO,LIRA-PALUO P.7 SCHOOL,808,11,2,12,222,165,412,13,425,0,O-111-89-03-06-01
PADER,AGAGO COUNTY,LIRA-PALWO,OMONGO,LIRA PALUO SUB-DISPENSARY,595,7,1,4,254,152,418,14,432,0,O-111-89-03-06-02
PADER,AGAGO COUNTY,LIRA-PALWO,OMONGO,BIWANG,319,4,0,6,123,86,219,8,227,0,O-111-89-03-06-03
PADER,AGAGO COUNTY,LIRA-PALWO,OTAKA,ALYEK P.7,188,0,0,2,66,15,83,2,85,0,O-111-89-03-07-01
PADER,AGAGO COUNTY,LIRA-PALWO,OTAKA,ARUM,498,5,1,3,242,47,298,4,302,0,O-111-89-03-07-02
PADER,AGAGO COUNTY,LIRA-PALWO,PAICAM,ABONE P 7 SCHOOL,602,10,6,12,269,110,407,5,412,0,O-111-89-03-08-01
PADER,AGAGO COUNTY,LIRA-PALWO,PAICAM,KWONKIC  P7 SCHOOL,605,7,4,14,207,126,358,46,404,0,O-111-89-03-08-02
PADER,AGAGO COUNTY,LOKOLE,AJALI,ANYENA P7 SCHOOL,718,21,0,11,393,63,488,11,499,0,O-111-89-04-01-01
PADER,AGAGO COUNTY,LOKOLE,AJALI,AJALI ATEDE,238,8,3,6,122,44,183,12,195,0,O-111-89-04-01-02
PADER,AGAGO COUNTY,LOKOLE,AJALI,LADERE,224,6,0,3,112,19,140,39,179,0,O-111-89-04-01-03
PADER,AGAGO COUNTY,LOKOLE,KITENY,LACANKWERI,447,6,5,7,214,67,299,3,302,0,O-111-89-04-02-01
PADER,AGAGO COUNTY,LOKOLE,KITENY,LAPIRIN P7 SCHOOL,352,4,0,2,149,32,187,45,232,0,O-111-89-04-02-02
PADER,AGAGO COUNTY,LOKOLE,KITENY,AYWEE LABUCE,296,3,0,0,146,42,191,2,193,0,O-111-89-04-02-03
PADER,AGAGO COUNTY,LOKOLE,KITENY,LUZIRA P 7 SCHOOL,218,5,0,1,128,41,175,1,176,0,O-111-89-04-02-04
PADER,AGAGO COUNTY,LOKOLE,NGUDI,NGORA P7 SCHOOL,808,6,2,7,413,98,526,8,534,0,O-111-89-04-03-01
PADER,AGAGO COUNTY,LOKOLE,NGUDI,TEKWORO ALUNGAR,243,7,1,4,128,27,167,5,172,0,O-111-89-04-03-02
PADER,AGAGO COUNTY,LOKOLE,NGUDI,OUTSIDE Q. GUARD,618,6,1,6,166,139,318,3,321,0,O-111-89-04-03-03
PADER,AGAGO COUNTY,LOKOLE,OLUNG,OLUNG P7 SCHOOL,450,5,3,3,228,35,274,8,282,0,O-111-89-04-04-01
PADER,AGAGO COUNTY,LOKOLE,OTUMPILI,TEGWENG,536,9,2,10,329,28,378,17,395,0,O-111-89-04-05-01
PADER,AGAGO COUNTY,LOKOLE,OTUMPILI,LAZWA,271,6,2,6,157,20,191,5,196,0,O-111-89-04-05-02
PADER,AGAGO COUNTY,OMOT,ACHOL-PII,ACHOLPII/LAPONO P.7 SCHOOL,540,3,2,1,187,28,221,10,231,0,O-111-89-05-01-01
PADER,AGAGO COUNTY,OMOT,ACHOL-PII,ARUM MARKET,251,2,0,1,87,15,105,1,106,0,O-111-89-05-01-02
PADER,AGAGO COUNTY,OMOT,ACHOL-PII,ARYEYE MARKET,408,2,1,0,46,2,51,13,64,0,O-111-89-05-01-03
PADER,AGAGO COUNTY,OMOT,ACHOL-PII,KAZIKAZI P7 SCH,505,2,0,6,184,33,225,6,231,0,O-111-89-05-01-04
PADER,AGAGO COUNTY,OMOT,ACHOL-PII,ARUM CAMP,490,4,1,0,140,86,231,7,238,0,O-111-89-05-01-05
PADER,AGAGO COUNTY,OMOT,AGELEC,AKWIL WARD,794,8,7,6,297,36,354,4,358,0,O-111-89-05-02-01
PADER,AGAGO COUNTY,OMOT,AGELEC,AYIKA WARD,452,2,14,2,103,5,126,4,130,0,O-111-89-05-02-02
PADER,AGAGO COUNTY,OMOT,AGELEC,ONGARO,76,0,0,0,16,0,16,5,21,0,O-111-89-05-02-03
PADER,AGAGO COUNTY,OMOT,ATECE,AWONODWE P.7 SCHOOL,503,3,9,2,79,6,99,6,105,0,O-111-89-05-03-01
PADER,AGAGO COUNTY,OMOT,ATECE,BARIMA MARKET,665,4,9,5,196,30,244,17,261,0,O-111-89-05-03-02
PADER,AGAGO COUNTY,OMOT,ATECE,OMOT HQS,527,3,2,2,150,47,204,12,216,0,O-111-89-05-03-03
PADER,AGAGO COUNTY,OMOT,ATECE,OWOLO,164,3,0,1,75,12,91,17,108,0,O-111-89-05-03-04
PADER,AGAGO COUNTY,OMOT,TENGE,GEREGERE T.C.,1194,3,2,9,276,214,504,10,514,0,O-111-89-05-04-01
PADER,AGAGO COUNTY,OMOT,TENGE,TE-ASSESSMENT,687,4,2,8,222,115,351,16,367,0,O-111-89-05-04-02
PADER,AGAGO COUNTY,OMOT,TENGE,TANGO YENGLEMI,298,4,3,0,112,17,136,22,158,0,O-111-89-05-04-03
PADER,AGAGO COUNTY,OMOT,TENGE,BARDANGA,377,4,1,5,146,70,226,8,234,0,O-111-89-05-04-04
PADER,AGAGO COUNTY,OMOT,TENGE,LATINLINGNAM,398,6,5,8,146,45,210,49,259,0,O-111-89-05-04-05
PADER,AGAGO COUNTY,PAIMOL,LAITA,LAMINGONEN P7 SCH,280,3,0,3,142,8,156,4,160,0,O-111-89-06-01-01
PADER,AGAGO COUNTY,PAIMOL,LAITA,LONGOR P7 SCH,583,15,5,2,276,18,316,22,338,0,O-111-89-06-01-02
PADER,AGAGO COUNTY,PAIMOL,MUTTO,NGORA,675,4,1,8,450,15,478,19,497,0,O-111-89-06-02-01
PADER,AGAGO COUNTY,PAIMOL,MUTTO,PIDA,720,8,4,8,475,20,515,33,548,0,O-111-89-06-02-02
PADER,AGAGO COUNTY,PAIMOL,MUTTO,SOLOTI,1002,14,6,13,442,213,688,8,696,0,O-111-89-06-02-03
PADER,AGAGO COUNTY,PAIMOL,MUTTO,TETUGO,527,3,2,5,390,6,406,7,413,0,O-111-89-06-02-04
PADER,AGAGO COUNTY,PAIMOL,MUTTO,NGORA OUTSIDE GUARD,215,1,0,0,67,5,73,0,73,0,O-111-89-06-02-05
PADER,AGAGO COUNTY,PAIMOL,OMIYA-PACHWA,LOMI P7 SCH,516,6,6,1,313,5,331,5,336,0,O-111-89-06-03-01
PADER,AGAGO COUNTY,PAIMOL,OMIYA-PACHWA,OMIYA PACWA P7 SCHOOL,578,5,1,0,384,16,406,10,416,0,O-111-89-06-03-02
PADER,AGAGO COUNTY,PAIMOL,OMIYA-PACHWA,OMIYA PACWA TC,1054,19,13,12,583,37,664,15,679,0,O-111-89-06-03-03
PADER,AGAGO COUNTY,PAIMOL,PACABOL A,AKWANG P SCHOOL,589,12,1,7,317,12,349,48,397,0,O-111-89-06-04-01
PADER,AGAGO COUNTY,PAIMOL,PACABOL A,KOKIL P 7 SCHOOL,627,9,1,3,425,18,456,26,482,0,O-111-89-06-04-02
PADER,AGAGO COUNTY,PAIMOL,PACABOL A,KOKIL DIVISION HQS,508,6,1,1,379,10,397,4,401,0,O-111-89-06-04-03
PADER,AGAGO COUNTY,PAIMOL,PACABOL A,APILA,276,8,3,8,203,2,224,15,239,0,O-111-89-06-04-04
PADER,AGAGO COUNTY,PARABONGO,KALONGO T.B.,MAIN MARKET (A),980,6,3,3,488,55,555,25,580,0,O-111-89-07-01-01
PADER,AGAGO COUNTY,PARABONGO,KALONGO T.B.,SUB-COUNTY CHIEF'S OFFICE (A),860,3,4,1,338,67,413,3,416,0,O-111-89-07-01-02
PADER,AGAGO COUNTY,PARABONGO,KALONGO T.B.,TOWN BOARD OFFICE (A),1058,8,3,6,437,67,521,37,558,0,O-111-89-07-01-03
PADER,AGAGO COUNTY,PARABONGO,KALONGO T.B.,SUB-COUNTY CHIEF'S OFFICE (B),611,5,2,0,268,47,322,4,326,0,O-111-89-07-01-04
PADER,AGAGO COUNTY,PARABONGO,KALONGO T.B.,MAIN MARKET (B),128,0,0,0,74,9,83,7,90,0,O-111-89-07-01-05
PADER,AGAGO COUNTY,PARABONGO,KALONGO T.B.,TOWN BOARD OFFICE (B),227,1,1,1,39,9,51,3,54,0,O-111-89-07-01-06
PADER,AGAGO COUNTY,PARABONGO,PABALA,KABALA P7 SCHOOL,666,10,1,3,417,38,469,26,495,0,O-111-89-07-02-01
PADER,AGAGO COUNTY,PARABONGO,PABALA,ABOT,140,1,1,0,100,3,105,1,106,0,O-111-89-07-02-02
PADER,AGAGO COUNTY,PARABONGO,PACER,LAPWOMO,480,7,2,3,329,30,371,10,381,0,O-111-89-07-03-01
PADER,AGAGO COUNTY,PARABONGO,PACER,PACER P.7 SCHOOL,614,7,4,10,357,69,447,5,452,0,O-111-89-07-03-02
PADER,AGAGO COUNTY,PARABONGO,PARUM,COTTON STORE KALONGO,715,4,0,2,481,10,497,5,502,0,O-111-89-07-04-01
PADER,AGAGO COUNTY,PARABONGO,PARUM,PAKOR P7 SCHOOL,576,12,2,6,366,35,421,12,433,0,O-111-89-07-04-02
PADER,AGAGO COUNTY,PARABONGO,PARUM,DUNGU,204,5,0,3,133,9,150,14,164,0,O-111-89-07-04-03
PADER,AGAGO COUNTY,PATONGO,APOBO,KOTOMOR,538,5,2,2,102,108,219,10,229,0,O-111-89-08-01-01
PADER,AGAGO COUNTY,PATONGO,KAL,COUNTY HQRS (A-N),906,4,0,5,254,190,453,11,464,0,O-111-89-08-02-01
PADER,AGAGO COUNTY,PATONGO,KAL,COUNTY HQRS (O-Z),658,3,3,2,176,115,299,10,309,0,O-111-89-08-02-02
PADER,AGAGO COUNTY,PATONGO,KAL,OPOROT TE ADWOKI,717,5,4,8,267,158,442,6,448,0,O-111-89-08-02-03
PADER,AGAGO COUNTY,PATONGO,KAL,ORAMA TE ASSESSMENT,405,4,2,0,133,115,254,27,281,0,O-111-89-08-02-04
PADER,AGAGO COUNTY,PATONGO,KAL,APANO LABWORYEMO,297,6,3,11,92,108,220,8,228,0,O-111-89-08-02-05
PADER,AGAGO COUNTY,PATONGO,LAKWA,AGWEDOLA,499,7,6,17,224,130,384,13,397,0,O-111-89-08-03-01
PADER,AGAGO COUNTY,PATONGO,LAKWA,BAROTIBA P7 SCHOOL,638,22,6,15,347,81,471,9,480,0,O-111-89-08-03-02
PADER,AGAGO COUNTY,PATONGO,LAKWA,FOREST,1441,25,6,15,270,356,672,31,703,0,O-111-89-08-03-03
PADER,AGAGO COUNTY,PATONGO,LOKEE,ODOKOMIT P7 SCHOOL,538,2,3,4,177,30,216,8,224,0,O-111-89-08-04-01
PADER,AGAGO COUNTY,PATONGO,LOKEE,OTEK,286,0,1,0,163,16,180,5,185,0,O-111-89-08-04-02
PADER,AGAGO COUNTY,PATONGO,LUKWANGOLE,ALOI CENTRAL,333,2,0,6,150,47,205,14,219,0,O-111-89-08-05-01
PADER,AGAGO COUNTY,PATONGO,LUKWANGOLE,ARUMUDWONG,508,8,0,5,321,54,388,22,410,0,O-111-89-08-05-02
PADER,AGAGO COUNTY,PATONGO,LUKWANGOLE,ALOI FORST,632,11,3,10,298,169,491,8,499,0,O-111-89-08-05-03
PADER,AGAGO COUNTY,PATONGO,ODONGIWINYO,ORETO IMAT,363,8,2,2,118,71,201,47,248,0,O-111-89-08-06-01
PADER,AGAGO COUNTY,PATONGO,ODONGIWINYO,OYERE,388,4,2,3,92,7,108,4,112,0,O-111-89-08-06-02
PADER,AGAGO COUNTY,PATONGO,OMATOWEE,OLYELO-WIDYEL,563,6,6,6,124,36,178,2,180,0,O-111-89-08-07-01
PADER,AGAGO COUNTY,PATONGO,OMATOWEE,ONUDUAPET,531,4,4,0,127,8,143,5,148,0,O-111-89-08-07-02
PADER,AGAGO COUNTY,PATONGO,OTEK,TEKULU,444,6,1,3,44,25,79,58,137,0,O-111-89-08-08-01
PADER,AGAGO COUNTY,WOL,GUDA,WOL CENTRE (A-L),431,5,1,8,148,38,200,6,206,0,O-111-89-09-01-01
PADER,AGAGO COUNTY,WOL,GUDA,WOL CENTRE (M-Z),361,5,2,3,145,35,190,9,199,0,O-111-89-09-01-02
PADER,AGAGO COUNTY,WOL,GUDA,LOKABAR,320,5,0,7,160,19,191,4,195,0,O-111-89-09-01-03
PADER,AGAGO COUNTY,WOL,GUDA,KICO,255,3,0,3,142,30,178,5,183,0,O-111-89-09-01-04
PADER,AGAGO COUNTY,WOL,KAL-AGUM,TOROMA,861,17,9,9,404,59,498,4,502,0,O-111-89-09-02-01
PADER,AGAGO COUNTY,WOL,KAL-AGUM,PARABONGOTEK,282,6,1,4,139,13,163,8,171,0,O-111-89-09-02-02
PADER,AGAGO COUNTY,WOL,OGOLE,OGOLE PRIMARY SCHOOL,623,10,3,13,287,67,380,23,403,0,O-111-89-09-03-01
PADER,AGAGO COUNTY,WOL,OGOLE,PANYAGOL,211,4,0,0,86,28,118,9,127,0,O-111-89-09-03-02
PADER,AGAGO COUNTY,WOL,PALUTI,JAI CHAPEL,367,5,4,3,228,21,261,6,267,0,O-111-89-09-04-01
PADER,AGAGO COUNTY,WOL,PALUTI,KALAKI SCHOOL,193,3,0,2,122,12,139,2,141,0,O-111-89-09-04-02
PADER,AGAGO COUNTY,WOL,PALUTI,KUYWEE,533,10,2,6,309,16,343,13,356,0,O-111-89-09-04-03
PADER,AGAGO COUNTY,WOL,PALUTI,KUYWEE CHAPEL,368,4,0,4,234,31,273,2,275,0,O-111-89-09-04-04
PADER,AGAGO COUNTY,WOL,ROGO,LUGUNG PRIMARY SCHOOL,572,17,3,14,203,81,318,9,327,0,O-111-89-09-05-01
PADER,AGAGO COUNTY,WOL,ROGO,OKWADOKO,552,7,0,10,206,32,255,9,264,0,O-111-89-09-05-02
PADER,AGAGO COUNTY,WOL,ROGO,OWILE CHAPEL,251,5,2,4,128,18,157,4,161,0,O-111-89-09-05-03
GULU,OMORO COUNTY,BOBI,PAIDONGO,LELAOBARO PRIMARY SCHOOL,403,4,1,1,242,2,250,7,257,0,O-115-26-01-01-01
GULU,OMORO COUNTY,BOBI,PAIDONGO,LELAOBARO MARKET,399,7,3,1,245,12,268,7,275,0,O-115-26-01-01-02
GULU,OMORO COUNTY,BOBI,PAIDWE,BOBI HEADQUATERS I,603,5,12,5,341,34,397,22,419,0,O-115-26-01-02-01
GULU,OMORO COUNTY,BOBI,PAIDWE,BOBI DIVISION HEADQUARTERS II,529,2,7,4,321,17,351,8,359,0,O-115-26-01-02-02
GULU,OMORO COUNTY,BOBI,PAIDWE,BOBI CHURCH OF UGANDA P 7 S,573,5,8,6,357,37,413,0,413,0,O-115-26-01-02-03
GULU,OMORO COUNTY,BOBI,PAIDWE,BOBI CHURCH OF UGANDA PR. 7,713,4,11,4,381,49,449,17,466,0,O-115-26-01-02-04
GULU,OMORO COUNTY,BOBI,PAIDWE,PAIDWE OUTSIDE Q.GUARD,390,0,1,0,47,14,62,2,64,0,O-115-26-01-02-05
GULU,OMORO COUNTY,BOBI,PALENGA,PALENGA P 7 SCHOOL A,551,3,2,1,262,36,304,8,312,0,O-115-26-01-03-01
GULU,OMORO COUNTY,BOBI,PALENGA,MR. OCHEN ANTHONY'S HOME,634,13,3,4,397,25,442,10,452,0,O-115-26-01-03-02
GULU,OMORO COUNTY,BOBI,PALENGA,PALENGA P 7 SCHOOL B,366,3,0,5,218,24,250,9,259,0,O-115-26-01-03-03
GULU,OMORO COUNTY,BOBI,PALWO,ST. THOMAS MORE MINAKULU PR.,682,3,3,7,343,38,394,14,408,0,O-115-26-01-04-01
GULU,OMORO COUNTY,BOBI,PALWO,OBALWAT MARKET,571,13,15,12,316,30,386,15,401,0,O-115-26-01-04-02
GULU,OMORO COUNTY,BOBI,PATEK,PATEK PRIMARY SCHOOL   I,677,8,4,10,424,27,473,7,480,0,O-115-26-01-05-01
GULU,OMORO COUNTY,BOBI,PATEK,BARKIC,716,8,19,13,443,19,502,13,515,0,O-115-26-01-05-02
GULU,OMORO COUNTY,KORO,ACOYO,ACOYO CHAPEL A,538,1,3,0,327,23,354,9,363,0,O-115-26-02-01-01
GULU,OMORO COUNTY,KORO,ACOYO,ACOYO CHAPEL B,335,1,2,0,188,17,208,10,218,0,O-115-26-02-01-02
GULU,OMORO COUNTY,KORO,IBAKARA,ABOLE PR. SCH.,448,6,2,4,252,7,271,11,282,0,O-115-26-02-02-01
GULU,OMORO COUNTY,KORO,IBAKARA,LAKWATOMER PRIMARY SCHOOL,328,0,3,2,152,10,167,5,172,0,O-115-26-02-02-02
GULU,OMORO COUNTY,KORO,LABWOC,OTEMA PRIMARY SCHOOL I,481,4,1,2,274,26,307,12,319,0,O-115-26-02-03-01
GULU,OMORO COUNTY,KORO,LABWOC,OTEMA PR. 7 II,287,5,2,4,165,7,183,18,201,0,O-115-26-02-03-02
GULU,OMORO COUNTY,KORO,LABWOC,ABILI PR. 7 SCH. I,569,3,4,2,332,28,369,6,375,0,O-115-26-02-03-03
GULU,OMORO COUNTY,KORO,LABWOC,ABILI PR. 7 SCH. II,525,4,3,4,347,14,372,3,375,0,O-115-26-02-03-04
GULU,OMORO COUNTY,KORO,LAPAINAT EAST,LABONGOLO A,630,7,3,3,392,12,417,9,426,0,O-115-26-02-04-01
GULU,OMORO COUNTY,KORO,LAPAINAT EAST,LAMINADERA PR. SCH.,174,1,2,0,116,6,125,5,130,0,O-115-26-02-04-02
GULU,OMORO COUNTY,KORO,LAPAINAT EAST,LABONGOLO B,222,6,1,2,135,2,146,2,148,0,O-115-26-02-04-03
GULU,OMORO COUNTY,KORO,LAPAINAT WEST,KITENY  CHAPEL,369,0,5,0,256,9,270,2,272,0,O-115-26-02-05-01
GULU,OMORO COUNTY,KORO,LAPAINAT WEST,ATEDE  PRIMARY SCHOOL,321,1,0,2,202,3,208,8,216,0,O-115-26-02-05-02
GULU,OMORO COUNTY,KORO,LAPAINAT WEST,LAPAINAT PRIMARY SCHOOL A,642,4,5,2,396,33,440,6,446,0,O-115-26-02-05-03
GULU,OMORO COUNTY,KORO,LAPAINAT WEST,LAPAINAT PRIMARY SCHOOL B,443,5,2,4,285,14,310,7,317,0,O-115-26-02-05-04
GULU,OMORO COUNTY,KORO,PAGEYA,KORO ABILI PR. 7 SCH.,520,2,4,2,333,12,353,9,362,0,O-115-26-02-06-01
GULU,OMORO COUNTY,KORO,PAGEYA,KORO DIVISION HEADQUARTERS,718,3,5,5,426,31,470,15,485,0,O-115-26-02-06-02
GULU,OMORO COUNTY,KORO,PAGEYA,KORO DIVISION HEADQUATERS B,537,4,2,1,307,20,334,7,341,0,O-115-26-02-06-03
GULU,OMORO COUNTY,KORO,PAGEYA,OUTSIDE QUARTER GUARD I,683,2,1,1,40,326,370,6,376,0,O-115-26-02-06-04
GULU,OMORO COUNTY,KORO,PAGEYA,OUTSIDE QUARTER GUARD II,316,1,1,1,41,151,195,4,199,0,O-115-26-02-06-05
GULU,OMORO COUNTY,LAKWANA,LANENO-BER,LANENOBER COOPERATIVE SOCI,335,3,2,2,170,22,199,9,208,0,O-115-26-03-01-01
GULU,OMORO COUNTY,LAKWANA,LANENO-BER,AKECHA P/S,147,0,0,0,84,13,97,4,101,0,O-115-26-03-01-02
GULU,OMORO COUNTY,LAKWANA,LUJORONGOLE,TE-TANGI I,272,3,8,3,147,9,170,3,173,0,O-115-26-03-02-01
GULU,OMORO COUNTY,LAKWANA,LUJORONGOLE,TE-TANGI II,495,4,5,2,198,6,215,6,221,0,O-115-26-03-02-02
GULU,OMORO COUNTY,LAKWANA,LUJORONGOLE,TE-TANGI III (A-J),350,5,0,6,223,9,243,11,254,0,O-115-26-03-02-03
GULU,OMORO COUNTY,LAKWANA,LUJORONGOLE,TE-TANGI III (K-Z),373,3,1,3,270,14,291,7,298,0,O-115-26-03-02-04
GULU,OMORO COUNTY,LAKWANA,PARAK,AWOO PR. 7 SCH. I,616,8,7,13,329,16,373,15,388,0,O-115-26-03-03-01
GULU,OMORO COUNTY,LAKWANA,PARAK,AWOO PR. 7 SCH. II,474,5,3,10,300,31,349,10,359,0,O-115-26-03-03-02
GULU,OMORO COUNTY,LAKWANA,PARAK,AWOO PR. 7 SCH. III,475,4,13,15,281,13,326,23,349,0,O-115-26-03-03-03
GULU,OMORO COUNTY,LAKWANA,TEGOT,LAKWANA P 7 SCH A,295,7,8,5,150,15,185,6,191,0,O-115-26-03-04-01
GULU,OMORO COUNTY,LAKWANA,TEGOT,LAKWANA P 7 SCH B,536,7,8,8,285,26,334,11,345,0,O-115-26-03-04-02
GULU,OMORO COUNTY,LAKWANA,TEGOT,LAKWANA P 7 SCH C,652,9,8,10,294,62,383,4,387,0,O-115-26-03-04-03
GULU,OMORO COUNTY,LAKWANA,TEGOT,LAKWANA P 7 SCH D,462,2,6,7,238,27,280,12,292,0,O-115-26-03-04-04
GULU,OMORO COUNTY,LALOGI,GEM,LALOGI DIVISION HEADQUARTER,634,8,7,7,342,28,392,2,394,0,O-115-26-04-01-01
GULU,OMORO COUNTY,LALOGI,GEM,LALOGI DIVISION HEADQUARTER,539,5,4,7,262,43,321,21,342,0,O-115-26-04-01-02
GULU,OMORO COUNTY,LALOGI,GEM,MINJA PR. 7 SCH. A,554,7,8,4,310,25,354,0,354,0,O-115-26-04-01-03
GULU,OMORO COUNTY,LALOGI,GEM,MINJA PRIMARY SCHOOL B,281,2,2,2,149,9,164,9,173,0,O-115-26-04-01-04
GULU,OMORO COUNTY,LALOGI,GEM,LALOGI DIVISION HEADQUARTER,443,9,4,3,217,27,260,12,272,0,O-115-26-04-01-05
GULU,OMORO COUNTY,LALOGI,IDOBO,LOYO -AJONGA MARKET,465,7,3,3,286,12,311,5,316,0,O-115-26-04-02-01
GULU,OMORO COUNTY,LALOGI,IDOBO,BARALIMO/IDOBO PR. 7 SCH.,615,6,3,7,342,25,383,15,398,0,O-115-26-04-02-02
GULU,OMORO COUNTY,LALOGI,IDOBO,BARALIMO/IDOBO PR. 7 SCH. II,345,3,2,6,171,19,201,6,207,0,O-115-26-04-02-03
GULU,OMORO COUNTY,LALOGI,JAKA,LALOGI MARKET,728,5,4,4,322,44,379,4,383,0,O-115-26-04-03-01
GULU,OMORO COUNTY,LALOGI,JAKA,LALOGI PR. 7 SCH. (A-L),534,0,0,0,14,1,15,1,16,0,O-115-26-04-03-02
GULU,OMORO COUNTY,LALOGI,JAKA,LALOGI PR. 7 SCH. (M-Z),561,0,3,0,6,0,9,0,9,0,O-115-26-04-03-03
GULU,OMORO COUNTY,LALOGI,JAKA,LALOGI PR. 7 SCH II,704,8,18,4,278,13,321,9,330,0,O-115-26-04-03-04
GULU,OMORO COUNTY,LALOGI,JAKA,LALOGI PR. 7 SCH III,228,8,1,1,119,6,135,24,159,0,O-115-26-04-03-05
GULU,OMORO COUNTY,LALOGI,JAKA,CORNER AGULA OUTSIDE Q. GUA,219,1,1,1,11,100,114,3,117,0,O-115-26-04-03-06
GULU,OMORO COUNTY,LALOGI,LUKWIR,ADAK PR. 7 SCH.,491,2,1,4,251,4,262,3,265,0,O-115-26-04-04-01
GULU,OMORO COUNTY,LALOGI,LUKWIR,AWALKOK PR. 7 SCH. I,672,0,5,5,168,208,386,14,400,0,O-115-26-04-04-02
GULU,OMORO COUNTY,LALOGI,LUKWIR,AWALKOK PRIMARY SCHOOL II,329,3,1,1,188,5,198,9,207,0,O-115-26-04-04-03
GULU,OMORO COUNTY,LALOGI,LUKWIR,CORNER LAKWAYA,428,5,1,2,253,6,267,9,276,0,O-115-26-04-04-04
GULU,OMORO COUNTY,LALOGI,PARWECH,LUKWIR PR. 7 SCH. I,566,7,2,3,292,35,339,8,347,0,O-115-26-04-05-01
GULU,OMORO COUNTY,LALOGI,PARWECH,LUKWIR PR. 7 II,592,10,4,7,315,17,353,14,367,0,O-115-26-04-05-02
GULU,OMORO COUNTY,LALOGI,PARWECH,LUKWIR PRIMARY SCHOOL III,573,10,3,0,334,19,366,6,372,0,O-115-26-04-05-03
GULU,OMORO COUNTY,ODEK,BINYA,ACHET MARKET I,678,11,4,8,270,22,315,17,332,0,O-115-26-05-01-01
GULU,OMORO COUNTY,ODEK,BINYA,ACHET MARKET II,560,11,3,5,307,25,351,2,353,0,O-115-26-05-01-02
GULU,OMORO COUNTY,ODEK,BINYA,ORAPWOYO P.7 SCH. I,291,5,0,0,185,5,195,10,205,0,O-115-26-05-01-03
GULU,OMORO COUNTY,ODEK,BINYA,ORAPWOYO P 7   SCHOOL II,595,13,8,7,307,19,354,28,382,0,O-115-26-05-01-04
GULU,OMORO COUNTY,ODEK,BINYA,ACHET MARKET III,568,5,3,3,347,36,394,4,398,0,O-115-26-05-01-05
GULU,OMORO COUNTY,ODEK,LAMOLA,DINO P 7 SCHOOL,967,22,6,15,380,161,584,32,616,0,O-115-26-05-02-01
GULU,OMORO COUNTY,ODEK,LAMOLA,AWALI P 6   SCHOOL,693,14,3,12,405,14,448,15,463,0,O-115-26-05-02-02
GULU,OMORO COUNTY,ODEK,LAMOLA,MALABA MARKET,604,8,10,4,324,32,378,16,394,0,O-115-26-05-02-03
GULU,OMORO COUNTY,ODEK,LAMOLA,AWERE P.7 SCHOOL,542,10,4,7,288,23,332,19,351,0,O-115-26-05-02-04
GULU,OMORO COUNTY,ODEK,LAMOLA,AWERE TRADING CENTRE,553,12,3,8,271,31,325,8,333,0,O-115-26-05-02-05
GULU,OMORO COUNTY,ODEK,LUKWOR,BAROLAM CO-OPERATIVE SOCIET,429,8,0,3,225,8,244,5,249,0,O-115-26-05-03-01
GULU,OMORO COUNTY,ODEK,LUKWOR,BAROLAM CO-OPERATIVE SOCIET,516,4,4,5,318,16,347,12,359,0,O-115-26-05-03-02
GULU,OMORO COUNTY,ODEK,LUKWOR,BAROLAM CO-OPERATIVE SOCIET,464,8,3,6,253,21,291,13,304,0,O-115-26-05-03-03
GULU,OMORO COUNTY,ODEK,LUKWOR,BAROLAM CO-OPERATIVE SOCIET,568,1,2,1,137,23,164,57,221,0,O-115-26-05-03-04
GULU,OMORO COUNTY,ODEK,PALARO,ODEK P. 7 SCH A,524,9,0,2,275,38,324,6,330,0,O-115-26-05-04-01
GULU,OMORO COUNTY,ODEK,PALARO,ODEK P. 7 SCH B,650,11,5,12,306,24,358,5,363,0,O-115-26-05-04-02
GULU,OMORO COUNTY,ODEK,PALARO,ODEK P. 7 SCH C,546,8,1,8,211,32,260,11,271,0,O-115-26-05-04-03
GULU,OMORO COUNTY,ODEK,PALARO,ODEK S/C HQRS,320,2,2,2,154,8,168,5,173,0,O-115-26-05-04-04
GULU,OMORO COUNTY,ONGAKO,ABWOCH,KWEYO P. 7 SCH I,443,5,2,2,178,33,220,20,240,0,O-115-26-06-01-01
GULU,OMORO COUNTY,ONGAKO,ABWOCH,ABWOCH PRIMARY SCHOOL,608,6,3,9,390,15,423,24,447,0,O-115-26-06-01-02
GULU,OMORO COUNTY,ONGAKO,ABWOCH,KWEYO P. 7 SCH II,469,2,3,1,274,19,299,6,305,0,O-115-26-06-01-03
GULU,OMORO COUNTY,ONGAKO,ALOKOLUM,ALOKOLUM CENTRE A,810,5,5,11,413,74,508,18,526,0,O-115-26-06-02-01
GULU,OMORO COUNTY,ONGAKO,ALOKOLUM,ALOKOLUM CENTRE B,330,3,1,1,151,37,193,10,203,0,O-115-26-06-02-02
GULU,OMORO COUNTY,ONGAKO,ALOKOLUM,BWOBO TOCHI P 7 SCH (A-L),446,8,3,3,247,15,276,26,302,0,O-115-26-06-02-03
GULU,OMORO COUNTY,ONGAKO,ALOKOLUM,BWOBO TOCHI P 7 SCH (L-Z),410,3,3,3,271,19,299,9,308,0,O-115-26-06-02-04
GULU,OMORO COUNTY,ONGAKO,KAL,KOCH KOO PRIMARY SCHOOL I,590,4,2,5,313,46,370,45,415,0,O-115-26-06-03-01
GULU,OMORO COUNTY,ONGAKO,KAL,KOCH KOO PR. 7 SCH. II,578,5,6,7,307,41,366,21,387,0,O-115-26-06-03-02
GULU,OMORO COUNTY,ONGAKO,KAL,KOCH KOO PRIMARY SCHOOL III,290,8,1,1,168,31,209,16,225,0,O-115-26-06-03-03
GULU,OMORO COUNTY,ONGAKO,ONYONA,ONGAKO TRADING CENTRE,269,1,4,1,155,15,176,10,186,0,O-115-26-06-04-01
GULU,OMORO COUNTY,ONGAKO,ONYONA,ABOKA CHAPEL,322,5,4,4,192,27,232,10,242,0,O-115-26-06-04-02
GULU,OMORO COUNTY,ONGAKO,ONYONA,TONGWIRI CHAPEL,412,5,3,3,243,23,277,16,293,0,O-115-26-06-04-03
GULU,OMORO COUNTY,ONGAKO,PATUDA,CUKE-BER COOPERATIVE SOCIE,399,4,4,5,193,29,235,13,248,0,O-115-26-06-05-01
GULU,OMORO COUNTY,ONGAKO,PATUDA,CUKE-BER CO-OPERATIVE SOCIE,800,12,4,5,463,23,507,11,518,0,O-115-26-06-05-02
NEBBI,JONAM COUNTY,PAKWACH,ATYAK,JUPOJOK VILLAGE,717,6,6,6,262,204,484,19,503,0,O-118-181-01-01-01
NEBBI,JONAM COUNTY,PAKWACH,ATYAK,PAROKETO P. SCHOOL,393,3,3,1,163,98,268,3,271,0,O-118-181-01-01-02
NEBBI,JONAM COUNTY,PAKWACH,ATYAK,AKELA COTTON STORE,814,10,6,3,278,175,472,7,479,0,O-118-181-01-01-03
NEBBI,JONAM COUNTY,PAKWACH,ATYAK,TECWA PA OCUNGO,503,8,4,6,245,94,357,4,361,0,O-118-181-01-01-04
NEBBI,JONAM COUNTY,PAKWACH,ATYAK,TEKWOGO PA APOKO,386,3,4,3,126,61,197,11,208,0,O-118-181-01-01-05
NEBBI,JONAM COUNTY,PAKWACH,MUKALE,CIT-ITI PRIMARY SCHOOL,329,1,3,4,92,138,238,5,243,0,O-118-181-01-02-01
NEBBI,JONAM COUNTY,PAKWACH,MUKALE,PANYIGORO PRI. SCHOOL,585,4,3,5,161,232,405,9,414,0,O-118-181-01-02-02
NEBBI,JONAM COUNTY,PAKWACH,MUKALE,TERALING VILLAGE,509,8,5,3,215,126,357,8,365,0,O-118-181-01-02-03
NEBBI,JONAM COUNTY,PAKWACH,MUKALE,PANYIGORO COTTON STORE,474,5,2,2,107,190,306,13,319,0,O-118-181-01-02-04
NEBBI,JONAM COUNTY,PAKWACH,PAROKETO,PAKECH P. SCHOOL,474,1,6,2,222,82,313,14,327,0,O-118-181-01-03-01
NEBBI,JONAM COUNTY,PAKWACH,PAROKETO,PUVONA P. SCHOOL,818,14,22,7,391,132,566,5,571,0,O-118-181-01-03-02
NEBBI,JONAM COUNTY,PAKWACH,PAROKETO,WORLD VISION OFFICE,555,8,8,3,224,129,372,12,384,0,O-118-181-01-03-03
NEBBI,JONAM COUNTY,PAKWACH,PAROKETO,TEE CWAA/JUPUTUR,469,3,5,6,263,57,334,8,342,0,O-118-181-01-03-04
NEBBI,JONAM COUNTY,PAKWACH T.C,AMOR,AYARA PRIMARY SCHOOL,728,7,19,16,264,175,481,14,495,0,O-118-181-02-01-01
NEBBI,JONAM COUNTY,PAKWACH T.C,AMOR,OWERE STATION,453,5,6,9,184,124,328,15,343,0,O-118-181-02-01-02
NEBBI,JONAM COUNTY,PAKWACH T.C,AMOR,OWERE PRIMARY SCHOOL,764,12,12,8,280,247,559,19,578,0,O-118-181-02-01-03
NEBBI,JONAM COUNTY,PAKWACH T.C,AMOR,THE KAVUJI C. STORE,641,9,26,8,301,111,455,19,474,0,O-118-181-02-01-04
NEBBI,JONAM COUNTY,PAKWACH T.C,AMOR,WANG - KAWA P. SCHOOL,745,8,23,6,229,227,493,6,499,0,O-118-181-02-01-05
NEBBI,JONAM COUNTY,PAKWACH T.C,POVUNGU,PAKWACH GIRLS P.SCHOOL,619,4,8,7,218,116,353,4,357,0,O-118-181-02-02-01
NEBBI,JONAM COUNTY,PAKWACH T.C,POVUNGU,OMACH PRIMARY SCHOOL,521,0,9,6,179,146,340,3,343,0,O-118-181-02-02-02
NEBBI,JONAM COUNTY,PAKWACH T.C,POVUNGU,PAKWACH HEALTH CENTRE,720,5,2,4,246,96,353,8,361,0,O-118-181-02-02-03
NEBBI,JONAM COUNTY,PAKWACH T.C,POVUNGU,PAKWACH PUBLIC SCHOOL,527,5,7,2,189,107,310,22,332,0,O-118-181-02-02-04
NEBBI,JONAM COUNTY,PAKWACH T.C,POVUNGU,U.C.C. PAKWACH,602,1,8,2,226,91,328,6,334,0,O-118-181-02-02-05
NEBBI,JONAM COUNTY,PAKWACH T.C,POVUNGU,KANISA PUVUNGU,511,2,5,3,141,148,299,15,314,0,O-118-181-02-02-06
NEBBI,JONAM COUNTY,PAKWACH T.C,POVUNGU,MUGOBE,605,3,15,2,268,119,407,7,414,0,O-118-181-02-02-07
NEBBI,JONAM COUNTY,PAKWACH T.C,POVUNGU,PUYOO,603,5,8,6,294,151,464,6,470,0,O-118-181-02-02-08
NEBBI,JONAM COUNTY,PAKWACH T.C,POVUNGU,PAJOBI P. SCHOOL,439,5,16,6,150,108,285,12,297,0,O-118-181-02-02-09
NEBBI,JONAM COUNTY,PAKWACH T.C,POVUNGU,PAKWACH T.C. OFFICE,477,2,5,1,142,51,201,3,204,0,O-118-181-02-02-10
NEBBI,JONAM COUNTY,PANYANGO,ALWI,ALIEKRA,90,1,1,0,20,49,71,2,73,0,O-118-181-03-01-01
NEBBI,JONAM COUNTY,PANYANGO,ALWI,KAYOM,339,5,7,4,130,105,251,1,252,0,O-118-181-03-01-02
NEBBI,JONAM COUNTY,PANYANGO,ALWI,NYARIEGI,362,6,10,2,110,124,252,0,252,0,O-118-181-03-01-03
NEBBI,JONAM COUNTY,PANYANGO,ALWI,PAILA CENTRE,598,3,16,9,225,155,408,10,418,0,O-118-181-03-01-04
NEBBI,JONAM COUNTY,PANYANGO,ALWI,PAINGEITH P. SCHOOL,380,3,13,2,80,166,264,16,280,0,O-118-181-03-01-05
NEBBI,JONAM COUNTY,PANYANGO,ALWI,PAJAO,292,0,3,2,99,74,178,10,188,0,O-118-181-03-01-06
NEBBI,JONAM COUNTY,PANYANGO,ALWI,PANGYETH CENTRE,204,1,4,4,70,56,135,6,141,0,O-118-181-03-01-07
NEBBI,JONAM COUNTY,PANYANGO,ALWI,PATENG CENTRE,678,7,38,9,229,103,386,9,395,0,O-118-181-03-01-08
NEBBI,JONAM COUNTY,PANYANGO,ALWI,PAYUNGU PRIMARY SCHOOL,518,6,4,2,170,144,326,14,340,0,O-118-181-03-01-09
NEBBI,JONAM COUNTY,PANYANGO,PACEGO,ANDIBO P. SCHOOL,674,6,14,3,303,93,419,23,442,0,O-118-181-03-02-01
NEBBI,JONAM COUNTY,PANYANGO,PACEGO,KINJU P. SCHOOL,456,9,9,2,186,91,297,18,315,0,O-118-181-03-02-02
NEBBI,JONAM COUNTY,PANYANGO,PACEGO,PACEGO P. SCHOOL,767,5,8,13,328,183,537,9,546,0,O-118-181-03-02-03
NEBBI,JONAM COUNTY,PANYANGO,PACEGO,PACEGO COTTON STORE,636,4,13,5,300,130,452,22,474,0,O-118-181-03-02-04
NEBBI,JONAM COUNTY,PANYANGO,PACEGO,PADOCH PRIMARY SCHOOL,690,6,16,9,233,191,455,11,466,0,O-118-181-03-02-05
NEBBI,JONAM COUNTY,PANYANGO,PACEGO,PANYANGO S/COUNTY HQRS,495,6,5,3,191,131,336,19,355,0,O-118-181-03-02-06
NEBBI,JONAM COUNTY,PANYANGO,PACEGO,KINJU PRI. SCH.,237,1,16,3,64,80,164,3,167,0,O-118-181-03-02-07
NEBBI,JONAM COUNTY,PANYANGO,PACEGO,RAGEM KENYA,180,1,2,2,90,33,128,7,135,0,O-118-181-03-02-08
NEBBI,JONAM COUNTY,PANYANGO,PAKIA,PAGWAYA P/SCHOOL,436,6,14,9,136,143,308,4,312,0,O-118-181-03-03-01
NEBBI,JONAM COUNTY,PANYANGO,PAKIA,PAKIA DISPENSARY,508,3,10,13,181,89,296,21,317,0,O-118-181-03-03-02
NEBBI,JONAM COUNTY,PANYANGO,PAKIA,PAMITO P. SCHOOL,601,7,12,10,161,182,372,20,392,0,O-118-181-03-03-03
NEBBI,JONAM COUNTY,PANYANGO,PAKIA,OCHEKE,453,6,5,9,92,166,278,22,300,0,O-118-181-03-03-04
NEBBI,JONAM COUNTY,PANYANGO,POKWERO,FUALWONGA P. SCHOOL,671,10,6,20,198,267,501,12,513,0,O-118-181-03-04-01
NEBBI,JONAM COUNTY,PANYANGO,POKWERO,LOBODEGI P. SCHOOL,522,7,13,6,248,75,349,8,357,0,O-118-181-03-04-02
NEBBI,JONAM COUNTY,PANYANGO,POKWERO,OWINY P. SCHOOL,850,13,9,19,235,306,582,17,599,0,O-118-181-03-04-03
NEBBI,JONAM COUNTY,PANYANGO,POKWERO,POKWERO P. SCHOOL,406,5,18,5,148,95,271,15,286,0,O-118-181-03-04-04
NEBBI,JONAM COUNTY,PANYANGO,POKWERO,POKWERO COTTON STORE,848,1,21,6,377,152,557,16,573,0,O-118-181-03-04-05
NEBBI,JONAM COUNTY,PANYANGO,POKWERO,JANAN ORWINYO COTTON STORE,236,5,6,7,87,55,160,14,174,0,O-118-181-03-04-06
NEBBI,JONAM COUNTY,PANYANGO,POKWERO,BANDAWULI,317,3,21,12,144,59,239,5,244,0,O-118-181-03-04-07
NEBBI,JONAM COUNTY,PANYIMUR,BORO,BORO PRIMARY SCHOOL,540,7,9,7,115,242,380,7,387,0,O-118-181-04-01-01
NEBBI,JONAM COUNTY,PANYIMUR,BORO,JAKOK CHAPEL,444,0,3,2,78,234,317,0,317,0,O-118-181-04-01-02
NEBBI,JONAM COUNTY,PANYIMUR,BORO,PANYIMUR S/COUNTY,394,9,7,1,124,112,253,11,264,0,O-118-181-04-01-03
NEBBI,JONAM COUNTY,PANYIMUR,BORO,NYAKIRO,325,2,2,1,110,99,214,3,217,0,O-118-181-04-01-04
NEBBI,JONAM COUNTY,PANYIMUR,BORO,WANGKADO COPE CENTRE,459,10,12,3,189,145,359,13,372,0,O-118-181-04-01-05
NEBBI,JONAM COUNTY,PANYIMUR,BORO,MARAMA PRIMARY SCHOOL,247,2,3,0,80,98,183,8,191,0,O-118-181-04-01-06
NEBBI,JONAM COUNTY,PANYIMUR,GANDA,FISHERIES STATION,785,9,4,1,271,207,492,8,500,0,O-118-181-04-02-01
NEBBI,JONAM COUNTY,PANYIMUR,GANDA,OGAL COTTON STORE,462,5,5,3,124,149,286,7,293,0,O-118-181-04-02-02
NEBBI,JONAM COUNTY,PANYIMUR,GANDA,PANYIMUR SEC. SCHOOL,528,4,6,5,134,222,371,1,372,0,O-118-181-04-02-03
NEBBI,JONAM COUNTY,PANYIMUR,GANDA,ACUNGIRWOTH PRI. SCHOOL,214,3,4,0,27,91,125,14,139,0,O-118-181-04-02-04
NEBBI,JONAM COUNTY,PANYIMUR,NYAKAGEI,ANGUMU CHAPEL,610,4,8,5,198,235,450,16,466,0,O-118-181-04-03-01
NEBBI,JONAM COUNTY,PANYIMUR,NYAKAGEI,NYAMUTANGA - CWA TREE,369,6,3,3,85,131,228,12,240,0,O-118-181-04-03-02
NEBBI,JONAM COUNTY,PANYIMUR,NYAKAGEI,DEI PRIMARY SCHOOL,608,3,9,5,137,223,377,11,388,0,O-118-181-04-03-03
NEBBI,JONAM COUNTY,PANYIMUR,NYAKAGEI,LULI - OGUTA P. SCHOOL,437,2,5,1,91,180,279,7,286,0,O-118-181-04-03-04
NEBBI,JONAM COUNTY,PANYIMUR,NYAKAGEI,SINGLA A NYAKAGEI COTTON ST,879,8,10,4,355,192,569,18,587,0,O-118-181-04-03-05
NEBBI,JONAM COUNTY,PANYIMUR,NYAKAGEI,DEI CENTRAL MOSQUE,544,6,7,9,132,191,345,8,353,0,O-118-181-04-03-06
NEBBI,JONAM COUNTY,PANYIMUR,NYAKAGEI,KAYONGA PRIMARY SCHOOL,265,3,5,0,77,104,189,5,194,0,O-118-181-04-03-07
NEBBI,JONAM COUNTY,WADELEY,MUTIR,MUTIR P. SCHOOL [TEE FOYO],622,10,2,6,319,124,461,9,470,0,O-118-181-05-01-01
NEBBI,JONAM COUNTY,WADELEY,MUTIR,PAJAGO PRIMARY SCHOOL,823,11,9,4,363,122,509,22,531,0,O-118-181-05-01-02
NEBBI,JONAM COUNTY,WADELEY,MUTIR,WANG - MUPAKA[AGU WEST],537,17,7,10,221,82,337,14,351,0,O-118-181-05-01-03
NEBBI,JONAM COUNTY,WADELEY,MUTIR,OJIGO PRIMARY SCHOOL,402,2,2,0,189,45,238,3,241,0,O-118-181-05-01-04
NEBBI,JONAM COUNTY,WADELEY,PAKWINYO,OJINGA PRIMARY SCHOOL,477,4,6,2,236,79,327,9,336,0,O-118-181-05-02-01
NEBBI,JONAM COUNTY,WADELEY,PAKWINYO,PAKWINYO COPE CENTRE,423,3,6,2,184,89,284,15,299,0,O-118-181-05-02-02
NEBBI,JONAM COUNTY,WADELEY,PAKWINYO,PABEGU THE-BONGO,321,5,2,5,177,38,227,9,236,0,O-118-181-05-02-03
NEBBI,JONAM COUNTY,WADELEY,PAKWINYO,PAKWINYO PRI. SCHOOL,153,2,10,2,55,27,96,1,97,0,O-118-181-05-02-04
NEBBI,JONAM COUNTY,WADELEY,PAKWINYO,OCAYO PRIMARY SCHOOL,162,4,4,5,54,49,116,0,116,0,O-118-181-05-02-05
NEBBI,JONAM COUNTY,WADELEY,PAKWINYO,PAVOGI,426,4,2,2,187,127,322,14,336,0,O-118-181-05-02-06
NEBBI,JONAM COUNTY,WADELEY,RAGEM,AYABU STORE,315,7,4,1,166,43,221,6,227,0,O-118-181-05-03-01
NEBBI,JONAM COUNTY,WADELEY,RAGEM,AJIBU PRIMARY SCHOOL,514,4,10,1,195,153,363,17,380,0,O-118-181-05-03-02
NEBBI,JONAM COUNTY,WADELEY,RAGEM,PATEN BUSH SCHOOL,643,10,6,1,261,196,474,6,480,0,O-118-181-05-03-03
NEBBI,JONAM COUNTY,WADELEY,RAGEM,RAGEM COTTON STORE,819,10,10,6,259,174,459,13,472,0,O-118-181-05-03-04
NEBBI,JONAM COUNTY,WADELEY,RAGEM,RAGEM HEALTH CENTRE,326,8,6,2,139,78,233,6,239,0,O-118-181-05-03-05
NAKAPIRIPIRIT,PIAN COUNTY,LOLACHAT,LORUKUMO,DOMOYE,342,0,1,1,2,257,261,2,263,0,O-123-148-01-01-01
NAKAPIRIPIRIT,PIAN COUNTY,LOLACHAT,LOTARUK,LOLACHT TRADING CENTRE,586,0,3,0,19,299,321,15,336,0,O-123-148-01-02-01
NAKAPIRIPIRIT,PIAN COUNTY,LOLACHAT,LOTARUK,NAMONI,394,1,1,6,5,213,226,5,231,0,O-123-148-01-02-02
NAKAPIRIPIRIT,PIAN COUNTY,LOLACHAT,LOTARUK,NATHINYONOIT,159,3,1,2,1,143,150,8,158,0,O-123-148-01-02-03
NAKAPIRIPIRIT,PIAN COUNTY,LOLACHAT,LOTARUK,NACHELE,210,2,0,0,2,129,133,0,133,0,O-123-148-01-02-04
NAKAPIRIPIRIT,PIAN COUNTY,LOLACHAT,NAKURI,LONSUNGU,538,0,0,3,1,463,467,4,471,0,O-123-148-01-03-01
NAKAPIRIPIRIT,PIAN COUNTY,LOLACHAT,NATIRAE,LOKIBUI,520,1,0,1,1,254,257,4,261,0,O-123-148-01-04-01
NAKAPIRIPIRIT,PIAN COUNTY,LOLACHAT,NATIRAE,MORUANGAMION,302,0,0,2,1,158,161,3,164,0,O-123-148-01-04-02
NAKAPIRIPIRIT,PIAN COUNTY,LOLACHAT,NATIRAE,NATIRAE,532,2,0,0,4,281,287,8,295,0,O-123-148-01-04-03
NAKAPIRIPIRIT,PIAN COUNTY,LOLACHAT,NATIRAE,NASINYONOIT,182,0,0,0,0,166,166,0,166,0,O-123-148-01-04-04
NAKAPIRIPIRIT,PIAN COUNTY,LOLACHAT,NATIRAE,MORUANGAMIYONI,190,0,0,0,0,0,0,0,0,1,O-123-148-01-04-05
NAKAPIRIPIRIT,PIAN COUNTY,LOLACHAT,SAKALE,LOPEDURU,402,1,1,2,3,262,269,0,269,0,O-123-148-01-05-01
NAKAPIRIPIRIT,PIAN COUNTY,LOLACHAT,SAKALE,NANGAMIT,248,0,0,1,3,149,153,2,155,0,O-123-148-01-05-02
NAKAPIRIPIRIT,PIAN COUNTY,LORENGEDWAT,KAMATURU,NAAPONG,654,1,6,6,4,288,305,29,334,0,O-123-148-02-01-01
NAKAPIRIPIRIT,PIAN COUNTY,LORENGEDWAT,NARISAE,NARISAE T.C.,733,3,6,11,26,253,299,24,323,0,O-123-148-02-02-01
NAKAPIRIPIRIT,PIAN COUNTY,LORENGEDWAT,NARISAE,LORENGEDWAT P/S,368,1,1,12,5,139,158,10,168,0,O-123-148-02-02-02
NAKAPIRIPIRIT,PIAN COUNTY,LORENGEDWAT,NATHINYONOIT,LONANGAT,271,0,0,3,1,148,152,12,164,0,O-123-148-02-03-01
NAKAPIRIPIRIT,PIAN COUNTY,LORENGEDWAT,NATHINYONOIT,NAWEET,462,0,0,1,1,245,247,9,256,0,O-123-148-02-03-02
NAKAPIRIPIRIT,PIAN COUNTY,LORENGEDWAT,NATHINYONOIT,OUTSIDE Q.GUARD,179,0,0,2,62,110,174,2,176,0,O-123-148-02-03-03
NAKAPIRIPIRIT,PIAN COUNTY,NABILATUK,ACEGERETOLIN,ARENGESIEP,389,0,4,4,3,219,230,25,255,0,O-123-148-03-01-01
NAKAPIRIPIRIT,PIAN COUNTY,NABILATUK,ACEGERETOLIN,CUCU PR. SCHOOL,668,0,1,1,8,477,487,12,499,0,O-123-148-03-01-02
NAKAPIRIPIRIT,PIAN COUNTY,NABILATUK,ACEGERETOLIN,LOTEDE,366,3,1,2,7,245,258,11,269,0,O-123-148-03-01-03
NAKAPIRIPIRIT,PIAN COUNTY,NABILATUK,KALOKWAMERI,LOSIMIT,608,7,5,7,13,188,220,25,245,0,O-123-148-03-02-01
NAKAPIRIPIRIT,PIAN COUNTY,NABILATUK,KALOKWAMERI,NAPONGAE,265,0,0,0,0,265,265,0,265,0,O-123-148-03-02-02
NAKAPIRIPIRIT,PIAN COUNTY,NABILATUK,KOTHIKE,NATERGEREBET,560,4,0,0,11,374,389,14,403,0,O-123-148-03-03-01
NAKAPIRIPIRIT,PIAN COUNTY,NABILATUK,KOTHIKE,NAYONIANGIKALIO,472,0,0,0,1,468,469,0,469,0,O-123-148-03-03-02
NAKAPIRIPIRIT,PIAN COUNTY,NABILATUK,LOKALAA,NADUDEP,364,0,0,0,1,213,214,9,223,0,O-123-148-03-04-01
NAKAPIRIPIRIT,PIAN COUNTY,NABILATUK,LOKALAA,NATHINYONOIT,516,0,1,0,3,292,296,5,301,0,O-123-148-03-04-02
NAKAPIRIPIRIT,PIAN COUNTY,NABILATUK,MAGORO,NABWAL,348,0,1,1,2,251,255,4,259,0,O-123-148-03-05-01
NAKAPIRIPIRIT,PIAN COUNTY,NABILATUK,MORUANGIBUIN,ARIAMAOI,474,0,2,0,24,293,319,0,319,0,O-123-148-03-06-01
NAKAPIRIPIRIT,PIAN COUNTY,NABILATUK,MORUANGIBUIN,NABILATUK TRADING CENTRE,629,6,1,5,51,292,355,14,369,0,O-123-148-03-06-02
NAKAPIRIPIRIT,PIAN COUNTY,NABILATUK,NAKOBEKOBE,NAKOBEKOBE,412,0,0,1,2,202,205,7,212,0,O-123-148-03-07-01
NAKAPIRIPIRIT,PIAN COUNTY,NABILATUK,NATOPOJO,LOKIRIMO,512,2,3,6,10,341,362,17,379,0,O-123-148-03-08-01
APAC,KWANIA COUNTY,ABONGOMOLA,ABANY,TE-ORO,536,6,31,2,247,82,368,7,375,0,O-126-2-01-01-01
APAC,KWANIA COUNTY,ABONGOMOLA,ABANY,AWEI,720,8,49,6,298,167,528,11,539,0,O-126-2-01-01-02
APAC,KWANIA COUNTY,ABONGOMOLA,ABANY,ABANY MARKET,552,5,26,18,256,71,376,13,389,0,O-126-2-01-01-03
APAC,KWANIA COUNTY,ABONGOMOLA,ABWONG,ABWONG P 7 SCHOOL,459,14,46,10,206,55,331,4,335,0,O-126-2-01-02-01
APAC,KWANIA COUNTY,ABONGOMOLA,ABWONG,AGWA P.7 SCHOOL,671,5,50,7,369,44,475,7,482,0,O-126-2-01-02-02
APAC,KWANIA COUNTY,ABONGOMOLA,ABWONG,OLIO P A G CHURCH/AMUDA,447,9,144,5,127,52,337,13,350,0,O-126-2-01-02-03
APAC,KWANIA COUNTY,ABONGOMOLA,ACUNGI,ACOININO P 7 SCHOOL,242,3,16,7,109,16,151,3,154,0,O-126-2-01-03-01
APAC,KWANIA COUNTY,ABONGOMOLA,ACUNGI,OWONYO KONO,455,5,19,2,266,18,310,10,320,0,O-126-2-01-03-02
APAC,KWANIA COUNTY,ABONGOMOLA,ACUNGI,ACUNGI P.7 SCHOOL,147,0,3,0,63,32,98,14,112,0,O-126-2-01-03-03
APAC,KWANIA COUNTY,ABONGOMOLA,ACUNGI,ABONGOMOLA,532,6,29,8,292,47,382,8,390,0,O-126-2-01-03-04
APAC,KWANIA COUNTY,ABONGOMOLA,AKALI,ALEL,227,3,31,1,114,8,157,1,158,0,O-126-2-01-04-01
APAC,KWANIA COUNTY,ABONGOMOLA,AKALI,TELELA,422,11,33,3,170,57,274,14,288,0,O-126-2-01-04-02
APAC,KWANIA COUNTY,ABONGOMOLA,AKALI,AGURI,583,16,51,11,230,76,384,15,399,0,O-126-2-01-04-03
APAC,KWANIA COUNTY,ABONGOMOLA,AKALI,OLOK MARKET,271,0,19,3,161,24,207,4,211,0,O-126-2-01-04-04
APAC,KWANIA COUNTY,ABONGOMOLA,AMORIGOGA,AMORIGOGA P 7 SCHOOL,733,14,26,15,412,68,535,17,552,0,O-126-2-01-05-01
APAC,KWANIA COUNTY,ABONGOMOLA,AMORIGOGA,ACOININO P 7 SCHOOL,426,0,39,3,170,47,259,27,286,0,O-126-2-01-05-02
APAC,KWANIA COUNTY,ABONGOMOLA,AMORIGOGA,TEYAO,415,5,25,1,236,24,291,0,291,0,O-126-2-01-05-03
APAC,KWANIA COUNTY,ADUKU,ABOKO,AORA,332,4,17,4,118,60,203,6,209,0,O-126-2-02-01-01
APAC,KWANIA COUNTY,ADUKU,ABOKO,AMIA P.7 SCHOOL,777,9,36,7,447,92,591,13,604,0,O-126-2-02-01-02
APAC,KWANIA COUNTY,ADUKU,ABOKO,ODEO CORNER,652,6,28,3,227,112,376,95,471,0,O-126-2-02-01-03
APAC,KWANIA COUNTY,ADUKU,ABOKO,ABOKO PRI. SCHOOL,156,2,9,8,63,15,97,29,126,0,O-126-2-02-01-04
APAC,KWANIA COUNTY,ADUKU,ABOKO,WIGWENG,356,7,23,5,120,75,230,33,263,0,O-126-2-02-01-05
APAC,KWANIA COUNTY,ADUKU,ADYEDA,ADYEDA CENTRE,448,6,34,4,166,84,294,34,328,0,O-126-2-02-02-01
APAC,KWANIA COUNTY,ADUKU,ADYEDA,APORWEGI P.7 SCHOOL,458,3,54,3,125,93,278,76,354,0,O-126-2-02-02-02
APAC,KWANIA COUNTY,ADUKU,ADYEDA,OT-OGOLE,454,3,21,2,140,98,264,89,353,0,O-126-2-02-02-03
APAC,KWANIA COUNTY,ADUKU,ADYEDA,ADUKU S.S.S,391,0,19,3,118,83,223,42,265,0,O-126-2-02-02-04
APAC,KWANIA COUNTY,ADUKU,ADYEDA,ADUKU U.C.C,395,1,20,2,141,73,237,8,245,0,O-126-2-02-02-05
APAC,KWANIA COUNTY,ADUKU,ALIRA,ALIRA B,505,7,58,5,201,59,330,9,339,0,O-126-2-02-03-01
APAC,KWANIA COUNTY,ADUKU,ALIRA,AKOT A,414,8,36,4,180,82,310,2,312,0,O-126-2-02-03-02
APAC,KWANIA COUNTY,ADUKU,ALIRA,OLEKE,629,8,28,0,268,42,346,92,438,0,O-126-2-02-03-03
APAC,KWANIA COUNTY,ADUKU,ALIRA,AKWODONG,257,3,32,0,118,29,182,7,189,0,O-126-2-02-03-04
APAC,KWANIA COUNTY,ADUKU,APIRE,APIRE,553,7,79,4,204,83,377,12,389,0,O-126-2-02-04-01
APAC,KWANIA COUNTY,ADUKU,APIRE,ANGOLENYANG,452,8,27,2,196,62,295,71,366,0,O-126-2-02-04-02
APAC,KWANIA COUNTY,ADUKU,APIRE,ACUT,311,4,57,7,128,50,246,10,256,0,O-126-2-02-04-03
APAC,KWANIA COUNTY,ADUKU,ONGOCENG,AKWON,368,8,14,9,162,78,271,1,272,0,O-126-2-02-05-01
APAC,KWANIA COUNTY,ADUKU,ONGOCENG,ANGINYI,517,3,27,7,310,50,397,14,411,0,O-126-2-02-05-02
APAC,KWANIA COUNTY,ADUKU,ONGOCENG,IKWERA,707,8,29,13,325,104,479,13,492,0,O-126-2-02-05-03
APAC,KWANIA COUNTY,ADUKU,ONGOCENG,AWANGA MARKET,492,6,20,3,166,55,250,107,357,0,O-126-2-02-05-04
APAC,KWANIA COUNTY,CAWENTE,ACENLWORO,BILI MARKET,317,4,30,7,87,34,162,81,243,0,O-126-2-03-01-01
APAC,KWANIA COUNTY,CAWENTE,ACENLWORO,ADAKINGO MARKET,585,9,53,11,223,139,435,12,447,0,O-126-2-03-01-02
APAC,KWANIA COUNTY,CAWENTE,AJAR,APOLIKA PRIMARY SCHOOL,684,7,49,9,220,89,374,55,429,0,O-126-2-03-02-01
APAC,KWANIA COUNTY,CAWENTE,AJAR,OGULE MARKET,484,3,30,0,128,82,243,57,300,0,O-126-2-03-02-02
APAC,KWANIA COUNTY,CAWENTE,ALIDO,CHAWENTE SUB-COUNTY HQRTS,596,1,36,1,188,142,368,48,416,0,O-126-2-03-03-01
APAC,KWANIA COUNTY,CAWENTE,ALIDO,ABOLI MARKET,677,16,55,12,299,107,489,17,506,0,O-126-2-03-03-02
APAC,KWANIA COUNTY,CAWENTE,ATONGTIDI,IWAL MARKET,445,9,48,1,138,54,250,63,313,0,O-126-2-03-04-01
APAC,KWANIA COUNTY,CAWENTE,ATONGTIDI,AMWANGA P.7 SCHOOL,658,12,63,15,244,127,461,14,475,0,O-126-2-03-04-02
APAC,KWANIA COUNTY,CAWENTE,ATONGTIDI,CHAWENTE S S,609,2,94,7,195,96,394,10,404,0,O-126-2-03-04-03
APAC,KWANIA COUNTY,CAWENTE,ATONGTIDI,AGOLO PRI. SCHOOL,342,2,42,1,134,45,224,0,224,0,O-126-2-03-04-04
APAC,KWANIA COUNTY,CAWENTE,ATONGTIDI,ACAMANUMU CORNER DAIRY,216,1,40,2,84,29,156,18,174,0,O-126-2-03-04-05
APAC,KWANIA COUNTY,CAWENTE,ATULE,ATULE S/GRADE SCHOOL,471,7,18,3,247,42,317,52,369,0,O-126-2-03-05-01
APAC,KWANIA COUNTY,CAWENTE,ATULE,ABAPIRI P 7 SCHOOL,807,6,63,4,187,150,410,89,499,0,O-126-2-03-05-02
APAC,KWANIA COUNTY,INOMO,ABEDMOT,AGOBI AID POST,551,12,82,3,217,100,414,12,426,0,O-126-2-04-01-01
APAC,KWANIA COUNTY,INOMO,ABEDMOT,AMAMBALE,568,12,107,3,192,87,401,7,408,0,O-126-2-04-01-02
APAC,KWANIA COUNTY,INOMO,ABEDMOT,TIMAKICA MARKET,298,3,53,4,118,55,233,2,235,0,O-126-2-04-01-03
APAC,KWANIA COUNTY,INOMO,AGWICIRI,ALAI,456,3,58,5,189,78,333,4,337,0,O-126-2-04-02-01
APAC,KWANIA COUNTY,INOMO,AGWICIRI,APUMI,546,1,24,4,241,83,353,84,437,0,O-126-2-04-02-02
APAC,KWANIA COUNTY,INOMO,AGWICIRI,ANYWAL,360,4,49,2,173,43,271,11,282,0,O-126-2-04-02-03
APAC,KWANIA COUNTY,INOMO,AGWICIRI,ACOWERE,154,0,19,1,73,13,106,16,122,0,O-126-2-04-02-04
APAC,KWANIA COUNTY,INOMO,AJOK,ONGICA,738,10,35,14,355,104,518,13,531,0,O-126-2-04-03-01
APAC,KWANIA COUNTY,INOMO,AJOK,LWALA,663,10,32,9,284,115,450,0,450,0,O-126-2-04-03-02
APAC,KWANIA COUNTY,INOMO,AJOK,BUNG GUDU,447,6,35,7,185,69,302,12,314,0,O-126-2-04-03-03
APAC,KWANIA COUNTY,INOMO,BANYA,AKOREMOR,397,6,148,2,115,36,307,9,316,0,O-126-2-04-04-01
APAC,KWANIA COUNTY,INOMO,BANYA,AKUTOABWOLE,604,9,55,5,283,134,486,5,491,0,O-126-2-04-04-02
APAC,KWANIA COUNTY,INOMO,INOMO,APIREMIT,501,8,33,7,168,127,343,0,343,0,O-126-2-04-05-01
APAC,KWANIA COUNTY,INOMO,INOMO,BARLWALA,548,4,39,4,207,58,312,54,366,0,O-126-2-04-05-02
APAC,KWANIA COUNTY,INOMO,INOMO,BARETEK,832,4,41,4,516,122,687,1,688,0,O-126-2-04-05-03
APAC,KWANIA COUNTY,INOMO,INOMO,ALIK P 7 SCHOOL,450,8,36,8,219,46,317,13,330,0,O-126-2-04-05-04
APAC,KWANIA COUNTY,NAMBIESO,ABULI,OGWIL,489,12,11,4,290,57,374,8,382,0,O-126-2-05-01-01
APAC,KWANIA COUNTY,NAMBIESO,ABULI,ABULI P.7,682,8,16,5,401,61,491,6,497,0,O-126-2-05-01-02
APAC,KWANIA COUNTY,NAMBIESO,ABULI,ODALOWANG/OMWONO,428,11,13,1,243,35,303,4,307,0,O-126-2-05-01-03
APAC,KWANIA COUNTY,NAMBIESO,ACABA,AGENGI A,285,2,12,3,78,119,214,4,218,0,O-126-2-05-02-01
APAC,KWANIA COUNTY,NAMBIESO,ACABA,BARATEGO/ATUMA P.7,462,4,17,3,117,99,240,80,320,0,O-126-2-05-02-02
APAC,KWANIA COUNTY,NAMBIESO,ACABA,AGWEI T.C,317,4,15,2,141,56,218,15,233,0,O-126-2-05-02-03
APAC,KWANIA COUNTY,NAMBIESO,ANWANGI,AYAT A,564,12,32,11,191,174,420,17,437,0,O-126-2-05-03-01
APAC,KWANIA COUNTY,NAMBIESO,ANWANGI,EMIN A,737,15,33,10,259,174,491,1,492,0,O-126-2-05-03-02
APAC,KWANIA COUNTY,NAMBIESO,ANWANGI,ANGEOKOMA,355,3,38,5,168,47,261,6,267,0,O-126-2-05-03-03
APAC,KWANIA COUNTY,NAMBIESO,AORNGA,ABURU,513,5,13,145,173,145,481,27,508,0,O-126-2-05-04-01
APAC,KWANIA COUNTY,NAMBIESO,AORNGA,OKWOR P.7,416,2,28,3,151,111,295,4,299,0,O-126-2-05-04-02
APAC,KWANIA COUNTY,NAMBIESO,AORNGA,EGWOR,262,1,14,4,96,9,124,46,170,0,O-126-2-05-04-03
APAC,KWANIA COUNTY,NAMBIESO,AYABI,AYABI T/CENTRE,625,5,7,9,367,79,467,8,475,0,O-126-2-05-05-01
APAC,KWANIA COUNTY,NAMBIESO,AYABI,AYABI P.7 SCHOOL,477,5,12,6,261,81,365,10,375,0,O-126-2-05-05-02
APAC,KWANIA COUNTY,NAMBIESO,AYABI,PUNUATAR P 7 SCHOOL,688,13,12,5,428,64,522,4,526,0,O-126-2-05-05-03
APAC,KWANIA COUNTY,NAMBIESO,BUNG,OYITO YAT,429,6,14,1,204,95,320,10,330,0,O-126-2-05-06-01
APAC,KWANIA COUNTY,NAMBIESO,BUNG,AJENGI,714,9,22,19,314,168,532,15,547,0,O-126-2-05-06-02
APAC,KWANIA COUNTY,NAMBIESO,ETEK OBER,AGWENYERE A PRIMARY SCHOO,637,18,13,5,262,65,363,82,445,0,O-126-2-05-07-01
APAC,KWANIA COUNTY,NAMBIESO,ETEK OBER,ETEK OBER PRIMARY SCHOOL,630,5,54,8,249,75,391,17,408,0,O-126-2-05-07-02
APAC,KWANIA COUNTY,NAMBIESO,OWINY,OWINY,484,0,7,4,181,165,357,0,357,0,O-126-2-05-08-01
APAC,KWANIA COUNTY,NAMBIESO,OWINY,IGOTI/ACULAWIC,559,11,16,6,319,73,425,5,430,0,O-126-2-05-08-02
APAC,KWANIA COUNTY,NAMBIESO,OWINY,AMITO MOT,228,1,2,1,106,67,177,1,178,0,O-126-2-05-08-03
MOYO,OBONGI COUNTY,ALIBA,ARINGAJOBI,OBONGI SEC SCH,548,14,0,8,224,92,338,17,355,0,O-129-152-01-01-01
MOYO,OBONGI COUNTY,ALIBA,DILOKATA,DILOKATA P SCH,639,20,2,25,218,134,399,33,432,0,O-129-152-01-02-01
MOYO,OBONGI COUNTY,ALIBA,DILOKATA,ALIBA BITO TRADING CENTRE,505,15,9,12,226,85,347,9,356,0,O-129-152-01-02-02
MOYO,OBONGI COUNTY,ALIBA,DILOKATA,RODO P SCH,493,2,2,5,228,90,327,15,342,0,O-129-152-01-02-03
MOYO,OBONGI COUNTY,ALIBA,EWAFA,ALIBA JAAGO'S HQTRS,608,16,3,15,226,118,378,31,409,0,O-129-152-01-03-01
MOYO,OBONGI COUNTY,ALIBA,EWAFA,EWAFA PRI. SCHOOL,476,10,1,7,222,94,334,6,340,0,O-129-152-01-03-02
MOYO,OBONGI COUNTY,ALIBA,INDILINGA,ALIBA P SCH,418,5,4,3,176,87,275,22,297,0,O-129-152-01-04-01
MOYO,OBONGI COUNTY,ALIBA,INDILINGA,INDILINGA MARKET,396,2,4,5,175,54,240,21,261,0,O-129-152-01-04-02
MOYO,OBONGI COUNTY,GIMARA,GOPELE,COMMUNITY CENTRE A (A-H),463,3,0,3,159,78,243,53,296,0,O-129-152-02-01-01
MOYO,OBONGI COUNTY,GIMARA,GOPELE,OBONGI P7 SCH,503,4,1,5,113,184,307,17,324,0,O-129-152-02-01-02
MOYO,OBONGI COUNTY,GIMARA,GOPELE,COMMUNITY CENTRE B (I-Z),441,9,1,2,160,92,264,11,275,0,O-129-152-02-01-03
MOYO,OBONGI COUNTY,GIMARA,GOPELE,COMMUNITY CENTRE C,408,12,0,4,150,87,253,43,296,0,O-129-152-02-01-04
MOYO,OBONGI COUNTY,GIMARA,LIWA,LIWA P SCH,453,11,1,3,175,149,339,9,348,0,O-129-152-02-02-01
MOYO,OBONGI COUNTY,GIMARA,LIWA,DELO P SCH,183,7,0,3,90,17,117,10,127,0,O-129-152-02-02-02
MOYO,OBONGI COUNTY,GIMARA,LIWA,JOAGO'S HQTRS,742,15,5,17,286,168,491,31,522,0,O-129-152-02-02-03
MOYO,OBONGI COUNTY,GIMARA,LOMUNGA,LOMUNGA P SCH,359,6,2,5,156,63,232,13,245,0,O-129-152-02-03-01
MOYO,OBONGI COUNTY,GIMARA,LOMUNGA,GOPELE PR SCH,561,12,11,10,253,120,406,18,424,0,O-129-152-02-03-02
MOYO,OBONGI COUNTY,ITULA,LEGU,ITULA PR. SCH,483,4,1,6,196,139,346,14,360,0,O-129-152-03-01-01
MOYO,OBONGI COUNTY,ITULA,LEGU,BELEMELING,462,3,2,7,125,132,269,32,301,0,O-129-152-03-01-02
MOYO,OBONGI COUNTY,ITULA,LEGU,ORINYA,257,0,2,3,74,80,159,12,171,0,O-129-152-03-01-03
MOYO,OBONGI COUNTY,ITULA,PAALUJO,NDIRINDIRI TRADING CENTRE,553,13,2,2,258,61,336,7,343,0,O-129-152-03-02-01
MOYO,OBONGI COUNTY,ITULA,PAALUJO,UKUNI PRODUCTION STORE,272,4,3,5,125,26,163,6,169,0,O-129-152-03-02-02
MOYO,OBONGI COUNTY,ITULA,PALORINYA,TABIBI TRADING CENTRE,327,3,4,1,115,110,233,24,257,0,O-129-152-03-03-01
MOYO,OBONGI COUNTY,ITULA,PALORINYA,PALORINYA PRI SCH,293,4,1,2,109,95,211,16,227,0,O-129-152-03-03-02
MOYO,OBONGI COUNTY,ITULA,UBBI,IBOA MARKET,317,5,3,0,89,110,207,16,223,0,O-129-152-03-04-01
MOYO,OBONGI COUNTY,ITULA,UBBI,ANDRA,260,7,2,3,79,110,201,8,209,0,O-129-152-03-04-02
MOYO,OBONGI COUNTY,ITULA,WAKA,DEMBGELE SUB-PARISH HQTRS,332,4,0,0,121,103,228,13,241,0,O-129-152-03-05-01
MOYO,OBONGI COUNTY,ITULA,WAKA,WAKA MARKET,309,14,10,17,145,23,209,21,230,0,O-129-152-03-05-02
ARUA,MADI-OKOLLO COUNTY,OFFAKA,ADRAA,ADRAA A,796,27,7,4,344,171,553,34,587,0,O-133-9-01-01-01
ARUA,MADI-OKOLLO COUNTY,OFFAKA,ADRAA,ADRAA B,248,4,3,3,100,37,147,40,187,0,O-133-9-01-01-02
ARUA,MADI-OKOLLO COUNTY,OFFAKA,ELIBU,ELIBU A,629,23,9,12,250,127,421,38,459,0,O-133-9-01-02-01
ARUA,MADI-OKOLLO COUNTY,OFFAKA,ELIBU,ELIBU B,695,23,2,10,258,189,482,25,507,0,O-133-9-01-02-02
ARUA,MADI-OKOLLO COUNTY,OFFAKA,OCEBU,OCEBU A,663,27,10,19,229,181,466,12,478,0,O-133-9-01-03-01
ARUA,MADI-OKOLLO COUNTY,OFFAKA,OCEBU,OCEBU B,314,9,5,8,111,99,232,20,252,0,O-133-9-01-03-02
ARUA,MADI-OKOLLO COUNTY,OFFAKA,OMBACHI,OMBACHI,675,10,6,12,365,79,472,32,504,0,O-133-9-01-04-01
ARUA,MADI-OKOLLO COUNTY,OFFAKA,OMU,OMUA A,775,8,4,13,375,112,512,27,539,0,O-133-9-01-05-01
ARUA,MADI-OKOLLO COUNTY,OFFAKA,OMU,OMUA B,403,6,4,2,171,107,290,11,301,0,O-133-9-01-05-02
ARUA,MADI-OKOLLO COUNTY,OFFAKA,ORIBU,NYANYABU/PAMURA,621,12,9,9,241,189,460,12,472,0,O-133-9-01-06-01
ARUA,MADI-OKOLLO COUNTY,OFFAKA,ORIBU,OCUBU/OMVULVO/ALIBU,555,10,1,4,269,111,395,24,419,0,O-133-9-01-06-02
ARUA,MADI-OKOLLO COUNTY,OFFAKA,ORIBU,NDU/OMVULVO/PAJO,433,7,5,6,165,154,337,9,346,0,O-133-9-01-06-03
ARUA,MADI-OKOLLO COUNTY,OGOKO,AYAVU,AYAVU (A-C),491,4,0,1,154,44,203,58,261,0,O-133-9-02-01-01
ARUA,MADI-OKOLLO COUNTY,OGOKO,AYAVU,YACHI,506,9,1,4,229,22,265,13,278,0,O-133-9-02-01-02
ARUA,MADI-OKOLLO COUNTY,OGOKO,AYAVU,AYAVU (D-Z),452,7,0,4,147,45,203,20,223,0,O-133-9-02-01-03
ARUA,MADI-OKOLLO COUNTY,OGOKO,ENYIO,ENYIO/AYAVU,602,14,5,15,231,93,358,25,383,0,O-133-9-02-02-01
ARUA,MADI-OKOLLO COUNTY,OGOKO,OLALI,OLALI A,647,7,5,6,315,82,415,36,451,0,O-133-9-02-03-01
ARUA,MADI-OKOLLO COUNTY,OGOKO,OLALI,OLALI B,349,6,3,0,177,57,243,11,254,0,O-133-9-02-03-02
ARUA,MADI-OKOLLO COUNTY,OGOKO,PAMYARA,PAMYARA A,280,5,2,2,122,55,186,13,199,0,O-133-9-02-04-01
ARUA,MADI-OKOLLO COUNTY,OGOKO,PAMYARA,PAMVARA B,506,10,11,9,147,130,307,28,335,0,O-133-9-02-04-02
ARUA,MADI-OKOLLO COUNTY,OGOKO,PANDUKU,PANDUKU/PARADOK B,243,4,4,2,110,37,157,34,191,0,O-133-9-02-05-01
ARUA,MADI-OKOLLO COUNTY,OGOKO,PANDUKU,PANDUKU/PARABOK C,225,4,1,0,113,16,134,0,134,0,O-133-9-02-05-02
ARUA,MADI-OKOLLO COUNTY,OGOKO,PARABOK,PANDUKU/PARABOK A,565,12,4,11,195,41,263,18,281,0,O-133-9-02-06-01
ARUA,MADI-OKOLLO COUNTY,OGOKO,PARABOK,PARABOK (A-L),590,16,3,14,211,97,341,29,370,0,O-133-9-02-06-02
ARUA,MADI-OKOLLO COUNTY,OGOKO,PARABOK,PARABOK (M-Z),480,8,1,4,192,66,271,29,300,0,O-133-9-02-06-03
ARUA,MADI-OKOLLO COUNTY,OKOLLO,AJIBU,ODRUBU/OLII,513,16,1,7,266,67,357,34,391,0,O-133-9-03-01-01
ARUA,MADI-OKOLLO COUNTY,OKOLLO,AJIBU,ZABU/OLII,772,18,8,6,337,99,468,0,468,0,O-133-9-03-01-02
ARUA,MADI-OKOLLO COUNTY,OKOLLO,BAITO,BAIYA,745,22,5,8,305,119,459,18,477,0,O-133-9-03-02-01
ARUA,MADI-OKOLLO COUNTY,OKOLLO,BAITO,ADRIBU/AJIBU/BAITO/ENDEBU,827,14,8,8,224,177,431,38,469,0,O-133-9-03-02-02
ARUA,MADI-OKOLLO COUNTY,OKOLLO,BAITO,ODUUJO,221,5,3,5,98,54,165,6,171,0,O-133-9-03-02-03
ARUA,MADI-OKOLLO COUNTY,OKOLLO,OKOLLO,OKOLLO A,927,12,7,4,414,135,572,37,609,0,O-133-9-03-03-01
ARUA,MADI-OKOLLO COUNTY,OKOLLO,OKOLLO,OKOLLO B,476,11,5,3,244,49,312,16,328,0,O-133-9-03-03-02
ARUA,MADI-OKOLLO COUNTY,OKOLLO,OKOLLO,OKOLLO C,226,4,3,4,94,56,161,11,172,0,O-133-9-03-03-03
ARUA,MADI-OKOLLO COUNTY,OKOLLO,OKOLLO,OKOLLO D,146,1,1,1,76,21,100,6,106,0,O-133-9-03-03-04
ARUA,MADI-OKOLLO COUNTY,OKOLLO,ONYOMU,BARIBU/PAMVA/ONYOMU,462,10,4,8,207,62,291,34,325,0,O-133-9-03-04-01
ARUA,MADI-OKOLLO COUNTY,RHINO CAMP,ANIPI,MARIZE,485,5,5,13,165,96,284,23,307,0,O-133-9-04-01-01
ARUA,MADI-OKOLLO COUNTY,RHINO CAMP,ANIPI,PILIA A,678,15,4,7,210,153,389,18,407,0,O-133-9-04-01-02
ARUA,MADI-OKOLLO COUNTY,RHINO CAMP,AWUVU,PALAYI/NDARA,529,16,9,8,187,182,402,42,444,0,O-133-9-04-02-01
ARUA,MADI-OKOLLO COUNTY,RHINO CAMP,AWUVU,NDARA/PALAYI,719,5,3,5,243,152,408,25,433,0,O-133-9-04-02-02
ARUA,MADI-OKOLLO COUNTY,RHINO CAMP,BANDILI,PILIA B,366,8,2,6,175,29,220,12,232,0,O-133-9-04-03-01
ARUA,MADI-OKOLLO COUNTY,RHINO CAMP,ERAMVA,OSIOZE,911,5,1,3,298,189,496,33,529,0,O-133-9-04-04-01
ARUA,MADI-OKOLLO COUNTY,RHINO CAMP,ERAMVA,JANDUA,733,6,8,9,260,191,474,24,498,0,O-133-9-04-04-02
ARUA,MADI-OKOLLO COUNTY,RHINO CAMP,GBULUKUATUNI,EMVEA/ANUA A,624,12,7,7,259,78,363,28,391,0,O-133-9-04-05-01
ARUA,MADI-OKOLLO COUNTY,RHINO CAMP,GBULUKUATUNI,EMVEA/ANUA D,403,10,1,7,143,47,208,19,227,0,O-133-9-04-05-02
ARUA,MADI-OKOLLO COUNTY,RHINO CAMP,MANAGO,EMVEA/ANUA C,504,14,2,8,202,76,302,16,318,0,O-133-9-04-06-01
ARUA,MADI-OKOLLO COUNTY,RIGBO,ALIBA,ALIBA (A-B),518,5,7,15,191,66,284,24,308,0,O-133-9-05-01-01
ARUA,MADI-OKOLLO COUNTY,RIGBO,ALIBA,ALIBA (C-Z),627,7,6,18,245,89,365,9,374,0,O-133-9-05-01-02
ARUA,MADI-OKOLLO COUNTY,RIGBO,ALIBA,ALIBA B,567,11,4,13,163,133,324,36,360,0,O-133-9-05-01-03
ARUA,MADI-OKOLLO COUNTY,RIGBO,EWANGA,DUMUA A,499,4,2,13,127,134,280,11,291,0,O-133-9-05-02-01
ARUA,MADI-OKOLLO COUNTY,RIGBO,EWANGA,DUMUA B,324,6,2,9,91,64,172,15,187,0,O-133-9-05-02-02
ARUA,MADI-OKOLLO COUNTY,RIGBO,KWILI,EMVENGA B,729,16,2,14,257,58,347,23,370,0,O-133-9-05-03-01
ARUA,MADI-OKOLLO COUNTY,RIGBO,LUBA,ONERO C (E-Z),515,9,2,6,179,125,321,16,337,0,O-133-9-05-04-01
ARUA,MADI-OKOLLO COUNTY,RIGBO,LUBA,ONERE B,242,3,3,3,91,47,147,7,154,0,O-133-9-05-04-02
ARUA,MADI-OKOLLO COUNTY,RIGBO,LUBA,ONERE C (A-C),465,7,3,8,200,156,374,17,391,0,O-133-9-05-04-03
ARUA,MADI-OKOLLO COUNTY,RIGBO,OCEA,ONERE A/B,334,6,0,4,79,68,157,0,157,0,O-133-9-05-05-01
ARUA,MADI-OKOLLO COUNTY,RIGBO,ODOI,ODOYI,934,10,8,15,290,237,560,19,579,0,O-133-9-05-06-01
ARUA,MADI-OKOLLO COUNTY,RIGBO,ODUBU,EMVENGA (A-C),378,5,0,8,184,65,262,32,294,0,O-133-9-05-07-01
ARUA,MADI-OKOLLO COUNTY,RIGBO,ODUBU,EMVENGA (D-Z),408,10,1,13,210,58,292,13,305,0,O-133-9-05-07-02
ARUA,MADI-OKOLLO COUNTY,RIGBO,ROGA,ROGA,552,8,5,16,182,91,302,46,348,0,O-133-9-05-08-01
ARUA,MADI-OKOLLO COUNTY,ULEPPI,ARARA,AWIRIAMVA/ARARA,707,10,7,10,180,311,518,37,555,0,O-133-9-06-01-01
ARUA,MADI-OKOLLO COUNTY,ULEPPI,KATIYI,KATIYI A,563,12,3,13,113,293,434,9,443,0,O-133-9-06-02-01
ARUA,MADI-OKOLLO COUNTY,ULEPPI,KATIYI,KATIYI B,581,7,3,4,103,272,389,15,404,0,O-133-9-06-02-02
ARUA,MADI-OKOLLO COUNTY,ULEPPI,LAWURA,AMBARU,397,9,1,1,129,128,268,36,304,0,O-133-9-06-03-01
ARUA,MADI-OKOLLO COUNTY,ULEPPI,LAWURA,ULEPPI TRADING CENTRE,942,8,1,4,221,334,568,27,595,0,O-133-9-06-03-02
KAABONG,DODOTH COUNTY,KAPEDO,KAPEDO,KADEPO,1077,20,12,19,98,388,537,54,591,0,O-134-93-01-01-01
KAABONG,DODOTH COUNTY,KAPEDO,KAPEDO,KOMOLICER,622,7,4,1,12,560,584,17,601,0,O-134-93-01-01-02
KAABONG,DODOTH COUNTY,KAPEDO,KAPEDO,NALAKAS P/S,355,8,5,6,34,275,328,17,345,0,O-134-93-01-01-03
KAABONG,DODOTH COUNTY,KAPEDO,KAWALAKOL,KOKORO,612,6,6,12,5,279,308,9,317,0,O-134-93-01-02-01
KAABONG,DODOTH COUNTY,KAPEDO,KAWALAKOL,NAOYAGUM-NATIRA,453,14,13,22,23,189,261,67,328,0,O-134-93-01-02-02
KAABONG,DODOTH COUNTY,KAPEDO,KAWALAKOL,NASEPERWAE,425,3,3,4,18,206,234,15,249,0,O-134-93-01-02-03
KAABONG,DODOTH COUNTY,KAPEDO,KAWALAKOL,LOMANOK,277,6,16,9,6,145,182,19,201,0,O-134-93-01-02-04
KAABONG,DODOTH COUNTY,KAPEDO,KOCHOLO,LOPWAA,40,0,1,1,26,7,35,5,40,0,O-134-93-01-03-01
KAABONG,DODOTH COUNTY,KAPEDO,KOCHOLO,NAKUNGUROIT,206,3,0,21,6,86,116,10,126,0,O-134-93-01-03-02
KAABONG,DODOTH COUNTY,KAPEDO,KUMET,TULIANYANG,229,4,0,3,10,66,83,6,89,0,O-134-93-01-04-01
KAABONG,DODOTH COUNTY,KAPEDO,LOKIAL,LOKIAL CAMP,357,3,6,17,9,286,321,17,338,0,O-134-93-01-05-01
KAABONG,DODOTH COUNTY,KAPEDO,NAKITEMYET (LOTWA,LOESE MUDANG,105,0,0,0,5,71,76,9,85,0,O-134-93-01-06-01
KAABONG,DODOTH COUNTY,KAPEDO,SANGAR,LONGEREP PRIMARY SCHOOL,432,1,1,1,1,167,171,10,181,0,O-134-93-01-07-01
KAABONG,DODOTH COUNTY,KAPEDO,SANGAR,TORE,378,8,10,12,22,65,117,30,147,0,O-134-93-01-07-02
KAABONG,DODOTH COUNTY,NAPORE (KARENGA),KARENGA,KAMUKOI(A-L),750,9,10,33,116,214,382,24,406,0,O-134-93-02-01-01
KAABONG,DODOTH COUNTY,NAPORE (KARENGA),KARENGA,KANGOLE,518,34,18,27,70,292,441,9,450,0,O-134-93-02-01-02
KAABONG,DODOTH COUNTY,NAPORE (KARENGA),KARENGA,ITONGOPED,292,6,4,9,47,121,187,13,200,0,O-134-93-02-01-03
KAABONG,DODOTH COUNTY,NAPORE (KARENGA),KARENGA,KAMUKOI(M-Z),398,12,6,16,59,135,228,18,246,0,O-134-93-02-01-04
KAABONG,DODOTH COUNTY,NAPORE (KARENGA),KARENGA,KAMUKOI OUTSIDE Q.GUARD,94,0,0,1,6,9,16,4,20,0,O-134-93-02-01-05
KAABONG,DODOTH COUNTY,NAPORE (KARENGA),LOBALANGIT,KAKWANGA,230,8,11,18,11,141,189,15,204,0,O-134-93-02-02-01
KAABONG,DODOTH COUNTY,NAPORE (KARENGA),LOBALANGIT,LOBALANGIT,612,36,19,23,61,235,374,25,399,0,O-134-93-02-02-02
KAABONG,DODOTH COUNTY,NAPORE (KARENGA),LOBALANGIT,SARACOM,400,10,8,10,9,206,243,38,281,0,O-134-93-02-02-03
KAABONG,DODOTH COUNTY,NAPORE (KARENGA),LOKORI,KIDEPO VALLEY N. PARK,169,0,2,6,41,49,98,2,100,0,O-134-93-02-03-01
KAABONG,DODOTH COUNTY,NAPORE (KARENGA),LOKORI,LOKORI PRIMARY SCHOOL,637,14,7,15,69,203,308,11,319,0,O-134-93-02-03-02
KAABONG,DODOTH COUNTY,NAPORE (KARENGA),LOKORI,NANGOLEMORU,350,27,20,20,45,95,207,16,223,0,O-134-93-02-03-03
KAABONG,DODOTH COUNTY,NAPORE (KARENGA),LOYORO/NAPORE,LOYORO/NAPORE,601,10,42,13,50,328,443,10,453,0,O-134-93-02-04-01
KAABONG,DODOTH COUNTY,NAPORE (KARENGA),LOYORO/NAPORE,NAKITOIT,414,3,0,5,24,329,361,19,380,0,O-134-93-02-04-02
KAABONG,DODOTH COUNTY,NAPORE (KARENGA),PIRE,PIRE,612,34,16,36,78,151,315,96,411,0,O-134-93-02-05-01
KAABONG,DODOTH COUNTY,NAPORE (KARENGA),PIRE,NAKELYO,373,8,6,16,41,119,190,54,244,0,O-134-93-02-05-02
